Poker Hand #HD1806770066: Hold'em No Limit ($0.05/$0.1) - 2024/06/08 16:51:39
Table 'NLHRed11' 6-max Seat #6 is the button
Seat 1: 5a9e900a ($6.97 in chips)
Seat 2: 348bc029 ($2 in chips)
Seat 3: d81241b3 ($19.73 in chips)
Seat 4: 15df06cd ($6.37 in chips)
Seat 5: b78bc1eb ($10 in chips)
Seat 6: Hero ($16.3 in chips)
5a9e900a: posts small blind $0.05
348bc029: posts big blind $0.1
*** HOLE CARDS ***
Dealt to 5a9e900a 
Dealt to 348bc029 
Dealt to d81241b3 
Dealt to 15df06cd 
Dealt to b78bc1eb 
Dealt to Hero [9h 8c]
d81241b3: raises $0.15 to $0.25
15df06cd: folds
b78bc1eb: folds
Hero: folds
5a9e900a: folds
348bc029: folds
Uncalled bet ($0.15) returned to d81241b3
*** SHOWDOWN ***
d81241b3 collected $0.25 from pot
*** SUMMARY ***
Total pot $0.25 | Rake $0 | Jackpot $0 | Bingo $0 | Fortune $0 | Tax $0
Seat 1: 5a9e900a (small blind) folded before Flop
Seat 2: 348bc029 (big blind) folded before Flop
Seat 3: d81241b3 collected ($0.25)
Seat 4: 15df06cd folded before Flop (didn't bet)
Seat 5: b78bc1eb folded before Flop (didn't bet)
Seat 6: Hero (button) folded before Flop (didn't bet)


Poker Hand #HD1806769895: Hold'em No Limit ($0.05/$0.1) - 2024/06/08 16:50:26
Table 'NLHRed11' 6-max Seat #5 is the button
Seat 1: 5a9e900a ($7.62 in chips)
Seat 3: d81241b3 ($20.38 in chips)
Seat 4: 15df06cd ($5.12 in chips)
Seat 5: b78bc1eb ($10 in chips)
Seat 6: Hero ($16.35 in chips)
Hero: posts small blind $0.05
5a9e900a: posts big blind $0.1
*** HOLE CARDS ***
Dealt to 5a9e900a 
Dealt to d81241b3 
Dealt to 15df06cd 
Dealt to b78bc1eb 
Dealt to Hero [8s Th]
d81241b3: raises $0.15 to $0.25
15df06cd: calls $0.25
b78bc1eb: folds
Hero: folds
5a9e900a: calls $0.15
*** FLOP *** [5d 6d 4s]
5a9e900a: checks
d81241b3: bets $0.4
15df06cd: calls $0.4
5a9e900a: calls $0.4
*** TURN *** [5d 6d 4s] [6h]
5a9e900a: checks
d81241b3: checks
15df06cd: checks
*** RIVER *** [5d 6d 4s 6h] [Qd]
5a9e900a: checks
d81241b3: checks
15df06cd: bets $0.66
5a9e900a: folds
d81241b3: folds
Uncalled bet ($0.66) returned to 15df06cd
*** SHOWDOWN ***
15df06cd collected $1.9 from pot
*** SUMMARY ***
Total pot $2 | Rake $0.1 | Jackpot $0 | Bingo $0 | Fortune $0 | Tax $0
Board [5d 6d 4s 6h Qd]
Seat 1: 5a9e900a (big blind) folded on the River
Seat 3: d81241b3 folded on the River
Seat 4: 15df06cd won ($1.9)
Seat 5: b78bc1eb (button) folded before Flop (didn't bet)
Seat 6: Hero (small blind) folded before Flop


Poker Hand #HD1806769843: Hold'em No Limit ($0.05/$0.1) - 2024/06/08 16:50:02
Table 'NLHRed11' 6-max Seat #4 is the button
Seat 1: 5a9e900a ($7.47 in chips)
Seat 3: d81241b3 ($20.38 in chips)
Seat 4: 15df06cd ($5.12 in chips)
Seat 5: b78bc1eb ($10 in chips)
Seat 6: Hero ($16.45 in chips)
b78bc1eb: posts small blind $0.05
Hero: posts big blind $0.1
*** HOLE CARDS ***
Dealt to 5a9e900a 
Dealt to d81241b3 
Dealt to 15df06cd 
Dealt to b78bc1eb 
Dealt to Hero [7h Kh]
5a9e900a: raises $0.15 to $0.25
d81241b3: folds
15df06cd: folds
b78bc1eb: folds
Hero: folds
Uncalled bet ($0.15) returned to 5a9e900a
*** SHOWDOWN ***
5a9e900a collected $0.25 from pot
*** SUMMARY ***
Total pot $0.25 | Rake $0 | Jackpot $0 | Bingo $0 | Fortune $0 | Tax $0
Seat 1: 5a9e900a collected ($0.25)
Seat 3: d81241b3 folded before Flop (didn't bet)
Seat 4: 15df06cd (button) folded before Flop (didn't bet)
Seat 5: b78bc1eb (small blind) folded before Flop
Seat 6: Hero (big blind) folded before Flop


Poker Hand #HD1806769792: Hold'em No Limit ($0.05/$0.1) - 2024/06/08 16:49:42
Table 'NLHRed11' 6-max Seat #3 is the button
Seat 1: 5a9e900a ($7.47 in chips)
Seat 3: d81241b3 ($20.38 in chips)
Seat 4: 15df06cd ($5.02 in chips)
Seat 5: b78bc1eb ($10 in chips)
Seat 6: Hero ($16.45 in chips)
15df06cd: posts small blind $0.05
b78bc1eb: posts big blind $0.1
*** HOLE CARDS ***
Dealt to 5a9e900a 
Dealt to d81241b3 
Dealt to 15df06cd 
Dealt to b78bc1eb 
Dealt to Hero [5c 7s]
Hero: folds
5a9e900a: folds
d81241b3: folds
15df06cd: raises $0.15 to $0.25
b78bc1eb: folds
Uncalled bet ($0.15) returned to 15df06cd
*** SHOWDOWN ***
15df06cd collected $0.2 from pot
*** SUMMARY ***
Total pot $0.2 | Rake $0 | Jackpot $0 | Bingo $0 | Fortune $0 | Tax $0
Seat 1: 5a9e900a folded before Flop (didn't bet)
Seat 3: d81241b3 (button) folded before Flop (didn't bet)
Seat 4: 15df06cd (small blind) collected ($0.2)
Seat 5: b78bc1eb (big blind) folded before Flop
Seat 6: Hero folded before Flop (didn't bet)


Poker Hand #HD1806769726: Hold'em No Limit ($0.05/$0.1) - 2024/06/08 16:49:11
Table 'NLHRed11' 6-max Seat #1 is the button
Seat 1: 5a9e900a ($7.72 in chips)
Seat 3: d81241b3 ($20.43 in chips)
Seat 4: 15df06cd ($4.74 in chips)
Seat 6: Hero ($16.45 in chips)
d81241b3: posts small blind $0.05
15df06cd: posts big blind $0.1
*** HOLE CARDS ***
Dealt to 5a9e900a 
Dealt to d81241b3 
Dealt to 15df06cd 
Dealt to Hero [6d Ah]
Hero: folds
5a9e900a: raises $0.15 to $0.25
d81241b3: folds
15df06cd: calls $0.15
*** FLOP *** [5d 9d 8s]
15df06cd: checks
5a9e900a: checks
*** TURN *** [5d 9d 8s] [8h]
15df06cd: checks
5a9e900a: checks
*** RIVER *** [5d 9d 8s 8h] [2h]
15df06cd: checks
5a9e900a: checks
15df06cd: shows [Qh 5h] (Pair of Eights and Pair of Fives)
5a9e900a: shows [6c Qc] (Pair of Eights)
*** SHOWDOWN ***
15df06cd collected $0.53 from pot
*** SUMMARY ***
Total pot $0.55 | Rake $0.02 | Jackpot $0 | Bingo $0 | Fortune $0 | Tax $0
Board [5d 9d 8s 8h 2h]
Seat 1: 5a9e900a (button) showed [6c Qc] and lost with Pair of Eights
Seat 3: d81241b3 (small blind) folded before Flop
Seat 4: 15df06cd (big blind) showed [Qh 5h] and won ($0.53) with Pair of Eights and Pair of Fives
Seat 6: Hero folded before Flop (didn't bet)


Poker Hand #HD1806769644: Hold'em No Limit ($0.05/$0.1) - 2024/06/08 16:48:35
Table 'NLHRed11' 6-max Seat #6 is the button
Seat 1: 5a9e900a ($8.14 in chips)
Seat 3: d81241b3 ($20.05 in chips)
Seat 4: 15df06cd ($4.74 in chips)
Seat 6: Hero ($16.45 in chips)
5a9e900a: posts small blind $0.05
d81241b3: posts big blind $0.1
*** HOLE CARDS ***
Dealt to 5a9e900a 
Dealt to d81241b3 
Dealt to 15df06cd 
Dealt to Hero [8d 3d]
15df06cd: folds
Hero: folds
5a9e900a: raises $0.15 to $0.25
d81241b3: calls $0.15
*** FLOP *** [4c Tc Kh]
5a9e900a: bets $0.17
d81241b3: raises $0.53 to $0.7
5a9e900a: folds
Uncalled bet ($0.53) returned to d81241b3
*** SHOWDOWN ***
d81241b3 collected $0.8 from pot
*** SUMMARY ***
Total pot $0.84 | Rake $0.04 | Jackpot $0 | Bingo $0 | Fortune $0 | Tax $0
Board [4c Tc Kh]
Seat 1: 5a9e900a (small blind) folded on the Flop
Seat 3: d81241b3 (big blind) won ($0.8)
Seat 4: 15df06cd folded before Flop (didn't bet)
Seat 6: Hero (button) folded before Flop (didn't bet)


Poker Hand #HD1806769531: Hold'em No Limit ($0.05/$0.1) - 2024/06/08 16:47:39
Table 'NLHRed11' 6-max Seat #4 is the button
Seat 1: 5a9e900a ($8.24 in chips)
Seat 2: 348bc029 ($1.85 in chips)
Seat 3: d81241b3 ($20.05 in chips)
Seat 4: 15df06cd ($3.02 in chips)
Seat 6: Hero ($16.5 in chips)
Hero: posts small blind $0.05
5a9e900a: posts big blind $0.1
*** HOLE CARDS ***
Dealt to 5a9e900a 
Dealt to 348bc029 
Dealt to d81241b3 
Dealt to 15df06cd 
Dealt to Hero [Kd 8c]
348bc029: raises $0.25 to $0.35
d81241b3: folds
15df06cd: raises $0.85 to $1.2
Hero: folds
5a9e900a: folds
348bc029: raises $0.65 to $1.85 and is all-in
15df06cd: calls $0.65
348bc029: shows [Qs Qh]
15df06cd: shows [Ad Ac]
*** FIRST FLOP *** [Kh 3d 2c]
*** FIRST TURN *** [Kh 3d 2c] [6c]
*** FIRST RIVER *** [Kh 3d 2c 6c] [Jh]
*** SECOND FLOP *** [Ks 7s 5c]
*** SECOND TURN *** [Ks 7s 5c] [As]
*** SECOND RIVER *** [Ks 7s 5c As] [2h]
*** FIRST SHOWDOWN ***
15df06cd collected $1.79 from pot
*** SECOND SHOWDOWN ***
15df06cd collected $1.78 from pot
*** SUMMARY ***
Total pot $3.85 | Rake $0.18 | Jackpot $0.1 | Bingo $0 | Fortune $0 | Tax $0
Hand was run two times
FIRST Board [Kh 3d 2c 6c Jh]
SECOND Board [Ks 7s 5c As 2h]
Seat 1: 5a9e900a (big blind) folded before Flop
Seat 2: 348bc029 showed [Qs Qh] and lost with Pair of Queens, and lost with Pair of Queens
Seat 3: d81241b3 folded before Flop (didn't bet)
Seat 4: 15df06cd (button) showed [Ad Ac] and won ($1.79) with Pair of Aces, and won ($1.78) with Three Aces
Seat 6: Hero (small blind) folded before Flop


Poker Hand #HD1806769411: Hold'em No Limit ($0.05/$0.1) - 2024/06/08 16:46:46
Table 'NLHRed11' 6-max Seat #3 is the button
Seat 1: 5a9e900a ($8.24 in chips)
Seat 2: 348bc029 ($2 in chips)
Seat 3: d81241b3 ($20.05 in chips)
Seat 4: 15df06cd ($3.12 in chips)
Seat 6: Hero ($16.26 in chips)
15df06cd: posts small blind $0.05
Hero: posts big blind $0.1
348bc029: posts big blind $0.1
348bc029: posts missed blind $0.05
*** HOLE CARDS ***
Dealt to 5a9e900a 
Dealt to 348bc029 
Dealt to d81241b3 
Dealt to 15df06cd 
Dealt to Hero [4s 3s]
5a9e900a: folds
348bc029: checks
d81241b3: folds
15df06cd: calls $0.05
Hero: checks
*** FLOP *** [Qh Ts Qc]
15df06cd: checks
Hero: checks
348bc029: checks
*** TURN *** [Qh Ts Qc] [Tc]
15df06cd: checks
Hero: bets $0.12
348bc029: folds
15df06cd: folds
Uncalled bet ($0.12) returned to Hero
*** SHOWDOWN ***
Hero collected $0.34 from pot
*** SUMMARY ***
Total pot $0.35 | Rake $0.01 | Jackpot $0 | Bingo $0 | Fortune $0 | Tax $0
Board [Qh Ts Qc Tc]
Seat 1: 5a9e900a folded before Flop (didn't bet)
Seat 2: 348bc029 folded on the Turn
Seat 3: d81241b3 (button) folded before Flop (didn't bet)
Seat 4: 15df06cd (small blind) folded on the Turn
Seat 6: Hero (big blind) won ($0.34)


Poker Hand #HD1806769185: Hold'em No Limit ($0.05/$0.1) - 2024/06/08 16:45:08
Table 'NLHRed11' 6-max Seat #1 is the button
Seat 1: 5a9e900a ($8.44 in chips)
Seat 3: d81241b3 ($20.1 in chips)
Seat 4: 15df06cd ($3.32 in chips)
Seat 5: c909ecba ($15.64 in chips)
Seat 6: Hero ($16.26 in chips)
d81241b3: posts small blind $0.05
15df06cd: posts big blind $0.1
*** HOLE CARDS ***
Dealt to 5a9e900a 
Dealt to d81241b3 
Dealt to 15df06cd 
Dealt to c909ecba 
Dealt to Hero [8s 5s]
c909ecba: raises $0.1 to $0.2
Hero: folds
5a9e900a: calls $0.2
d81241b3: folds
15df06cd: calls $0.1
*** FLOP *** [4c 7s 6c]
15df06cd: checks
c909ecba: checks
5a9e900a: checks
*** TURN *** [4c 7s 6c] [Qc]
15df06cd: checks
c909ecba: bets $0.49
5a9e900a: folds
15df06cd: folds
Uncalled bet ($0.49) returned to c909ecba
*** SHOWDOWN ***
c909ecba collected $0.62 from pot
*** SUMMARY ***
Total pot $0.65 | Rake $0.03 | Jackpot $0 | Bingo $0 | Fortune $0 | Tax $0
Board [4c 7s 6c Qc]
Seat 1: 5a9e900a (button) folded on the Turn
Seat 3: d81241b3 (small blind) folded before Flop
Seat 4: 15df06cd (big blind) folded on the Turn
Seat 5: c909ecba won ($0.62)
Seat 6: Hero folded before Flop (didn't bet)


Poker Hand #HD1806769106: Hold'em No Limit ($0.05/$0.1) - 2024/06/08 16:44:32
Table 'NLHRed11' 6-max Seat #6 is the button
Seat 1: 5a9e900a ($7.64 in chips)
Seat 3: d81241b3 ($20.2 in chips)
Seat 4: 15df06cd ($4.1 in chips)
Seat 5: c909ecba ($15.64 in chips)
Seat 6: Hero ($16.26 in chips)
5a9e900a: posts small blind $0.05
d81241b3: posts big blind $0.1
*** HOLE CARDS ***
Dealt to 5a9e900a 
Dealt to d81241b3 
Dealt to 15df06cd 
Dealt to c909ecba 
Dealt to Hero [Js 7c]
15df06cd: raises $0.1 to $0.2
c909ecba: folds
Hero: folds
5a9e900a: raises $0.25 to $0.45
d81241b3: folds
15df06cd: calls $0.25
*** FLOP *** [4d 3c 4s]
5a9e900a: bets $0.33
15df06cd: calls $0.33
*** TURN *** [4d 3c 4s] [8d]
5a9e900a: bets $0.83
15df06cd: folds
Uncalled bet ($0.83) returned to 5a9e900a
*** SHOWDOWN ***
5a9e900a collected $1.58 from pot
*** SUMMARY ***
Total pot $1.66 | Rake $0.08 | Jackpot $0 | Bingo $0 | Fortune $0 | Tax $0
Board [4d 3c 4s 8d]
Seat 1: 5a9e900a (small blind) won ($1.58)
Seat 3: d81241b3 (big blind) folded before Flop
Seat 4: 15df06cd folded on the Turn
Seat 5: c909ecba folded before Flop (didn't bet)
Seat 6: Hero (button) folded before Flop (didn't bet)


Poker Hand #HD1806768874: Hold'em No Limit ($0.05/$0.1) - 2024/06/08 16:42:46
Table 'NLHRed11' 6-max Seat #5 is the button
Seat 1: 5a9e900a ($9.62 in chips)
Seat 2: 348bc029 ($3.28 in chips)
Seat 3: d81241b3 ($20.4 in chips)
Seat 4: 15df06cd ($4.1 in chips)
Seat 5: c909ecba ($10.66 in chips)
Seat 6: Hero ($16.31 in chips)
Hero: posts small blind $0.05
5a9e900a: posts big blind $0.1
*** HOLE CARDS ***
Dealt to 5a9e900a 
Dealt to 348bc029 
Dealt to d81241b3 
Dealt to 15df06cd 
Dealt to c909ecba 
Dealt to Hero [Jh 3c]
348bc029: calls $0.1
d81241b3: raises $0.1 to $0.2
15df06cd: folds
c909ecba: raises $0.7 to $0.9
Hero: folds
5a9e900a: raises $1.08 to $1.98
348bc029: raises $1.3 to $3.28 and is all-in
d81241b3: folds
c909ecba: raises $7.38 to $10.66 and is all-in
5a9e900a: folds
Uncalled bet ($7.38) returned to c909ecba
c909ecba: shows [Ah Kh]
348bc029: shows [8s 8h]
*** FLOP *** [Ac 5s Th]
*** TURN *** [Ac 5s Th] [2d]
*** RIVER *** [Ac 5s Th 2d] [2h]
d81241b3: shows [Ad] (Pair of Aces and Pair of Twos)
*** SHOWDOWN ***
c909ecba collected $8.26 from pot
*** SUMMARY ***
Total pot $8.79 | Rake $0.43 | Jackpot $0.1 | Bingo $0 | Fortune $0 | Tax $0
Board [Ac 5s Th 2d 2h]
Seat 1: 5a9e900a (big blind) folded before Flop
Seat 2: 348bc029 showed [8s 8h] and lost with Pair of Eights and Pair of Twos
Seat 3: d81241b3 folded before Flop
Seat 4: 15df06cd folded before Flop (didn't bet)
Seat 5: c909ecba (button) showed [Ah Kh] and won ($8.26) with Pair of Aces and Pair of Twos
Seat 6: Hero (small blind) folded before Flop


Poker Hand #HD1806768767: Hold'em No Limit ($0.05/$0.1) - 2024/06/08 16:41:54
Table 'NLHRed11' 6-max Seat #4 is the button
Seat 1: 5a9e900a ($9.62 in chips)
Seat 2: 348bc029 ($3.14 in chips)
Seat 3: d81241b3 ($20.4 in chips)
Seat 4: 15df06cd ($4.1 in chips)
Seat 5: c909ecba ($10.71 in chips)
Seat 6: Hero ($16.41 in chips)
c909ecba: posts small blind $0.05
Hero: posts big blind $0.1
*** HOLE CARDS ***
Dealt to 5a9e900a 
Dealt to 348bc029 
Dealt to d81241b3 
Dealt to 15df06cd 
Dealt to c909ecba 
Dealt to Hero [Ks 4h]
5a9e900a: folds
348bc029: calls $0.1
d81241b3: folds
15df06cd: folds
c909ecba: folds
Hero: checks
*** FLOP *** [As 5h 6d]
Hero: checks
348bc029: checks
*** TURN *** [As 5h 6d] [Qd]
Hero: checks
348bc029: bets $0.19
Hero: folds
Uncalled bet ($0.19) returned to 348bc029
*** SHOWDOWN ***
348bc029 collected $0.24 from pot
*** SUMMARY ***
Total pot $0.25 | Rake $0.01 | Jackpot $0 | Bingo $0 | Fortune $0 | Tax $0
Board [As 5h 6d Qd]
Seat 1: 5a9e900a folded before Flop (didn't bet)
Seat 2: 348bc029 won ($0.24)
Seat 3: d81241b3 folded before Flop (didn't bet)
Seat 4: 15df06cd (button) folded before Flop (didn't bet)
Seat 5: c909ecba (small blind) folded before Flop
Seat 6: Hero (big blind) folded on the Turn


Poker Hand #HD1806768657: Hold'em No Limit ($0.05/$0.1) - 2024/06/08 16:41:02
Table 'NLHRed11' 6-max Seat #3 is the button
Seat 1: 5a9e900a ($9.62 in chips)
Seat 2: 348bc029 ($3.14 in chips)
Seat 3: d81241b3 ($20.4 in chips)
Seat 4: 15df06cd ($4.52 in chips)
Seat 5: c909ecba ($10.33 in chips)
Seat 6: Hero ($16.41 in chips)
15df06cd: posts small blind $0.05
c909ecba: posts big blind $0.1
*** HOLE CARDS ***
Dealt to 5a9e900a 
Dealt to 348bc029 
Dealt to d81241b3 
Dealt to 15df06cd 
Dealt to c909ecba 
Dealt to Hero [2d 8d]
Hero: folds
5a9e900a: folds
348bc029: folds
d81241b3: folds
15df06cd: raises $0.15 to $0.25
c909ecba: calls $0.15
*** FLOP *** [Qd 9s 7c]
15df06cd: bets $0.17
c909ecba: raises $0.42 to $0.59
15df06cd: folds
Uncalled bet ($0.42) returned to c909ecba
*** SHOWDOWN ***
c909ecba collected $0.8 from pot
*** SUMMARY ***
Total pot $0.84 | Rake $0.04 | Jackpot $0 | Bingo $0 | Fortune $0 | Tax $0
Board [Qd 9s 7c]
Seat 1: 5a9e900a folded before Flop (didn't bet)
Seat 2: 348bc029 folded before Flop (didn't bet)
Seat 3: d81241b3 (button) folded before Flop (didn't bet)
Seat 4: 15df06cd (small blind) folded on the Flop
Seat 5: c909ecba (big blind) won ($0.8)
Seat 6: Hero folded before Flop (didn't bet)


Poker Hand #HD1806768580: Hold'em No Limit ($0.05/$0.1) - 2024/06/08 16:40:27
Table 'NLHRed11' 6-max Seat #2 is the button
Seat 1: 5a9e900a ($9.62 in chips)
Seat 2: 348bc029 ($3.34 in chips)
Seat 3: d81241b3 ($20.45 in chips)
Seat 4: 15df06cd ($4.62 in chips)
Seat 5: c909ecba ($10 in chips)
Seat 6: Hero ($16.41 in chips)
d81241b3: posts small blind $0.05
15df06cd: posts big blind $0.1
*** HOLE CARDS ***
Dealt to 5a9e900a 
Dealt to 348bc029 
Dealt to d81241b3 
Dealt to 15df06cd 
Dealt to c909ecba 
Dealt to Hero [Ac 5s]
c909ecba: raises $0.1 to $0.2
Hero: folds
5a9e900a: folds
348bc029: calls $0.2
d81241b3: folds
15df06cd: folds
*** FLOP *** [Qd Kd Ah]
c909ecba: bets $0.19
348bc029: folds
Uncalled bet ($0.19) returned to c909ecba
*** SHOWDOWN ***
c909ecba collected $0.53 from pot
*** SUMMARY ***
Total pot $0.55 | Rake $0.02 | Jackpot $0 | Bingo $0 | Fortune $0 | Tax $0
Board [Qd Kd Ah]
Seat 1: 5a9e900a folded before Flop (didn't bet)
Seat 2: 348bc029 (button) folded on the Flop
Seat 3: d81241b3 (small blind) folded before Flop
Seat 4: 15df06cd (big blind) folded before Flop
Seat 5: c909ecba won ($0.53)
Seat 6: Hero folded before Flop (didn't bet)


Poker Hand #HD1806768446: Hold'em No Limit ($0.05/$0.1) - 2024/06/08 16:39:19
Table 'NLHRed11' 6-max Seat #1 is the button
Seat 1: 5a9e900a ($10.75 in chips)
Seat 2: 348bc029 ($1.7 in chips)
Seat 3: d81241b3 ($20.55 in chips)
Seat 4: 15df06cd ($5.17 in chips)
Seat 5: c909ecba ($10 in chips)
Seat 6: Hero ($16.41 in chips)
348bc029: posts small blind $0.05
d81241b3: posts big blind $0.1
*** HOLE CARDS ***
Dealt to 5a9e900a 
Dealt to 348bc029 
Dealt to d81241b3 
Dealt to 15df06cd 
Dealt to c909ecba 
Dealt to Hero [7d 7s]
15df06cd: raises $0.1 to $0.2
c909ecba: folds
Hero: folds
5a9e900a: raises $0.35 to $0.55
348bc029: calls $0.5
d81241b3: folds
15df06cd: calls $0.35
*** FLOP *** [2h 4d 9s]
348bc029: checks
15df06cd: checks
5a9e900a: checks
*** TURN *** [2h 4d 9s] [8h]
348bc029: bets $0.58
15df06cd: folds
5a9e900a: calls $0.58
*** RIVER *** [2h 4d 9s 8h] [5c]
348bc029: bets $0.57 and is all-in
5a9e900a: folds
Uncalled bet ($0.57) returned to 348bc029
*** SHOWDOWN ***
348bc029 collected $2.77 from pot
*** SUMMARY ***
Total pot $2.91 | Rake $0.14 | Jackpot $0 | Bingo $0 | Fortune $0 | Tax $0
Board [2h 4d 9s 8h 5c]
Seat 1: 5a9e900a (button) folded on the River
Seat 2: 348bc029 (small blind) won ($2.77)
Seat 3: d81241b3 (big blind) folded before Flop
Seat 4: 15df06cd folded on the Turn
Seat 5: c909ecba folded before Flop (didn't bet)
Seat 6: Hero folded before Flop (didn't bet)


Poker Hand #HD1806768299: Hold'em No Limit ($0.05/$0.1) - 2024/06/08 16:38:08
Table 'NLHRed11' 6-max Seat #6 is the button
Seat 1: 5a9e900a ($10.02 in chips)
Seat 2: 348bc029 ($1.9 in chips)
Seat 3: d81241b3 ($20.55 in chips)
Seat 4: 15df06cd ($5.77 in chips)
Seat 5: c909ecba ($10 in chips)
Seat 6: Hero ($16.41 in chips)
5a9e900a: posts small blind $0.05
348bc029: posts big blind $0.1
*** HOLE CARDS ***
Dealt to 5a9e900a 
Dealt to 348bc029 
Dealt to d81241b3 
Dealt to 15df06cd 
Dealt to c909ecba 
Dealt to Hero [Ac 5d]
d81241b3: folds
15df06cd: raises $0.1 to $0.2
c909ecba: folds
Hero: folds
5a9e900a: calls $0.15
348bc029: calls $0.1
*** FLOP *** [Qc 4c 8d]
5a9e900a: checks
348bc029: checks
15df06cd: checks
*** TURN *** [Qc 4c 8d] [Ts]
5a9e900a: checks
348bc029: checks
15df06cd: bets $0.4
5a9e900a: calls $0.4
348bc029: folds
*** RIVER *** [Qc 4c 8d Ts] [Kc]
5a9e900a: checks
15df06cd: checks
5a9e900a: shows [Th 9c] (Pair of Tens)
15df06cd: shows [9d 6d] (King-High)
*** SHOWDOWN ***
5a9e900a collected $1.33 from pot
*** SUMMARY ***
Total pot $1.4 | Rake $0.07 | Jackpot $0 | Bingo $0 | Fortune $0 | Tax $0
Board [Qc 4c 8d Ts Kc]
Seat 1: 5a9e900a (small blind) showed [Th 9c] and won ($1.33) with Pair of Tens
Seat 2: 348bc029 (big blind) folded on the Turn
Seat 3: d81241b3 folded before Flop (didn't bet)
Seat 4: 15df06cd showed [9d 6d] and lost with King-High
Seat 5: c909ecba folded before Flop (didn't bet)
Seat 6: Hero (button) folded before Flop (didn't bet)


Poker Hand #HD1806768157: Hold'em No Limit ($0.05/$0.1) - 2024/06/08 16:37:00
Table 'NLHRed11' 6-max Seat #5 is the button
Seat 1: 5a9e900a ($10.12 in chips)
Seat 2: 348bc029 ($2 in chips)
Seat 3: d81241b3 ($20.8 in chips)
Seat 4: 15df06cd ($4.95 in chips)
Seat 5: c909ecba ($10 in chips)
Seat 6: Hero ($16.46 in chips)
Hero: posts small blind $0.05
5a9e900a: posts big blind $0.1
348bc029: posts big blind $0.1
*** HOLE CARDS ***
Dealt to 5a9e900a 
Dealt to 348bc029 
Dealt to d81241b3 
Dealt to 15df06cd 
Dealt to c909ecba 
Dealt to Hero [7d Js]
348bc029: checks
d81241b3: raises $0.15 to $0.25
15df06cd: raises $0.65 to $0.9
c909ecba: folds
Hero: folds
5a9e900a: raises $1.65 to $2.55
348bc029: folds
d81241b3: folds
15df06cd: calls $1.65
*** FLOP *** [6c 7s 9d]
5a9e900a: bets $2.75
15df06cd: calls $2.4 and is all-in
Uncalled bet ($0.35) returned to 5a9e900a
5a9e900a: shows [Ah Kc] (Ace-High)
15df06cd: shows [Kd Ad] (Ace-High)
*** TURN *** [6c 7s 9d] [5d]
*** RIVER *** [6c 7s 9d 5d] [5s]
15df06cd: Receives Cashout ($0.92)
*** SHOWDOWN ***
5a9e900a collected $4.85 from pot
15df06cd collected $4.85 from pot
*** SUMMARY ***
Total pot $10.3 | Rake $0.5 | Jackpot $0.1 | Bingo $0 | Fortune $0 | Tax $0
Board [6c 7s 9d 5d 5s]
Seat 1: 5a9e900a (big blind) showed [Ah Kc] and won ($4.85) with Pair of Fives
Seat 2: 348bc029 folded before Flop
Seat 3: d81241b3 folded before Flop
Seat 4: 15df06cd showed [Kd Ad] and won ($0) with Pair of Fives, EV Cashout ($5.77)
Seat 5: c909ecba (button) folded before Flop (didn't bet)
Seat 6: Hero (small blind) folded before Flop


Poker Hand #HD1806768122: Hold'em No Limit ($0.05/$0.1) - 2024/06/08 16:36:45
Table 'NLHRed11' 6-max Seat #4 is the button
Seat 1: 5a9e900a ($10.12 in chips)
Seat 3: d81241b3 ($20.8 in chips)
Seat 4: 15df06cd ($4.8 in chips)
Seat 5: c909ecba ($10.05 in chips)
Seat 6: Hero ($16.56 in chips)
c909ecba: posts small blind $0.05
Hero: posts big blind $0.1
*** HOLE CARDS ***
Dealt to 5a9e900a 
Dealt to d81241b3 
Dealt to 15df06cd 
Dealt to c909ecba 
Dealt to Hero [7h 8c]
5a9e900a: folds
d81241b3: folds
15df06cd: raises $0.15 to $0.25
c909ecba: folds
Hero: folds
Uncalled bet ($0.15) returned to 15df06cd
*** SHOWDOWN ***
15df06cd collected $0.25 from pot
*** SUMMARY ***
Total pot $0.25 | Rake $0 | Jackpot $0 | Bingo $0 | Fortune $0 | Tax $0
Seat 1: 5a9e900a folded before Flop (didn't bet)
Seat 3: d81241b3 folded before Flop (didn't bet)
Seat 4: 15df06cd (button) collected ($0.25)
Seat 5: c909ecba (small blind) folded before Flop
Seat 6: Hero (big blind) folded before Flop


Poker Hand #HD1806768103: Hold'em No Limit ($0.05/$0.1) - 2024/06/08 16:36:35
Table 'NLHRed11' 6-max Seat #3 is the button
Seat 1: 5a9e900a ($10.12 in chips)
Seat 3: d81241b3 ($20.8 in chips)
Seat 4: 15df06cd ($4.85 in chips)
Seat 5: c909ecba ($10 in chips)
Seat 6: Hero ($16.56 in chips)
15df06cd: posts small blind $0.05
c909ecba: posts big blind $0.1
*** HOLE CARDS ***
Dealt to 5a9e900a 
Dealt to d81241b3 
Dealt to 15df06cd 
Dealt to c909ecba 
Dealt to Hero [Tc Ks]
Hero: folds
5a9e900a: folds
d81241b3: folds
15df06cd: folds
Uncalled bet ($0.05) returned to c909ecba
*** SHOWDOWN ***
c909ecba collected $0.1 from pot
*** SUMMARY ***
Total pot $0.1 | Rake $0 | Jackpot $0 | Bingo $0 | Fortune $0 | Tax $0
Seat 1: 5a9e900a folded before Flop (didn't bet)
Seat 3: d81241b3 (button) folded before Flop (didn't bet)
Seat 4: 15df06cd (small blind) folded before Flop
Seat 5: c909ecba (big blind) collected ($0.1)
Seat 6: Hero folded before Flop (didn't bet)


Poker Hand #HD1806768087: Hold'em No Limit ($0.05/$0.1) - 2024/06/08 16:36:27
Table 'NLHRed11' 6-max Seat #1 is the button
Seat 1: 5a9e900a ($10.12 in chips)
Seat 3: d81241b3 ($20.85 in chips)
Seat 4: 15df06cd ($4.8 in chips)
Seat 6: Hero ($16.56 in chips)
d81241b3: posts small blind $0.05
15df06cd: posts big blind $0.1
*** HOLE CARDS ***
Dealt to 5a9e900a 
Dealt to d81241b3 
Dealt to 15df06cd 
Dealt to Hero [8h 7c]
Hero: folds
5a9e900a: folds
d81241b3: folds
Uncalled bet ($0.05) returned to 15df06cd
*** SHOWDOWN ***
15df06cd collected $0.1 from pot
*** SUMMARY ***
Total pot $0.1 | Rake $0 | Jackpot $0 | Bingo $0 | Fortune $0 | Tax $0
Seat 1: 5a9e900a (button) folded before Flop (didn't bet)
Seat 3: d81241b3 (small blind) folded before Flop
Seat 4: 15df06cd (big blind) collected ($0.1)
Seat 6: Hero folded before Flop (didn't bet)


Poker Hand #HD1806767980: Hold'em No Limit ($0.05/$0.1) - 2024/06/08 16:35:34
Table 'NLHRed11' 6-max Seat #6 is the button
Seat 1: 5a9e900a ($10.46 in chips)
Seat 3: d81241b3 ($20.54 in chips)
Seat 4: 15df06cd ($4.8 in chips)
Seat 6: Hero ($16.56 in chips)
5a9e900a: posts small blind $0.05
d81241b3: posts big blind $0.1
*** HOLE CARDS ***
Dealt to 5a9e900a 
Dealt to d81241b3 
Dealt to 15df06cd 
Dealt to Hero [5h Jc]
15df06cd: folds
Hero: folds
5a9e900a: raises $0.1 to $0.2
d81241b3: calls $0.1
*** FLOP *** [4s 9d 7s]
5a9e900a: bets $0.14
d81241b3: calls $0.14
*** TURN *** [4s 9d 7s] [6h]
5a9e900a: checks
d81241b3: bets $0.4
5a9e900a: folds
Uncalled bet ($0.4) returned to d81241b3
*** SHOWDOWN ***
d81241b3 collected $0.65 from pot
*** SUMMARY ***
Total pot $0.68 | Rake $0.03 | Jackpot $0 | Bingo $0 | Fortune $0 | Tax $0
Board [4s 9d 7s 6h]
Seat 1: 5a9e900a (small blind) folded on the Turn
Seat 3: d81241b3 (big blind) won ($0.65)
Seat 4: 15df06cd folded before Flop (didn't bet)
Seat 6: Hero (button) folded before Flop (didn't bet)


Poker Hand #HD1806767874: Hold'em No Limit ($0.05/$0.1) - 2024/06/08 16:34:41
Table 'NLHRed11' 6-max Seat #4 is the button
Seat 1: 5a9e900a ($10.56 in chips)
Seat 2: 2811b061 ($19.02 in chips)
Seat 3: d81241b3 ($19.67 in chips)
Seat 4: 15df06cd ($4.8 in chips)
Seat 6: Hero ($16.61 in chips)
Hero: posts small blind $0.05
5a9e900a: posts big blind $0.1
*** HOLE CARDS ***
Dealt to 5a9e900a 
Dealt to 2811b061 
Dealt to d81241b3 
Dealt to 15df06cd 
Dealt to Hero [7h 6s]
2811b061: raises $0.2 to $0.3
d81241b3: raises $0.5 to $0.8
15df06cd: folds
Hero: folds
5a9e900a: folds
2811b061: calls $0.5
*** FLOP *** [6c Qh 5h]
2811b061: checks
d81241b3: checks
*** TURN *** [6c Qh 5h] [3c]
2811b061: checks
d81241b3: checks
*** RIVER *** [6c Qh 5h 3c] [8s]
2811b061: checks
d81241b3: bets $1.32
2811b061: folds
Uncalled bet ($1.32) returned to d81241b3
*** SHOWDOWN ***
d81241b3 collected $1.67 from pot
*** SUMMARY ***
Total pot $1.75 | Rake $0.08 | Jackpot $0 | Bingo $0 | Fortune $0 | Tax $0
Board [6c Qh 5h 3c 8s]
Seat 1: 5a9e900a (big blind) folded before Flop
Seat 2: 2811b061 folded on the River
Seat 3: d81241b3 won ($1.67)
Seat 4: 15df06cd (button) folded before Flop (didn't bet)
Seat 6: Hero (small blind) folded before Flop


Poker Hand #HD1806767803: Hold'em No Limit ($0.05/$0.1) - 2024/06/08 16:34:08
Table 'NLHRed11' 6-max Seat #3 is the button
Seat 1: 5a9e900a ($10.56 in chips)
Seat 2: 2811b061 ($19.32 in chips)
Seat 3: d81241b3 ($19.67 in chips)
Seat 4: 15df06cd ($4.43 in chips)
Seat 6: Hero ($16.71 in chips)
15df06cd: posts small blind $0.05
Hero: posts big blind $0.1
*** HOLE CARDS ***
Dealt to 5a9e900a 
Dealt to 2811b061 
Dealt to d81241b3 
Dealt to 15df06cd 
Dealt to Hero [5d Qs]
5a9e900a: folds
2811b061: raises $0.2 to $0.3
d81241b3: folds
15df06cd: calls $0.25
Hero: folds
*** FLOP *** [3d Jh Kd]
15df06cd: bets $0.24
2811b061: folds
Uncalled bet ($0.24) returned to 15df06cd
*** SHOWDOWN ***
15df06cd collected $0.67 from pot
*** SUMMARY ***
Total pot $0.7 | Rake $0.03 | Jackpot $0 | Bingo $0 | Fortune $0 | Tax $0
Board [3d Jh Kd]
Seat 1: 5a9e900a folded before Flop (didn't bet)
Seat 2: 2811b061 folded on the Flop
Seat 3: d81241b3 (button) folded before Flop (didn't bet)
Seat 4: 15df06cd (small blind) won ($0.67)
Seat 6: Hero (big blind) folded before Flop


Poker Hand #HD1806767692: Hold'em No Limit ($0.05/$0.1) - 2024/06/08 16:33:18
Table 'NLHRed11' 6-max Seat #2 is the button
Seat 1: 5a9e900a ($10.56 in chips)
Seat 2: 2811b061 ($10.33 in chips)
Seat 3: d81241b3 ($19.72 in chips)
Seat 4: 15df06cd ($4.53 in chips)
Seat 5: c05e96ba ($9.93 in chips)
Seat 6: Hero ($16.71 in chips)
d81241b3: posts small blind $0.05
15df06cd: posts big blind $0.1
*** HOLE CARDS ***
Dealt to 5a9e900a 
Dealt to 2811b061 
Dealt to d81241b3 
Dealt to 15df06cd 
Dealt to c05e96ba 
Dealt to Hero [Ah 6c]
c05e96ba: raises $0.2 to $0.3
Hero: folds
5a9e900a: folds
2811b061: raises $0.8 to $1.1
d81241b3: folds
15df06cd: folds
c05e96ba: calls $0.8
*** FLOP *** [4c 8d 9h]
c05e96ba: checks
2811b061: bets $1.56
c05e96ba: calls $1.56
*** TURN *** [4c 8d 9h] [3s]
c05e96ba: checks
2811b061: bets $3.62
c05e96ba: calls $3.62
*** RIVER *** [4c 8d 9h 3s] [Qd]
c05e96ba: checks
2811b061: bets $4.05 and is all-in
c05e96ba: calls $3.65 and is all-in
Uncalled bet ($0.4) returned to 2811b061
2811b061: shows [Kc Kd] (Pair of Kings)
c05e96ba: shows [2d 9d] (Pair of Nines)
*** SHOWDOWN ***
2811b061 collected $18.92 from pot
*** SUMMARY ***
Total pot $20.01 | Rake $0.99 | Jackpot $0.1 | Bingo $0 | Fortune $0 | Tax $0
Board [4c 8d 9h 3s Qd]
Seat 1: 5a9e900a folded before Flop (didn't bet)
Seat 2: 2811b061 (button) showed [Kc Kd] and won ($18.92) with Pair of Kings
Seat 3: d81241b3 (small blind) folded before Flop
Seat 4: 15df06cd (big blind) folded before Flop
Seat 5: c05e96ba showed [2d 9d] and lost with Pair of Nines
Seat 6: Hero folded before Flop (didn't bet)


Poker Hand #HD1806767638: Hold'em No Limit ($0.05/$0.1) - 2024/06/08 16:32:57
Table 'NLHRed11' 6-max Seat #1 is the button
Seat 1: 5a9e900a ($10.56 in chips)
Seat 2: 2811b061 ($10.38 in chips)
Seat 3: d81241b3 ($19.82 in chips)
Seat 4: 15df06cd ($4.53 in chips)
Seat 5: c05e96ba ($9.93 in chips)
Seat 6: Hero ($16.56 in chips)
2811b061: posts small blind $0.05
d81241b3: posts big blind $0.1
*** HOLE CARDS ***
Dealt to 5a9e900a 
Dealt to 2811b061 
Dealt to d81241b3 
Dealt to 15df06cd 
Dealt to c05e96ba 
Dealt to Hero [5d 5h]
15df06cd: folds
c05e96ba: folds
Hero: raises $0.14 to $0.24
5a9e900a: folds
2811b061: folds
d81241b3: folds
Uncalled bet ($0.14) returned to Hero
*** SHOWDOWN ***
Hero collected $0.25 from pot
*** SUMMARY ***
Total pot $0.25 | Rake $0 | Jackpot $0 | Bingo $0 | Fortune $0 | Tax $0
Seat 1: 5a9e900a (button) folded before Flop (didn't bet)
Seat 2: 2811b061 (small blind) folded before Flop
Seat 3: d81241b3 (big blind) folded before Flop
Seat 4: 15df06cd folded before Flop (didn't bet)
Seat 5: c05e96ba folded before Flop (didn't bet)
Seat 6: Hero collected ($0.25)


Poker Hand #HD1806767598: Hold'em No Limit ($0.05/$0.1) - 2024/06/08 16:32:37
Table 'NLHRed11' 6-max Seat #6 is the button
Seat 1: 5a9e900a ($10.61 in chips)
Seat 2: 2811b061 ($10.48 in chips)
Seat 3: d81241b3 ($19.82 in chips)
Seat 4: 15df06cd ($4.38 in chips)
Seat 5: c05e96ba ($9.93 in chips)
Seat 6: Hero ($16.56 in chips)
5a9e900a: posts small blind $0.05
2811b061: posts big blind $0.1
*** HOLE CARDS ***
Dealt to 5a9e900a 
Dealt to 2811b061 
Dealt to d81241b3 
Dealt to 15df06cd 
Dealt to c05e96ba 
Dealt to Hero [Td Js]
d81241b3: folds
15df06cd: raises $0.1 to $0.2
c05e96ba: folds
Hero: folds
5a9e900a: folds
2811b061: folds
Uncalled bet ($0.1) returned to 15df06cd
*** SHOWDOWN ***
15df06cd collected $0.25 from pot
*** SUMMARY ***
Total pot $0.25 | Rake $0 | Jackpot $0 | Bingo $0 | Fortune $0 | Tax $0
Seat 1: 5a9e900a (small blind) folded before Flop
Seat 2: 2811b061 (big blind) folded before Flop
Seat 3: d81241b3 folded before Flop (didn't bet)
Seat 4: 15df06cd collected ($0.25)
Seat 5: c05e96ba folded before Flop (didn't bet)
Seat 6: Hero (button) folded before Flop (didn't bet)


Poker Hand #HD1806767491: Hold'em No Limit ($0.05/$0.1) - 2024/06/08 16:31:48
Table 'NLHRed11' 6-max Seat #5 is the button
Seat 1: 5a9e900a ($10.86 in chips)
Seat 2: 2811b061 ($10.48 in chips)
Seat 3: d81241b3 ($19.54 in chips)
Seat 4: 15df06cd ($4.38 in chips)
Seat 5: c05e96ba ($9.93 in chips)
Seat 6: Hero ($16.61 in chips)
Hero: posts small blind $0.05
5a9e900a: posts big blind $0.1
*** HOLE CARDS ***
Dealt to 5a9e900a 
Dealt to 2811b061 
Dealt to d81241b3 
Dealt to 15df06cd 
Dealt to c05e96ba 
Dealt to Hero [6d 6h]
2811b061: folds
d81241b3: raises $0.15 to $0.25
15df06cd: folds
c05e96ba: folds
Hero: folds
5a9e900a: calls $0.15
*** FLOP *** [Qs Kd 8h]
5a9e900a: checks
d81241b3: bets $0.28
5a9e900a: folds
Uncalled bet ($0.28) returned to d81241b3
*** SHOWDOWN ***
d81241b3 collected $0.53 from pot
*** SUMMARY ***
Total pot $0.55 | Rake $0.02 | Jackpot $0 | Bingo $0 | Fortune $0 | Tax $0
Board [Qs Kd 8h]
Seat 1: 5a9e900a (big blind) folded on the Flop
Seat 2: 2811b061 folded before Flop (didn't bet)
Seat 3: d81241b3 won ($0.53)
Seat 4: 15df06cd folded before Flop (didn't bet)
Seat 5: c05e96ba (button) folded before Flop (didn't bet)
Seat 6: Hero (small blind) folded before Flop


Poker Hand #HD1806767420: Hold'em No Limit ($0.05/$0.1) - 2024/06/08 16:31:11
Table 'NLHRed11' 6-max Seat #4 is the button
Seat 1: 5a9e900a ($10.86 in chips)
Seat 2: 2811b061 ($10.48 in chips)
Seat 3: d81241b3 ($19.54 in chips)
Seat 4: 15df06cd ($4.75 in chips)
Seat 5: c05e96ba ($9.5 in chips)
Seat 6: Hero ($16.71 in chips)
c05e96ba: posts small blind $0.05
Hero: posts big blind $0.1
*** HOLE CARDS ***
Dealt to 5a9e900a 
Dealt to 2811b061 
Dealt to d81241b3 
Dealt to 15df06cd 
Dealt to c05e96ba 
Dealt to Hero [Qc 6s]
5a9e900a: folds
2811b061: folds
d81241b3: folds
15df06cd: raises $0.1 to $0.2
c05e96ba: calls $0.15
Hero: folds
*** FLOP *** [8s 6c Qd]
c05e96ba: checks
15df06cd: bets $0.17
c05e96ba: raises $0.63 to $0.8
15df06cd: folds
Uncalled bet ($0.63) returned to c05e96ba
*** SHOWDOWN ***
c05e96ba collected $0.8 from pot
*** SUMMARY ***
Total pot $0.84 | Rake $0.04 | Jackpot $0 | Bingo $0 | Fortune $0 | Tax $0
Board [8s 6c Qd]
Seat 1: 5a9e900a folded before Flop (didn't bet)
Seat 2: 2811b061 folded before Flop (didn't bet)
Seat 3: d81241b3 folded before Flop (didn't bet)
Seat 4: 15df06cd (button) folded on the Flop
Seat 5: c05e96ba (small blind) won ($0.8)
Seat 6: Hero (big blind) folded before Flop


Poker Hand #HD1806767352: Hold'em No Limit ($0.05/$0.1) - 2024/06/08 16:30:45
Table 'NLHRed11' 6-max Seat #3 is the button
Seat 1: 5a9e900a ($10.86 in chips)
Seat 2: 2811b061 ($10.48 in chips)
Seat 3: d81241b3 ($19.31 in chips)
Seat 4: 15df06cd ($4.8 in chips)
Seat 5: c05e96ba ($9.7 in chips)
Seat 6: Hero ($16.71 in chips)
15df06cd: posts small blind $0.05
c05e96ba: posts big blind $0.1
*** HOLE CARDS ***
Dealt to 5a9e900a 
Dealt to 2811b061 
Dealt to d81241b3 
Dealt to 15df06cd 
Dealt to c05e96ba 
Dealt to Hero [9s 8h]
Hero: folds
5a9e900a: folds
2811b061: folds
d81241b3: raises $0.1 to $0.2
15df06cd: folds
c05e96ba: calls $0.1
*** FLOP *** [Td 7s 2c]
c05e96ba: checks
d81241b3: bets $0.23
c05e96ba: folds
Uncalled bet ($0.23) returned to d81241b3
*** SHOWDOWN ***
d81241b3 collected $0.43 from pot
*** SUMMARY ***
Total pot $0.45 | Rake $0.02 | Jackpot $0 | Bingo $0 | Fortune $0 | Tax $0
Board [Td 7s 2c]
Seat 1: 5a9e900a folded before Flop (didn't bet)
Seat 2: 2811b061 folded before Flop (didn't bet)
Seat 3: d81241b3 (button) won ($0.43)
Seat 4: 15df06cd (small blind) folded before Flop
Seat 5: c05e96ba (big blind) folded on the Flop
Seat 6: Hero folded before Flop (didn't bet)


Poker Hand #HD1806767324: Hold'em No Limit ($0.05/$0.1) - 2024/06/08 16:30:33
Table 'NLHRed11' 6-max Seat #2 is the button
Seat 1: 5a9e900a ($10.86 in chips)
Seat 2: 2811b061 ($10.48 in chips)
Seat 3: d81241b3 ($19.36 in chips)
Seat 4: 15df06cd ($4.9 in chips)
Seat 5: c05e96ba ($9.55 in chips)
Seat 6: Hero ($16.71 in chips)
d81241b3: posts small blind $0.05
15df06cd: posts big blind $0.1
*** HOLE CARDS ***
Dealt to 5a9e900a 
Dealt to 2811b061 
Dealt to d81241b3 
Dealt to 15df06cd 
Dealt to c05e96ba 
Dealt to Hero [8c Jd]
c05e96ba: raises $0.2 to $0.3
Hero: folds
5a9e900a: folds
2811b061: folds
d81241b3: folds
15df06cd: folds
Uncalled bet ($0.2) returned to c05e96ba
*** SHOWDOWN ***
c05e96ba collected $0.25 from pot
*** SUMMARY ***
Total pot $0.25 | Rake $0 | Jackpot $0 | Bingo $0 | Fortune $0 | Tax $0
Seat 1: 5a9e900a folded before Flop (didn't bet)
Seat 2: 2811b061 (button) folded before Flop (didn't bet)
Seat 3: d81241b3 (small blind) folded before Flop
Seat 4: 15df06cd (big blind) folded before Flop
Seat 5: c05e96ba collected ($0.25)
Seat 6: Hero folded before Flop (didn't bet)


Poker Hand #HD1806767288: Hold'em No Limit ($0.05/$0.1) - 2024/06/08 16:30:14
Table 'NLHRed11' 6-max Seat #1 is the button
Seat 1: 5a9e900a ($10.71 in chips)
Seat 2: 2811b061 ($10.53 in chips)
Seat 3: d81241b3 ($19.46 in chips)
Seat 4: 15df06cd ($4.9 in chips)
Seat 5: c05e96ba ($9.55 in chips)
Seat 6: Hero ($16.71 in chips)
2811b061: posts small blind $0.05
d81241b3: posts big blind $0.1
*** HOLE CARDS ***
Dealt to 5a9e900a 
Dealt to 2811b061 
Dealt to d81241b3 
Dealt to 15df06cd 
Dealt to c05e96ba 
Dealt to Hero [Tc 3d]
15df06cd: folds
c05e96ba: folds
Hero: folds
5a9e900a: raises $0.15 to $0.25
2811b061: folds
d81241b3: folds
Uncalled bet ($0.15) returned to 5a9e900a
*** SHOWDOWN ***
5a9e900a collected $0.25 from pot
*** SUMMARY ***
Total pot $0.25 | Rake $0 | Jackpot $0 | Bingo $0 | Fortune $0 | Tax $0
Seat 1: 5a9e900a (button) collected ($0.25)
Seat 2: 2811b061 (small blind) folded before Flop
Seat 3: d81241b3 (big blind) folded before Flop
Seat 4: 15df06cd folded before Flop (didn't bet)
Seat 5: c05e96ba folded before Flop (didn't bet)
Seat 6: Hero folded before Flop (didn't bet)


Poker Hand #HD1806767257: Hold'em No Limit ($0.05/$0.1) - 2024/06/08 16:30:02
Table 'NLHRed11' 6-max Seat #6 is the button
Seat 1: 5a9e900a ($10.76 in chips)
Seat 2: 2811b061 ($10.63 in chips)
Seat 4: 15df06cd ($4.9 in chips)
Seat 5: c05e96ba ($9.55 in chips)
Seat 6: Hero ($16.56 in chips)
5a9e900a: posts small blind $0.05
2811b061: posts big blind $0.1
*** HOLE CARDS ***
Dealt to 5a9e900a 
Dealt to 2811b061 
Dealt to 15df06cd 
Dealt to c05e96ba 
Dealt to Hero [Qc Jh]
15df06cd: folds
c05e96ba: folds
Hero: raises $0.14 to $0.24
5a9e900a: folds
2811b061: folds
Uncalled bet ($0.14) returned to Hero
*** SHOWDOWN ***
Hero collected $0.25 from pot
*** SUMMARY ***
Total pot $0.25 | Rake $0 | Jackpot $0 | Bingo $0 | Fortune $0 | Tax $0
Seat 1: 5a9e900a (small blind) folded before Flop
Seat 2: 2811b061 (big blind) folded before Flop
Seat 4: 15df06cd folded before Flop (didn't bet)
Seat 5: c05e96ba folded before Flop (didn't bet)
Seat 6: Hero (button) collected ($0.25)


Poker Hand #HD1806767168: Hold'em No Limit ($0.05/$0.1) - 2024/06/08 16:29:21
Table 'NLHRed11' 6-max Seat #5 is the button
Seat 1: 5a9e900a ($10 in chips)
Seat 2: 2811b061 ($10.63 in chips)
Seat 4: 15df06cd ($5 in chips)
Seat 5: c05e96ba ($10.23 in chips)
Seat 6: Hero ($16.61 in chips)
Hero: posts small blind $0.05
5a9e900a: posts big blind $0.1
15df06cd: posts big blind $0.1
*** HOLE CARDS ***
Dealt to 5a9e900a 
Dealt to 2811b061 
Dealt to 15df06cd 
Dealt to c05e96ba 
Dealt to Hero [Ad 5h]
2811b061: folds
15df06cd: checks
c05e96ba: raises $0.2 to $0.3
Hero: folds
5a9e900a: calls $0.2
15df06cd: folds
*** FLOP *** [3s 4d 7c]
5a9e900a: checks
c05e96ba: bets $0.38
5a9e900a: calls $0.38
*** TURN *** [3s 4d 7c] [7s]
5a9e900a: checks
c05e96ba: checks
*** RIVER *** [3s 4d 7c 7s] [5d]
5a9e900a: bets $1.14
c05e96ba: folds
Uncalled bet ($1.14) returned to 5a9e900a
*** SHOWDOWN ***
5a9e900a collected $1.44 from pot
*** SUMMARY ***
Total pot $1.51 | Rake $0.07 | Jackpot $0 | Bingo $0 | Fortune $0 | Tax $0
Board [3s 4d 7c 7s 5d]
Seat 1: 5a9e900a (big blind) won ($1.44)
Seat 2: 2811b061 folded before Flop (didn't bet)
Seat 4: 15df06cd folded before Flop
Seat 5: c05e96ba (button) folded on the River
Seat 6: Hero (small blind) folded before Flop


Poker Hand #HD1806766962: Hold'em No Limit ($0.05/$0.1) - 2024/06/08 16:27:43
Table 'NLHRed11' 6-max Seat #4 is the button
Seat 2: 2811b061 ($10.63 in chips)
Seat 4: 6aee4cd1 ($9.25 in chips)
Seat 5: c05e96ba ($15.13 in chips)
Seat 6: Hero ($12.29 in chips)
c05e96ba: posts small blind $0.05
Hero: posts big blind $0.1
*** HOLE CARDS ***
Dealt to 2811b061 
Dealt to 6aee4cd1 
Dealt to c05e96ba 
Dealt to Hero [Kd Kc]
2811b061: folds
6aee4cd1: folds
c05e96ba: raises $0.15 to $0.25
Hero: raises $0.65 to $0.9
c05e96ba: calls $0.65
*** FLOP *** [Th 3s 6d]
c05e96ba: checks
Hero: bets $0.8
c05e96ba: calls $0.8
*** TURN *** [Th 3s 6d] [5c]
c05e96ba: checks
Hero: checks
*** RIVER *** [Th 3s 6d 5c] [2d]
c05e96ba: bets $1.13
Hero: raises $2.07 to $3.2
c05e96ba: calls $2.07
Hero: shows [Kd Kc] (Pair of Kings)
c05e96ba: shows [7d 7s] (Pair of Sevens)
*** SHOWDOWN ***
Hero collected $9.22 from pot
*** SUMMARY ***
Total pot $9.8 | Rake $0.48 | Jackpot $0.1 | Bingo $0 | Fortune $0 | Tax $0
Board [Th 3s 6d 5c 2d]
Seat 2: 2811b061 folded before Flop (didn't bet)
Seat 4: 6aee4cd1 (button) folded before Flop (didn't bet)
Seat 5: c05e96ba (small blind) showed [7d 7s] and lost with Pair of Sevens
Seat 6: Hero (big blind) showed [Kd Kc] and won ($9.22) with Pair of Kings


Poker Hand #HD1806766866: Hold'em No Limit ($0.05/$0.1) - 2024/06/08 16:26:56
Table 'NLHRed11' 6-max Seat #2 is the button
Seat 2: 2811b061 ($10.63 in chips)
Seat 4: 6aee4cd1 ($9.9 in chips)
Seat 5: c05e96ba ($14.54 in chips)
Seat 6: Hero ($12.29 in chips)
6aee4cd1: posts small blind $0.05
c05e96ba: posts big blind $0.1
*** HOLE CARDS ***
Dealt to 2811b061 
Dealt to 6aee4cd1 
Dealt to c05e96ba 
Dealt to Hero [5d 7c]
Hero: folds
2811b061: folds
6aee4cd1: raises $0.2 to $0.3
c05e96ba: calls $0.2
*** FLOP *** [3s 4s Qh]
6aee4cd1: bets $0.35
c05e96ba: calls $0.35
*** TURN *** [3s 4s Qh] [6h]
6aee4cd1: checks
c05e96ba: bets $0.43
6aee4cd1: folds
Uncalled bet ($0.43) returned to c05e96ba
*** SHOWDOWN ***
c05e96ba collected $1.24 from pot
*** SUMMARY ***
Total pot $1.3 | Rake $0.06 | Jackpot $0 | Bingo $0 | Fortune $0 | Tax $0
Board [3s 4s Qh 6h]
Seat 2: 2811b061 (button) folded before Flop (didn't bet)
Seat 4: 6aee4cd1 (small blind) folded on the Turn
Seat 5: c05e96ba (big blind) won ($1.24)
Seat 6: Hero folded before Flop (didn't bet)


Poker Hand #HD1806766842: Hold'em No Limit ($0.05/$0.1) - 2024/06/08 16:26:45
Table 'NLHRed11' 6-max Seat #6 is the button
Seat 2: 2811b061 ($10.68 in chips)
Seat 4: 6aee4cd1 ($10 in chips)
Seat 5: c05e96ba ($14.54 in chips)
Seat 6: Hero ($12.14 in chips)
2811b061: posts small blind $0.05
6aee4cd1: posts big blind $0.1
*** HOLE CARDS ***
Dealt to 2811b061 
Dealt to 6aee4cd1 
Dealt to c05e96ba 
Dealt to Hero [8h 7h]
c05e96ba: folds
Hero: raises $0.14 to $0.24
2811b061: folds
6aee4cd1: folds
Uncalled bet ($0.14) returned to Hero
*** SHOWDOWN ***
Hero collected $0.25 from pot
*** SUMMARY ***
Total pot $0.25 | Rake $0 | Jackpot $0 | Bingo $0 | Fortune $0 | Tax $0
Seat 2: 2811b061 (small blind) folded before Flop
Seat 4: 6aee4cd1 (big blind) folded before Flop
Seat 5: c05e96ba folded before Flop (didn't bet)
Seat 6: Hero (button) collected ($0.25)


Poker Hand #HD1806766823: Hold'em No Limit ($0.05/$0.1) - 2024/06/08 16:26:36
Table 'NLHRed11' 6-max Seat #5 is the button
Seat 2: 2811b061 ($10.63 in chips)
Seat 4: 6aee4cd1 ($10 in chips)
Seat 5: c05e96ba ($14.54 in chips)
Seat 6: Hero ($12.19 in chips)
Hero: posts small blind $0.05
2811b061: posts big blind $0.1
*** HOLE CARDS ***
Dealt to 2811b061 
Dealt to 6aee4cd1 
Dealt to c05e96ba 
Dealt to Hero [4h Ks]
6aee4cd1: folds
c05e96ba: folds
Hero: folds
Uncalled bet ($0.05) returned to 2811b061
*** SHOWDOWN ***
2811b061 collected $0.1 from pot
*** SUMMARY ***
Total pot $0.1 | Rake $0 | Jackpot $0 | Bingo $0 | Fortune $0 | Tax $0
Seat 2: 2811b061 (big blind) collected ($0.1)
Seat 4: 6aee4cd1 folded before Flop (didn't bet)
Seat 5: c05e96ba (button) folded before Flop (didn't bet)
Seat 6: Hero (small blind) folded before Flop


Poker Hand #HD1806766805: Hold'em No Limit ($0.05/$0.1) - 2024/06/08 16:26:28
Table 'NLHRed11' 6-max Seat #4 is the button
Seat 2: 2811b061 ($10.63 in chips)
Seat 4: 6aee4cd1 ($10 in chips)
Seat 5: c05e96ba ($14.59 in chips)
Seat 6: Hero ($12.14 in chips)
c05e96ba: posts small blind $0.05
Hero: posts big blind $0.1
*** HOLE CARDS ***
Dealt to 2811b061 
Dealt to 6aee4cd1 
Dealt to c05e96ba 
Dealt to Hero [9c Td]
2811b061: folds
6aee4cd1: folds
c05e96ba: folds
Uncalled bet ($0.05) returned to Hero
*** SHOWDOWN ***
Hero collected $0.1 from pot
*** SUMMARY ***
Total pot $0.1 | Rake $0 | Jackpot $0 | Bingo $0 | Fortune $0 | Tax $0
Seat 2: 2811b061 folded before Flop (didn't bet)
Seat 4: 6aee4cd1 (button) folded before Flop (didn't bet)
Seat 5: c05e96ba (small blind) folded before Flop
Seat 6: Hero (big blind) collected ($0.1)


Poker Hand #HD1806766793: Hold'em No Limit ($0.05/$0.1) - 2024/06/08 16:26:22
Table 'NLHRed11' 6-max Seat #2 is the button
Seat 2: 2811b061 ($10.63 in chips)
Seat 4: 6aee4cd1 ($10.05 in chips)
Seat 5: c05e96ba ($14.54 in chips)
Seat 6: Hero ($12.14 in chips)
6aee4cd1: posts small blind $0.05
c05e96ba: posts big blind $0.1
*** HOLE CARDS ***
Dealt to 2811b061 
Dealt to 6aee4cd1 
Dealt to c05e96ba 
Dealt to Hero [Ks 5h]
Hero: folds
2811b061: folds
6aee4cd1: folds
Uncalled bet ($0.05) returned to c05e96ba
*** SHOWDOWN ***
c05e96ba collected $0.1 from pot
*** SUMMARY ***
Total pot $0.1 | Rake $0 | Jackpot $0 | Bingo $0 | Fortune $0 | Tax $0
Seat 2: 2811b061 (button) folded before Flop (didn't bet)
Seat 4: 6aee4cd1 (small blind) folded before Flop
Seat 5: c05e96ba (big blind) collected ($0.1)
Seat 6: Hero folded before Flop (didn't bet)


Poker Hand #HD1806766775: Hold'em No Limit ($0.05/$0.1) - 2024/06/08 16:26:11
Table 'NLHRed11' 6-max Seat #6 is the button
Seat 2: 2811b061 ($10.68 in chips)
Seat 4: 6aee4cd1 ($10 in chips)
Seat 5: c05e96ba ($14.54 in chips)
Seat 6: Hero ($12.14 in chips)
2811b061: posts small blind $0.05
6aee4cd1: posts big blind $0.1
*** HOLE CARDS ***
Dealt to 2811b061 
Dealt to 6aee4cd1 
Dealt to c05e96ba 
Dealt to Hero [3h Qs]
c05e96ba: folds
Hero: folds
2811b061: folds
Uncalled bet ($0.05) returned to 6aee4cd1
*** SHOWDOWN ***
6aee4cd1 collected $0.1 from pot
*** SUMMARY ***
Total pot $0.1 | Rake $0 | Jackpot $0 | Bingo $0 | Fortune $0 | Tax $0
Seat 2: 2811b061 (small blind) folded before Flop
Seat 4: 6aee4cd1 (big blind) collected ($0.1)
Seat 5: c05e96ba folded before Flop (didn't bet)
Seat 6: Hero (button) folded before Flop (didn't bet)


Poker Hand #HD1806766730: Hold'em No Limit ($0.05/$0.1) - 2024/06/08 16:25:47
Table 'NLHRed11' 6-max Seat #5 is the button
Seat 2: 2811b061 ($10 in chips)
Seat 5: c05e96ba ($15.24 in chips)
Seat 6: Hero ($12.19 in chips)
Hero: posts small blind $0.05
2811b061: posts big blind $0.1
*** HOLE CARDS ***
Dealt to 2811b061 
Dealt to c05e96ba 
Dealt to Hero [Qc 4s]
c05e96ba: raises $0.1 to $0.2
Hero: folds
2811b061: raises $0.5 to $0.7
c05e96ba: calls $0.5
*** FLOP *** [Jc 8h 5d]
2811b061: bets $0.96
c05e96ba: folds
Uncalled bet ($0.96) returned to 2811b061
*** SHOWDOWN ***
2811b061 collected $1.38 from pot
*** SUMMARY ***
Total pot $1.45 | Rake $0.07 | Jackpot $0 | Bingo $0 | Fortune $0 | Tax $0
Board [Jc 8h 5d]
Seat 2: 2811b061 (big blind) won ($1.38)
Seat 5: c05e96ba (button) folded on the Flop
Seat 6: Hero (small blind) folded before Flop


Poker Hand #HD1806766540: Hold'em No Limit ($0.05/$0.1) - 2024/06/08 16:24:17
Table 'NLHRed11' 6-max Seat #3 is the button
Seat 2: 2811b061 ($9.65 in chips)
Seat 3: d81241b3 ($19.46 in chips)
Seat 5: c05e96ba ($11.84 in chips)
Seat 6: Hero ($12.29 in chips)
c05e96ba: posts small blind $0.05
Hero: posts big blind $0.1
*** HOLE CARDS ***
Dealt to 2811b061 
Dealt to d81241b3 
Dealt to c05e96ba 
Dealt to Hero [Ks 4s]
2811b061: raises $0.2 to $0.3
d81241b3: folds
c05e96ba: calls $0.25
Hero: folds
*** FLOP *** [7d 2s 6c]
c05e96ba: checks
2811b061: bets $0.47
c05e96ba: calls $0.47
*** TURN *** [7d 2s 6c] [5d]
c05e96ba: checks
2811b061: bets $1.09
c05e96ba: calls $1.09
*** RIVER *** [7d 2s 6c 5d] [2c]
c05e96ba: checks
2811b061: bets $1.91
c05e96ba: raises $8.07 to $9.98 and is all-in
2811b061: folds
Uncalled bet ($8.07) returned to c05e96ba
*** SHOWDOWN ***
c05e96ba collected $7.17 from pot
*** SUMMARY ***
Total pot $7.64 | Rake $0.37 | Jackpot $0.1 | Bingo $0 | Fortune $0 | Tax $0
Board [7d 2s 6c 5d 2c]
Seat 2: 2811b061 folded on the River
Seat 3: d81241b3 (button) folded before Flop (didn't bet)
Seat 5: c05e96ba (small blind) won ($7.17)
Seat 6: Hero (big blind) folded before Flop


Poker Hand #HD1806766329: Hold'em No Limit ($0.05/$0.1) - 2024/06/08 16:22:26
Table 'NLHRed11' 6-max Seat #2 is the button
Seat 2: 2811b061 ($9.65 in chips)
Seat 3: d81241b3 ($21.96 in chips)
Seat 4: b175dcea ($20.23 in chips)
Seat 5: c05e96ba ($11.84 in chips)
Seat 6: Hero ($10.04 in chips)
d81241b3: posts small blind $0.05
b175dcea: posts big blind $0.1
*** HOLE CARDS ***
Dealt to 2811b061 
Dealt to d81241b3 
Dealt to b175dcea 
Dealt to c05e96ba 
Dealt to Hero [Qd Qh]
c05e96ba: folds
Hero: raises $0.1 to $0.2
2811b061: folds
d81241b3: raises $0.85 to $1.05
b175dcea: folds
Hero: raises $1.45 to $2.5
d81241b3: calls $1.45
*** FLOP *** [9d Th 9h]
d81241b3: checks
Hero: bets $1.4
d81241b3: folds
Uncalled bet ($1.4) returned to Hero
*** SHOWDOWN ***
Hero collected $4.75 from pot
*** SUMMARY ***
Total pot $5.1 | Rake $0.25 | Jackpot $0.1 | Bingo $0 | Fortune $0 | Tax $0
Board [9d Th 9h]
Seat 2: 2811b061 (button) folded before Flop (didn't bet)
Seat 3: d81241b3 (small blind) folded on the Flop
Seat 4: b175dcea (big blind) folded before Flop
Seat 5: c05e96ba folded before Flop (didn't bet)
Seat 6: Hero won ($4.75)


Poker Hand #HD1806766283: Hold'em No Limit ($0.05/$0.1) - 2024/06/08 16:22:05
Table 'NLHRed11' 6-max Seat #6 is the button
Seat 2: 2811b061 ($9.7 in chips)
Seat 3: d81241b3 ($22.06 in chips)
Seat 4: b175dcea ($20.23 in chips)
Seat 5: c05e96ba ($11.69 in chips)
Seat 6: Hero ($10.04 in chips)
2811b061: posts small blind $0.05
d81241b3: posts big blind $0.1
*** HOLE CARDS ***
Dealt to 2811b061 
Dealt to d81241b3 
Dealt to b175dcea 
Dealt to c05e96ba 
Dealt to Hero [6s 9s]
b175dcea: folds
c05e96ba: raises $0.1 to $0.2
Hero: folds
2811b061: folds
d81241b3: folds
Uncalled bet ($0.1) returned to c05e96ba
*** SHOWDOWN ***
c05e96ba collected $0.25 from pot
*** SUMMARY ***
Total pot $0.25 | Rake $0 | Jackpot $0 | Bingo $0 | Fortune $0 | Tax $0
Seat 2: 2811b061 (small blind) folded before Flop
Seat 3: d81241b3 (big blind) folded before Flop
Seat 4: b175dcea folded before Flop (didn't bet)
Seat 5: c05e96ba collected ($0.25)
Seat 6: Hero (button) folded before Flop (didn't bet)


Poker Hand #HD1806766209: Hold'em No Limit ($0.05/$0.1) - 2024/06/08 16:21:26
Table 'NLHRed11' 6-max Seat #5 is the button
Seat 2: 2811b061 ($9.8 in chips)
Seat 3: d81241b3 ($22.16 in chips)
Seat 4: b175dcea ($21.08 in chips)
Seat 5: c05e96ba ($10.68 in chips)
Seat 6: Hero ($10.09 in chips)
Hero: posts small blind $0.05
2811b061: posts big blind $0.1
*** HOLE CARDS ***
Dealt to 2811b061 
Dealt to d81241b3 
Dealt to b175dcea 
Dealt to c05e96ba 
Dealt to Hero [8s Ac]
d81241b3: calls $0.1
b175dcea: raises $0.1 to $0.2
c05e96ba: raises $0.65 to $0.85
Hero: folds
2811b061: folds
d81241b3: folds
b175dcea: calls $0.65
*** FLOP *** [8d 3s 5d]
b175dcea: checks
c05e96ba: bets $0.65
b175dcea: folds
Uncalled bet ($0.65) returned to c05e96ba
*** SHOWDOWN ***
c05e96ba collected $1.86 from pot
*** SUMMARY ***
Total pot $1.95 | Rake $0.09 | Jackpot $0 | Bingo $0 | Fortune $0 | Tax $0
Board [8d 3s 5d]
Seat 2: 2811b061 (big blind) folded before Flop
Seat 3: d81241b3 folded before Flop
Seat 4: b175dcea folded on the Flop
Seat 5: c05e96ba (button) won ($1.86)
Seat 6: Hero (small blind) folded before Flop


Poker Hand #HD1806766094: Hold'em No Limit ($0.05/$0.1) - 2024/06/08 16:20:29
Table 'NLHRed11' 6-max Seat #4 is the button
Seat 1: ad17dbfc ($11.57 in chips)
Seat 2: 2811b061 ($9.8 in chips)
Seat 3: d81241b3 ($21.6 in chips)
Seat 4: b175dcea ($21.08 in chips)
Seat 5: c05e96ba ($10.98 in chips)
Seat 6: Hero ($10.39 in chips)
c05e96ba: posts small blind $0.05
Hero: posts big blind $0.1
*** HOLE CARDS ***
Dealt to ad17dbfc 
Dealt to 2811b061 
Dealt to d81241b3 
Dealt to b175dcea 
Dealt to c05e96ba 
Dealt to Hero [4h 5h]
ad17dbfc: folds
2811b061: folds
d81241b3: raises $0.2 to $0.3
b175dcea: folds
c05e96ba: calls $0.25
Hero: calls $0.2
*** FLOP *** [6s 9s Ac]
c05e96ba: checks
Hero: checks
d81241b3: checks
*** TURN *** [6s 9s Ac] [Kh]
c05e96ba: checks
Hero: checks
d81241b3: bets $0.6
c05e96ba: folds
Hero: folds
Uncalled bet ($0.6) returned to d81241b3
*** SHOWDOWN ***
d81241b3 collected $0.86 from pot
*** SUMMARY ***
Total pot $0.9 | Rake $0.04 | Jackpot $0 | Bingo $0 | Fortune $0 | Tax $0
Board [6s 9s Ac Kh]
Seat 1: ad17dbfc folded before Flop (didn't bet)
Seat 2: 2811b061 folded before Flop (didn't bet)
Seat 3: d81241b3 won ($0.86)
Seat 4: b175dcea (button) folded before Flop (didn't bet)
Seat 5: c05e96ba (small blind) folded on the Turn
Seat 6: Hero (big blind) folded on the Turn


Poker Hand #HD1806766010: Hold'em No Limit ($0.05/$0.1) - 2024/06/08 16:19:49
Table 'NLHRed11' 6-max Seat #3 is the button
Seat 1: ad17dbfc ($11.67 in chips)
Seat 2: 2811b061 ($9.8 in chips)
Seat 3: d81241b3 ($21.6 in chips)
Seat 4: b175dcea ($21.93 in chips)
Seat 5: c05e96ba ($10.12 in chips)
Seat 6: Hero ($10.39 in chips)
b175dcea: posts small blind $0.05
c05e96ba: posts big blind $0.1
*** HOLE CARDS ***
Dealt to ad17dbfc 
Dealt to 2811b061 
Dealt to d81241b3 
Dealt to b175dcea 
Dealt to c05e96ba 
Dealt to Hero [Kc 8c]
Hero: folds
ad17dbfc: calls $0.1
2811b061: folds
d81241b3: folds
b175dcea: calls $0.05
c05e96ba: checks
*** FLOP *** [Ad 9s 9h]
b175dcea: checks
c05e96ba: checks
ad17dbfc: checks
*** TURN *** [Ad 9s 9h] [3d]
b175dcea: checks
c05e96ba: bets $0.15
ad17dbfc: folds
b175dcea: calls $0.15
*** RIVER *** [Ad 9s 9h 3d] [Js]
b175dcea: checks
c05e96ba: bets $0.6
b175dcea: calls $0.6
c05e96ba: shows [9c Jh] (Nines Full over Jacks)
b175dcea: shows [2d As] (Pair of Aces and Pair of Nines)
*** SHOWDOWN ***
c05e96ba collected $1.71 from pot
*** SUMMARY ***
Total pot $1.8 | Rake $0.09 | Jackpot $0 | Bingo $0 | Fortune $0 | Tax $0
Board [Ad 9s 9h 3d Js]
Seat 1: ad17dbfc folded on the Turn
Seat 2: 2811b061 folded before Flop (didn't bet)
Seat 3: d81241b3 (button) folded before Flop (didn't bet)
Seat 4: b175dcea (small blind) showed [2d As] and lost with Pair of Aces and Pair of Nines
Seat 5: c05e96ba (big blind) showed [9c Jh] and won ($1.71) with Nines Full over Jacks
Seat 6: Hero folded before Flop (didn't bet)


Poker Hand #HD1806765945: Hold'em No Limit ($0.05/$0.1) - 2024/06/08 16:19:19
Table 'NLHRed11' 6-max Seat #2 is the button
Seat 1: ad17dbfc ($11.87 in chips)
Seat 2: 2811b061 ($10 in chips)
Seat 3: d81241b3 ($21.13 in chips)
Seat 4: b175dcea ($22.03 in chips)
Seat 5: c05e96ba ($10.12 in chips)
Seat 6: Hero ($10.39 in chips)
d81241b3: posts small blind $0.05
b175dcea: posts big blind $0.1
*** HOLE CARDS ***
Dealt to ad17dbfc 
Dealt to 2811b061 
Dealt to d81241b3 
Dealt to b175dcea 
Dealt to c05e96ba 
Dealt to Hero [4s 3c]
c05e96ba: folds
Hero: folds
ad17dbfc: raises $0.1 to $0.2
2811b061: calls $0.2
d81241b3: raises $0.7 to $0.9
b175dcea: folds
ad17dbfc: folds
2811b061: folds
Uncalled bet ($0.7) returned to d81241b3
*** SHOWDOWN ***
d81241b3 collected $0.67 from pot
*** SUMMARY ***
Total pot $0.7 | Rake $0.03 | Jackpot $0 | Bingo $0 | Fortune $0 | Tax $0
Seat 1: ad17dbfc folded before Flop
Seat 2: 2811b061 (button) folded before Flop
Seat 3: d81241b3 (small blind) collected ($0.67)
Seat 4: b175dcea (big blind) folded before Flop
Seat 5: c05e96ba folded before Flop (didn't bet)
Seat 6: Hero folded before Flop (didn't bet)


Poker Hand #HD1806765819: Hold'em No Limit ($0.05/$0.1) - 2024/06/08 16:18:19
Table 'NLHRed11' 6-max Seat #1 is the button
Seat 1: ad17dbfc ($12.17 in chips)
Seat 2: 2811b061 ($8.61 in chips)
Seat 3: d81241b3 ($21.23 in chips)
Seat 4: b175dcea ($22.03 in chips)
Seat 5: c05e96ba ($9.02 in chips)
Seat 6: Hero ($10.39 in chips)
2811b061: posts small blind $0.05
d81241b3: posts big blind $0.1
*** HOLE CARDS ***
Dealt to ad17dbfc 
Dealt to 2811b061 
Dealt to d81241b3 
Dealt to b175dcea 
Dealt to c05e96ba 
Dealt to Hero [8c Kh]
b175dcea: folds
c05e96ba: raises $0.2 to $0.3
Hero: folds
ad17dbfc: calls $0.3
2811b061: calls $0.25
d81241b3: folds
*** FLOP *** [8s Qd Ah]
2811b061: checks
c05e96ba: bets $0.5
ad17dbfc: folds
2811b061: calls $0.5
*** TURN *** [8s Qd Ah] [Js]
2811b061: checks
c05e96ba: checks
*** RIVER *** [8s Qd Ah Js] [4d]
2811b061: checks
c05e96ba: bets $1.5
2811b061: folds
Uncalled bet ($1.5) returned to c05e96ba
*** SHOWDOWN ***
c05e96ba collected $1.9 from pot
*** SUMMARY ***
Total pot $2 | Rake $0.1 | Jackpot $0 | Bingo $0 | Fortune $0 | Tax $0
Board [8s Qd Ah Js 4d]
Seat 1: ad17dbfc (button) folded on the Flop
Seat 2: 2811b061 (small blind) folded on the River
Seat 3: d81241b3 (big blind) folded before Flop
Seat 4: b175dcea folded before Flop (didn't bet)
Seat 5: c05e96ba won ($1.9)
Seat 6: Hero folded before Flop (didn't bet)


Poker Hand #HD1806765785: Hold'em No Limit ($0.05/$0.1) - 2024/06/08 16:18:05
Table 'NLHRed11' 6-max Seat #6 is the button
Seat 1: ad17dbfc ($12.22 in chips)
Seat 2: 2811b061 ($8.71 in chips)
Seat 3: d81241b3 ($21.23 in chips)
Seat 4: b175dcea ($22.03 in chips)
Seat 5: c05e96ba ($8.87 in chips)
Seat 6: Hero ($10.39 in chips)
ad17dbfc: posts small blind $0.05
2811b061: posts big blind $0.1
*** HOLE CARDS ***
Dealt to ad17dbfc 
Dealt to 2811b061 
Dealt to d81241b3 
Dealt to b175dcea 
Dealt to c05e96ba 
Dealt to Hero [Tc 5s]
d81241b3: folds
b175dcea: folds
c05e96ba: raises $0.2 to $0.3
Hero: folds
ad17dbfc: folds
2811b061: folds
Uncalled bet ($0.2) returned to c05e96ba
*** SHOWDOWN ***
c05e96ba collected $0.25 from pot
*** SUMMARY ***
Total pot $0.25 | Rake $0 | Jackpot $0 | Bingo $0 | Fortune $0 | Tax $0
Seat 1: ad17dbfc (small blind) folded before Flop
Seat 2: 2811b061 (big blind) folded before Flop
Seat 3: d81241b3 folded before Flop (didn't bet)
Seat 4: b175dcea folded before Flop (didn't bet)
Seat 5: c05e96ba collected ($0.25)
Seat 6: Hero (button) folded before Flop (didn't bet)


Poker Hand #HD1806765739: Hold'em No Limit ($0.05/$0.1) - 2024/06/08 16:17:38
Table 'NLHRed11' 6-max Seat #5 is the button
Seat 1: ad17dbfc ($12.42 in chips)
Seat 2: 2811b061 ($8.71 in chips)
Seat 3: d81241b3 ($21.23 in chips)
Seat 4: b175dcea ($21.61 in chips)
Seat 5: c05e96ba ($9.07 in chips)
Seat 6: Hero ($10.44 in chips)
Hero: posts small blind $0.05
ad17dbfc: posts big blind $0.1
*** HOLE CARDS ***
Dealt to ad17dbfc 
Dealt to 2811b061 
Dealt to d81241b3 
Dealt to b175dcea 
Dealt to c05e96ba 
Dealt to Hero [9c 3s]
2811b061: folds
d81241b3: folds
b175dcea: raises $0.1 to $0.2
c05e96ba: calls $0.2
Hero: folds
ad17dbfc: calls $0.1
*** FLOP *** [Kc 9s 8d]
ad17dbfc: checks
b175dcea: checks
c05e96ba: checks
*** TURN *** [Kc 9s 8d] [Kd]
ad17dbfc: checks
b175dcea: bets $0.33
c05e96ba: folds
ad17dbfc: folds
Uncalled bet ($0.33) returned to b175dcea
b175dcea: shows [As 6s] (Pair of Kings)
*** SHOWDOWN ***
b175dcea collected $0.62 from pot
*** SUMMARY ***
Total pot $0.65 | Rake $0.03 | Jackpot $0 | Bingo $0 | Fortune $0 | Tax $0
Board [Kc 9s 8d Kd]
Seat 1: ad17dbfc (big blind) folded on the Turn
Seat 2: 2811b061 folded before Flop (didn't bet)
Seat 3: d81241b3 folded before Flop (didn't bet)
Seat 4: b175dcea showed [As 6s] and won ($0.62)
Seat 5: c05e96ba (button) folded on the Turn
Seat 6: Hero (small blind) folded before Flop


Poker Hand #HD1806765714: Hold'em No Limit ($0.05/$0.1) - 2024/06/08 16:17:23
Table 'NLHRed11' 6-max Seat #4 is the button
Seat 1: ad17dbfc ($12.42 in chips)
Seat 2: 2811b061 ($8.71 in chips)
Seat 3: d81241b3 ($21.08 in chips)
Seat 4: b175dcea ($21.61 in chips)
Seat 5: c05e96ba ($9.12 in chips)
Seat 6: Hero ($10.54 in chips)
c05e96ba: posts small blind $0.05
Hero: posts big blind $0.1
*** HOLE CARDS ***
Dealt to ad17dbfc 
Dealt to 2811b061 
Dealt to d81241b3 
Dealt to b175dcea 
Dealt to c05e96ba 
Dealt to Hero [4h 9c]
ad17dbfc: folds
2811b061: folds
d81241b3: raises $0.15 to $0.25
b175dcea: folds
c05e96ba: folds
Hero: folds
Uncalled bet ($0.15) returned to d81241b3
*** SHOWDOWN ***
d81241b3 collected $0.25 from pot
*** SUMMARY ***
Total pot $0.25 | Rake $0 | Jackpot $0 | Bingo $0 | Fortune $0 | Tax $0
Seat 1: ad17dbfc folded before Flop (didn't bet)
Seat 2: 2811b061 folded before Flop (didn't bet)
Seat 3: d81241b3 collected ($0.25)
Seat 4: b175dcea (button) folded before Flop (didn't bet)
Seat 5: c05e96ba (small blind) folded before Flop
Seat 6: Hero (big blind) folded before Flop


Poker Hand #HD1806765642: Hold'em No Limit ($0.05/$0.1) - 2024/06/08 16:16:51
Table 'NLHRed11' 6-max Seat #3 is the button
Seat 1: ad17dbfc ($12.42 in chips)
Seat 2: 2811b061 ($8.71 in chips)
Seat 3: d81241b3 ($21.08 in chips)
Seat 4: b175dcea ($21.07 in chips)
Seat 5: c05e96ba ($9.72 in chips)
Seat 6: Hero ($10.54 in chips)
b175dcea: posts small blind $0.05
c05e96ba: posts big blind $0.1
*** HOLE CARDS ***
Dealt to ad17dbfc 
Dealt to 2811b061 
Dealt to d81241b3 
Dealt to b175dcea 
Dealt to c05e96ba 
Dealt to Hero [3s 6h]
Hero: folds
ad17dbfc: folds
2811b061: folds
d81241b3: folds
b175dcea: raises $0.2 to $0.3
c05e96ba: calls $0.2
*** FLOP *** [Ks 9s Td]
b175dcea: bets $0.3
c05e96ba: calls $0.3
*** TURN *** [Ks 9s Td] [9h]
b175dcea: bets $0.6
c05e96ba: folds
Uncalled bet ($0.6) returned to b175dcea
b175dcea: shows [6c 3h] (Pair of Nines)
*** SHOWDOWN ***
b175dcea collected $1.14 from pot
*** SUMMARY ***
Total pot $1.2 | Rake $0.06 | Jackpot $0 | Bingo $0 | Fortune $0 | Tax $0
Board [Ks 9s Td 9h]
Seat 1: ad17dbfc folded before Flop (didn't bet)
Seat 2: 2811b061 folded before Flop (didn't bet)
Seat 3: d81241b3 (button) folded before Flop (didn't bet)
Seat 4: b175dcea (small blind) showed [6c 3h] and won ($1.14)
Seat 5: c05e96ba (big blind) folded on the Turn
Seat 6: Hero folded before Flop (didn't bet)


Poker Hand #HD1806675593: Hold'em No Limit ($0.05/$0.1) - 2024/06/08 16:16:29
Table 'NLHRed11' 6-max Seat #2 is the button
Seat 1: ad17dbfc ($12.62 in chips)
Seat 2: 2811b061 ($8.71 in chips)
Seat 3: d81241b3 ($21.13 in chips)
Seat 4: b175dcea ($20.65 in chips)
Seat 5: c05e96ba ($9.92 in chips)
Seat 6: Hero ($10.54 in chips)
d81241b3: posts small blind $0.05
b175dcea: posts big blind $0.1
*** HOLE CARDS ***
Dealt to ad17dbfc 
Dealt to 2811b061 
Dealt to d81241b3 
Dealt to b175dcea 
Dealt to c05e96ba 
Dealt to Hero [Kh 5h]
c05e96ba: raises $0.1 to $0.2
Hero: folds
ad17dbfc: calls $0.2
2811b061: folds
d81241b3: folds
b175dcea: raises $20.45 to $20.65 and is all-in
c05e96ba: folds
ad17dbfc: folds
Uncalled bet ($20.45) returned to b175dcea
*** SHOWDOWN ***
b175dcea collected $0.62 from pot
*** SUMMARY ***
Total pot $0.65 | Rake $0.03 | Jackpot $0 | Bingo $0 | Fortune $0 | Tax $0
Seat 1: ad17dbfc folded before Flop
Seat 2: 2811b061 (button) folded before Flop (didn't bet)
Seat 3: d81241b3 (small blind) folded before Flop
Seat 4: b175dcea (big blind) collected ($0.62)
Seat 5: c05e96ba folded before Flop
Seat 6: Hero folded before Flop (didn't bet)


Poker Hand #HD1806675514: Hold'em No Limit ($0.05/$0.1) - 2024/06/08 16:15:48
Table 'NLHRed11' 6-max Seat #1 is the button
Seat 1: ad17dbfc ($12.86 in chips)
Seat 2: 2811b061 ($8.95 in chips)
Seat 3: d81241b3 ($21.23 in chips)
Seat 4: b175dcea ($20.65 in chips)
Seat 5: c05e96ba ($9.92 in chips)
Seat 6: Hero ($10 in chips)
2811b061: posts small blind $0.05
d81241b3: posts big blind $0.1
*** HOLE CARDS ***
Dealt to ad17dbfc 
Dealt to 2811b061 
Dealt to d81241b3 
Dealt to b175dcea 
Dealt to c05e96ba 
Dealt to Hero [5d Ah]
b175dcea: folds
c05e96ba: folds
Hero: raises $0.14 to $0.24
ad17dbfc: calls $0.24
2811b061: calls $0.19
d81241b3: folds
*** FLOP *** [Ac Qd Js]
2811b061: checks
Hero: checks
ad17dbfc: checks
*** TURN *** [Ac Qd Js] [5h]
2811b061: checks
Hero: bets $0.4
ad17dbfc: folds
2811b061: folds
Uncalled bet ($0.4) returned to Hero
*** SHOWDOWN ***
Hero collected $0.78 from pot
*** SUMMARY ***
Total pot $0.82 | Rake $0.04 | Jackpot $0 | Bingo $0 | Fortune $0 | Tax $0
Board [Ac Qd Js 5h]
Seat 1: ad17dbfc (button) folded on the Turn
Seat 2: 2811b061 (small blind) folded on the Turn
Seat 3: d81241b3 (big blind) folded before Flop
Seat 4: b175dcea folded before Flop (didn't bet)
Seat 5: c05e96ba folded before Flop (didn't bet)
Seat 6: Hero won ($0.78)


Poker Hand #HD1806675445: Hold'em No Limit ($0.05/$0.1) - 2024/06/08 16:15:15
Table 'NLHRed11' 6-max Seat #6 is the button
Seat 1: ad17dbfc ($13.51 in chips)
Seat 2: 2811b061 ($9.05 in chips)
Seat 3: d81241b3 ($21.23 in chips)
Seat 4: b175dcea ($20.65 in chips)
Seat 5: c05e96ba ($9.24 in chips)
Seat 6: Hero ($10 in chips)
ad17dbfc: posts small blind $0.05
2811b061: posts big blind $0.1
*** HOLE CARDS ***
Dealt to ad17dbfc 
Dealt to 2811b061 
Dealt to d81241b3 
Dealt to b175dcea 
Dealt to c05e96ba 
Dealt to Hero [8h 2s]
d81241b3: folds
b175dcea: folds
c05e96ba: raises $0.2 to $0.3
Hero: folds
ad17dbfc: calls $0.25
2811b061: folds
*** FLOP *** [Ac Tc Jc]
ad17dbfc: checks
c05e96ba: checks
*** TURN *** [Ac Tc Jc] [6h]
ad17dbfc: checks
c05e96ba: checks
*** RIVER *** [Ac Tc Jc 6h] [4c]
ad17dbfc: bets $0.35
c05e96ba: calls $0.35
ad17dbfc: shows [2h 5h] (Ace-High)
c05e96ba: shows [9c 9s] (Ace High Flush)
*** SHOWDOWN ***
c05e96ba collected $1.33 from pot
*** SUMMARY ***
Total pot $1.4 | Rake $0.07 | Jackpot $0 | Bingo $0 | Fortune $0 | Tax $0
Board [Ac Tc Jc 6h 4c]
Seat 1: ad17dbfc (small blind) showed [2h 5h] and lost with Ace-High
Seat 2: 2811b061 (big blind) folded before Flop
Seat 3: d81241b3 folded before Flop (didn't bet)
Seat 4: b175dcea folded before Flop (didn't bet)
Seat 5: c05e96ba showed [9c 9s] and won ($1.33) with Ace High Flush
Seat 6: Hero (button) folded before Flop (didn't bet)


Poker Hand #HD1806675356: Hold'em No Limit ($0.05/$0.1) - 2024/06/08 16:14:34
Table 'NLHRed11' 6-max Seat #5 is the button
Seat 1: ad17dbfc ($13.24 in chips)
Seat 2: 2811b061 ($9.05 in chips)
Seat 3: d81241b3 ($21.23 in chips)
Seat 4: b175dcea ($20.65 in chips)
Seat 5: c05e96ba ($9.24 in chips)
Seat 6: Hero ($10.05 in chips)
Hero: posts small blind $0.05
ad17dbfc: posts big blind $0.1
*** HOLE CARDS ***
Dealt to ad17dbfc 
Dealt to 2811b061 
Dealt to d81241b3 
Dealt to b175dcea 
Dealt to c05e96ba 
Dealt to Hero [5h Ah]
2811b061: folds
d81241b3: folds
b175dcea: folds
c05e96ba: folds
Hero: raises $0.2 to $0.3
ad17dbfc: calls $0.2
*** FLOP *** [8c 7s Jc]
Hero: checks
ad17dbfc: bets $0.2
Hero: folds
Uncalled bet ($0.2) returned to ad17dbfc
*** SHOWDOWN ***
ad17dbfc collected $0.57 from pot
*** SUMMARY ***
Total pot $0.6 | Rake $0.03 | Jackpot $0 | Bingo $0 | Fortune $0 | Tax $0
Board [8c 7s Jc]
Seat 1: ad17dbfc (big blind) won ($0.57)
Seat 2: 2811b061 folded before Flop (didn't bet)
Seat 3: d81241b3 folded before Flop (didn't bet)
Seat 4: b175dcea folded before Flop (didn't bet)
Seat 5: c05e96ba (button) folded before Flop (didn't bet)
Seat 6: Hero (small blind) folded on the Flop


Poker Hand #HD1806675337: Hold'em No Limit ($0.05/$0.1) - 2024/06/08 16:14:24
Table 'NLHRed11' 6-max Seat #4 is the button
Seat 1: ad17dbfc ($13.24 in chips)
Seat 2: 2811b061 ($9.05 in chips)
Seat 3: d81241b3 ($21.23 in chips)
Seat 4: b175dcea ($20.65 in chips)
Seat 5: c05e96ba ($9.29 in chips)
Seat 6: Hero ($10 in chips)
c05e96ba: posts small blind $0.05
Hero: posts big blind $0.1
*** HOLE CARDS ***
Dealt to ad17dbfc 
Dealt to 2811b061 
Dealt to d81241b3 
Dealt to b175dcea 
Dealt to c05e96ba 
Dealt to Hero [Ks As]
ad17dbfc: folds
2811b061: folds
d81241b3: folds
b175dcea: folds
c05e96ba: folds
Uncalled bet ($0.05) returned to Hero
*** SHOWDOWN ***
Hero collected $0.1 from pot
*** SUMMARY ***
Total pot $0.1 | Rake $0 | Jackpot $0 | Bingo $0 | Fortune $0 | Tax $0
Seat 1: ad17dbfc folded before Flop (didn't bet)
Seat 2: 2811b061 folded before Flop (didn't bet)
Seat 3: d81241b3 folded before Flop (didn't bet)
Seat 4: b175dcea (button) folded before Flop (didn't bet)
Seat 5: c05e96ba (small blind) folded before Flop
Seat 6: Hero (big blind) collected ($0.1)


Poker Hand #HD1806675315: Hold'em No Limit ($0.05/$0.1) - 2024/06/08 16:14:12
Table 'NLHRed11' 6-max Seat #3 is the button
Seat 1: ad17dbfc ($13.24 in chips)
Seat 2: 2811b061 ($9.05 in chips)
Seat 3: d81241b3 ($21.23 in chips)
Seat 4: b175dcea ($20.7 in chips)
Seat 5: c05e96ba ($9.24 in chips)
Seat 6: Hero ($10 in chips)
b175dcea: posts small blind $0.05
c05e96ba: posts big blind $0.1
*** HOLE CARDS ***
Dealt to ad17dbfc 
Dealt to 2811b061 
Dealt to d81241b3 
Dealt to b175dcea 
Dealt to c05e96ba 
Dealt to Hero [4d Jh]
Hero: folds
ad17dbfc: folds
2811b061: folds
d81241b3: folds
b175dcea: folds
Uncalled bet ($0.05) returned to c05e96ba
*** SHOWDOWN ***
c05e96ba collected $0.1 from pot
*** SUMMARY ***
Total pot $0.1 | Rake $0 | Jackpot $0 | Bingo $0 | Fortune $0 | Tax $0
Seat 1: ad17dbfc folded before Flop (didn't bet)
Seat 2: 2811b061 folded before Flop (didn't bet)
Seat 3: d81241b3 (button) folded before Flop (didn't bet)
Seat 4: b175dcea (small blind) folded before Flop
Seat 5: c05e96ba (big blind) collected ($0.1)
Seat 6: Hero folded before Flop (didn't bet)


Poker Hand #HD1806675232: Hold'em No Limit ($0.05/$0.1) - 2024/06/08 16:13:29
Table 'NLHRed11' 6-max Seat #2 is the button
Seat 1: ad17dbfc ($12.68 in chips)
Seat 2: 2811b061 ($9.05 in chips)
Seat 3: d81241b3 ($21.43 in chips)
Seat 4: b175dcea ($20.9 in chips)
Seat 5: c05e96ba ($9.44 in chips)
Seat 6: Hero ($10 in chips)
d81241b3: posts small blind $0.05
b175dcea: posts big blind $0.1
*** HOLE CARDS ***
Dealt to ad17dbfc 
Dealt to 2811b061 
Dealt to d81241b3 
Dealt to b175dcea 
Dealt to c05e96ba 
Dealt to Hero [7s 6s]
c05e96ba: raises $0.1 to $0.2
Hero: folds
ad17dbfc: calls $0.2
2811b061: folds
d81241b3: calls $0.15
b175dcea: calls $0.1
*** FLOP *** [5h 8s Ac]
d81241b3: checks
b175dcea: checks
c05e96ba: checks
ad17dbfc: bets $0.4
d81241b3: folds
b175dcea: folds
c05e96ba: folds
Uncalled bet ($0.4) returned to ad17dbfc
*** SHOWDOWN ***
ad17dbfc collected $0.76 from pot
*** SUMMARY ***
Total pot $0.8 | Rake $0.04 | Jackpot $0 | Bingo $0 | Fortune $0 | Tax $0
Board [5h 8s Ac]
Seat 1: ad17dbfc won ($0.76)
Seat 2: 2811b061 (button) folded before Flop (didn't bet)
Seat 3: d81241b3 (small blind) folded on the Flop
Seat 4: b175dcea (big blind) folded on the Flop
Seat 5: c05e96ba folded on the Flop
Seat 6: Hero folded before Flop (didn't bet)


Poker Hand #HD1806675191: Hold'em No Limit ($0.05/$0.1) - 2024/06/08 16:13:09
Table 'NLHRed11' 6-max Seat #1 is the button
Seat 1: ad17dbfc ($12.53 in chips)
Seat 2: 2811b061 ($9.1 in chips)
Seat 3: d81241b3 ($21.53 in chips)
Seat 4: b175dcea ($20.9 in chips)
Seat 5: c05e96ba ($9.44 in chips)
Seat 6: Hero ($10 in chips)
2811b061: posts small blind $0.05
d81241b3: posts big blind $0.1
*** HOLE CARDS ***
Dealt to ad17dbfc 
Dealt to 2811b061 
Dealt to d81241b3 
Dealt to b175dcea 
Dealt to c05e96ba 
Dealt to Hero [5d Kc]
b175dcea: folds
c05e96ba: folds
Hero: folds
ad17dbfc: raises $0.2 to $0.3
2811b061: folds
d81241b3: folds
Uncalled bet ($0.2) returned to ad17dbfc
*** SHOWDOWN ***
ad17dbfc collected $0.25 from pot
*** SUMMARY ***
Total pot $0.25 | Rake $0 | Jackpot $0 | Bingo $0 | Fortune $0 | Tax $0
Seat 1: ad17dbfc (button) collected ($0.25)
Seat 2: 2811b061 (small blind) folded before Flop
Seat 3: d81241b3 (big blind) folded before Flop
Seat 4: b175dcea folded before Flop (didn't bet)
Seat 5: c05e96ba folded before Flop (didn't bet)
Seat 6: Hero folded before Flop (didn't bet)


Poker Hand #HD1806675039: Hold'em No Limit ($0.05/$0.1) - 2024/06/08 16:12:03
Table 'NLHRed11' 6-max Seat #6 is the button
Seat 1: ad17dbfc ($12.58 in chips)
Seat 2: 2811b061 ($9.2 in chips)
Seat 3: d81241b3 ($21.53 in chips)
Seat 4: b175dcea ($16.87 in chips)
Seat 5: c05e96ba ($9.44 in chips)
Seat 6: Hero ($10 in chips)
ad17dbfc: posts small blind $0.05
2811b061: posts big blind $0.1
*** HOLE CARDS ***
Dealt to ad17dbfc 
Dealt to 2811b061 
Dealt to d81241b3 
Dealt to b175dcea 
Dealt to c05e96ba 
Dealt to Hero [Qh Ah]
d81241b3: folds
b175dcea: raises $0.2 to $0.3
c05e96ba: folds
Hero: raises $0.6 to $0.9
ad17dbfc: folds
2811b061: folds
b175dcea: raises $15.97 to $16.87 and is all-in
Hero: calls $9.1 and is all-in
Uncalled bet ($6.87) returned to b175dcea
b175dcea: shows [Kd Ks]
Hero: shows [Qh Ah]
*** FLOP *** [4d 7h Kh]
b175dcea: Chooses to EV Cashout 
*** TURN *** [4d 7h Kh] [9s]
*** RIVER *** [4d 7h Kh 9s] [Qd]
b175dcea: Pays Cashout Risk ($5.02)
*** SHOWDOWN ***
b175dcea collected $19.05 from pot
*** SUMMARY ***
Total pot $20.15 | Rake $1 | Jackpot $0.1 | Bingo $0 | Fortune $0 | Tax $0
Board [4d 7h Kh 9s Qd]
Seat 1: ad17dbfc (small blind) folded before Flop
Seat 2: 2811b061 (big blind) folded before Flop
Seat 3: d81241b3 folded before Flop (didn't bet)
Seat 4: b175dcea showed [Kd Ks] and won ($19.05) with Three Kings, Cashout Risk ($5.02)
Seat 5: c05e96ba folded before Flop (didn't bet)
Seat 6: Hero (button) showed [Qh Ah] and lost with Pair of Queens


Poker Hand #HD1806675017: Hold'em No Limit ($0.05/$0.1) - 2024/06/08 16:11:49
Table 'NLHRed11' 6-max Seat #5 is the button
Seat 1: ad17dbfc ($12.68 in chips)
Seat 2: 2811b061 ($9.2 in chips)
Seat 3: d81241b3 ($21.53 in chips)
Seat 4: b175dcea ($16.87 in chips)
Seat 5: c05e96ba ($9.29 in chips)
Seat 6: Hero ($10 in chips)
Hero: posts small blind $0.05
ad17dbfc: posts big blind $0.1
*** HOLE CARDS ***
Dealt to ad17dbfc 
Dealt to 2811b061 
Dealt to d81241b3 
Dealt to b175dcea 
Dealt to c05e96ba 
Dealt to Hero [3d 7c]
2811b061: folds
d81241b3: folds
b175dcea: folds
c05e96ba: raises $0.2 to $0.3
Hero: folds
ad17dbfc: folds
Uncalled bet ($0.2) returned to c05e96ba
*** SHOWDOWN ***
c05e96ba collected $0.25 from pot
*** SUMMARY ***
Total pot $0.25 | Rake $0 | Jackpot $0 | Bingo $0 | Fortune $0 | Tax $0
Seat 1: ad17dbfc (big blind) folded before Flop
Seat 2: 2811b061 folded before Flop (didn't bet)
Seat 3: d81241b3 folded before Flop (didn't bet)
Seat 4: b175dcea folded before Flop (didn't bet)
Seat 5: c05e96ba (button) collected ($0.25)
Seat 6: Hero (small blind) folded before Flop


Poker Hand #HD1806674968: Hold'em No Limit ($0.05/$0.1) - 2024/06/08 16:11:27
Table 'NLHRed11' 6-max Seat #4 is the button
Seat 1: ad17dbfc ($12.68 in chips)
Seat 2: 2811b061 ($9.2 in chips)
Seat 3: d81241b3 ($21.53 in chips)
Seat 4: b175dcea ($16.14 in chips)
Seat 5: c05e96ba ($9.99 in chips)
Seat 6: Hero ($10 in chips)
c05e96ba: posts small blind $0.05
Hero: posts big blind $0.1
*** HOLE CARDS ***
Dealt to ad17dbfc 
Dealt to 2811b061 
Dealt to d81241b3 
Dealt to b175dcea 
Dealt to c05e96ba 
Dealt to Hero [Kc 4s]
ad17dbfc: folds
2811b061: folds
d81241b3: folds
b175dcea: raises $0.1 to $0.2
c05e96ba: raises $0.5 to $0.7
Hero: folds
b175dcea: raises $15.44 to $16.14 and is all-in
c05e96ba: folds
Uncalled bet ($15.44) returned to b175dcea
b175dcea: shows [6h Td]
*** SHOWDOWN ***
b175dcea collected $1.43 from pot
*** SUMMARY ***
Total pot $1.5 | Rake $0.07 | Jackpot $0 | Bingo $0 | Fortune $0 | Tax $0
Seat 1: ad17dbfc folded before Flop (didn't bet)
Seat 2: 2811b061 folded before Flop (didn't bet)
Seat 3: d81241b3 folded before Flop (didn't bet)
Seat 4: b175dcea (button) showed [6h Td] and collected ($1.43)
Seat 5: c05e96ba (small blind) folded before Flop
Seat 6: Hero (big blind) folded before Flop


Poker Hand #HD1806674840: Hold'em No Limit ($0.05/$0.1) - 2024/06/08 16:10:27
Table 'NLHRed11' 6-max Seat #3 is the button
Seat 1: ad17dbfc ($12.68 in chips)
Seat 2: 2811b061 ($9.5 in chips)
Seat 3: d81241b3 ($21.83 in chips)
Seat 4: b175dcea ($14.94 in chips)
Seat 5: c05e96ba ($10.69 in chips)
Seat 6: Hero ($10 in chips)
b175dcea: posts small blind $0.05
c05e96ba: posts big blind $0.1
*** HOLE CARDS ***
Dealt to ad17dbfc 
Dealt to 2811b061 
Dealt to d81241b3 
Dealt to b175dcea 
Dealt to c05e96ba 
Dealt to Hero [4c Js]
Hero: folds
ad17dbfc: folds
2811b061: raises $0.2 to $0.3
d81241b3: calls $0.3
b175dcea: calls $0.25
c05e96ba: calls $0.2
*** FLOP *** [9s 2h 6d]
b175dcea: checks
c05e96ba: bets $0.4
2811b061: folds
d81241b3: folds
b175dcea: calls $0.4
*** TURN *** [9s 2h 6d] [Ks]
b175dcea: checks
c05e96ba: checks
*** RIVER *** [9s 2h 6d Ks] [8c]
b175dcea: bets $2
c05e96ba: folds
Uncalled bet ($2) returned to b175dcea
*** SHOWDOWN ***
b175dcea collected $1.9 from pot
*** SUMMARY ***
Total pot $2 | Rake $0.1 | Jackpot $0 | Bingo $0 | Fortune $0 | Tax $0
Board [9s 2h 6d Ks 8c]
Seat 1: ad17dbfc folded before Flop (didn't bet)
Seat 2: 2811b061 folded on the Flop
Seat 3: d81241b3 (button) folded on the Flop
Seat 4: b175dcea (small blind) won ($1.9)
Seat 5: c05e96ba (big blind) folded on the River
Seat 6: Hero folded before Flop (didn't bet)


Poker Hand #HD1806674702: Hold'em No Limit ($0.05/$0.1) - 2024/06/08 16:09:20
Table 'NLHRed11' 6-max Seat #2 is the button
Seat 1: ad17dbfc ($12.68 in chips)
Seat 2: 2811b061 ($9.5 in chips)
Seat 3: d81241b3 ($20.75 in chips)
Seat 4: b175dcea ($16.14 in chips)
Seat 5: c05e96ba ($10.69 in chips)
Seat 6: Hero ($10 in chips)
d81241b3: posts small blind $0.05
b175dcea: posts big blind $0.1
*** HOLE CARDS ***
Dealt to ad17dbfc 
Dealt to 2811b061 
Dealt to d81241b3 
Dealt to b175dcea 
Dealt to c05e96ba 
Dealt to Hero [9s 6c]
c05e96ba: folds
Hero: folds
ad17dbfc: folds
2811b061: folds
d81241b3: raises $0.2 to $0.3
b175dcea: calls $0.2
*** FLOP *** [Th 2c 5h]
d81241b3: bets $0.3
b175dcea: calls $0.3
*** TURN *** [Th 2c 5h] [7h]
d81241b3: checks
b175dcea: bets $0.6
d81241b3: calls $0.6
*** RIVER *** [Th 2c 5h 7h] [5c]
d81241b3: checks
b175dcea: checks
d81241b3: shows [Td Tc] (Tens Full over Fives)
b175dcea: shows [6h Ks] (Pair of Fives)
*** SHOWDOWN ***
d81241b3 collected $2.28 from pot
*** SUMMARY ***
Total pot $2.4 | Rake $0.12 | Jackpot $0 | Bingo $0 | Fortune $0 | Tax $0
Board [Th 2c 5h 7h 5c]
Seat 1: ad17dbfc folded before Flop (didn't bet)
Seat 2: 2811b061 (button) folded before Flop (didn't bet)
Seat 3: d81241b3 (small blind) showed [Td Tc] and won ($2.28) with Tens Full over Fives
Seat 4: b175dcea (big blind) showed [6h Ks] and lost with Pair of Fives
Seat 5: c05e96ba folded before Flop (didn't bet)
Seat 6: Hero folded before Flop (didn't bet)


Poker Hand #HD1806674570: Hold'em No Limit ($0.05/$0.1) - 2024/06/08 16:08:14
Table 'NLHRed11' 6-max Seat #1 is the button
Seat 1: ad17dbfc ($11.77 in chips)
Seat 2: 2811b061 ($9.94 in chips)
Seat 3: d81241b3 ($20.85 in chips)
Seat 4: b175dcea ($16.58 in chips)
Seat 5: c05e96ba ($10.69 in chips)
Seat 6: Hero ($10 in chips)
2811b061: posts small blind $0.05
d81241b3: posts big blind $0.1
*** HOLE CARDS ***
Dealt to ad17dbfc 
Dealt to 2811b061 
Dealt to d81241b3 
Dealt to b175dcea 
Dealt to c05e96ba 
Dealt to Hero [7h 5c]
b175dcea: raises $0.1 to $0.2
c05e96ba: folds
Hero: folds
ad17dbfc: calls $0.2
2811b061: calls $0.15
d81241b3: folds
*** FLOP *** [6d 7s Qc]
2811b061: checks
b175dcea: bets $0.24
ad17dbfc: calls $0.24
2811b061: calls $0.24
*** TURN *** [6d 7s Qc] [2d]
2811b061: checks
b175dcea: checks
ad17dbfc: checks
*** RIVER *** [6d 7s Qc 2d] [6c]
2811b061: checks
b175dcea: checks
ad17dbfc: bets $1.42
2811b061: folds
b175dcea: folds
Uncalled bet ($1.42) returned to ad17dbfc
b175dcea: shows [9s] (Pair of Sixes)
*** SHOWDOWN ***
ad17dbfc collected $1.35 from pot
*** SUMMARY ***
Total pot $1.42 | Rake $0.07 | Jackpot $0 | Bingo $0 | Fortune $0 | Tax $0
Board [6d 7s Qc 2d 6c]
Seat 1: ad17dbfc (button) won ($1.35)
Seat 2: 2811b061 (small blind) folded on the River
Seat 3: d81241b3 (big blind) folded before Flop
Seat 4: b175dcea folded on the River
Seat 5: c05e96ba folded before Flop (didn't bet)
Seat 6: Hero folded before Flop (didn't bet)


Poker Hand #HD1806674460: Hold'em No Limit ($0.05/$0.1) - 2024/06/08 16:07:18
Table 'NLHRed11' 6-max Seat #6 is the button
Seat 1: ad17dbfc ($10.82 in chips)
Seat 2: 2811b061 ($10.04 in chips)
Seat 3: d81241b3 ($21.1 in chips)
Seat 4: b175dcea ($16.58 in chips)
Seat 5: c05e96ba ($11.37 in chips)
Seat 6: Hero ($10 in chips)
ad17dbfc: posts small blind $0.05
2811b061: posts big blind $0.1
*** HOLE CARDS ***
Dealt to ad17dbfc 
Dealt to 2811b061 
Dealt to d81241b3 
Dealt to b175dcea 
Dealt to c05e96ba 
Dealt to Hero [2s Jd]
d81241b3: raises $0.15 to $0.25
b175dcea: folds
c05e96ba: calls $0.25
Hero: folds
ad17dbfc: calls $0.2
2811b061: folds
*** FLOP *** [7s Qc 4s]
ad17dbfc: checks
d81241b3: checks
c05e96ba: checks
*** TURN *** [7s Qc 4s] [9d]
ad17dbfc: checks
d81241b3: checks
c05e96ba: bets $0.43
ad17dbfc: raises $0.86 to $1.29
d81241b3: folds
c05e96ba: folds
Uncalled bet ($0.86) returned to ad17dbfc
*** SHOWDOWN ***
ad17dbfc collected $1.63 from pot
*** SUMMARY ***
Total pot $1.71 | Rake $0.08 | Jackpot $0 | Bingo $0 | Fortune $0 | Tax $0
Board [7s Qc 4s 9d]
Seat 1: ad17dbfc (small blind) won ($1.63)
Seat 2: 2811b061 (big blind) folded before Flop
Seat 3: d81241b3 folded on the Turn
Seat 4: b175dcea folded before Flop (didn't bet)
Seat 5: c05e96ba folded on the Turn
Seat 6: Hero (button) folded before Flop (didn't bet)


Poker Hand #HD1806674360: Hold'em No Limit ($0.05/$0.1) - 2024/06/08 16:06:29
Table 'NLHRed11' 6-max Seat #5 is the button
Seat 1: ad17dbfc ($11.07 in chips)
Seat 2: 2811b061 ($10.04 in chips)
Seat 3: d81241b3 ($20.23 in chips)
Seat 4: b175dcea ($17.23 in chips)
Seat 5: c05e96ba ($11.37 in chips)
Seat 6: Hero ($10 in chips)
Hero: posts small blind $0.05
ad17dbfc: posts big blind $0.1
*** HOLE CARDS ***
Dealt to ad17dbfc 
Dealt to 2811b061 
Dealt to d81241b3 
Dealt to b175dcea 
Dealt to c05e96ba 
Dealt to Hero [2s 8h]
2811b061: folds
d81241b3: raises $0.15 to $0.25
b175dcea: calls $0.25
c05e96ba: folds
Hero: folds
ad17dbfc: calls $0.15
*** FLOP *** [7h 2d Kc]
ad17dbfc: checks
d81241b3: checks
b175dcea: bets $0.4
ad17dbfc: folds
d81241b3: calls $0.4
*** TURN *** [7h 2d Kc] [2c]
d81241b3: checks
b175dcea: checks
*** RIVER *** [7h 2d Kc 2c] [9h]
d81241b3: checks
b175dcea: checks
d81241b3: shows [Qc Qd] (Pair of Queens and Pair of Twos)
b175dcea: shows [4s 7c] (Pair of Sevens and Pair of Twos)
*** SHOWDOWN ***
d81241b3 collected $1.52 from pot
*** SUMMARY ***
Total pot $1.6 | Rake $0.08 | Jackpot $0 | Bingo $0 | Fortune $0 | Tax $0
Board [7h 2d Kc 2c 9h]
Seat 1: ad17dbfc (big blind) folded on the Flop
Seat 2: 2811b061 folded before Flop (didn't bet)
Seat 3: d81241b3 showed [Qc Qd] and won ($1.52) with Pair of Queens and Pair of Twos
Seat 4: b175dcea showed [4s 7c] and lost with Pair of Sevens and Pair of Twos
Seat 5: c05e96ba (button) folded before Flop (didn't bet)
Seat 6: Hero (small blind) folded before Flop


Poker Hand #HD1806674275: Hold'em No Limit ($0.05/$0.1) - 2024/06/08 16:05:45
Table 'NLHRed11' 6-max Seat #4 is the button
Seat 1: ad17dbfc ($11.57 in chips)
Seat 2: 2811b061 ($10.04 in chips)
Seat 3: d81241b3 ($20.23 in chips)
Seat 4: b175dcea ($17.73 in chips)
Seat 5: c05e96ba ($10.35 in chips)
Seat 6: Hero ($10.03 in chips)
c05e96ba: posts small blind $0.05
Hero: posts big blind $0.1
*** HOLE CARDS ***
Dealt to ad17dbfc 
Dealt to 2811b061 
Dealt to d81241b3 
Dealt to b175dcea 
Dealt to c05e96ba 
Dealt to Hero [6s 5d]
ad17dbfc: raises $0.2 to $0.3
2811b061: folds
d81241b3: folds
b175dcea: raises $0.2 to $0.5
c05e96ba: calls $0.45
Hero: folds
ad17dbfc: calls $0.2
*** FLOP *** [5h Td 2c]
c05e96ba: checks
ad17dbfc: checks
b175dcea: checks
*** TURN *** [5h Td 2c] [9c]
c05e96ba: bets $0.8
ad17dbfc: folds
b175dcea: folds
Uncalled bet ($0.8) returned to c05e96ba
*** SHOWDOWN ***
c05e96ba collected $1.52 from pot
*** SUMMARY ***
Total pot $1.6 | Rake $0.08 | Jackpot $0 | Bingo $0 | Fortune $0 | Tax $0
Board [5h Td 2c 9c]
Seat 1: ad17dbfc folded on the Turn
Seat 2: 2811b061 folded before Flop (didn't bet)
Seat 3: d81241b3 folded before Flop (didn't bet)
Seat 4: b175dcea (button) folded on the Turn
Seat 5: c05e96ba (small blind) won ($1.52)
Seat 6: Hero (big blind) folded before Flop


Poker Hand #HD1806674221: Hold'em No Limit ($0.05/$0.1) - 2024/06/08 16:05:17
Table 'NLHRed11' 6-max Seat #3 is the button
Seat 1: ad17dbfc ($11.43 in chips)
Seat 2: 2811b061 ($10.04 in chips)
Seat 3: d81241b3 ($20.23 in chips)
Seat 4: b175dcea ($17.78 in chips)
Seat 5: c05e96ba ($10.45 in chips)
Seat 6: Hero ($10.03 in chips)
b175dcea: posts small blind $0.05
c05e96ba: posts big blind $0.1
*** HOLE CARDS ***
Dealt to ad17dbfc 
Dealt to 2811b061 
Dealt to d81241b3 
Dealt to b175dcea 
Dealt to c05e96ba 
Dealt to Hero [3d Qs]
Hero: folds
ad17dbfc: calls $0.1
2811b061: folds
d81241b3: folds
b175dcea: folds
c05e96ba: checks
*** FLOP *** [7h Ad 7c]
c05e96ba: checks
ad17dbfc: checks
*** TURN *** [7h Ad 7c] [Qc]
c05e96ba: checks
ad17dbfc: bets $0.19
c05e96ba: folds
Uncalled bet ($0.19) returned to ad17dbfc
*** SHOWDOWN ***
ad17dbfc collected $0.24 from pot
*** SUMMARY ***
Total pot $0.25 | Rake $0.01 | Jackpot $0 | Bingo $0 | Fortune $0 | Tax $0
Board [7h Ad 7c Qc]
Seat 1: ad17dbfc won ($0.24)
Seat 2: 2811b061 folded before Flop (didn't bet)
Seat 3: d81241b3 (button) folded before Flop (didn't bet)
Seat 4: b175dcea (small blind) folded before Flop
Seat 5: c05e96ba (big blind) folded on the Turn
Seat 6: Hero folded before Flop (didn't bet)


Poker Hand #HD1806674190: Hold'em No Limit ($0.05/$0.1) - 2024/06/08 16:04:58
Table 'NLHRed11' 6-max Seat #2 is the button
Seat 1: ad17dbfc ($11.43 in chips)
Seat 2: 2811b061 ($10.04 in chips)
Seat 3: d81241b3 ($20.28 in chips)
Seat 4: b175dcea ($17.88 in chips)
Seat 5: c05e96ba ($10.3 in chips)
Seat 6: Hero ($10.03 in chips)
d81241b3: posts small blind $0.05
b175dcea: posts big blind $0.1
*** HOLE CARDS ***
Dealt to ad17dbfc 
Dealt to 2811b061 
Dealt to d81241b3 
Dealt to b175dcea 
Dealt to c05e96ba 
Dealt to Hero [Kd 8c]
c05e96ba: raises $0.2 to $0.3
Hero: folds
ad17dbfc: folds
2811b061: folds
d81241b3: folds
b175dcea: folds
Uncalled bet ($0.2) returned to c05e96ba
*** SHOWDOWN ***
c05e96ba collected $0.25 from pot
*** SUMMARY ***
Total pot $0.25 | Rake $0 | Jackpot $0 | Bingo $0 | Fortune $0 | Tax $0
Seat 1: ad17dbfc folded before Flop (didn't bet)
Seat 2: 2811b061 (button) folded before Flop (didn't bet)
Seat 3: d81241b3 (small blind) folded before Flop
Seat 4: b175dcea (big blind) folded before Flop
Seat 5: c05e96ba collected ($0.25)
Seat 6: Hero folded before Flop (didn't bet)


Poker Hand #HD1806674146: Hold'em No Limit ($0.05/$0.1) - 2024/06/08 16:04:34
Table 'NLHRed11' 6-max Seat #1 is the button
Seat 1: ad17dbfc ($11.73 in chips)
Seat 2: 2811b061 ($10.09 in chips)
Seat 3: d81241b3 ($20.38 in chips)
Seat 4: b175dcea ($17.88 in chips)
Seat 5: c05e96ba ($9.88 in chips)
Seat 6: Hero ($10.03 in chips)
2811b061: posts small blind $0.05
d81241b3: posts big blind $0.1
*** HOLE CARDS ***
Dealt to ad17dbfc 
Dealt to 2811b061 
Dealt to d81241b3 
Dealt to b175dcea 
Dealt to c05e96ba 
Dealt to Hero [5h 6s]
b175dcea: folds
c05e96ba: raises $0.2 to $0.3
Hero: folds
ad17dbfc: calls $0.3
2811b061: folds
d81241b3: folds
*** FLOP *** [Js 5c 3s]
c05e96ba: bets $0.38
ad17dbfc: folds
Uncalled bet ($0.38) returned to c05e96ba
*** SHOWDOWN ***
c05e96ba collected $0.72 from pot
*** SUMMARY ***
Total pot $0.75 | Rake $0.03 | Jackpot $0 | Bingo $0 | Fortune $0 | Tax $0
Board [Js 5c 3s]
Seat 1: ad17dbfc (button) folded on the Flop
Seat 2: 2811b061 (small blind) folded before Flop
Seat 3: d81241b3 (big blind) folded before Flop
Seat 4: b175dcea folded before Flop (didn't bet)
Seat 5: c05e96ba won ($0.72)
Seat 6: Hero folded before Flop (didn't bet)


Poker Hand #HD1806674084: Hold'em No Limit ($0.05/$0.1) - 2024/06/08 16:04:05
Table 'NLHRed11' 6-max Seat #6 is the button
Seat 1: ad17dbfc ($11.83 in chips)
Seat 2: 2811b061 ($10 in chips)
Seat 3: d81241b3 ($20.38 in chips)
Seat 4: b175dcea ($17.88 in chips)
Seat 5: c05e96ba ($9.88 in chips)
Seat 6: Hero ($10.03 in chips)
ad17dbfc: posts small blind $0.05
2811b061: posts big blind $0.1
*** HOLE CARDS ***
Dealt to ad17dbfc 
Dealt to 2811b061 
Dealt to d81241b3 
Dealt to b175dcea 
Dealt to c05e96ba 
Dealt to Hero [Jc 4d]
d81241b3: folds
b175dcea: folds
c05e96ba: folds
Hero: folds
ad17dbfc: calls $0.05
2811b061: checks
*** FLOP *** [7c Ks 2s]
ad17dbfc: checks
2811b061: checks
*** TURN *** [7c Ks 2s] [As]
ad17dbfc: checks
2811b061: checks
*** RIVER *** [7c Ks 2s As] [Ad]
ad17dbfc: checks
2811b061: checks
ad17dbfc: shows [9h Td] (Pair of Aces)
2811b061: shows [9d 2h] (Pair of Aces and Pair of Twos)
*** SHOWDOWN ***
2811b061 collected $0.19 from pot
*** SUMMARY ***
Total pot $0.2 | Rake $0.01 | Jackpot $0 | Bingo $0 | Fortune $0 | Tax $0
Board [7c Ks 2s As Ad]
Seat 1: ad17dbfc (small blind) showed [9h Td] and lost with Pair of Aces
Seat 2: 2811b061 (big blind) showed [9d 2h] and won ($0.19) with Pair of Aces and Pair of Twos
Seat 3: d81241b3 folded before Flop (didn't bet)
Seat 4: b175dcea folded before Flop (didn't bet)
Seat 5: c05e96ba folded before Flop (didn't bet)
Seat 6: Hero (button) folded before Flop (didn't bet)


Poker Hand #HD1806673982: Hold'em No Limit ($0.05/$0.1) - 2024/06/08 16:03:16
Table 'NLHRed11' 6-max Seat #5 is the button
Seat 1: ad17dbfc ($13.2 in chips)
Seat 3: d81241b3 ($20.38 in chips)
Seat 4: b175dcea ($18.08 in chips)
Seat 5: c05e96ba ($8.41 in chips)
Seat 6: Hero ($10.08 in chips)
Hero: posts small blind $0.05
ad17dbfc: posts big blind $0.1
*** HOLE CARDS ***
Dealt to ad17dbfc 
Dealt to d81241b3 
Dealt to b175dcea 
Dealt to c05e96ba 
Dealt to Hero [6c Kh]
d81241b3: folds
b175dcea: raises $0.1 to $0.2
c05e96ba: raises $0.42 to $0.62
Hero: folds
ad17dbfc: calls $0.52
b175dcea: folds
*** FLOP *** [Qs Kc 7d]
ad17dbfc: checks
c05e96ba: bets $0.75
ad17dbfc: calls $0.75
*** TURN *** [Qs Kc 7d] [8d]
ad17dbfc: checks
c05e96ba: bets $1.5
ad17dbfc: folds
Uncalled bet ($1.5) returned to c05e96ba
*** SHOWDOWN ***
c05e96ba collected $2.84 from pot
*** SUMMARY ***
Total pot $2.99 | Rake $0.15 | Jackpot $0 | Bingo $0 | Fortune $0 | Tax $0
Board [Qs Kc 7d 8d]
Seat 1: ad17dbfc (big blind) folded on the Turn
Seat 3: d81241b3 folded before Flop (didn't bet)
Seat 4: b175dcea folded before Flop
Seat 5: c05e96ba (button) won ($2.84)
Seat 6: Hero (small blind) folded before Flop


Poker Hand #HD1806673924: Hold'em No Limit ($0.05/$0.1) - 2024/06/08 16:02:46
Table 'NLHRed11' 6-max Seat #4 is the button
Seat 1: ad17dbfc ($13.2 in chips)
Seat 3: d81241b3 ($20.38 in chips)
Seat 4: b175dcea ($17.58 in chips)
Seat 5: c05e96ba ($8.86 in chips)
Seat 6: Hero ($10.18 in chips)
c05e96ba: posts small blind $0.05
Hero: posts big blind $0.1
*** HOLE CARDS ***
Dealt to ad17dbfc 
Dealt to d81241b3 
Dealt to b175dcea 
Dealt to c05e96ba 
Dealt to Hero [5c 8s]
ad17dbfc: folds
d81241b3: folds
b175dcea: raises $0.1 to $0.2
c05e96ba: calls $0.15
Hero: folds
*** FLOP *** [9s 4s 7c]
c05e96ba: checks
b175dcea: checks
*** TURN *** [9s 4s 7c] [8c]
c05e96ba: bets $0.25
b175dcea: raises $17.13 to $17.38 and is all-in
c05e96ba: folds
Uncalled bet ($17.13) returned to b175dcea
b175dcea: shows [Js] (Jack-High)
*** SHOWDOWN ***
b175dcea collected $0.95 from pot
*** SUMMARY ***
Total pot $1 | Rake $0.05 | Jackpot $0 | Bingo $0 | Fortune $0 | Tax $0
Board [9s 4s 7c 8c]
Seat 1: ad17dbfc folded before Flop (didn't bet)
Seat 3: d81241b3 folded before Flop (didn't bet)
Seat 4: b175dcea (button) showed [Js] and won ($0.95)
Seat 5: c05e96ba (small blind) folded on the Turn
Seat 6: Hero (big blind) folded before Flop


Poker Hand #HD1806673912: Hold'em No Limit ($0.05/$0.1) - 2024/06/08 16:02:36
Table 'NLHRed11' 6-max Seat #3 is the button
Seat 1: ad17dbfc ($13.2 in chips)
Seat 3: d81241b3 ($20.38 in chips)
Seat 4: b175dcea ($17.63 in chips)
Seat 5: c05e96ba ($8.81 in chips)
Seat 6: Hero ($10.18 in chips)
b175dcea: posts small blind $0.05
c05e96ba: posts big blind $0.1
*** HOLE CARDS ***
Dealt to ad17dbfc 
Dealt to d81241b3 
Dealt to b175dcea 
Dealt to c05e96ba 
Dealt to Hero [9s 8d]
Hero: folds
ad17dbfc: folds
d81241b3: folds
b175dcea: folds
Uncalled bet ($0.05) returned to c05e96ba
*** SHOWDOWN ***
c05e96ba collected $0.1 from pot
*** SUMMARY ***
Total pot $0.1 | Rake $0 | Jackpot $0 | Bingo $0 | Fortune $0 | Tax $0
Seat 1: ad17dbfc folded before Flop (didn't bet)
Seat 3: d81241b3 (button) folded before Flop (didn't bet)
Seat 4: b175dcea (small blind) folded before Flop
Seat 5: c05e96ba (big blind) collected ($0.1)
Seat 6: Hero folded before Flop (didn't bet)


Poker Hand #HD1806673816: Hold'em No Limit ($0.05/$0.1) - 2024/06/08 16:01:44
Table 'NLHRed11' 6-max Seat #1 is the button
Seat 1: ad17dbfc ($12.87 in chips)
Seat 2: bd544f4f ($28.05 in chips)
Seat 3: d81241b3 ($20.48 in chips)
Seat 4: b175dcea ($17.63 in chips)
Seat 5: c05e96ba ($9.01 in chips)
Seat 6: Hero ($10.18 in chips)
bd544f4f: posts small blind $0.05
d81241b3: posts big blind $0.1
*** HOLE CARDS ***
Dealt to ad17dbfc 
Dealt to bd544f4f 
Dealt to d81241b3 
Dealt to b175dcea 
Dealt to c05e96ba 
Dealt to Hero [9h 4d]
b175dcea: folds
c05e96ba: raises $0.1 to $0.2
Hero: folds
ad17dbfc: calls $0.2
bd544f4f: folds
d81241b3: folds
*** FLOP *** [6d Td Jd]
c05e96ba: checks
ad17dbfc: checks
*** TURN *** [6d Td Jd] [Qc]
c05e96ba: checks
ad17dbfc: checks
*** RIVER *** [6d Td Jd Qc] [2h]
c05e96ba: checks
ad17dbfc: checks
c05e96ba: shows [Kh 4h] (King-High)
ad17dbfc: shows [4s Ah] (Ace-High)
*** SHOWDOWN ***
ad17dbfc collected $0.53 from pot
*** SUMMARY ***
Total pot $0.55 | Rake $0.02 | Jackpot $0 | Bingo $0 | Fortune $0 | Tax $0
Board [6d Td Jd Qc 2h]
Seat 1: ad17dbfc (button) showed [4s Ah] and won ($0.53) with Ace-High
Seat 2: bd544f4f (small blind) folded before Flop
Seat 3: d81241b3 (big blind) folded before Flop
Seat 4: b175dcea folded before Flop (didn't bet)
Seat 5: c05e96ba showed [Kh 4h] and lost with King-High
Seat 6: Hero folded before Flop (didn't bet)


Poker Hand #HD1806673709: Hold'em No Limit ($0.05/$0.1) - 2024/06/08 16:00:48
Table 'NLHRed11' 6-max Seat #6 is the button
Seat 1: ad17dbfc ($12.18 in chips)
Seat 2: bd544f4f ($28.15 in chips)
Seat 3: d81241b3 ($20.48 in chips)
Seat 4: b175dcea ($17.83 in chips)
Seat 5: c05e96ba ($9.45 in chips)
Seat 6: Hero ($10.18 in chips)
ad17dbfc: posts small blind $0.05
bd544f4f: posts big blind $0.1
*** HOLE CARDS ***
Dealt to ad17dbfc 
Dealt to bd544f4f 
Dealt to d81241b3 
Dealt to b175dcea 
Dealt to c05e96ba 
Dealt to Hero [9d Tc]
d81241b3: folds
b175dcea: raises $0.1 to $0.2
c05e96ba: calls $0.2
Hero: folds
ad17dbfc: calls $0.15
bd544f4f: folds
*** FLOP *** [8d Ac Ah]
ad17dbfc: checks
b175dcea: checks
c05e96ba: checks
*** TURN *** [8d Ac Ah] [2c]
ad17dbfc: bets $0.24
b175dcea: folds
c05e96ba: calls $0.24
*** RIVER *** [8d Ac Ah 2c] [Th]
ad17dbfc: bets $0.39
c05e96ba: folds
Uncalled bet ($0.39) returned to ad17dbfc
*** SHOWDOWN ***
ad17dbfc collected $1.13 from pot
*** SUMMARY ***
Total pot $1.18 | Rake $0.05 | Jackpot $0 | Bingo $0 | Fortune $0 | Tax $0
Board [8d Ac Ah 2c Th]
Seat 1: ad17dbfc (small blind) won ($1.13)
Seat 2: bd544f4f (big blind) folded before Flop
Seat 3: d81241b3 folded before Flop (didn't bet)
Seat 4: b175dcea folded on the Turn
Seat 5: c05e96ba folded on the River
Seat 6: Hero (button) folded before Flop (didn't bet)


Poker Hand #HD1806673510: Hold'em No Limit ($0.05/$0.1) - 2024/06/08 15:59:13
Table 'NLHRed11' 6-max Seat #5 is the button
Seat 1: ad17dbfc ($10.32 in chips)
Seat 2: bd544f4f ($28.15 in chips)
Seat 3: d81241b3 ($22.33 in chips)
Seat 4: b175dcea ($17.83 in chips)
Seat 5: c05e96ba ($9.7 in chips)
Seat 6: Hero ($10.23 in chips)
Hero: posts small blind $0.05
ad17dbfc: posts big blind $0.1
*** HOLE CARDS ***
Dealt to ad17dbfc 
Dealt to bd544f4f 
Dealt to d81241b3 
Dealt to b175dcea 
Dealt to c05e96ba 
Dealt to Hero [7h 8d]
bd544f4f: folds
d81241b3: raises $0.15 to $0.25
b175dcea: folds
c05e96ba: calls $0.25
Hero: folds
ad17dbfc: calls $0.15
*** FLOP *** [8s 2d 4d]
ad17dbfc: checks
d81241b3: bets $0.4
c05e96ba: folds
ad17dbfc: calls $0.4
*** TURN *** [8s 2d 4d] [6s]
ad17dbfc: checks
d81241b3: bets $1.2
ad17dbfc: calls $1.2
*** RIVER *** [8s 2d 4d 6s] [Qh]
ad17dbfc: checks
d81241b3: checks
ad17dbfc: shows [2c 5d] (Pair of Twos)
d81241b3: shows [9d Jd] (Queen-High)
*** SHOWDOWN ***
ad17dbfc collected $3.71 from pot
*** SUMMARY ***
Total pot $4 | Rake $0.19 | Jackpot $0.1 | Bingo $0 | Fortune $0 | Tax $0
Board [8s 2d 4d 6s Qh]
Seat 1: ad17dbfc (big blind) showed [2c 5d] and won ($3.71) with Pair of Twos
Seat 2: bd544f4f folded before Flop (didn't bet)
Seat 3: d81241b3 showed [9d Jd] and lost with Queen-High
Seat 4: b175dcea folded before Flop (didn't bet)
Seat 5: c05e96ba (button) folded on the Flop
Seat 6: Hero (small blind) folded before Flop


Poker Hand #HD1806673443: Hold'em No Limit ($0.05/$0.1) - 2024/06/08 15:58:43
Table 'NLHRed11' 6-max Seat #4 is the button
Seat 1: ad17dbfc ($10.32 in chips)
Seat 2: bd544f4f ($28.15 in chips)
Seat 3: d81241b3 ($22.33 in chips)
Seat 4: b175dcea ($18.03 in chips)
Seat 5: c05e96ba ($9.75 in chips)
Seat 6: Hero ($10 in chips)
c05e96ba: posts small blind $0.05
Hero: posts big blind $0.1
*** HOLE CARDS ***
Dealt to ad17dbfc 
Dealt to bd544f4f 
Dealt to d81241b3 
Dealt to b175dcea 
Dealt to c05e96ba 
Dealt to Hero [Ac Jc]
ad17dbfc: folds
bd544f4f: folds
d81241b3: folds
b175dcea: raises $0.1 to $0.2
c05e96ba: folds
Hero: raises $0.7 to $0.9
b175dcea: folds
Uncalled bet ($0.7) returned to Hero
*** SHOWDOWN ***
Hero collected $0.43 from pot
*** SUMMARY ***
Total pot $0.45 | Rake $0.02 | Jackpot $0 | Bingo $0 | Fortune $0 | Tax $0
Seat 1: ad17dbfc folded before Flop (didn't bet)
Seat 2: bd544f4f folded before Flop (didn't bet)
Seat 3: d81241b3 folded before Flop (didn't bet)
Seat 4: b175dcea (button) folded before Flop
Seat 5: c05e96ba (small blind) folded before Flop
Seat 6: Hero (big blind) collected ($0.43)


Poker Hand #HD1806673386: Hold'em No Limit ($0.05/$0.1) - 2024/06/08 15:58:11
Table 'NLHRed11' 6-max Seat #3 is the button
Seat 1: ad17dbfc ($10 in chips)
Seat 2: bd544f4f ($28.15 in chips)
Seat 3: d81241b3 ($22.33 in chips)
Seat 4: b175dcea ($18.08 in chips)
Seat 5: c05e96ba ($10.05 in chips)
Seat 6: Hero ($10 in chips)
b175dcea: posts small blind $0.05
c05e96ba: posts big blind $0.1
ad17dbfc: posts big blind $0.1
ad17dbfc: posts missed blind $0.05
*** HOLE CARDS ***
Dealt to ad17dbfc 
Dealt to bd544f4f 
Dealt to d81241b3 
Dealt to b175dcea 
Dealt to c05e96ba 
Dealt to Hero [Tc 3h]
Hero: folds
ad17dbfc: raises $0.2 to $0.3
bd544f4f: folds
d81241b3: folds
b175dcea: folds
c05e96ba: calls $0.2
*** FLOP *** [Kh 7c Ks]
c05e96ba: checks
ad17dbfc: checks
*** TURN *** [Kh 7c Ks] [7d]
c05e96ba: checks
ad17dbfc: checks
*** RIVER *** [Kh 7c Ks 7d] [5h]
c05e96ba: checks
ad17dbfc: bets $0.35
c05e96ba: folds
Uncalled bet ($0.35) returned to ad17dbfc
*** SHOWDOWN ***
ad17dbfc collected $0.67 from pot
*** SUMMARY ***
Total pot $0.7 | Rake $0.03 | Jackpot $0 | Bingo $0 | Fortune $0 | Tax $0
Board [Kh 7c Ks 7d 5h]
Seat 1: ad17dbfc won ($0.67)
Seat 2: bd544f4f folded before Flop (didn't bet)
Seat 3: d81241b3 (button) folded before Flop (didn't bet)
Seat 4: b175dcea (small blind) folded before Flop
Seat 5: c05e96ba (big blind) folded on the River
Seat 6: Hero folded before Flop (didn't bet)


Poker Hand #HD1806673325: Hold'em No Limit ($0.05/$0.1) - 2024/06/08 15:57:41
Table 'NLHRed11' 6-max Seat #2 is the button
Seat 2: bd544f4f ($28.15 in chips)
Seat 3: d81241b3 ($22.38 in chips)
Seat 4: b175dcea ($17.54 in chips)
Seat 5: c05e96ba ($10.05 in chips)
Seat 6: Hero ($10 in chips)
d81241b3: posts small blind $0.05
b175dcea: posts big blind $0.1
*** HOLE CARDS ***
Dealt to bd544f4f 
Dealt to d81241b3 
Dealt to b175dcea 
Dealt to c05e96ba 
Dealt to Hero [Ad 6d]
c05e96ba: folds
Hero: raises $0.1 to $0.2
bd544f4f: folds
d81241b3: folds
b175dcea: raises $0.34 to $0.54
Hero: calls $0.34
*** FLOP *** [Td 6h Jc]
b175dcea: bets $0.85
Hero: folds
Uncalled bet ($0.85) returned to b175dcea
b175dcea: shows [9h 4d] (Jack-High)
*** SHOWDOWN ***
b175dcea collected $1.08 from pot
*** SUMMARY ***
Total pot $1.13 | Rake $0.05 | Jackpot $0 | Bingo $0 | Fortune $0 | Tax $0
Board [Td 6h Jc]
Seat 2: bd544f4f (button) folded before Flop (didn't bet)
Seat 3: d81241b3 (small blind) folded before Flop
Seat 4: b175dcea (big blind) showed [9h 4d] and won ($1.08)
Seat 5: c05e96ba folded before Flop (didn't bet)
Seat 6: Hero folded on the Flop


Poker Hand #HD1806673277: Hold'em No Limit ($0.05/$0.1) - 2024/06/08 15:57:17
Table 'NLHRed11' 6-max Seat #6 is the button
Seat 2: bd544f4f ($28.2 in chips)
Seat 3: d81241b3 ($22.48 in chips)
Seat 4: b175dcea ($17.54 in chips)
Seat 5: c05e96ba ($9.9 in chips)
Seat 6: Hero ($10 in chips)
bd544f4f: posts small blind $0.05
d81241b3: posts big blind $0.1
*** HOLE CARDS ***
Dealt to bd544f4f 
Dealt to d81241b3 
Dealt to b175dcea 
Dealt to c05e96ba 
Dealt to Hero [7h Th]
b175dcea: folds
c05e96ba: raises $0.2 to $0.3
Hero: folds
bd544f4f: folds
d81241b3: folds
Uncalled bet ($0.2) returned to c05e96ba
*** SHOWDOWN ***
c05e96ba collected $0.25 from pot
*** SUMMARY ***
Total pot $0.25 | Rake $0 | Jackpot $0 | Bingo $0 | Fortune $0 | Tax $0
Seat 2: bd544f4f (small blind) folded before Flop
Seat 3: d81241b3 (big blind) folded before Flop
Seat 4: b175dcea folded before Flop (didn't bet)
Seat 5: c05e96ba collected ($0.25)
Seat 6: Hero (button) folded before Flop (didn't bet)


Poker Hand #HD1806673228: Hold'em No Limit ($0.05/$0.1) - 2024/06/08 15:56:55
Table 'NLHRed11' 6-max Seat #5 is the button
Seat 2: bd544f4f ($28.3 in chips)
Seat 3: d81241b3 ($22.48 in chips)
Seat 4: b175dcea ($17.54 in chips)
Seat 5: c05e96ba ($9.75 in chips)
Seat 6: Hero ($10.05 in chips)
Hero: posts small blind $0.05
bd544f4f: posts big blind $0.1
*** HOLE CARDS ***
Dealt to bd544f4f 
Dealt to d81241b3 
Dealt to b175dcea 
Dealt to c05e96ba 
Dealt to Hero [4s 7d]
d81241b3: folds
b175dcea: folds
c05e96ba: raises $0.1 to $0.2
Hero: folds
bd544f4f: folds
Uncalled bet ($0.1) returned to c05e96ba
*** SHOWDOWN ***
c05e96ba collected $0.25 from pot
*** SUMMARY ***
Total pot $0.25 | Rake $0 | Jackpot $0 | Bingo $0 | Fortune $0 | Tax $0
Seat 2: bd544f4f (big blind) folded before Flop
Seat 3: d81241b3 folded before Flop (didn't bet)
Seat 4: b175dcea folded before Flop (didn't bet)
Seat 5: c05e96ba (button) collected ($0.25)
Seat 6: Hero (small blind) folded before Flop


Poker Hand #HD1806673196: Hold'em No Limit ($0.05/$0.1) - 2024/06/08 15:56:42
Table 'NLHRed11' 6-max Seat #4 is the button
Seat 2: bd544f4f ($28.3 in chips)
Seat 3: d81241b3 ($22.48 in chips)
Seat 4: b175dcea ($17.54 in chips)
Seat 5: c05e96ba ($9.8 in chips)
Seat 6: Hero ($10 in chips)
c05e96ba: posts small blind $0.05
Hero: posts big blind $0.1
*** HOLE CARDS ***
Dealt to bd544f4f 
Dealt to d81241b3 
Dealt to b175dcea 
Dealt to c05e96ba 
Dealt to Hero [Ah 7s]
bd544f4f: folds
d81241b3: folds
b175dcea: folds
c05e96ba: folds
Uncalled bet ($0.05) returned to Hero
*** SHOWDOWN ***
Hero collected $0.1 from pot
*** SUMMARY ***
Total pot $0.1 | Rake $0 | Jackpot $0 | Bingo $0 | Fortune $0 | Tax $0
Seat 2: bd544f4f folded before Flop (didn't bet)
Seat 3: d81241b3 folded before Flop (didn't bet)
Seat 4: b175dcea (button) folded before Flop (didn't bet)
Seat 5: c05e96ba (small blind) folded before Flop
Seat 6: Hero (big blind) collected ($0.1)


Poker Hand #HD1806673042: Hold'em No Limit ($0.05/$0.1) - 2024/06/08 15:55:22
Table 'NLHRed11' 6-max Seat #3 is the button
Seat 2: bd544f4f ($28.3 in chips)
Seat 3: d81241b3 ($17.65 in chips)
Seat 4: b175dcea ($17.74 in chips)
Seat 5: c05e96ba ($10 in chips)
Seat 6: Hero ($10 in chips)
b175dcea: posts small blind $0.05
c05e96ba: posts big blind $0.1
*** HOLE CARDS ***
Dealt to bd544f4f 
Dealt to d81241b3 
Dealt to b175dcea 
Dealt to c05e96ba 
Dealt to Hero [Jh Jd]
Hero: raises $0.1 to $0.2
bd544f4f: folds
d81241b3: calls $0.2
b175dcea: calls $0.15
c05e96ba: calls $0.1
*** FLOP *** [4c Jc 7c]
b175dcea: checks
c05e96ba: checks
Hero: bets $0.4
d81241b3: calls $0.4
b175dcea: folds
c05e96ba: folds
*** TURN *** [4c Jc 7c] [Th]
Hero: bets $1.3
d81241b3: calls $1.3
*** RIVER *** [4c Jc 7c Th] [2s]
Hero: checks
d81241b3: bets $3.15
Hero: calls $3.15
d81241b3: shows [Tc Ac] (Ace High Flush)
Hero: shows [Jh Jd] (Three Jacks)
*** SHOWDOWN ***
d81241b3 collected $9.88 from pot
*** SUMMARY ***
Total pot $10.5 | Rake $0.52 | Jackpot $0.1 | Bingo $0 | Fortune $0 | Tax $0
Board [4c Jc 7c Th 2s]
Seat 2: bd544f4f folded before Flop (didn't bet)
Seat 3: d81241b3 (button) showed [Tc Ac] and won ($9.88) with Ace High Flush
Seat 4: b175dcea (small blind) folded on the Flop
Seat 5: c05e96ba (big blind) folded on the Flop
Seat 6: Hero showed [Jh Jd] and lost with Three Jacks


Poker Hand #HD1806672910: Hold'em No Limit ($0.05/$0.1) - 2024/06/08 15:54:18
Table 'NLHRed11' 6-max Seat #2 is the button
Seat 1: ad17dbfc ($1.12 in chips)
Seat 2: bd544f4f ($28.3 in chips)
Seat 3: d81241b3 ($16.35 in chips)
Seat 4: b175dcea ($17.84 in chips)
Seat 6: Hero ($10 in chips)
d81241b3: posts small blind $0.05
b175dcea: posts big blind $0.1
*** HOLE CARDS ***
Dealt to ad17dbfc 
Dealt to bd544f4f 
Dealt to d81241b3 
Dealt to b175dcea 
Dealt to Hero [Jh Kc]
Hero: raises $0.1 to $0.2
ad17dbfc: calls $0.2
bd544f4f: folds
d81241b3: raises $0.53 to $0.73
b175dcea: folds
Hero: folds
ad17dbfc: calls $0.53
*** FLOP *** [5s 3h 3s]
d81241b3: bets $0.59
ad17dbfc: calls $0.39 and is all-in
Uncalled bet ($0.2) returned to d81241b3
d81241b3: shows [Tc Ac] (Pair of Treys)
ad17dbfc: shows [8s Js] (Pair of Treys)
*** TURN *** [5s 3h 3s] [9d]
*** RIVER *** [5s 3h 3s 9d] [5d]
*** SHOWDOWN ***
d81241b3 collected $2.42 from pot
*** SUMMARY ***
Total pot $2.54 | Rake $0.12 | Jackpot $0 | Bingo $0 | Fortune $0 | Tax $0
Board [5s 3h 3s 9d 5d]
Seat 1: ad17dbfc showed [8s Js] and lost with Pair of Fives and Pair of Treys
Seat 2: bd544f4f (button) folded before Flop (didn't bet)
Seat 3: d81241b3 (small blind) showed [Tc Ac] and won ($2.42) with Pair of Fives and Pair of Treys
Seat 4: b175dcea (big blind) folded before Flop
Seat 6: Hero folded before Flop


Poker Hand #HD1806672778: Hold'em No Limit ($0.05/$0.1) - 2024/06/08 15:53:14
Table 'NLHRed11' 6-max Seat #1 is the button
Seat 1: ad17dbfc ($3.36 in chips)
Seat 2: bd544f4f ($28.35 in chips)
Seat 3: d81241b3 ($16.45 in chips)
Seat 4: b175dcea ($15.77 in chips)
Seat 6: Hero ($10 in chips)
bd544f4f: posts small blind $0.05
d81241b3: posts big blind $0.1
*** HOLE CARDS ***
Dealt to ad17dbfc 
Dealt to bd544f4f 
Dealt to d81241b3 
Dealt to b175dcea 
Dealt to Hero [8c 6d]
b175dcea: raises $0.1 to $0.2
Hero: folds
ad17dbfc: calls $0.2
bd544f4f: folds
d81241b3: folds
*** FLOP *** [8h 5h 4s]
b175dcea: bets $0.28
ad17dbfc: calls $0.28
*** TURN *** [8h 5h 4s] [Ks]
b175dcea: bets $0.37
ad17dbfc: calls $0.37
*** RIVER *** [8h 5h 4s Ks] [Th]
b175dcea: checks
ad17dbfc: bets $1.39
b175dcea: calls $1.39
ad17dbfc: shows [Qc 6c] (King-High)
b175dcea: shows [6h 7c] (Eights-High Straight)
*** SHOWDOWN ***
b175dcea collected $4.31 from pot
*** SUMMARY ***
Total pot $4.63 | Rake $0.22 | Jackpot $0.1 | Bingo $0 | Fortune $0 | Tax $0
Board [8h 5h 4s Ks Th]
Seat 1: ad17dbfc (button) showed [Qc 6c] and lost with King-High
Seat 2: bd544f4f (small blind) folded before Flop
Seat 3: d81241b3 (big blind) folded before Flop
Seat 4: b175dcea showed [6h 7c] and won ($4.31) with Eights-High Straight
Seat 6: Hero folded before Flop (didn't bet)


Poker Hand #HD1806672759: Hold'em No Limit ($0.05/$0.1) - 2024/06/08 15:53:05
Table 'NLHRed11' 6-max Seat #6 is the button
Seat 1: ad17dbfc ($3.41 in chips)
Seat 2: bd544f4f ($28.3 in chips)
Seat 3: d81241b3 ($16.45 in chips)
Seat 4: b175dcea ($15.77 in chips)
Seat 6: Hero ($10 in chips)
ad17dbfc: posts small blind $0.05
bd544f4f: posts big blind $0.1
*** HOLE CARDS ***
Dealt to ad17dbfc 
Dealt to bd544f4f 
Dealt to d81241b3 
Dealt to b175dcea 
Dealt to Hero [3d 8d]
d81241b3: folds
b175dcea: folds
Hero: folds
ad17dbfc: folds
Uncalled bet ($0.05) returned to bd544f4f
*** SHOWDOWN ***
bd544f4f collected $0.1 from pot
*** SUMMARY ***
Total pot $0.1 | Rake $0 | Jackpot $0 | Bingo $0 | Fortune $0 | Tax $0
Seat 1: ad17dbfc (small blind) folded before Flop
Seat 2: bd544f4f (big blind) collected ($0.1)
Seat 3: d81241b3 folded before Flop (didn't bet)
Seat 4: b175dcea folded before Flop (didn't bet)
Seat 6: Hero (button) folded before Flop (didn't bet)


Poker Hand #HD1806672577: Hold'em No Limit ($0.05/$0.1) - 2024/06/08 15:51:20
Table 'NLHRed11' 6-max Seat #4 is the button
Seat 1: ad17dbfc ($3.51 in chips)
Seat 2: bd544f4f ($28.3 in chips)
Seat 3: d81241b3 ($10.88 in chips)
Seat 4: b175dcea ($16.07 in chips)
Seat 5: cfde2efb ($5.76 in chips)
Seat 6: Hero ($10 in chips)
cfde2efb: posts small blind $0.05
Hero: posts big blind $0.1
*** HOLE CARDS ***
Dealt to ad17dbfc 
Dealt to bd544f4f 
Dealt to d81241b3 
Dealt to b175dcea 
Dealt to cfde2efb 
Dealt to Hero [9h Td]
ad17dbfc: calls $0.1
bd544f4f: folds
d81241b3: raises $0.2 to $0.3
b175dcea: calls $0.3
cfde2efb: raises $1.2 to $1.5
Hero: folds
ad17dbfc: folds
d81241b3: calls $1.2
b175dcea: folds
*** FLOP *** [Qs 5d Jh]
cfde2efb: bets $0.9
d81241b3: calls $0.9
*** TURN *** [Qs 5d Jh] [6d]
cfde2efb: bets $3.36 and is all-in
d81241b3: calls $3.36
cfde2efb: shows [5h Ah] (Pair of Fives)
d81241b3: shows [Kh Qd] (Pair of Queens)
*** RIVER *** [Qs 5d Jh 6d] [Kd]
*** SHOWDOWN ***
d81241b3 collected $11.33 from pot
*** SUMMARY ***
Total pot $12.02 | Rake $0.59 | Jackpot $0.1 | Bingo $0 | Fortune $0 | Tax $0
Board [Qs 5d Jh 6d Kd]
Seat 1: ad17dbfc folded before Flop
Seat 2: bd544f4f folded before Flop (didn't bet)
Seat 3: d81241b3 showed [Kh Qd] and won ($11.33) with Pair of Kings and Pair of Queens
Seat 4: b175dcea (button) folded before Flop
Seat 5: cfde2efb (small blind) showed [5h Ah] and lost with Pair of Fives
Seat 6: Hero (big blind) folded before Flop


Poker Hand #HD1806672438: Hold'em No Limit ($0.05/$0.1) - 2024/06/08 15:50:12
Table 'NLHRed11' 6-max Seat #3 is the button
Seat 1: ad17dbfc ($8.76 in chips)
Seat 2: bd544f4f ($28.3 in chips)
Seat 3: d81241b3 ($10.88 in chips)
Seat 4: b175dcea ($10.96 in chips)
Seat 5: cfde2efb ($6.06 in chips)
Seat 6: Hero ($10 in chips)
b175dcea: posts small blind $0.05
cfde2efb: posts big blind $0.1
*** HOLE CARDS ***
Dealt to ad17dbfc 
Dealt to bd544f4f 
Dealt to d81241b3 
Dealt to b175dcea 
Dealt to cfde2efb 
Dealt to Hero [9d Kd]
Hero: raises $0.1 to $0.2
ad17dbfc: calls $0.2
bd544f4f: folds
d81241b3: folds
b175dcea: calls $0.15
cfde2efb: calls $0.1
*** FLOP *** [6s 5c 3s]
b175dcea: bets $0.1
cfde2efb: calls $0.1
Hero: folds
ad17dbfc: raises $0.55 to $0.65
b175dcea: calls $0.55
cfde2efb: folds
*** TURN *** [6s 5c 3s] [Jh]
b175dcea: checks
ad17dbfc: bets $1.65
b175dcea: calls $1.65
*** RIVER *** [6s 5c 3s Jh] [Jc]
b175dcea: checks
ad17dbfc: bets $2.75
b175dcea: calls $2.75
ad17dbfc: shows [Th 9s] (Pair of Jacks)
b175dcea: shows [9h 6d] (Pair of Jacks and Pair of Sixes)
*** SHOWDOWN ***
b175dcea collected $10.36 from pot
*** SUMMARY ***
Total pot $11 | Rake $0.54 | Jackpot $0.1 | Bingo $0 | Fortune $0 | Tax $0
Board [6s 5c 3s Jh Jc]
Seat 1: ad17dbfc showed [Th 9s] and lost with Pair of Jacks
Seat 2: bd544f4f folded before Flop (didn't bet)
Seat 3: d81241b3 (button) folded before Flop (didn't bet)
Seat 4: b175dcea (small blind) showed [9h 6d] and won ($10.36) with Pair of Jacks and Pair of Sixes
Seat 5: cfde2efb (big blind) folded on the Flop
Seat 6: Hero folded on the Flop


Poker Hand #HD1806672409: Hold'em No Limit ($0.05/$0.1) - 2024/06/08 15:49:56
Table 'NLHRed11' 6-max Seat #2 is the button
Seat 1: ad17dbfc ($8.76 in chips)
Seat 2: bd544f4f ($28.3 in chips)
Seat 3: d81241b3 ($10.93 in chips)
Seat 4: b175dcea ($11.06 in chips)
Seat 5: cfde2efb ($5.91 in chips)
Seat 6: Hero ($10 in chips)
d81241b3: posts small blind $0.05
b175dcea: posts big blind $0.1
*** HOLE CARDS ***
Dealt to ad17dbfc 
Dealt to bd544f4f 
Dealt to d81241b3 
Dealt to b175dcea 
Dealt to cfde2efb 
Dealt to Hero [2h 5c]
cfde2efb: raises $0.15 to $0.25
Hero: folds
ad17dbfc: folds
bd544f4f: folds
d81241b3: folds
b175dcea: folds
Uncalled bet ($0.15) returned to cfde2efb
*** SHOWDOWN ***
cfde2efb collected $0.25 from pot
*** SUMMARY ***
Total pot $0.25 | Rake $0 | Jackpot $0 | Bingo $0 | Fortune $0 | Tax $0
Seat 1: ad17dbfc folded before Flop (didn't bet)
Seat 2: bd544f4f (button) folded before Flop (didn't bet)
Seat 3: d81241b3 (small blind) folded before Flop
Seat 4: b175dcea (big blind) folded before Flop
Seat 5: cfde2efb collected ($0.25)
Seat 6: Hero folded before Flop (didn't bet)


Poker Hand #HD1806672369: Hold'em No Limit ($0.05/$0.1) - 2024/06/08 15:49:36
Table 'NLHRed11' 6-max Seat #1 is the button
Seat 1: ad17dbfc ($8.61 in chips)
Seat 2: bd544f4f ($28.35 in chips)
Seat 3: d81241b3 ($11.03 in chips)
Seat 4: b175dcea ($11.06 in chips)
Seat 5: cfde2efb ($5.91 in chips)
Seat 6: Hero ($10 in chips)
bd544f4f: posts small blind $0.05
d81241b3: posts big blind $0.1
*** HOLE CARDS ***
Dealt to ad17dbfc 
Dealt to bd544f4f 
Dealt to d81241b3 
Dealt to b175dcea 
Dealt to cfde2efb 
Dealt to Hero [4s Kh]
b175dcea: folds
cfde2efb: folds
Hero: folds
ad17dbfc: raises $0.2 to $0.3
bd544f4f: folds
d81241b3: folds
Uncalled bet ($0.2) returned to ad17dbfc
*** SHOWDOWN ***
ad17dbfc collected $0.25 from pot
*** SUMMARY ***
Total pot $0.25 | Rake $0 | Jackpot $0 | Bingo $0 | Fortune $0 | Tax $0
Seat 1: ad17dbfc (button) collected ($0.25)
Seat 2: bd544f4f (small blind) folded before Flop
Seat 3: d81241b3 (big blind) folded before Flop
Seat 4: b175dcea folded before Flop (didn't bet)
Seat 5: cfde2efb folded before Flop (didn't bet)
Seat 6: Hero folded before Flop (didn't bet)


Poker Hand #HD1806672264: Hold'em No Limit ($0.05/$0.1) - 2024/06/08 15:48:37
Table 'NLHRed11' 6-max Seat #6 is the button
Seat 1: ad17dbfc ($8.52 in chips)
Seat 2: bd544f4f ($28.45 in chips)
Seat 3: d81241b3 ($11.03 in chips)
Seat 4: b175dcea ($11.06 in chips)
Seat 5: cfde2efb ($5.91 in chips)
Seat 6: Hero ($10 in chips)
ad17dbfc: posts small blind $0.05
bd544f4f: posts big blind $0.1
*** HOLE CARDS ***
Dealt to ad17dbfc 
Dealt to bd544f4f 
Dealt to d81241b3 
Dealt to b175dcea 
Dealt to cfde2efb 
Dealt to Hero [3s Jc]
d81241b3: folds
b175dcea: folds
cfde2efb: folds
Hero: folds
ad17dbfc: calls $0.05
bd544f4f: checks
*** FLOP *** [5c 3c 8d]
ad17dbfc: checks
bd544f4f: checks
*** TURN *** [5c 3c 8d] [Qd]
ad17dbfc: checks
bd544f4f: checks
*** RIVER *** [5c 3c 8d Qd] [Ac]
ad17dbfc: bets $0.2
bd544f4f: folds
Uncalled bet ($0.2) returned to ad17dbfc
*** SHOWDOWN ***
ad17dbfc collected $0.19 from pot
*** SUMMARY ***
Total pot $0.2 | Rake $0.01 | Jackpot $0 | Bingo $0 | Fortune $0 | Tax $0
Board [5c 3c 8d Qd Ac]
Seat 1: ad17dbfc (small blind) won ($0.19)
Seat 2: bd544f4f (big blind) folded on the River
Seat 3: d81241b3 folded before Flop (didn't bet)
Seat 4: b175dcea folded before Flop (didn't bet)
Seat 5: cfde2efb folded before Flop (didn't bet)
Seat 6: Hero (button) folded before Flop (didn't bet)


Poker Hand #HD1806672160: Hold'em No Limit ($0.05/$0.1) - 2024/06/08 15:47:42
Table 'NLHRed11' 6-max Seat #5 is the button
Seat 1: ad17dbfc ($9.64 in chips)
Seat 2: bd544f4f ($28.45 in chips)
Seat 3: d81241b3 ($11.03 in chips)
Seat 4: b175dcea ($10 in chips)
Seat 5: cfde2efb ($5.91 in chips)
Seat 6: Hero ($10.05 in chips)
Hero: posts small blind $0.05
ad17dbfc: posts big blind $0.1
b175dcea: posts missed blind $0.05
*** HOLE CARDS ***
Dealt to ad17dbfc 
Dealt to bd544f4f 
Dealt to d81241b3 
Dealt to b175dcea 
Dealt to cfde2efb 
Dealt to Hero [2d 2h]
bd544f4f: folds
d81241b3: folds
b175dcea: raises $0.2 to $0.3
cfde2efb: folds
Hero: folds
ad17dbfc: calls $0.2
*** FLOP *** [3s Tc Qd]
ad17dbfc: checks
b175dcea: bets $0.35
ad17dbfc: calls $0.35
*** TURN *** [3s Tc Qd] [As]
ad17dbfc: checks
b175dcea: checks
*** RIVER *** [3s Tc Qd As] [6s]
ad17dbfc: bets $0.47
b175dcea: raises $1.17 to $1.64
ad17dbfc: folds
Uncalled bet ($1.17) returned to b175dcea
*** SHOWDOWN ***
b175dcea collected $2.23 from pot
*** SUMMARY ***
Total pot $2.34 | Rake $0.11 | Jackpot $0 | Bingo $0 | Fortune $0 | Tax $0
Board [3s Tc Qd As 6s]
Seat 1: ad17dbfc (big blind) folded on the River
Seat 2: bd544f4f folded before Flop (didn't bet)
Seat 3: d81241b3 folded before Flop (didn't bet)
Seat 4: b175dcea won ($2.23)
Seat 5: cfde2efb (button) folded before Flop (didn't bet)
Seat 6: Hero (small blind) folded before Flop


Poker Hand #HD1806672127: Hold'em No Limit ($0.05/$0.1) - 2024/06/08 15:47:25
Table 'NLHRed11' 6-max Seat #3 is the button
Seat 1: ad17dbfc ($9.64 in chips)
Seat 2: bd544f4f ($28.45 in chips)
Seat 3: d81241b3 ($11.03 in chips)
Seat 5: cfde2efb ($5.96 in chips)
Seat 6: Hero ($10 in chips)
cfde2efb: posts small blind $0.05
Hero: posts big blind $0.1
*** HOLE CARDS ***
Dealt to ad17dbfc 
Dealt to bd544f4f 
Dealt to d81241b3 
Dealt to cfde2efb 
Dealt to Hero [8h 6h]
ad17dbfc: folds
bd544f4f: folds
d81241b3: folds
cfde2efb: folds
Uncalled bet ($0.05) returned to Hero
*** SHOWDOWN ***
Hero collected $0.1 from pot
*** SUMMARY ***
Total pot $0.1 | Rake $0 | Jackpot $0 | Bingo $0 | Fortune $0 | Tax $0
Seat 1: ad17dbfc folded before Flop (didn't bet)
Seat 2: bd544f4f folded before Flop (didn't bet)
Seat 3: d81241b3 (button) folded before Flop (didn't bet)
Seat 5: cfde2efb (small blind) folded before Flop
Seat 6: Hero (big blind) collected ($0.1)


Poker Hand #HD1806671978: Hold'em No Limit ($0.05/$0.1) - 2024/06/08 15:45:59
Table 'NLHRed11' 6-max Seat #2 is the button
Seat 1: ad17dbfc ($9.74 in chips)
Seat 2: bd544f4f ($18.47 in chips)
Seat 3: d81241b3 ($11.08 in chips)
Seat 4: b175dcea ($10.93 in chips)
Seat 5: cfde2efb ($5.96 in chips)
Seat 6: Hero ($10 in chips)
d81241b3: posts small blind $0.05
b175dcea: posts big blind $0.1
*** HOLE CARDS ***
Dealt to ad17dbfc 
Dealt to bd544f4f 
Dealt to d81241b3 
Dealt to b175dcea 
Dealt to cfde2efb 
Dealt to Hero [Qd 5c]
cfde2efb: folds
Hero: folds
ad17dbfc: calls $0.1
bd544f4f: raises $0.7 to $0.8
d81241b3: folds
b175dcea: calls $0.7
ad17dbfc: folds
*** FLOP *** [Jd 7h Th]
b175dcea: checks
bd544f4f: bets $1.32
b175dcea: raises $1.32 to $2.64
bd544f4f: calls $1.32
*** TURN *** [Jd 7h Th] [Jc]
b175dcea: bets $7.49 and is all-in
bd544f4f: calls $7.49
b175dcea: shows [Tc 9c] (Pair of Jacks and Pair of Tens)
bd544f4f: shows [Ac As] (Pair of Aces and Pair of Jacks)
*** FIRST RIVER *** [Jd 7h Th Jc] [Ks]
*** SECOND RIVER *** [Jd 7h Th Jc] [3c]
*** FIRST SHOWDOWN ***
bd544f4f collected $10.46 from pot
*** SECOND SHOWDOWN ***
bd544f4f collected $10.45 from pot
*** SUMMARY ***
Total pot $22.01 | Rake $1 | Jackpot $0.1 | Bingo $0 | Fortune $0 | Tax $0
Hand was run two times
FIRST Board [Jd 7h Th Jc Ks]
SECOND Board [3c]
Seat 1: ad17dbfc folded before Flop
Seat 2: bd544f4f (button) showed [Ac As] and won ($10.46) with Pair of Aces and Pair of Jacks, and won ($10.45)
Seat 3: d81241b3 (small blind) folded before Flop
Seat 4: b175dcea (big blind) showed [Tc 9c] and lost with Pair of Jacks and Pair of Tens, and lost
Seat 5: cfde2efb folded before Flop (didn't bet)
Seat 6: Hero folded before Flop (didn't bet)


Poker Hand #HD1806671951: Hold'em No Limit ($0.05/$0.1) - 2024/06/08 15:45:45
Table 'NLHRed11' 6-max Seat #1 is the button
Seat 1: ad17dbfc ($9.59 in chips)
Seat 2: bd544f4f ($18.52 in chips)
Seat 3: d81241b3 ($11.18 in chips)
Seat 4: b175dcea ($10.93 in chips)
Seat 5: cfde2efb ($5.96 in chips)
Seat 6: Hero ($10 in chips)
bd544f4f: posts small blind $0.05
d81241b3: posts big blind $0.1
*** HOLE CARDS ***
Dealt to ad17dbfc 
Dealt to bd544f4f 
Dealt to d81241b3 
Dealt to b175dcea 
Dealt to cfde2efb 
Dealt to Hero [7c 9s]
b175dcea: folds
cfde2efb: folds
Hero: folds
ad17dbfc: raises $0.1 to $0.2
bd544f4f: folds
d81241b3: folds
Uncalled bet ($0.1) returned to ad17dbfc
*** SHOWDOWN ***
ad17dbfc collected $0.25 from pot
*** SUMMARY ***
Total pot $0.25 | Rake $0 | Jackpot $0 | Bingo $0 | Fortune $0 | Tax $0
Seat 1: ad17dbfc (button) collected ($0.25)
Seat 2: bd544f4f (small blind) folded before Flop
Seat 3: d81241b3 (big blind) folded before Flop
Seat 4: b175dcea folded before Flop (didn't bet)
Seat 5: cfde2efb folded before Flop (didn't bet)
Seat 6: Hero folded before Flop (didn't bet)


Poker Hand #HD1806671908: Hold'em No Limit ($0.05/$0.1) - 2024/06/08 15:45:24
Table 'NLHRed11' 6-max Seat #6 is the button
Seat 1: ad17dbfc ($9.64 in chips)
Seat 2: bd544f4f ($18.62 in chips)
Seat 4: b175dcea ($10.78 in chips)
Seat 5: cfde2efb ($5.96 in chips)
Seat 6: Hero ($10 in chips)
ad17dbfc: posts small blind $0.05
bd544f4f: posts big blind $0.1
*** HOLE CARDS ***
Dealt to ad17dbfc 
Dealt to bd544f4f 
Dealt to b175dcea 
Dealt to cfde2efb 
Dealt to Hero [8h 9c]
b175dcea: raises $0.1 to $0.2
cfde2efb: folds
Hero: folds
ad17dbfc: folds
bd544f4f: folds
Uncalled bet ($0.1) returned to b175dcea
*** SHOWDOWN ***
b175dcea collected $0.25 from pot
*** SUMMARY ***
Total pot $0.25 | Rake $0 | Jackpot $0 | Bingo $0 | Fortune $0 | Tax $0
Seat 1: ad17dbfc (small blind) folded before Flop
Seat 2: bd544f4f (big blind) folded before Flop
Seat 4: b175dcea collected ($0.25)
Seat 5: cfde2efb folded before Flop (didn't bet)
Seat 6: Hero (button) folded before Flop (didn't bet)


Poker Hand #HD1806671856: Hold'em No Limit ($0.05/$0.1) - 2024/06/08 15:44:56
Table 'NLHRed11' 6-max Seat #5 is the button
Seat 1: ad17dbfc ($9.59 in chips)
Seat 2: bd544f4f ($18.62 in chips)
Seat 3: d81241b3 ($11.18 in chips)
Seat 4: b175dcea ($10.78 in chips)
Seat 5: cfde2efb ($5.96 in chips)
Seat 6: Hero ($10 in chips)
Hero: posts small blind $0.05
ad17dbfc: posts big blind $0.1
*** HOLE CARDS ***
Dealt to ad17dbfc 
Dealt to bd544f4f 
Dealt to d81241b3 
Dealt to b175dcea 
Dealt to cfde2efb 
Dealt to Hero [Js 3s]
bd544f4f: folds
d81241b3: folds
b175dcea: folds
cfde2efb: folds
Hero: folds
Uncalled bet ($0.05) returned to ad17dbfc
*** SHOWDOWN ***
ad17dbfc collected $0.1 from pot
*** SUMMARY ***
Total pot $0.1 | Rake $0 | Jackpot $0 | Bingo $0 | Fortune $0 | Tax $0
Seat 1: ad17dbfc (big blind) collected ($0.1)
Seat 2: bd544f4f folded before Flop (didn't bet)
Seat 3: d81241b3 folded before Flop (didn't bet)
Seat 4: b175dcea folded before Flop (didn't bet)
Seat 5: cfde2efb (button) folded before Flop (didn't bet)
Seat 6: Hero (small blind) folded before Flop


Poker Hand #HD1806671820: Hold'em No Limit ($0.05/$0.1) - 2024/06/08 15:44:36
Table 'NLHRed11' 6-max Seat #4 is the button
Seat 1: ad17dbfc ($9.59 in chips)
Seat 2: bd544f4f ($18.62 in chips)
Seat 3: d81241b3 ($11.18 in chips)
Seat 4: b175dcea ($10.63 in chips)
Seat 5: cfde2efb ($6.01 in chips)
Seat 6: Hero ($10 in chips)
cfde2efb: posts small blind $0.05
Hero: posts big blind $0.1
*** HOLE CARDS ***
Dealt to ad17dbfc 
Dealt to bd544f4f 
Dealt to d81241b3 
Dealt to b175dcea 
Dealt to cfde2efb 
Dealt to Hero [6c As]
ad17dbfc: folds
bd544f4f: folds
d81241b3: folds
b175dcea: raises $0.1 to $0.2
cfde2efb: folds
Hero: folds
Uncalled bet ($0.1) returned to b175dcea
*** SHOWDOWN ***
b175dcea collected $0.25 from pot
*** SUMMARY ***
Total pot $0.25 | Rake $0 | Jackpot $0 | Bingo $0 | Fortune $0 | Tax $0
Seat 1: ad17dbfc folded before Flop (didn't bet)
Seat 2: bd544f4f folded before Flop (didn't bet)
Seat 3: d81241b3 folded before Flop (didn't bet)
Seat 4: b175dcea (button) collected ($0.25)
Seat 5: cfde2efb (small blind) folded before Flop
Seat 6: Hero (big blind) folded before Flop


Poker Hand #HD1806671762: Hold'em No Limit ($0.05/$0.1) - 2024/06/08 15:44:07
Table 'NLHRed11' 6-max Seat #3 is the button
Seat 1: ad17dbfc ($9.59 in chips)
Seat 2: bd544f4f ($18.62 in chips)
Seat 3: d81241b3 ($11.18 in chips)
Seat 4: b175dcea ($10.27 in chips)
Seat 5: cfde2efb ($6.41 in chips)
Seat 6: Hero ($10 in chips)
b175dcea: posts small blind $0.05
cfde2efb: posts big blind $0.1
*** HOLE CARDS ***
Dealt to ad17dbfc 
Dealt to bd544f4f 
Dealt to d81241b3 
Dealt to b175dcea 
Dealt to cfde2efb 
Dealt to Hero [9s 4d]
Hero: folds
ad17dbfc: folds
bd544f4f: folds
d81241b3: folds
b175dcea: raises $0.1 to $0.2
cfde2efb: calls $0.1
*** FLOP *** [4h Jh 9h]
b175dcea: checks
cfde2efb: checks
*** TURN *** [4h Jh 9h] [7c]
b175dcea: bets $0.2
cfde2efb: calls $0.2
*** RIVER *** [4h Jh 9h 7c] [Ah]
b175dcea: bets $0.27
cfde2efb: folds
Uncalled bet ($0.27) returned to b175dcea
*** SHOWDOWN ***
b175dcea collected $0.76 from pot
*** SUMMARY ***
Total pot $0.8 | Rake $0.04 | Jackpot $0 | Bingo $0 | Fortune $0 | Tax $0
Board [4h Jh 9h 7c Ah]
Seat 1: ad17dbfc folded before Flop (didn't bet)
Seat 2: bd544f4f folded before Flop (didn't bet)
Seat 3: d81241b3 (button) folded before Flop (didn't bet)
Seat 4: b175dcea (small blind) won ($0.76)
Seat 5: cfde2efb (big blind) folded on the River
Seat 6: Hero folded before Flop (didn't bet)


Poker Hand #HD1806671676: Hold'em No Limit ($0.05/$0.1) - 2024/06/08 15:43:30
Table 'NLHRed11' 6-max Seat #2 is the button
Seat 1: ad17dbfc ($9.59 in chips)
Seat 2: bd544f4f ($18.62 in chips)
Seat 3: d81241b3 ($11.48 in chips)
Seat 4: b175dcea ($10 in chips)
Seat 5: cfde2efb ($6.41 in chips)
Seat 6: Hero ($10 in chips)
d81241b3: posts small blind $0.05
b175dcea: posts big blind $0.1
*** HOLE CARDS ***
Dealt to ad17dbfc 
Dealt to bd544f4f 
Dealt to d81241b3 
Dealt to b175dcea 
Dealt to cfde2efb 
Dealt to Hero [2s 3d]
cfde2efb: folds
Hero: folds
ad17dbfc: folds
bd544f4f: folds
d81241b3: raises $0.2 to $0.3
b175dcea: calls $0.2
*** FLOP *** [Qc Ts 4s]
d81241b3: checks
b175dcea: bets $0.45
d81241b3: folds
Uncalled bet ($0.45) returned to b175dcea
*** SHOWDOWN ***
b175dcea collected $0.57 from pot
*** SUMMARY ***
Total pot $0.6 | Rake $0.03 | Jackpot $0 | Bingo $0 | Fortune $0 | Tax $0
Board [Qc Ts 4s]
Seat 1: ad17dbfc folded before Flop (didn't bet)
Seat 2: bd544f4f (button) folded before Flop (didn't bet)
Seat 3: d81241b3 (small blind) folded on the Flop
Seat 4: b175dcea (big blind) won ($0.57)
Seat 5: cfde2efb folded before Flop (didn't bet)
Seat 6: Hero folded before Flop (didn't bet)


Poker Hand #HD1806671647: Hold'em No Limit ($0.05/$0.1) - 2024/06/08 15:43:18
Table 'NLHRed11' 6-max Seat #1 is the button
Seat 1: ad17dbfc ($9.44 in chips)
Seat 2: bd544f4f ($18.67 in chips)
Seat 3: d81241b3 ($11.58 in chips)
Seat 5: cfde2efb ($6.41 in chips)
Seat 6: Hero ($10 in chips)
bd544f4f: posts small blind $0.05
d81241b3: posts big blind $0.1
*** HOLE CARDS ***
Dealt to ad17dbfc 
Dealt to bd544f4f 
Dealt to d81241b3 
Dealt to cfde2efb 
Dealt to Hero [Kd 3h]
cfde2efb: folds
Hero: folds
ad17dbfc: raises $0.2 to $0.3
bd544f4f: folds
d81241b3: folds
Uncalled bet ($0.2) returned to ad17dbfc
*** SHOWDOWN ***
ad17dbfc collected $0.25 from pot
*** SUMMARY ***
Total pot $0.25 | Rake $0 | Jackpot $0 | Bingo $0 | Fortune $0 | Tax $0
Seat 1: ad17dbfc (button) collected ($0.25)
Seat 2: bd544f4f (small blind) folded before Flop
Seat 3: d81241b3 (big blind) folded before Flop
Seat 5: cfde2efb folded before Flop (didn't bet)
Seat 6: Hero folded before Flop (didn't bet)


Poker Hand #HD1806671601: Hold'em No Limit ($0.05/$0.1) - 2024/06/08 15:42:55
Table 'NLHRed11' 6-max Seat #6 is the button
Seat 1: ad17dbfc ($9.49 in chips)
Seat 2: bd544f4f ($18.4 in chips)
Seat 3: d81241b3 ($11.58 in chips)
Seat 5: cfde2efb ($6.41 in chips)
Seat 6: Hero ($10 in chips)
ad17dbfc: posts small blind $0.05
bd544f4f: posts big blind $0.1
*** HOLE CARDS ***
Dealt to ad17dbfc 
Dealt to bd544f4f 
Dealt to d81241b3 
Dealt to cfde2efb 
Dealt to Hero [5s 7s]
d81241b3: folds
cfde2efb: folds
Hero: raises $0.14 to $0.24
ad17dbfc: folds
bd544f4f: raises $0.76 to $1
Hero: folds
Uncalled bet ($0.76) returned to bd544f4f
*** SHOWDOWN ***
bd544f4f collected $0.51 from pot
*** SUMMARY ***
Total pot $0.53 | Rake $0.02 | Jackpot $0 | Bingo $0 | Fortune $0 | Tax $0
Seat 1: ad17dbfc (small blind) folded before Flop
Seat 2: bd544f4f (big blind) collected ($0.51)
Seat 3: d81241b3 folded before Flop (didn't bet)
Seat 5: cfde2efb folded before Flop (didn't bet)
Seat 6: Hero (button) folded before Flop


Poker Hand #HD1806671580: Hold'em No Limit ($0.05/$0.1) - 2024/06/08 15:42:41
Table 'NLHRed11' 6-max Seat #5 is the button
Seat 1: ad17dbfc ($9.59 in chips)
Seat 2: bd544f4f ($18.4 in chips)
Seat 3: d81241b3 ($11.58 in chips)
Seat 5: cfde2efb ($6.26 in chips)
Seat 6: Hero ($10 in chips)
Hero: posts small blind $0.05
ad17dbfc: posts big blind $0.1
*** HOLE CARDS ***
Dealt to ad17dbfc 
Dealt to bd544f4f 
Dealt to d81241b3 
Dealt to cfde2efb 
Dealt to Hero [8s 5h]
bd544f4f: folds
d81241b3: folds
cfde2efb: raises $0.15 to $0.25
Hero: folds
ad17dbfc: folds
Uncalled bet ($0.15) returned to cfde2efb
*** SHOWDOWN ***
cfde2efb collected $0.25 from pot
*** SUMMARY ***
Total pot $0.25 | Rake $0 | Jackpot $0 | Bingo $0 | Fortune $0 | Tax $0
Seat 1: ad17dbfc (big blind) folded before Flop
Seat 2: bd544f4f folded before Flop (didn't bet)
Seat 3: d81241b3 folded before Flop (didn't bet)
Seat 5: cfde2efb (button) collected ($0.25)
Seat 6: Hero (small blind) folded before Flop


Poker Hand #HD1806671545: Hold'em No Limit ($0.05/$0.1) - 2024/06/08 15:42:27
Table 'NLHRed11' 6-max Seat #3 is the button
Seat 1: ad17dbfc ($9.59 in chips)
Seat 2: bd544f4f ($18.25 in chips)
Seat 3: d81241b3 ($11.58 in chips)
Seat 5: cfde2efb ($6.31 in chips)
Seat 6: Hero ($10 in chips)
cfde2efb: posts small blind $0.05
Hero: posts big blind $0.1
*** HOLE CARDS ***
Dealt to ad17dbfc 
Dealt to bd544f4f 
Dealt to d81241b3 
Dealt to cfde2efb 
Dealt to Hero [6h Ts]
ad17dbfc: folds
bd544f4f: raises $0.15 to $0.25
d81241b3: folds
cfde2efb: folds
Hero: folds
Uncalled bet ($0.15) returned to bd544f4f
*** SHOWDOWN ***
bd544f4f collected $0.25 from pot
*** SUMMARY ***
Total pot $0.25 | Rake $0 | Jackpot $0 | Bingo $0 | Fortune $0 | Tax $0
Seat 1: ad17dbfc folded before Flop (didn't bet)
Seat 2: bd544f4f collected ($0.25)
Seat 3: d81241b3 (button) folded before Flop (didn't bet)
Seat 5: cfde2efb (small blind) folded before Flop
Seat 6: Hero (big blind) folded before Flop


Poker Hand #HD1806671513: Hold'em No Limit ($0.05/$0.1) - 2024/06/08 15:42:10
Table 'NLHRed11' 6-max Seat #2 is the button
Seat 1: ad17dbfc ($9.44 in chips)
Seat 2: bd544f4f ($18.25 in chips)
Seat 3: d81241b3 ($11.63 in chips)
Seat 5: cfde2efb ($6.41 in chips)
Seat 6: Hero ($10 in chips)
d81241b3: posts small blind $0.05
cfde2efb: posts big blind $0.1
*** HOLE CARDS ***
Dealt to ad17dbfc 
Dealt to bd544f4f 
Dealt to d81241b3 
Dealt to cfde2efb 
Dealt to Hero [3d 7c]
Hero: folds
ad17dbfc: raises $0.2 to $0.3
bd544f4f: folds
d81241b3: folds
cfde2efb: folds
Uncalled bet ($0.2) returned to ad17dbfc
*** SHOWDOWN ***
ad17dbfc collected $0.25 from pot
*** SUMMARY ***
Total pot $0.25 | Rake $0 | Jackpot $0 | Bingo $0 | Fortune $0 | Tax $0
Seat 1: ad17dbfc collected ($0.25)
Seat 2: bd544f4f (button) folded before Flop (didn't bet)
Seat 3: d81241b3 (small blind) folded before Flop
Seat 5: cfde2efb (big blind) folded before Flop
Seat 6: Hero folded before Flop (didn't bet)


Poker Hand #HD1806671362: Hold'em No Limit ($0.05/$0.1) - 2024/06/08 15:40:57
Table 'NLHRed11' 6-max Seat #1 is the button
Seat 1: ad17dbfc ($9.44 in chips)
Seat 2: bd544f4f ($18.3 in chips)
Seat 3: d81241b3 ($11.73 in chips)
Seat 4: 5e4e7f5d ($23.07 in chips)
Seat 5: cfde2efb ($5 in chips)
Seat 6: Hero ($11.4 in chips)
bd544f4f: posts small blind $0.05
d81241b3: posts big blind $0.1
*** HOLE CARDS ***
Dealt to ad17dbfc 
Dealt to bd544f4f 
Dealt to d81241b3 
Dealt to 5e4e7f5d 
Dealt to cfde2efb 
Dealt to Hero [Jh Ks]
5e4e7f5d: folds
cfde2efb: raises $0.15 to $0.25
Hero: raises $0.55 to $0.8
ad17dbfc: folds
bd544f4f: folds
d81241b3: folds
cfde2efb: calls $0.55
*** FLOP *** [Qc 4s 7s]
cfde2efb: checks
Hero: bets $0.6
cfde2efb: calls $0.6
*** TURN *** [Qc 4s 7s] [3d]
cfde2efb: checks
Hero: checks
*** RIVER *** [Qc 4s 7s 3d] [8h]
cfde2efb: checks
Hero: checks
cfde2efb: shows [Qd Td] (Pair of Queens)
Hero: shows [Jh Ks] (King-High)
*** SHOWDOWN ***
cfde2efb collected $2.81 from pot
*** SUMMARY ***
Total pot $2.95 | Rake $0.14 | Jackpot $0 | Bingo $0 | Fortune $0 | Tax $0
Board [Qc 4s 7s 3d 8h]
Seat 1: ad17dbfc (button) folded before Flop (didn't bet)
Seat 2: bd544f4f (small blind) folded before Flop
Seat 3: d81241b3 (big blind) folded before Flop
Seat 4: 5e4e7f5d folded before Flop (didn't bet)
Seat 5: cfde2efb showed [Qd Td] and won ($2.81) with Pair of Queens
Seat 6: Hero showed [Jh Ks] and lost with King-High


Poker Hand #HD1806671140: Hold'em No Limit ($0.05/$0.1) - 2024/06/08 15:38:51
Table 'NLHRed11' 6-max Seat #6 is the button
Seat 1: ad17dbfc ($9.49 in chips)
Seat 2: bd544f4f ($18.4 in chips)
Seat 3: d81241b3 ($11.73 in chips)
Seat 4: 5e4e7f5d ($12.01 in chips)
Seat 5: cfde2efb ($17.01 in chips)
Seat 6: Hero ($11.4 in chips)
ad17dbfc: posts small blind $0.05
bd544f4f: posts big blind $0.1
*** HOLE CARDS ***
Dealt to ad17dbfc 
Dealt to bd544f4f 
Dealt to d81241b3 
Dealt to 5e4e7f5d 
Dealt to cfde2efb 
Dealt to Hero [3s 9h]
d81241b3: folds
5e4e7f5d: raises $0.15 to $0.25
cfde2efb: raises $0.65 to $0.9
Hero: folds
ad17dbfc: folds
bd544f4f: folds
5e4e7f5d: calls $0.65
*** FLOP *** [Kc As Ts]
5e4e7f5d: checks
cfde2efb: bets $0.65
5e4e7f5d: calls $0.65
*** TURN *** [Kc As Ts] [6c]
5e4e7f5d: checks
cfde2efb: bets $2.44
5e4e7f5d: calls $2.44
*** RIVER *** [Kc As Ts 6c] [3h]
5e4e7f5d: checks
cfde2efb: bets $8.13
5e4e7f5d: calls $8.02 and is all-in
Uncalled bet ($0.11) returned to cfde2efb
cfde2efb: shows [Jd Jc] (Pair of Jacks)
5e4e7f5d: shows [Qh Ad] (Pair of Aces)
*** SHOWDOWN ***
5e4e7f5d collected $23.07 from pot
*** SUMMARY ***
Total pot $24.17 | Rake $1 | Jackpot $0.1 | Bingo $0 | Fortune $0 | Tax $0
Board [Kc As Ts 6c 3h]
Seat 1: ad17dbfc (small blind) folded before Flop
Seat 2: bd544f4f (big blind) folded before Flop
Seat 3: d81241b3 folded before Flop (didn't bet)
Seat 4: 5e4e7f5d showed [Qh Ad] and won ($23.07) with Pair of Aces
Seat 5: cfde2efb showed [Jd Jc] and lost with Pair of Jacks
Seat 6: Hero (button) folded before Flop (didn't bet)


Poker Hand #HD1806671113: Hold'em No Limit ($0.05/$0.1) - 2024/06/08 15:38:42
Table 'NLHRed11' 6-max Seat #5 is the button
Seat 1: ad17dbfc ($9.44 in chips)
Seat 2: bd544f4f ($18.4 in chips)
Seat 3: d81241b3 ($11.73 in chips)
Seat 4: 5e4e7f5d ($12.01 in chips)
Seat 5: cfde2efb ($17.01 in chips)
Seat 6: Hero ($11.45 in chips)
Hero: posts small blind $0.05
ad17dbfc: posts big blind $0.1
*** HOLE CARDS ***
Dealt to ad17dbfc 
Dealt to bd544f4f 
Dealt to d81241b3 
Dealt to 5e4e7f5d 
Dealt to cfde2efb 
Dealt to Hero [8d Ah]
bd544f4f: folds
d81241b3: folds
5e4e7f5d: folds
cfde2efb: folds
Hero: folds
Uncalled bet ($0.05) returned to ad17dbfc
*** SHOWDOWN ***
ad17dbfc collected $0.1 from pot
*** SUMMARY ***
Total pot $0.1 | Rake $0 | Jackpot $0 | Bingo $0 | Fortune $0 | Tax $0
Seat 1: ad17dbfc (big blind) collected ($0.1)
Seat 2: bd544f4f folded before Flop (didn't bet)
Seat 3: d81241b3 folded before Flop (didn't bet)
Seat 4: 5e4e7f5d folded before Flop (didn't bet)
Seat 5: cfde2efb (button) folded before Flop (didn't bet)
Seat 6: Hero (small blind) folded before Flop


Poker Hand #HD1806671091: Hold'em No Limit ($0.05/$0.1) - 2024/06/08 15:38:28
Table 'NLHRed11' 6-max Seat #4 is the button
Seat 1: ad17dbfc ($9.44 in chips)
Seat 2: bd544f4f ($18.4 in chips)
Seat 3: d81241b3 ($11.73 in chips)
Seat 4: 5e4e7f5d ($12.01 in chips)
Seat 5: cfde2efb ($16.91 in chips)
Seat 6: Hero ($11.55 in chips)
cfde2efb: posts small blind $0.05
Hero: posts big blind $0.1
*** HOLE CARDS ***
Dealt to ad17dbfc 
Dealt to bd544f4f 
Dealt to d81241b3 
Dealt to 5e4e7f5d 
Dealt to cfde2efb 
Dealt to Hero [7d Tc]
ad17dbfc: folds
bd544f4f: folds
d81241b3: folds
5e4e7f5d: folds
cfde2efb: raises $0.2 to $0.3
Hero: folds
Uncalled bet ($0.2) returned to cfde2efb
*** SHOWDOWN ***
cfde2efb collected $0.2 from pot
*** SUMMARY ***
Total pot $0.2 | Rake $0 | Jackpot $0 | Bingo $0 | Fortune $0 | Tax $0
Seat 1: ad17dbfc folded before Flop (didn't bet)
Seat 2: bd544f4f folded before Flop (didn't bet)
Seat 3: d81241b3 folded before Flop (didn't bet)
Seat 4: 5e4e7f5d (button) folded before Flop (didn't bet)
Seat 5: cfde2efb (small blind) collected ($0.2)
Seat 6: Hero (big blind) folded before Flop


Poker Hand #HD1806670969: Hold'em No Limit ($0.05/$0.1) - 2024/06/08 15:37:25
Table 'NLHRed11' 6-max Seat #3 is the button
Seat 1: ad17dbfc ($9.44 in chips)
Seat 2: bd544f4f ($18.4 in chips)
Seat 3: d81241b3 ($11.73 in chips)
Seat 4: 5e4e7f5d ($12.06 in chips)
Seat 5: cfde2efb ($17.31 in chips)
Seat 6: Hero ($11.14 in chips)
5e4e7f5d: posts small blind $0.05
cfde2efb: posts big blind $0.1
*** HOLE CARDS ***
Dealt to ad17dbfc 
Dealt to bd544f4f 
Dealt to d81241b3 
Dealt to 5e4e7f5d 
Dealt to cfde2efb 
Dealt to Hero [Kh Jh]
Hero: raises $0.1 to $0.2
ad17dbfc: folds
bd544f4f: folds
d81241b3: folds
5e4e7f5d: folds
cfde2efb: calls $0.1
*** FLOP *** [7d 4s Ks]
cfde2efb: checks
Hero: bets $0.2
cfde2efb: calls $0.2
*** TURN *** [7d 4s Ks] [Tc]
cfde2efb: checks
Hero: bets $0.4
cfde2efb: folds
Uncalled bet ($0.4) returned to Hero
*** SHOWDOWN ***
Hero collected $0.81 from pot
*** SUMMARY ***
Total pot $0.85 | Rake $0.04 | Jackpot $0 | Bingo $0 | Fortune $0 | Tax $0
Board [7d 4s Ks Tc]
Seat 1: ad17dbfc folded before Flop (didn't bet)
Seat 2: bd544f4f folded before Flop (didn't bet)
Seat 3: d81241b3 (button) folded before Flop (didn't bet)
Seat 4: 5e4e7f5d (small blind) folded before Flop
Seat 5: cfde2efb (big blind) folded on the Turn
Seat 6: Hero won ($0.81)


Poker Hand #HD1806670880: Hold'em No Limit ($0.05/$0.1) - 2024/06/08 15:36:51
Table 'NLHRed11' 6-max Seat #2 is the button
Seat 1: ad17dbfc ($9.64 in chips)
Seat 2: bd544f4f ($17.88 in chips)
Seat 3: d81241b3 ($11.78 in chips)
Seat 4: 5e4e7f5d ($12.16 in chips)
Seat 5: cfde2efb ($17.31 in chips)
Seat 6: Hero ($11.34 in chips)
d81241b3: posts small blind $0.05
5e4e7f5d: posts big blind $0.1
*** HOLE CARDS ***
Dealt to ad17dbfc 
Dealt to bd544f4f 
Dealt to d81241b3 
Dealt to 5e4e7f5d 
Dealt to cfde2efb 
Dealt to Hero [8h 8s]
cfde2efb: folds
Hero: raises $0.1 to $0.2
ad17dbfc: calls $0.2
bd544f4f: raises $0.8 to $1
d81241b3: folds
5e4e7f5d: folds
Hero: folds
ad17dbfc: folds
Uncalled bet ($0.8) returned to bd544f4f
*** SHOWDOWN ***
bd544f4f collected $0.72 from pot
*** SUMMARY ***
Total pot $0.75 | Rake $0.03 | Jackpot $0 | Bingo $0 | Fortune $0 | Tax $0
Seat 1: ad17dbfc folded before Flop
Seat 2: bd544f4f (button) collected ($0.72)
Seat 3: d81241b3 (small blind) folded before Flop
Seat 4: 5e4e7f5d (big blind) folded before Flop
Seat 5: cfde2efb folded before Flop (didn't bet)
Seat 6: Hero folded before Flop


Poker Hand #HD1806670741: Hold'em No Limit ($0.05/$0.1) - 2024/06/08 15:35:36
Table 'NLHRed11' 6-max Seat #1 is the button
Seat 1: ad17dbfc ($11.31 in chips)
Seat 2: bd544f4f ($17.93 in chips)
Seat 3: d81241b3 ($10.32 in chips)
Seat 4: 5e4e7f5d ($12.16 in chips)
Seat 5: cfde2efb ($17.31 in chips)
Seat 6: Hero ($11.34 in chips)
bd544f4f: posts small blind $0.05
d81241b3: posts big blind $0.1
*** HOLE CARDS ***
Dealt to ad17dbfc 
Dealt to bd544f4f 
Dealt to d81241b3 
Dealt to 5e4e7f5d 
Dealt to cfde2efb 
Dealt to Hero [8s 3s]
5e4e7f5d: folds
cfde2efb: folds
Hero: folds
ad17dbfc: raises $0.1 to $0.2
bd544f4f: folds
d81241b3: calls $0.1
*** FLOP *** [Jd Tc Js]
d81241b3: checks
ad17dbfc: checks
*** TURN *** [Jd Tc Js] [2d]
d81241b3: bets $0.34
ad17dbfc: calls $0.34
*** RIVER *** [Jd Tc Js 2d] [Qh]
d81241b3: bets $1.13
ad17dbfc: calls $1.13
d81241b3: shows [Jh Ks] (Three Jacks)
ad17dbfc: shows [Qd 8d] (Pair of Queens and Pair of Jacks)
*** SHOWDOWN ***
d81241b3 collected $3.13 from pot
*** SUMMARY ***
Total pot $3.39 | Rake $0.16 | Jackpot $0.1 | Bingo $0 | Fortune $0 | Tax $0
Board [Jd Tc Js 2d Qh]
Seat 1: ad17dbfc (button) showed [Qd 8d] and lost with Pair of Queens and Pair of Jacks
Seat 2: bd544f4f (small blind) folded before Flop
Seat 3: d81241b3 (big blind) showed [Jh Ks] and won ($3.13) with Three Jacks
Seat 4: 5e4e7f5d folded before Flop (didn't bet)
Seat 5: cfde2efb folded before Flop (didn't bet)
Seat 6: Hero folded before Flop (didn't bet)


Poker Hand #HD1806670682: Hold'em No Limit ($0.05/$0.1) - 2024/06/08 15:35:08
Table 'NLHRed11' 6-max Seat #6 is the button
Seat 1: ad17dbfc ($11.56 in chips)
Seat 2: bd544f4f ($18.03 in chips)
Seat 3: d81241b3 ($10 in chips)
Seat 4: 5e4e7f5d ($12.16 in chips)
Seat 5: cfde2efb ($17.31 in chips)
Seat 6: Hero ($11.34 in chips)
ad17dbfc: posts small blind $0.05
bd544f4f: posts big blind $0.1
*** HOLE CARDS ***
Dealt to ad17dbfc 
Dealt to bd544f4f 
Dealt to d81241b3 
Dealt to 5e4e7f5d 
Dealt to cfde2efb 
Dealt to Hero [Ad 2h]
d81241b3: raises $0.15 to $0.25
5e4e7f5d: folds
cfde2efb: folds
Hero: folds
ad17dbfc: calls $0.2
bd544f4f: folds
*** FLOP *** [Kc Qc Kh]
ad17dbfc: checks
d81241b3: bets $0.3
ad17dbfc: folds
Uncalled bet ($0.3) returned to d81241b3
*** SHOWDOWN ***
d81241b3 collected $0.57 from pot
*** SUMMARY ***
Total pot $0.6 | Rake $0.03 | Jackpot $0 | Bingo $0 | Fortune $0 | Tax $0
Board [Kc Qc Kh]
Seat 1: ad17dbfc (small blind) folded on the Flop
Seat 2: bd544f4f (big blind) folded before Flop
Seat 3: d81241b3 won ($0.57)
Seat 4: 5e4e7f5d folded before Flop (didn't bet)
Seat 5: cfde2efb folded before Flop (didn't bet)
Seat 6: Hero (button) folded before Flop (didn't bet)


Poker Hand #HD1806670583: Hold'em No Limit ($0.05/$0.1) - 2024/06/08 15:34:26
Table 'NLHRed11' 6-max Seat #5 is the button
Seat 1: ad17dbfc ($11.11 in chips)
Seat 2: bd544f4f ($18.03 in chips)
Seat 4: 5e4e7f5d ($12.16 in chips)
Seat 5: cfde2efb ($17.75 in chips)
Seat 6: Hero ($11.39 in chips)
Hero: posts small blind $0.05
ad17dbfc: posts big blind $0.1
*** HOLE CARDS ***
Dealt to ad17dbfc 
Dealt to bd544f4f 
Dealt to 5e4e7f5d 
Dealt to cfde2efb 
Dealt to Hero [8d Tc]
bd544f4f: folds
5e4e7f5d: folds
cfde2efb: raises $0.15 to $0.25
Hero: folds
ad17dbfc: calls $0.15
*** FLOP *** [Td Th 9d]
ad17dbfc: checks
cfde2efb: bets $0.19
ad17dbfc: calls $0.19
*** TURN *** [Td Th 9d] [Qh]
ad17dbfc: checks
cfde2efb: checks
*** RIVER *** [Td Th 9d Qh] [6c]
ad17dbfc: checks
cfde2efb: checks
ad17dbfc: shows [6h Ah] (Pair of Tens and Pair of Sixes)
cfde2efb: shows [Ad 8s] (Pair of Tens)
*** SHOWDOWN ***
ad17dbfc collected $0.89 from pot
*** SUMMARY ***
Total pot $0.93 | Rake $0.04 | Jackpot $0 | Bingo $0 | Fortune $0 | Tax $0
Board [Td Th 9d Qh 6c]
Seat 1: ad17dbfc (big blind) showed [6h Ah] and won ($0.89) with Pair of Tens and Pair of Sixes
Seat 2: bd544f4f folded before Flop (didn't bet)
Seat 4: 5e4e7f5d folded before Flop (didn't bet)
Seat 5: cfde2efb (button) showed [Ad 8s] and lost with Pair of Tens
Seat 6: Hero (small blind) folded before Flop


Poker Hand #HD1806670530: Hold'em No Limit ($0.05/$0.1) - 2024/06/08 15:34:00
Table 'NLHRed11' 6-max Seat #4 is the button
Seat 1: ad17dbfc ($11.11 in chips)
Seat 2: bd544f4f ($18.03 in chips)
Seat 3: d81241b3 ($10 in chips)
Seat 4: 5e4e7f5d ($12.16 in chips)
Seat 5: cfde2efb ($17.65 in chips)
Seat 6: Hero ($11.49 in chips)
cfde2efb: posts small blind $0.05
Hero: posts big blind $0.1
*** HOLE CARDS ***
Dealt to ad17dbfc 
Dealt to bd544f4f 
Dealt to d81241b3 
Dealt to 5e4e7f5d 
Dealt to cfde2efb 
Dealt to Hero [5s 7c]
ad17dbfc: folds
bd544f4f: folds
d81241b3: folds
5e4e7f5d: folds
cfde2efb: raises $0.2 to $0.3
Hero: folds
Uncalled bet ($0.2) returned to cfde2efb
*** SHOWDOWN ***
cfde2efb collected $0.2 from pot
*** SUMMARY ***
Total pot $0.2 | Rake $0 | Jackpot $0 | Bingo $0 | Fortune $0 | Tax $0
Seat 1: ad17dbfc folded before Flop (didn't bet)
Seat 2: bd544f4f folded before Flop (didn't bet)
Seat 3: d81241b3 folded before Flop (didn't bet)
Seat 4: 5e4e7f5d (button) folded before Flop (didn't bet)
Seat 5: cfde2efb (small blind) collected ($0.2)
Seat 6: Hero (big blind) folded before Flop


Poker Hand #HD1806670432: Hold'em No Limit ($0.05/$0.1) - 2024/06/08 15:33:11
Table 'NLHRed11' 6-max Seat #3 is the button
Seat 1: ad17dbfc ($11.11 in chips)
Seat 2: bd544f4f ($18.03 in chips)
Seat 3: d81241b3 ($6.03 in chips)
Seat 4: 5e4e7f5d ($11.93 in chips)
Seat 5: cfde2efb ($17.9 in chips)
Seat 6: Hero ($11.49 in chips)
5e4e7f5d: posts small blind $0.05
cfde2efb: posts big blind $0.1
*** HOLE CARDS ***
Dealt to ad17dbfc 
Dealt to bd544f4f 
Dealt to d81241b3 
Dealt to 5e4e7f5d 
Dealt to cfde2efb 
Dealt to Hero [4s 6s]
Hero: folds
ad17dbfc: folds
bd544f4f: folds
d81241b3: folds
5e4e7f5d: raises $0.15 to $0.25
cfde2efb: calls $0.15
*** FLOP *** [7d 7h 9d]
5e4e7f5d: checks
cfde2efb: checks
*** TURN *** [7d 7h 9d] [Kd]
5e4e7f5d: checks
cfde2efb: checks
*** RIVER *** [7d 7h 9d Kd] [4h]
5e4e7f5d: bets $0.5
cfde2efb: folds
Uncalled bet ($0.5) returned to 5e4e7f5d
*** SHOWDOWN ***
5e4e7f5d collected $0.48 from pot
*** SUMMARY ***
Total pot $0.5 | Rake $0.02 | Jackpot $0 | Bingo $0 | Fortune $0 | Tax $0
Board [7d 7h 9d Kd 4h]
Seat 1: ad17dbfc folded before Flop (didn't bet)
Seat 2: bd544f4f folded before Flop (didn't bet)
Seat 3: d81241b3 (button) folded before Flop (didn't bet)
Seat 4: 5e4e7f5d (small blind) won ($0.48)
Seat 5: cfde2efb (big blind) folded on the River
Seat 6: Hero folded before Flop (didn't bet)


Poker Hand #HD1806670189: Hold'em No Limit ($0.05/$0.1) - 2024/06/08 15:31:20
Table 'NLHRed11' 6-max Seat #2 is the button
Seat 1: ad17dbfc ($11.11 in chips)
Seat 2: bd544f4f ($13.76 in chips)
Seat 3: d81241b3 ($10.03 in chips)
Seat 4: 5e4e7f5d ($12.03 in chips)
Seat 5: cfde2efb ($18.6 in chips)
Seat 6: Hero ($11.49 in chips)
d81241b3: posts small blind $0.05
5e4e7f5d: posts big blind $0.1
*** HOLE CARDS ***
Dealt to ad17dbfc 
Dealt to bd544f4f 
Dealt to d81241b3 
Dealt to 5e4e7f5d 
Dealt to cfde2efb 
Dealt to Hero [5d 6d]
cfde2efb: raises $0.15 to $0.25
Hero: folds
ad17dbfc: folds
bd544f4f: raises $0.45 to $0.7
d81241b3: calls $0.65
5e4e7f5d: folds
cfde2efb: calls $0.45
*** FLOP *** [6h As 5s]
d81241b3: checks
cfde2efb: checks
bd544f4f: bets $1.1
d81241b3: calls $1.1
cfde2efb: folds
*** TURN *** [6h As 5s] [6s]
d81241b3: checks
bd544f4f: bets $2.2
d81241b3: calls $2.2
*** RIVER *** [6h As 5s 6s] [Kc]
d81241b3: checks
bd544f4f: bets $8.8
d81241b3: folds
Uncalled bet ($8.8) returned to bd544f4f
*** SHOWDOWN ***
bd544f4f collected $8.27 from pot
*** SUMMARY ***
Total pot $8.8 | Rake $0.43 | Jackpot $0.1 | Bingo $0 | Fortune $0 | Tax $0
Board [6h As 5s 6s Kc]
Seat 1: ad17dbfc folded before Flop (didn't bet)
Seat 2: bd544f4f (button) won ($8.27)
Seat 3: d81241b3 (small blind) folded on the River
Seat 4: 5e4e7f5d (big blind) folded before Flop
Seat 5: cfde2efb folded on the Flop
Seat 6: Hero folded before Flop (didn't bet)


Poker Hand #HD1806670159: Hold'em No Limit ($0.05/$0.1) - 2024/06/08 15:31:05
Table 'NLHRed11' 6-max Seat #1 is the button
Seat 1: ad17dbfc ($10.96 in chips)
Seat 2: bd544f4f ($13.81 in chips)
Seat 3: d81241b3 ($10.13 in chips)
Seat 4: 5e4e7f5d ($12.03 in chips)
Seat 5: cfde2efb ($18.6 in chips)
Seat 6: Hero ($11.49 in chips)
bd544f4f: posts small blind $0.05
d81241b3: posts big blind $0.1
*** HOLE CARDS ***
Dealt to ad17dbfc 
Dealt to bd544f4f 
Dealt to d81241b3 
Dealt to 5e4e7f5d 
Dealt to cfde2efb 
Dealt to Hero [6s Tc]
5e4e7f5d: folds
cfde2efb: folds
Hero: folds
ad17dbfc: raises $0.1 to $0.2
bd544f4f: folds
d81241b3: folds
Uncalled bet ($0.1) returned to ad17dbfc
*** SHOWDOWN ***
ad17dbfc collected $0.25 from pot
*** SUMMARY ***
Total pot $0.25 | Rake $0 | Jackpot $0 | Bingo $0 | Fortune $0 | Tax $0
Seat 1: ad17dbfc (button) collected ($0.25)
Seat 2: bd544f4f (small blind) folded before Flop
Seat 3: d81241b3 (big blind) folded before Flop
Seat 4: 5e4e7f5d folded before Flop (didn't bet)
Seat 5: cfde2efb folded before Flop (didn't bet)
Seat 6: Hero folded before Flop (didn't bet)


Poker Hand #HD1806670107: Hold'em No Limit ($0.05/$0.1) - 2024/06/08 15:30:38
Table 'NLHRed11' 6-max Seat #6 is the button
Seat 1: ad17dbfc ($11.01 in chips)
Seat 2: bd544f4f ($13.91 in chips)
Seat 3: d81241b3 ($10.13 in chips)
Seat 4: 5e4e7f5d ($11.88 in chips)
Seat 5: cfde2efb ($18.6 in chips)
Seat 6: Hero ($11.49 in chips)
ad17dbfc: posts small blind $0.05
bd544f4f: posts big blind $0.1
*** HOLE CARDS ***
Dealt to ad17dbfc 
Dealt to bd544f4f 
Dealt to d81241b3 
Dealt to 5e4e7f5d 
Dealt to cfde2efb 
Dealt to Hero [4d 8h]
d81241b3: folds
5e4e7f5d: raises $0.15 to $0.25
cfde2efb: folds
Hero: folds
ad17dbfc: folds
bd544f4f: folds
Uncalled bet ($0.15) returned to 5e4e7f5d
*** SHOWDOWN ***
5e4e7f5d collected $0.25 from pot
*** SUMMARY ***
Total pot $0.25 | Rake $0 | Jackpot $0 | Bingo $0 | Fortune $0 | Tax $0
Seat 1: ad17dbfc (small blind) folded before Flop
Seat 2: bd544f4f (big blind) folded before Flop
Seat 3: d81241b3 folded before Flop (didn't bet)
Seat 4: 5e4e7f5d collected ($0.25)
Seat 5: cfde2efb folded before Flop (didn't bet)
Seat 6: Hero (button) folded before Flop (didn't bet)


Poker Hand #HD1806670054: Hold'em No Limit ($0.05/$0.1) - 2024/06/08 15:30:10
Table 'NLHRed11' 6-max Seat #5 is the button
Seat 1: ad17dbfc ($11.26 in chips)
Seat 2: bd544f4f ($13.91 in chips)
Seat 3: d81241b3 ($9.85 in chips)
Seat 4: 5e4e7f5d ($11.88 in chips)
Seat 5: cfde2efb ($18.6 in chips)
Seat 6: Hero ($11.54 in chips)
Hero: posts small blind $0.05
ad17dbfc: posts big blind $0.1
*** HOLE CARDS ***
Dealt to ad17dbfc 
Dealt to bd544f4f 
Dealt to d81241b3 
Dealt to 5e4e7f5d 
Dealt to cfde2efb 
Dealt to Hero [2s 8s]
bd544f4f: folds
d81241b3: raises $0.15 to $0.25
5e4e7f5d: folds
cfde2efb: folds
Hero: folds
ad17dbfc: calls $0.15
*** FLOP *** [5h Ac Jh]
ad17dbfc: checks
d81241b3: bets $0.25
ad17dbfc: folds
Uncalled bet ($0.25) returned to d81241b3
*** SHOWDOWN ***
d81241b3 collected $0.53 from pot
*** SUMMARY ***
Total pot $0.55 | Rake $0.02 | Jackpot $0 | Bingo $0 | Fortune $0 | Tax $0
Board [5h Ac Jh]
Seat 1: ad17dbfc (big blind) folded on the Flop
Seat 2: bd544f4f folded before Flop (didn't bet)
Seat 3: d81241b3 won ($0.53)
Seat 4: 5e4e7f5d folded before Flop (didn't bet)
Seat 5: cfde2efb (button) folded before Flop (didn't bet)
Seat 6: Hero (small blind) folded before Flop


Poker Hand #HD1806670004: Hold'em No Limit ($0.05/$0.1) - 2024/06/08 15:29:47
Table 'NLHRed11' 6-max Seat #4 is the button
Seat 1: ad17dbfc ($11.26 in chips)
Seat 2: bd544f4f ($13.91 in chips)
Seat 3: d81241b3 ($9.85 in chips)
Seat 4: 5e4e7f5d ($11.88 in chips)
Seat 5: cfde2efb ($18.5 in chips)
Seat 6: Hero ($11.64 in chips)
cfde2efb: posts small blind $0.05
Hero: posts big blind $0.1
*** HOLE CARDS ***
Dealt to ad17dbfc 
Dealt to bd544f4f 
Dealt to d81241b3 
Dealt to 5e4e7f5d 
Dealt to cfde2efb 
Dealt to Hero [4h Js]
ad17dbfc: folds
bd544f4f: folds
d81241b3: folds
5e4e7f5d: folds
cfde2efb: raises $0.2 to $0.3
Hero: folds
Uncalled bet ($0.2) returned to cfde2efb
*** SHOWDOWN ***
cfde2efb collected $0.2 from pot
*** SUMMARY ***
Total pot $0.2 | Rake $0 | Jackpot $0 | Bingo $0 | Fortune $0 | Tax $0
Seat 1: ad17dbfc folded before Flop (didn't bet)
Seat 2: bd544f4f folded before Flop (didn't bet)
Seat 3: d81241b3 folded before Flop (didn't bet)
Seat 4: 5e4e7f5d (button) folded before Flop (didn't bet)
Seat 5: cfde2efb (small blind) collected ($0.2)
Seat 6: Hero (big blind) folded before Flop


Poker Hand #HD1806669952: Hold'em No Limit ($0.05/$0.1) - 2024/06/08 15:29:20
Table 'NLHRed11' 6-max Seat #3 is the button
Seat 1: ad17dbfc ($11.12 in chips)
Seat 2: bd544f4f ($13.91 in chips)
Seat 3: d81241b3 ($9.85 in chips)
Seat 4: 5e4e7f5d ($11.93 in chips)
Seat 5: cfde2efb ($18.6 in chips)
Seat 6: Hero ($11.64 in chips)
5e4e7f5d: posts small blind $0.05
cfde2efb: posts big blind $0.1
*** HOLE CARDS ***
Dealt to ad17dbfc 
Dealt to bd544f4f 
Dealt to d81241b3 
Dealt to 5e4e7f5d 
Dealt to cfde2efb 
Dealt to Hero [8s 5s]
Hero: folds
ad17dbfc: calls $0.1
bd544f4f: folds
d81241b3: folds
5e4e7f5d: folds
cfde2efb: checks
*** FLOP *** [As 8h 2c]
cfde2efb: checks
ad17dbfc: checks
*** TURN *** [As 8h 2c] [6s]
cfde2efb: checks
ad17dbfc: bets $0.19
cfde2efb: folds
Uncalled bet ($0.19) returned to ad17dbfc
*** SHOWDOWN ***
ad17dbfc collected $0.24 from pot
*** SUMMARY ***
Total pot $0.25 | Rake $0.01 | Jackpot $0 | Bingo $0 | Fortune $0 | Tax $0
Board [As 8h 2c 6s]
Seat 1: ad17dbfc won ($0.24)
Seat 2: bd544f4f folded before Flop (didn't bet)
Seat 3: d81241b3 (button) folded before Flop (didn't bet)
Seat 4: 5e4e7f5d (small blind) folded before Flop
Seat 5: cfde2efb (big blind) folded on the Turn
Seat 6: Hero folded before Flop (didn't bet)


Poker Hand #HD1806669855: Hold'em No Limit ($0.05/$0.1) - 2024/06/08 15:28:24
Table 'NLHRed11' 6-max Seat #2 is the button
Seat 1: ad17dbfc ($11.12 in chips)
Seat 2: bd544f4f ($13.91 in chips)
Seat 3: d81241b3 ($9.9 in chips)
Seat 4: 5e4e7f5d ($12.37 in chips)
Seat 5: cfde2efb ($18.15 in chips)
Seat 6: Hero ($11.64 in chips)
d81241b3: posts small blind $0.05
5e4e7f5d: posts big blind $0.1
*** HOLE CARDS ***
Dealt to ad17dbfc 
Dealt to bd544f4f 
Dealt to d81241b3 
Dealt to 5e4e7f5d 
Dealt to cfde2efb 
Dealt to Hero [5s Qh]
cfde2efb: raises $0.15 to $0.25
Hero: folds
ad17dbfc: folds
bd544f4f: folds
d81241b3: folds
5e4e7f5d: calls $0.15
*** FLOP *** [2c Ac 3d]
5e4e7f5d: checks
cfde2efb: bets $0.19
5e4e7f5d: calls $0.19
*** TURN *** [2c Ac 3d] [As]
5e4e7f5d: checks
cfde2efb: checks
*** RIVER *** [2c Ac 3d As] [2d]
5e4e7f5d: checks
cfde2efb: bets $0.31
5e4e7f5d: folds
Uncalled bet ($0.31) returned to cfde2efb
*** SHOWDOWN ***
cfde2efb collected $0.89 from pot
*** SUMMARY ***
Total pot $0.93 | Rake $0.04 | Jackpot $0 | Bingo $0 | Fortune $0 | Tax $0
Board [2c Ac 3d As 2d]
Seat 1: ad17dbfc folded before Flop (didn't bet)
Seat 2: bd544f4f (button) folded before Flop (didn't bet)
Seat 3: d81241b3 (small blind) folded before Flop
Seat 4: 5e4e7f5d (big blind) folded on the River
Seat 5: cfde2efb won ($0.89)
Seat 6: Hero folded before Flop (didn't bet)


Poker Hand #HD1806669791: Hold'em No Limit ($0.05/$0.1) - 2024/06/08 15:27:53
Table 'NLHRed11' 6-max Seat #1 is the button
Seat 1: ad17dbfc ($11.36 in chips)
Seat 2: bd544f4f ($13.96 in chips)
Seat 3: d81241b3 ($10 in chips)
Seat 4: 5e4e7f5d ($12.37 in chips)
Seat 5: cfde2efb ($18.15 in chips)
Seat 6: Hero ($11.28 in chips)
bd544f4f: posts small blind $0.05
d81241b3: posts big blind $0.1
*** HOLE CARDS ***
Dealt to ad17dbfc 
Dealt to bd544f4f 
Dealt to d81241b3 
Dealt to 5e4e7f5d 
Dealt to cfde2efb 
Dealt to Hero [5s 6s]
5e4e7f5d: folds
cfde2efb: folds
Hero: raises $0.14 to $0.24
ad17dbfc: calls $0.24
bd544f4f: folds
d81241b3: folds
*** FLOP *** [7d 8c Ks]
Hero: bets $0.5
ad17dbfc: folds
Uncalled bet ($0.5) returned to Hero
*** SHOWDOWN ***
Hero collected $0.6 from pot
*** SUMMARY ***
Total pot $0.63 | Rake $0.03 | Jackpot $0 | Bingo $0 | Fortune $0 | Tax $0
Board [7d 8c Ks]
Seat 1: ad17dbfc (button) folded on the Flop
Seat 2: bd544f4f (small blind) folded before Flop
Seat 3: d81241b3 (big blind) folded before Flop
Seat 4: 5e4e7f5d folded before Flop (didn't bet)
Seat 5: cfde2efb folded before Flop (didn't bet)
Seat 6: Hero won ($0.6)


Poker Hand #HD1806669764: Hold'em No Limit ($0.05/$0.1) - 2024/06/08 15:27:40
Table 'NLHRed11' 6-max Seat #6 is the button
Seat 1: ad17dbfc ($11.41 in chips)
Seat 2: bd544f4f ($14.06 in chips)
Seat 4: 5e4e7f5d ($12.22 in chips)
Seat 5: cfde2efb ($18.15 in chips)
Seat 6: Hero ($11.28 in chips)
ad17dbfc: posts small blind $0.05
bd544f4f: posts big blind $0.1
*** HOLE CARDS ***
Dealt to ad17dbfc 
Dealt to bd544f4f 
Dealt to 5e4e7f5d 
Dealt to cfde2efb 
Dealt to Hero [3s Ts]
5e4e7f5d: raises $0.15 to $0.25
cfde2efb: folds
Hero: folds
ad17dbfc: folds
bd544f4f: folds
Uncalled bet ($0.15) returned to 5e4e7f5d
*** SHOWDOWN ***
5e4e7f5d collected $0.25 from pot
*** SUMMARY ***
Total pot $0.25 | Rake $0 | Jackpot $0 | Bingo $0 | Fortune $0 | Tax $0
Seat 1: ad17dbfc (small blind) folded before Flop
Seat 2: bd544f4f (big blind) folded before Flop
Seat 4: 5e4e7f5d collected ($0.25)
Seat 5: cfde2efb folded before Flop (didn't bet)
Seat 6: Hero (button) folded before Flop (didn't bet)


Poker Hand #HD1806669715: Hold'em No Limit ($0.05/$0.1) - 2024/06/08 15:27:14
Table 'NLHRed11' 6-max Seat #5 is the button
Seat 1: ad17dbfc ($11.51 in chips)
Seat 2: bd544f4f ($14.36 in chips)
Seat 4: 5e4e7f5d ($12.22 in chips)
Seat 5: cfde2efb ($19.15 in chips)
Seat 6: Hero ($10 in chips)
Hero: posts small blind $0.05
ad17dbfc: posts big blind $0.1
*** HOLE CARDS ***
Dealt to ad17dbfc 
Dealt to bd544f4f 
Dealt to 5e4e7f5d 
Dealt to cfde2efb 
Dealt to Hero [Qs As]
bd544f4f: raises $0.2 to $0.3
5e4e7f5d: folds
cfde2efb: raises $0.7 to $1
Hero: raises $1.5 to $2.5
ad17dbfc: folds
bd544f4f: folds
cfde2efb: folds
Uncalled bet ($1.5) returned to Hero
*** SHOWDOWN ***
Hero collected $2.28 from pot
*** SUMMARY ***
Total pot $2.4 | Rake $0.12 | Jackpot $0 | Bingo $0 | Fortune $0 | Tax $0
Seat 1: ad17dbfc (big blind) folded before Flop
Seat 2: bd544f4f folded before Flop
Seat 4: 5e4e7f5d folded before Flop (didn't bet)
Seat 5: cfde2efb (button) folded before Flop
Seat 6: Hero (small blind) collected ($2.28)


Poker Hand #HD1806669622: Hold'em No Limit ($0.05/$0.1) - 2024/06/08 15:26:27
Table 'NLHRed11' 6-max Seat #4 is the button
Seat 1: ad17dbfc ($11.51 in chips)
Seat 2: bd544f4f ($14.36 in chips)
Seat 4: 5e4e7f5d ($11.82 in chips)
Seat 5: cfde2efb ($19.2 in chips)
Seat 6: Hero ($10.15 in chips)
cfde2efb: posts small blind $0.05
Hero: posts big blind $0.1
*** HOLE CARDS ***
Dealt to ad17dbfc 
Dealt to bd544f4f 
Dealt to 5e4e7f5d 
Dealt to cfde2efb 
Dealt to Hero [9d 7d]
ad17dbfc: folds
bd544f4f: folds
5e4e7f5d: raises $0.15 to $0.25
cfde2efb: folds
Hero: calls $0.15
*** FLOP *** [9s 8s Qs]
Hero: checks
5e4e7f5d: bets $0.14
Hero: calls $0.14
*** TURN *** [9s 8s Qs] [3c]
Hero: checks
5e4e7f5d: checks
*** RIVER *** [9s 8s Qs 3c] [As]
Hero: checks
5e4e7f5d: bets $1.03
Hero: folds
Uncalled bet ($1.03) returned to 5e4e7f5d
*** SHOWDOWN ***
5e4e7f5d collected $0.79 from pot
*** SUMMARY ***
Total pot $0.83 | Rake $0.04 | Jackpot $0 | Bingo $0 | Fortune $0 | Tax $0
Board [9s 8s Qs 3c As]
Seat 1: ad17dbfc folded before Flop (didn't bet)
Seat 2: bd544f4f folded before Flop (didn't bet)
Seat 4: 5e4e7f5d (button) won ($0.79)
Seat 5: cfde2efb (small blind) folded before Flop
Seat 6: Hero (big blind) folded on the River


Poker Hand #HD1806669562: Hold'em No Limit ($0.05/$0.1) - 2024/06/08 15:25:52
Table 'NLHRed11' 6-max Seat #2 is the button
Seat 1: ad17dbfc ($11.51 in chips)
Seat 2: bd544f4f ($14.36 in chips)
Seat 4: 5e4e7f5d ($11.92 in chips)
Seat 5: cfde2efb ($19.11 in chips)
Seat 6: Hero ($10.15 in chips)
5e4e7f5d: posts small blind $0.05
cfde2efb: posts big blind $0.1
*** HOLE CARDS ***
Dealt to ad17dbfc 
Dealt to bd544f4f 
Dealt to 5e4e7f5d 
Dealt to cfde2efb 
Dealt to Hero [6h Tc]
Hero: folds
ad17dbfc: folds
bd544f4f: folds
5e4e7f5d: calls $0.05
cfde2efb: checks
*** FLOP *** [8c 5c Kh]
5e4e7f5d: checks
cfde2efb: checks
*** TURN *** [8c 5c Kh] [Ks]
5e4e7f5d: checks
cfde2efb: checks
*** RIVER *** [8c 5c Kh Ks] [4c]
5e4e7f5d: checks
cfde2efb: bets $0.15
5e4e7f5d: folds
Uncalled bet ($0.15) returned to cfde2efb
*** SHOWDOWN ***
cfde2efb collected $0.19 from pot
*** SUMMARY ***
Total pot $0.2 | Rake $0.01 | Jackpot $0 | Bingo $0 | Fortune $0 | Tax $0
Board [8c 5c Kh Ks 4c]
Seat 1: ad17dbfc folded before Flop (didn't bet)
Seat 2: bd544f4f (button) folded before Flop (didn't bet)
Seat 4: 5e4e7f5d (small blind) folded on the River
Seat 5: cfde2efb (big blind) won ($0.19)
Seat 6: Hero folded before Flop (didn't bet)


Poker Hand #HD1806669390: Hold'em No Limit ($0.05/$0.1) - 2024/06/08 15:24:18
Table 'NLHRed11' 6-max Seat #1 is the button
Seat 1: ad17dbfc ($12.65 in chips)
Seat 2: bd544f4f ($14.41 in chips)
Seat 4: 5e4e7f5d ($10.84 in chips)
Seat 5: cfde2efb ($19.11 in chips)
Seat 6: Hero ($10.15 in chips)
bd544f4f: posts small blind $0.05
5e4e7f5d: posts big blind $0.1
*** HOLE CARDS ***
Dealt to ad17dbfc 
Dealt to bd544f4f 
Dealt to 5e4e7f5d 
Dealt to cfde2efb 
Dealt to Hero [Qh 5d]
cfde2efb: folds
Hero: folds
ad17dbfc: calls $0.1
bd544f4f: folds
5e4e7f5d: checks
*** FLOP *** [7d Td 9s]
5e4e7f5d: checks
ad17dbfc: checks
*** TURN *** [7d Td 9s] [6s]
5e4e7f5d: checks
ad17dbfc: bets $0.13
5e4e7f5d: raises $0.91 to $1.04
ad17dbfc: calls $0.91
*** RIVER *** [7d Td 9s 6s] [2h]
5e4e7f5d: bets $3.73
ad17dbfc: folds
Uncalled bet ($3.73) returned to 5e4e7f5d
ad17dbfc: shows [Th] (Pair of Tens)
*** SHOWDOWN ***
5e4e7f5d collected $2.22 from pot
*** SUMMARY ***
Total pot $2.33 | Rake $0.11 | Jackpot $0 | Bingo $0 | Fortune $0 | Tax $0
Board [7d Td 9s 6s 2h]
Seat 1: ad17dbfc (button) folded on the River
Seat 2: bd544f4f (small blind) folded before Flop
Seat 4: 5e4e7f5d (big blind) won ($2.22)
Seat 5: cfde2efb folded before Flop (didn't bet)
Seat 6: Hero folded before Flop (didn't bet)


Poker Hand #HD1806669367: Hold'em No Limit ($0.05/$0.1) - 2024/06/08 15:24:06
Table 'NLHRed11' 6-max Seat #6 is the button
Seat 1: ad17dbfc ($12.7 in chips)
Seat 2: bd544f4f ($14.51 in chips)
Seat 3: 62d6f0b ($14.63 in chips)
Seat 4: 5e4e7f5d ($10.84 in chips)
Seat 5: cfde2efb ($19.11 in chips)
Seat 6: Hero ($10 in chips)
ad17dbfc: posts small blind $0.05
bd544f4f: posts big blind $0.1
*** HOLE CARDS ***
Dealt to ad17dbfc 
Dealt to bd544f4f 
Dealt to 62d6f0b 
Dealt to 5e4e7f5d 
Dealt to cfde2efb 
Dealt to Hero [Ts Td]
62d6f0b: folds
5e4e7f5d: folds
cfde2efb: folds
Hero: raises $0.14 to $0.24
ad17dbfc: folds
bd544f4f: folds
Uncalled bet ($0.14) returned to Hero
*** SHOWDOWN ***
Hero collected $0.25 from pot
*** SUMMARY ***
Total pot $0.25 | Rake $0 | Jackpot $0 | Bingo $0 | Fortune $0 | Tax $0
Seat 1: ad17dbfc (small blind) folded before Flop
Seat 2: bd544f4f (big blind) folded before Flop
Seat 3: 62d6f0b folded before Flop (didn't bet)
Seat 4: 5e4e7f5d folded before Flop (didn't bet)
Seat 5: cfde2efb folded before Flop (didn't bet)
Seat 6: Hero (button) collected ($0.25)


Poker Hand #HD1806669334: Hold'em No Limit ($0.05/$0.1) - 2024/06/08 15:23:49
Table 'NLHRed11' 6-max Seat #5 is the button
Seat 1: ad17dbfc ($12.8 in chips)
Seat 2: bd544f4f ($14.51 in chips)
Seat 3: 62d6f0b ($14.63 in chips)
Seat 4: 5e4e7f5d ($10.69 in chips)
Seat 5: cfde2efb ($19.11 in chips)
Seat 6: Hero ($10 in chips)
Hero: posts small blind $0.05
ad17dbfc: posts big blind $0.1
*** HOLE CARDS ***
Dealt to ad17dbfc 
Dealt to bd544f4f 
Dealt to 62d6f0b 
Dealt to 5e4e7f5d 
Dealt to cfde2efb 
Dealt to Hero [8h 4s]
bd544f4f: folds
62d6f0b: folds
5e4e7f5d: raises $0.15 to $0.25
cfde2efb: folds
Hero: folds
ad17dbfc: folds
Uncalled bet ($0.15) returned to 5e4e7f5d
*** SHOWDOWN ***
5e4e7f5d collected $0.25 from pot
*** SUMMARY ***
Total pot $0.25 | Rake $0 | Jackpot $0 | Bingo $0 | Fortune $0 | Tax $0
Seat 1: ad17dbfc (big blind) folded before Flop
Seat 2: bd544f4f folded before Flop (didn't bet)
Seat 3: 62d6f0b folded before Flop (didn't bet)
Seat 4: 5e4e7f5d collected ($0.25)
Seat 5: cfde2efb (button) folded before Flop (didn't bet)
Seat 6: Hero (small blind) folded before Flop


Poker Hand #HD1806669270: Hold'em No Limit ($0.05/$0.1) - 2024/06/08 15:23:17
Table 'NLHRed11' 6-max Seat #4 is the button
Seat 1: ad17dbfc ($12.8 in chips)
Seat 2: bd544f4f ($14.36 in chips)
Seat 3: 62d6f0b ($14.63 in chips)
Seat 4: 5e4e7f5d ($10.69 in chips)
Seat 5: cfde2efb ($19.16 in chips)
Seat 6: Hero ($10 in chips)
cfde2efb: posts small blind $0.05
Hero: posts big blind $0.1
*** HOLE CARDS ***
Dealt to ad17dbfc 
Dealt to bd544f4f 
Dealt to 62d6f0b 
Dealt to 5e4e7f5d 
Dealt to cfde2efb 
Dealt to Hero [7s Ah]
ad17dbfc: folds
bd544f4f: raises $0.15 to $0.25
62d6f0b: folds
5e4e7f5d: folds
cfde2efb: folds
Hero: folds
Uncalled bet ($0.15) returned to bd544f4f
*** SHOWDOWN ***
bd544f4f collected $0.25 from pot
*** SUMMARY ***
Total pot $0.25 | Rake $0 | Jackpot $0 | Bingo $0 | Fortune $0 | Tax $0
Seat 1: ad17dbfc folded before Flop (didn't bet)
Seat 2: bd544f4f collected ($0.25)
Seat 3: 62d6f0b folded before Flop (didn't bet)
Seat 4: 5e4e7f5d (button) folded before Flop (didn't bet)
Seat 5: cfde2efb (small blind) folded before Flop
Seat 6: Hero (big blind) folded before Flop


Poker Hand #HD1806669143: Hold'em No Limit ($0.05/$0.1) - 2024/06/08 15:22:08
Table 'NLHRed11' 6-max Seat #3 is the button
Seat 1: ad17dbfc ($12.8 in chips)
Seat 2: bd544f4f ($14.36 in chips)
Seat 3: 62d6f0b ($14.63 in chips)
Seat 4: 5e4e7f5d ($10.05 in chips)
Seat 5: cfde2efb ($19.66 in chips)
Seat 6: Hero ($10 in chips)
5e4e7f5d: posts small blind $0.05
cfde2efb: posts big blind $0.1
*** HOLE CARDS ***
Dealt to ad17dbfc 
Dealt to bd544f4f 
Dealt to 62d6f0b 
Dealt to 5e4e7f5d 
Dealt to cfde2efb 
Dealt to Hero [7s 7d]
Hero: raises $0.1 to $0.2
ad17dbfc: folds
bd544f4f: folds
62d6f0b: folds
5e4e7f5d: calls $0.15
cfde2efb: calls $0.1
*** FLOP *** [Tc 6c Ks]
5e4e7f5d: checks
cfde2efb: checks
Hero: checks
*** TURN *** [Tc 6c Ks] [2d]
5e4e7f5d: checks
cfde2efb: checks
Hero: checks
*** RIVER *** [Tc 6c Ks 2d] [3d]
5e4e7f5d: checks
cfde2efb: bets $0.3
Hero: folds
5e4e7f5d: calls $0.3
cfde2efb: shows [9s 8s] (King-High)
5e4e7f5d: shows [3c Qc] (Pair of Treys)
*** SHOWDOWN ***
5e4e7f5d collected $1.14 from pot
*** SUMMARY ***
Total pot $1.2 | Rake $0.06 | Jackpot $0 | Bingo $0 | Fortune $0 | Tax $0
Board [Tc 6c Ks 2d 3d]
Seat 1: ad17dbfc folded before Flop (didn't bet)
Seat 2: bd544f4f folded before Flop (didn't bet)
Seat 3: 62d6f0b (button) folded before Flop (didn't bet)
Seat 4: 5e4e7f5d (small blind) showed [3c Qc] and won ($1.14) with Pair of Treys
Seat 5: cfde2efb (big blind) showed [9s 8s] and lost with King-High
Seat 6: Hero folded on the River


Poker Hand #HD1806669127: Hold'em No Limit ($0.05/$0.1) - 2024/06/08 15:22:00
Table 'NLHRed11' 6-max Seat #2 is the button
Seat 1: ad17dbfc ($12.8 in chips)
Seat 2: bd544f4f ($14.36 in chips)
Seat 3: 62d6f0b ($14.68 in chips)
Seat 4: 5e4e7f5d ($10 in chips)
Seat 5: cfde2efb ($19.66 in chips)
Seat 6: Hero ($10 in chips)
62d6f0b: posts small blind $0.05
5e4e7f5d: posts big blind $0.1
*** HOLE CARDS ***
Dealt to ad17dbfc 
Dealt to bd544f4f 
Dealt to 62d6f0b 
Dealt to 5e4e7f5d 
Dealt to cfde2efb 
Dealt to Hero [8c 2d]
cfde2efb: folds
Hero: folds
ad17dbfc: folds
bd544f4f: folds
62d6f0b: folds
Uncalled bet ($0.05) returned to 5e4e7f5d
*** SHOWDOWN ***
5e4e7f5d collected $0.1 from pot
*** SUMMARY ***
Total pot $0.1 | Rake $0 | Jackpot $0 | Bingo $0 | Fortune $0 | Tax $0
Seat 1: ad17dbfc folded before Flop (didn't bet)
Seat 2: bd544f4f (button) folded before Flop (didn't bet)
Seat 3: 62d6f0b (small blind) folded before Flop
Seat 4: 5e4e7f5d (big blind) collected ($0.1)
Seat 5: cfde2efb folded before Flop (didn't bet)
Seat 6: Hero folded before Flop (didn't bet)


Poker Hand #HD1806669077: Hold'em No Limit ($0.05/$0.1) - 2024/06/08 15:21:36
Table 'NLHRed11' 6-max Seat #1 is the button
Seat 1: ad17dbfc ($12.8 in chips)
Seat 2: bd544f4f ($14.41 in chips)
Seat 3: 62d6f0b ($14.78 in chips)
Seat 4: 5e4e7f5d ($10 in chips)
Seat 5: cfde2efb ($19.51 in chips)
Seat 6: Hero ($10 in chips)
bd544f4f: posts small blind $0.05
62d6f0b: posts big blind $0.1
*** HOLE CARDS ***
Dealt to ad17dbfc 
Dealt to bd544f4f 
Dealt to 62d6f0b 
Dealt to 5e4e7f5d 
Dealt to cfde2efb 
Dealt to Hero [2s Ts]
5e4e7f5d: folds
cfde2efb: raises $0.15 to $0.25
Hero: folds
ad17dbfc: folds
bd544f4f: folds
62d6f0b: folds
Uncalled bet ($0.15) returned to cfde2efb
*** SHOWDOWN ***
cfde2efb collected $0.25 from pot
*** SUMMARY ***
Total pot $0.25 | Rake $0 | Jackpot $0 | Bingo $0 | Fortune $0 | Tax $0
Seat 1: ad17dbfc (button) folded before Flop (didn't bet)
Seat 2: bd544f4f (small blind) folded before Flop
Seat 3: 62d6f0b (big blind) folded before Flop
Seat 4: 5e4e7f5d folded before Flop (didn't bet)
Seat 5: cfde2efb collected ($0.25)
Seat 6: Hero folded before Flop (didn't bet)


Poker Hand #HD1806669034: Hold'em No Limit ($0.05/$0.1) - 2024/06/08 15:21:12
Table 'NLHRed11' 6-max Seat #6 is the button
Seat 1: ad17dbfc ($12.85 in chips)
Seat 2: bd544f4f ($14.36 in chips)
Seat 3: 62d6f0b ($14.78 in chips)
Seat 4: 5e4e7f5d ($10 in chips)
Seat 5: cfde2efb ($19.51 in chips)
Seat 6: Hero ($10 in chips)
ad17dbfc: posts small blind $0.05
bd544f4f: posts big blind $0.1
*** HOLE CARDS ***
Dealt to ad17dbfc 
Dealt to bd544f4f 
Dealt to 62d6f0b 
Dealt to 5e4e7f5d 
Dealt to cfde2efb 
Dealt to Hero [8h 4h]
62d6f0b: folds
5e4e7f5d: folds
cfde2efb: folds
Hero: folds
ad17dbfc: folds
Uncalled bet ($0.05) returned to bd544f4f
*** SHOWDOWN ***
bd544f4f collected $0.1 from pot
*** SUMMARY ***
Total pot $0.1 | Rake $0 | Jackpot $0 | Bingo $0 | Fortune $0 | Tax $0
Seat 1: ad17dbfc (small blind) folded before Flop
Seat 2: bd544f4f (big blind) collected ($0.1)
Seat 3: 62d6f0b folded before Flop (didn't bet)
Seat 4: 5e4e7f5d folded before Flop (didn't bet)
Seat 5: cfde2efb folded before Flop (didn't bet)
Seat 6: Hero (button) folded before Flop (didn't bet)


Poker Hand #HD1806669005: Hold'em No Limit ($0.05/$0.1) - 2024/06/08 15:20:59
Table 'NLHRed11' 6-max Seat #5 is the button
Seat 1: ad17dbfc ($12.95 in chips)
Seat 2: bd544f4f ($14.36 in chips)
Seat 3: 62d6f0b ($14.63 in chips)
Seat 4: 5e4e7f5d ($10 in chips)
Seat 5: cfde2efb ($19.51 in chips)
Seat 6: Hero ($10 in chips)
Hero: posts small blind $0.05
ad17dbfc: posts big blind $0.1
*** HOLE CARDS ***
Dealt to ad17dbfc 
Dealt to bd544f4f 
Dealt to 62d6f0b 
Dealt to 5e4e7f5d 
Dealt to cfde2efb 
Dealt to Hero [Jd 2c]
bd544f4f: folds
62d6f0b: raises $0.2 to $0.3
5e4e7f5d: folds
cfde2efb: folds
Hero: folds
ad17dbfc: folds
Uncalled bet ($0.2) returned to 62d6f0b
*** SHOWDOWN ***
62d6f0b collected $0.25 from pot
*** SUMMARY ***
Total pot $0.25 | Rake $0 | Jackpot $0 | Bingo $0 | Fortune $0 | Tax $0
Seat 1: ad17dbfc (big blind) folded before Flop
Seat 2: bd544f4f folded before Flop (didn't bet)
Seat 3: 62d6f0b collected ($0.25)
Seat 4: 5e4e7f5d folded before Flop (didn't bet)
Seat 5: cfde2efb (button) folded before Flop (didn't bet)
Seat 6: Hero (small blind) folded before Flop


Poker Hand #HD1806668876: Hold'em No Limit ($0.05/$0.1) - 2024/06/08 15:19:48
Table 'NLHRed11' 6-max Seat #4 is the button
Seat 1: ad17dbfc ($12.95 in chips)
Seat 2: bd544f4f ($14.36 in chips)
Seat 3: 62d6f0b ($14.63 in chips)
Seat 4: 5e4e7f5d ($10 in chips)
Seat 5: cfde2efb ($17.98 in chips)
Seat 6: Hero ($10 in chips)
cfde2efb: posts small blind $0.05
Hero: posts big blind $0.1
*** HOLE CARDS ***
Dealt to ad17dbfc 
Dealt to bd544f4f 
Dealt to 62d6f0b 
Dealt to 5e4e7f5d 
Dealt to cfde2efb 
Dealt to Hero [2c 6s]
ad17dbfc: folds
bd544f4f: folds
62d6f0b: folds
5e4e7f5d: raises $0.15 to $0.25
cfde2efb: raises $0.75 to $1
Hero: folds
5e4e7f5d: calls $0.75
*** FLOP *** [8s 8d 4c]
cfde2efb: bets $0.7
5e4e7f5d: calls $0.7
*** TURN *** [8s 8d 4c] [4s]
cfde2efb: bets $2.3
5e4e7f5d: folds
Uncalled bet ($2.3) returned to cfde2efb
*** SHOWDOWN ***
cfde2efb collected $3.23 from pot
*** SUMMARY ***
Total pot $3.5 | Rake $0.17 | Jackpot $0.1 | Bingo $0 | Fortune $0 | Tax $0
Board [8s 8d 4c 4s]
Seat 1: ad17dbfc folded before Flop (didn't bet)
Seat 2: bd544f4f folded before Flop (didn't bet)
Seat 3: 62d6f0b folded before Flop (didn't bet)
Seat 4: 5e4e7f5d (button) folded on the Turn
Seat 5: cfde2efb (small blind) won ($3.23)
Seat 6: Hero (big blind) folded before Flop


Poker Hand #HD1806668766: Hold'em No Limit ($0.05/$0.1) - 2024/06/08 15:18:50
Table 'NLHRed11' 6-max Seat #3 is the button
Seat 1: ad17dbfc ($12.95 in chips)
Seat 2: bd544f4f ($14.36 in chips)
Seat 3: 62d6f0b ($14.63 in chips)
Seat 4: 5e4e7f5d ($10 in chips)
Seat 5: cfde2efb ($17.71 in chips)
Seat 6: Hero ($10 in chips)
5e4e7f5d: posts small blind $0.05
cfde2efb: posts big blind $0.1
*** HOLE CARDS ***
Dealt to ad17dbfc 
Dealt to bd544f4f 
Dealt to 62d6f0b 
Dealt to 5e4e7f5d 
Dealt to cfde2efb 
Dealt to Hero [Qd 2c]
Hero: folds
ad17dbfc: folds
bd544f4f: folds
62d6f0b: folds
5e4e7f5d: raises $0.2 to $0.3
cfde2efb: calls $0.2
*** FLOP *** [7h Qh 9h]
5e4e7f5d: checks
cfde2efb: checks
*** TURN *** [7h Qh 9h] [4c]
5e4e7f5d: checks
cfde2efb: checks
*** RIVER *** [7h Qh 9h 4c] [9s]
5e4e7f5d: checks
cfde2efb: bets $0.2
5e4e7f5d: folds
Uncalled bet ($0.2) returned to cfde2efb
*** SHOWDOWN ***
cfde2efb collected $0.57 from pot
*** SUMMARY ***
Total pot $0.6 | Rake $0.03 | Jackpot $0 | Bingo $0 | Fortune $0 | Tax $0
Board [7h Qh 9h 4c 9s]
Seat 1: ad17dbfc folded before Flop (didn't bet)
Seat 2: bd544f4f folded before Flop (didn't bet)
Seat 3: 62d6f0b (button) folded before Flop (didn't bet)
Seat 4: 5e4e7f5d (small blind) folded on the River
Seat 5: cfde2efb (big blind) won ($0.57)
Seat 6: Hero folded before Flop (didn't bet)


Poker Hand #HD1806668647: Hold'em No Limit ($0.05/$0.1) - 2024/06/08 15:17:47
Table 'NLHRed11' 6-max Seat #2 is the button
Seat 1: ad17dbfc ($11.99 in chips)
Seat 2: bd544f4f ($14.36 in chips)
Seat 3: 62d6f0b ($14.93 in chips)
Seat 4: 5e4e7f5d ($10 in chips)
Seat 5: cfde2efb ($17.71 in chips)
Seat 6: Hero ($10 in chips)
62d6f0b: posts small blind $0.05
5e4e7f5d: posts big blind $0.1
*** HOLE CARDS ***
Dealt to ad17dbfc 
Dealt to bd544f4f 
Dealt to 62d6f0b 
Dealt to 5e4e7f5d 
Dealt to cfde2efb 
Dealt to Hero [3c Qc]
cfde2efb: folds
Hero: folds
ad17dbfc: raises $0.2 to $0.3
bd544f4f: folds
62d6f0b: calls $0.25
5e4e7f5d: calls $0.2
*** FLOP *** [8s 4h Kc]
62d6f0b: checks
5e4e7f5d: checks
ad17dbfc: checks
*** TURN *** [8s 4h Kc] [Ks]
62d6f0b: checks
5e4e7f5d: checks
ad17dbfc: checks
*** RIVER *** [8s 4h Kc Ks] [4c]
62d6f0b: checks
5e4e7f5d: bets $0.45
ad17dbfc: calls $0.45
62d6f0b: folds
5e4e7f5d: shows [3s Qs] (Pair of Kings and Pair of Fours)
ad17dbfc: shows [As Jd] (Pair of Kings and Pair of Fours)
*** SHOWDOWN ***
ad17dbfc collected $1.71 from pot
*** SUMMARY ***
Total pot $1.8 | Rake $0.09 | Jackpot $0 | Bingo $0 | Fortune $0 | Tax $0
Board [8s 4h Kc Ks 4c]
Seat 1: ad17dbfc showed [As Jd] and won ($1.71) with Pair of Kings and Pair of Fours
Seat 2: bd544f4f (button) folded before Flop (didn't bet)
Seat 3: 62d6f0b (small blind) folded on the River
Seat 4: 5e4e7f5d (big blind) showed [3s Qs] and lost with Pair of Kings and Pair of Fours
Seat 5: cfde2efb folded before Flop (didn't bet)
Seat 6: Hero folded before Flop (didn't bet)


Poker Hand #HD1806668544: Hold'em No Limit ($0.05/$0.1) - 2024/06/08 15:16:48
Table 'NLHRed11' 6-max Seat #1 is the button
Seat 1: ad17dbfc ($10.57 in chips)
Seat 2: bd544f4f ($14.41 in chips)
Seat 3: 62d6f0b ($15.03 in chips)
Seat 4: 5e4e7f5d ($10 in chips)
Seat 5: cfde2efb ($18.86 in chips)
Seat 6: Hero ($10 in chips)
bd544f4f: posts small blind $0.05
62d6f0b: posts big blind $0.1
*** HOLE CARDS ***
Dealt to ad17dbfc 
Dealt to bd544f4f 
Dealt to 62d6f0b 
Dealt to 5e4e7f5d 
Dealt to cfde2efb 
Dealt to Hero [7h 3h]
5e4e7f5d: raises $0.15 to $0.25
cfde2efb: calls $0.25
Hero: folds
ad17dbfc: raises $0.9 to $1.15
bd544f4f: folds
62d6f0b: folds
5e4e7f5d: folds
cfde2efb: calls $0.9
*** FLOP *** [Jh 6h Kc]
cfde2efb: checks
ad17dbfc: bets $9.42 and is all-in
cfde2efb: folds
Uncalled bet ($9.42) returned to ad17dbfc
*** SHOWDOWN ***
ad17dbfc collected $2.57 from pot
*** SUMMARY ***
Total pot $2.7 | Rake $0.13 | Jackpot $0 | Bingo $0 | Fortune $0 | Tax $0
Board [Jh 6h Kc]
Seat 1: ad17dbfc (button) won ($2.57)
Seat 2: bd544f4f (small blind) folded before Flop
Seat 3: 62d6f0b (big blind) folded before Flop
Seat 4: 5e4e7f5d folded before Flop
Seat 5: cfde2efb folded on the Flop
Seat 6: Hero folded before Flop (didn't bet)


Poker Hand #HD1806668517: Hold'em No Limit ($0.05/$0.1) - 2024/06/08 15:16:36
Table 'NLHRed11' 6-max Seat #6 is the button
Seat 1: ad17dbfc ($10.62 in chips)
Seat 2: bd544f4f ($14.36 in chips)
Seat 3: 62d6f0b ($15.03 in chips)
Seat 4: 5e4e7f5d ($10 in chips)
Seat 5: cfde2efb ($18.86 in chips)
Seat 6: Hero ($10 in chips)
ad17dbfc: posts small blind $0.05
bd544f4f: posts big blind $0.1
*** HOLE CARDS ***
Dealt to ad17dbfc 
Dealt to bd544f4f 
Dealt to 62d6f0b 
Dealt to 5e4e7f5d 
Dealt to cfde2efb 
Dealt to Hero [Kh 5d]
62d6f0b: folds
5e4e7f5d: folds
cfde2efb: folds
Hero: folds
ad17dbfc: folds
Uncalled bet ($0.05) returned to bd544f4f
*** SHOWDOWN ***
bd544f4f collected $0.1 from pot
*** SUMMARY ***
Total pot $0.1 | Rake $0 | Jackpot $0 | Bingo $0 | Fortune $0 | Tax $0
Seat 1: ad17dbfc (small blind) folded before Flop
Seat 2: bd544f4f (big blind) collected ($0.1)
Seat 3: 62d6f0b folded before Flop (didn't bet)
Seat 4: 5e4e7f5d folded before Flop (didn't bet)
Seat 5: cfde2efb folded before Flop (didn't bet)
Seat 6: Hero (button) folded before Flop (didn't bet)


Poker Hand #HD1806668498: Hold'em No Limit ($0.05/$0.1) - 2024/06/08 15:16:26
Table 'NLHRed11' 6-max Seat #5 is the button
Seat 1: ad17dbfc ($10.57 in chips)
Seat 2: bd544f4f ($14.36 in chips)
Seat 3: 62d6f0b ($15.03 in chips)
Seat 4: 5e4e7f5d ($10 in chips)
Seat 5: cfde2efb ($18.86 in chips)
Seat 6: Hero ($10 in chips)
Hero: posts small blind $0.05
ad17dbfc: posts big blind $0.1
*** HOLE CARDS ***
Dealt to ad17dbfc 
Dealt to bd544f4f 
Dealt to 62d6f0b 
Dealt to 5e4e7f5d 
Dealt to cfde2efb 
Dealt to Hero [7c 4h]
bd544f4f: folds
62d6f0b: folds
5e4e7f5d: folds
cfde2efb: folds
Hero: folds
Uncalled bet ($0.05) returned to ad17dbfc
*** SHOWDOWN ***
ad17dbfc collected $0.1 from pot
*** SUMMARY ***
Total pot $0.1 | Rake $0 | Jackpot $0 | Bingo $0 | Fortune $0 | Tax $0
Seat 1: ad17dbfc (big blind) collected ($0.1)
Seat 2: bd544f4f folded before Flop (didn't bet)
Seat 3: 62d6f0b folded before Flop (didn't bet)
Seat 4: 5e4e7f5d folded before Flop (didn't bet)
Seat 5: cfde2efb (button) folded before Flop (didn't bet)
Seat 6: Hero (small blind) folded before Flop


Poker Hand #HD1806668426: Hold'em No Limit ($0.05/$0.1) - 2024/06/08 15:15:53
Table 'NLHRed11' 6-max Seat #4 is the button
Seat 1: ad17dbfc ($10.97 in chips)
Seat 2: bd544f4f ($14.36 in chips)
Seat 3: 62d6f0b ($14.52 in chips)
Seat 4: 5e4e7f5d ($10 in chips)
Seat 5: cfde2efb ($18.91 in chips)
Seat 6: Hero ($10 in chips)
cfde2efb: posts small blind $0.05
Hero: posts big blind $0.1
*** HOLE CARDS ***
Dealt to ad17dbfc 
Dealt to bd544f4f 
Dealt to 62d6f0b 
Dealt to 5e4e7f5d 
Dealt to cfde2efb 
Dealt to Hero [2h Kh]
ad17dbfc: calls $0.1
bd544f4f: folds
62d6f0b: raises $0.3 to $0.4
5e4e7f5d: folds
cfde2efb: folds
Hero: folds
ad17dbfc: calls $0.3
*** FLOP *** [6h Jh 9s]
ad17dbfc: checks
62d6f0b: bets $0.5
ad17dbfc: folds
Uncalled bet ($0.5) returned to 62d6f0b
*** SHOWDOWN ***
62d6f0b collected $0.91 from pot
*** SUMMARY ***
Total pot $0.95 | Rake $0.04 | Jackpot $0 | Bingo $0 | Fortune $0 | Tax $0
Board [6h Jh 9s]
Seat 1: ad17dbfc folded on the Flop
Seat 2: bd544f4f folded before Flop (didn't bet)
Seat 3: 62d6f0b won ($0.91)
Seat 4: 5e4e7f5d (button) folded before Flop (didn't bet)
Seat 5: cfde2efb (small blind) folded before Flop
Seat 6: Hero (big blind) folded before Flop


