Poker Hand #RC2709884436: Hold'em No Limit ($0.05/$0.1) - 2024/07/13 16:14:35
Table 'RushAndCash8569696' 6-max Seat #1 is the button
Seat 1: Hero ($10 in chips)
Seat 2: 1a77f0a9 ($15.77 in chips)
Seat 3: 5f5a92f6 ($10.99 in chips)
Seat 4: 6641ba33 ($10.82 in chips)
Seat 5: c35214bd ($23.07 in chips)
Seat 6: 45558a98 ($4.46 in chips)
1a77f0a9: posts small blind $0.05
5f5a92f6: posts big blind $0.1
*** HOLE CARDS ***
Dealt to Hero [9s Ks]
Dealt to 1a77f0a9 
Dealt to 5f5a92f6 
Dealt to 6641ba33 
Dealt to c35214bd 
Dealt to 45558a98 
6641ba33: folds
c35214bd: folds
45558a98: folds
Hero: raises $0.14 to $0.24
1a77f0a9: folds
5f5a92f6: calls $0.14
*** FLOP *** [3d Qd 6c]
5f5a92f6: checks
Hero: checks
*** TURN *** [3d Qd 6c] [7c]
5f5a92f6: bets $0.35
Hero: folds
Uncalled bet ($0.35) returned to 5f5a92f6
*** SHOWDOWN ***
5f5a92f6 collected $0.51 from pot
*** SUMMARY ***
Total pot $0.53 | Rake $0.02 | Jackpot $0 | Bingo $0 | Fortune $0 | Tax $0
Board [3d Qd 6c 7c]
Seat 1: Hero (button) folded on the Turn
Seat 2: 1a77f0a9 (small blind) folded before Flop
Seat 3: 5f5a92f6 (big blind) won ($0.51)
Seat 4: 6641ba33 folded before Flop (didn't bet)
Seat 5: c35214bd folded before Flop (didn't bet)
Seat 6: 45558a98 folded before Flop (didn't bet)


Poker Hand #RC2709884414: Hold'em No Limit ($0.05/$0.1) - 2024/07/13 16:14:32
Table 'RushAndCash8569674' 6-max Seat #1 is the button
Seat 1: 61613b5e ($13.28 in chips)
Seat 2: 8f496a21 ($12.87 in chips)
Seat 3: e7bed158 ($24.43 in chips)
Seat 4: 5bc4c7ed ($6.38 in chips)
Seat 5: eeef255e ($5.38 in chips)
Seat 6: Hero ($10 in chips)
8f496a21: posts small blind $0.05
e7bed158: posts big blind $0.1
*** HOLE CARDS ***
Dealt to 61613b5e 
Dealt to 8f496a21 
Dealt to e7bed158 
Dealt to 5bc4c7ed 
Dealt to eeef255e 
Dealt to Hero [6h 8s]
5bc4c7ed: raises $0.1 to $0.2
eeef255e: folds
Hero: folds
61613b5e: calls $0.2
8f496a21: folds
e7bed158: folds
*** FLOP *** [6c 9c 5h]
5bc4c7ed: checks
61613b5e: checks
*** TURN *** [6c 9c 5h] [Ts]
5bc4c7ed: bets $0.28
61613b5e: calls $0.28
*** RIVER *** [6c 9c 5h Ts] [Kc]
5bc4c7ed: checks
61613b5e: bets $0.84
5bc4c7ed: folds
Uncalled bet ($0.84) returned to 61613b5e
*** SHOWDOWN ***
61613b5e collected $1.06 from pot
*** SUMMARY ***
Total pot $1.11 | Rake $0.05 | Jackpot $0 | Bingo $0 | Fortune $0 | Tax $0
Board [6c 9c 5h Ts Kc]
Seat 1: 61613b5e (button) won ($1.06)
Seat 2: 8f496a21 (small blind) folded before Flop
Seat 3: e7bed158 (big blind) folded before Flop
Seat 4: 5bc4c7ed folded on the River
Seat 5: eeef255e folded before Flop (didn't bet)
Seat 6: Hero folded before Flop (didn't bet)


Poker Hand #RC2709884386: Hold'em No Limit ($0.05/$0.1) - 2024/07/13 16:14:29
Table 'RushAndCash8569646' 6-max Seat #1 is the button
Seat 1: f63f2fdc ($18.25 in chips)
Seat 2: 62a8aa44 ($12.37 in chips)
Seat 3: 9ba7fa65 ($21.87 in chips)
Seat 4: 8802b459 ($20.67 in chips)
Seat 5: Hero ($10 in chips)
Seat 6: 7b481363 ($9.37 in chips)
62a8aa44: posts small blind $0.05
9ba7fa65: posts big blind $0.1
*** HOLE CARDS ***
Dealt to f63f2fdc 
Dealt to 62a8aa44 
Dealt to 9ba7fa65 
Dealt to 8802b459 
Dealt to Hero [6c 7c]
Dealt to 7b481363 
8802b459: folds
Hero: folds
7b481363: folds
f63f2fdc: raises $0.15 to $0.25
62a8aa44: folds
9ba7fa65: folds
Uncalled bet ($0.15) returned to f63f2fdc
*** SHOWDOWN ***
f63f2fdc collected $0.25 from pot
*** SUMMARY ***
Total pot $0.25 | Rake $0 | Jackpot $0 | Bingo $0 | Fortune $0 | Tax $0
Seat 1: f63f2fdc (button) collected ($0.25)
Seat 2: 62a8aa44 (small blind) folded before Flop
Seat 3: 9ba7fa65 (big blind) folded before Flop
Seat 4: 8802b459 folded before Flop (didn't bet)
Seat 5: Hero folded before Flop (didn't bet)
Seat 6: 7b481363 folded before Flop (didn't bet)


Poker Hand #RC2709884363: Hold'em No Limit ($0.05/$0.1) - 2024/07/13 16:14:25
Table 'RushAndCash8569623' 6-max Seat #1 is the button
Seat 1: Hero ($10 in chips)
Seat 2: a99198e7 ($13.54 in chips)
Seat 3: 5d8cd1ee ($7.26 in chips)
Seat 4: a08d2995 ($10.9 in chips)
Seat 5: eb25af25 ($11.31 in chips)
Seat 6: 3d6d6858 ($10.15 in chips)
a99198e7: posts small blind $0.05
5d8cd1ee: posts big blind $0.1
*** HOLE CARDS ***
Dealt to Hero [9s 8d]
Dealt to a99198e7 
Dealt to 5d8cd1ee 
Dealt to a08d2995 
Dealt to eb25af25 
Dealt to 3d6d6858 
a08d2995: folds
eb25af25: folds
3d6d6858: raises $0.15 to $0.25
Hero: folds
a99198e7: folds
5d8cd1ee: folds
Uncalled bet ($0.15) returned to 3d6d6858
*** SHOWDOWN ***
3d6d6858 collected $0.25 from pot
*** SUMMARY ***
Total pot $0.25 | Rake $0 | Jackpot $0 | Bingo $0 | Fortune $0 | Tax $0
Seat 1: Hero (button) folded before Flop (didn't bet)
Seat 2: a99198e7 (small blind) folded before Flop
Seat 3: 5d8cd1ee (big blind) folded before Flop
Seat 4: a08d2995 folded before Flop (didn't bet)
Seat 5: eb25af25 folded before Flop (didn't bet)
Seat 6: 3d6d6858 collected ($0.25)


Poker Hand #RC2709884324: Hold'em No Limit ($0.05/$0.1) - 2024/07/13 16:14:21
Table 'RushAndCash8569584' 6-max Seat #1 is the button
Seat 1: fba1fbfe ($10.22 in chips)
Seat 2: Hero ($10 in chips)
Seat 3: c4e1ec91 ($10 in chips)
Seat 4: 836cec3 ($2.5 in chips)
Seat 5: 3846027 ($13.33 in chips)
Seat 6: 5fca6fb7 ($10.13 in chips)
Hero: posts small blind $0.05
c4e1ec91: posts big blind $0.1
*** HOLE CARDS ***
Dealt to fba1fbfe 
Dealt to Hero [Qd 7c]
Dealt to c4e1ec91 
Dealt to 836cec3 
Dealt to 3846027 
Dealt to 5fca6fb7 
836cec3: calls $0.1
3846027: folds
5fca6fb7: folds
fba1fbfe: folds
Hero: folds
c4e1ec91: checks
*** FLOP *** [Qc Th 6d]
c4e1ec91: checks
836cec3: checks
*** TURN *** [Qc Th 6d] [2s]
c4e1ec91: checks
836cec3: checks
*** RIVER *** [Qc Th 6d 2s] [Tc]
c4e1ec91: checks
836cec3: checks
c4e1ec91: shows [5h Qs] (Pair of Queens and Pair of Tens)
836cec3: shows [As 3s] (Pair of Tens)
*** SHOWDOWN ***
c4e1ec91 collected $0.24 from pot
*** SUMMARY ***
Total pot $0.25 | Rake $0.01 | Jackpot $0 | Bingo $0 | Fortune $0 | Tax $0
Board [Qc Th 6d 2s Tc]
Seat 1: fba1fbfe (button) folded before Flop (didn't bet)
Seat 2: Hero (small blind) folded before Flop
Seat 3: c4e1ec91 (big blind) showed [5h Qs] and won ($0.24) with Pair of Queens and Pair of Tens
Seat 4: 836cec3 showed [As 3s] and lost with Pair of Tens
Seat 5: 3846027 folded before Flop (didn't bet)
Seat 6: 5fca6fb7 folded before Flop (didn't bet)


Poker Hand #RC2709884274: Hold'em No Limit ($0.05/$0.1) - 2024/07/13 16:14:14
Table 'RushAndCash8569534' 6-max Seat #1 is the button
Seat 1: 58a7abae ($22.01 in chips)
Seat 2: a46439e2 ($14.52 in chips)
Seat 3: Hero ($10 in chips)
Seat 4: 9e3098c3 ($17.47 in chips)
Seat 5: 4f476a98 ($13.71 in chips)
Seat 6: c1465bdb ($23.37 in chips)
a46439e2: posts small blind $0.05
Hero: posts big blind $0.1
*** HOLE CARDS ***
Dealt to 58a7abae 
Dealt to a46439e2 
Dealt to Hero [8s Qd]
Dealt to 9e3098c3 
Dealt to 4f476a98 
Dealt to c1465bdb 
9e3098c3: raises $0.15 to $0.25
4f476a98: folds
c1465bdb: folds
58a7abae: folds
a46439e2: folds
Hero: folds
Uncalled bet ($0.15) returned to 9e3098c3
*** SHOWDOWN ***
9e3098c3 collected $0.25 from pot
*** SUMMARY ***
Total pot $0.25 | Rake $0 | Jackpot $0 | Bingo $0 | Fortune $0 | Tax $0
Seat 1: 58a7abae (button) folded before Flop (didn't bet)
Seat 2: a46439e2 (small blind) folded before Flop
Seat 3: Hero (big blind) folded before Flop
Seat 4: 9e3098c3 collected ($0.25)
Seat 5: 4f476a98 folded before Flop (didn't bet)
Seat 6: c1465bdb folded before Flop (didn't bet)


Poker Hand #RC2709884250: Hold'em No Limit ($0.05/$0.1) - 2024/07/13 16:14:11
Table 'RushAndCash8569510' 6-max Seat #1 is the button
Seat 1: 414da696 ($22.63 in chips)
Seat 2: 6ad395ba ($11.49 in chips)
Seat 3: 9e6421ea ($10 in chips)
Seat 4: Hero ($10 in chips)
Seat 5: dff87709 ($11.25 in chips)
Seat 6: 5fca6fb7 ($10.18 in chips)
6ad395ba: posts small blind $0.05
9e6421ea: posts big blind $0.1
*** HOLE CARDS ***
Dealt to 414da696 
Dealt to 6ad395ba 
Dealt to 9e6421ea 
Dealt to Hero [Jc 8s]
Dealt to dff87709 
Dealt to 5fca6fb7 
Hero: folds
dff87709: folds
5fca6fb7: folds
414da696: folds
6ad395ba: folds
Uncalled bet ($0.05) returned to 9e6421ea
*** SHOWDOWN ***
9e6421ea collected $0.1 from pot
*** SUMMARY ***
Total pot $0.1 | Rake $0 | Jackpot $0 | Bingo $0 | Fortune $0 | Tax $0
Seat 1: 414da696 (button) folded before Flop (didn't bet)
Seat 2: 6ad395ba (small blind) folded before Flop
Seat 3: 9e6421ea (big blind) collected ($0.1)
Seat 4: Hero folded before Flop (didn't bet)
Seat 5: dff87709 folded before Flop (didn't bet)
Seat 6: 5fca6fb7 folded before Flop (didn't bet)


Poker Hand #RC2709883842: Hold'em No Limit ($0.05/$0.1) - 2024/07/13 16:13:21
Table 'RushAndCash8569102' 6-max Seat #1 is the button
Seat 1: f713ac32 ($3.01 in chips)
Seat 2: 6af5a5e9 ($11.09 in chips)
Seat 3: 2c149aba ($14.7 in chips)
Seat 4: Hero ($10.15 in chips)
Seat 5: f4ccd897 ($17.52 in chips)
Seat 6: e76f9564 ($45.29 in chips)
6af5a5e9: posts small blind $0.05
2c149aba: posts big blind $0.1
*** HOLE CARDS ***
Dealt to f713ac32 
Dealt to 6af5a5e9 
Dealt to 2c149aba 
Dealt to Hero [Ks Ah]
Dealt to f4ccd897 
Dealt to e76f9564 
Hero: raises $0.1 to $0.2
f4ccd897: folds
e76f9564: folds
f713ac32: folds
6af5a5e9: folds
2c149aba: calls $0.1
*** FLOP *** [5c 6s 6d]
2c149aba: checks
Hero: checks
*** TURN *** [5c 6s 6d] [5s]
2c149aba: bets $0.34
Hero: calls $0.34
*** RIVER *** [5c 6s 6d 5s] [4d]
2c149aba: bets $0.85
Hero: folds
Uncalled bet ($0.85) returned to 2c149aba
*** SHOWDOWN ***
2c149aba collected $1.08 from pot
*** SUMMARY ***
Total pot $1.13 | Rake $0.05 | Jackpot $0 | Bingo $0 | Fortune $0 | Tax $0
Board [5c 6s 6d 5s 4d]
Seat 1: f713ac32 (button) folded before Flop (didn't bet)
Seat 2: 6af5a5e9 (small blind) folded before Flop
Seat 3: 2c149aba (big blind) won ($1.08)
Seat 4: Hero folded on the River
Seat 5: f4ccd897 folded before Flop (didn't bet)
Seat 6: e76f9564 folded before Flop (didn't bet)


Poker Hand #RC2709883745: Hold'em No Limit ($0.05/$0.1) - 2024/07/13 16:13:10
Table 'RushAndCash8569005' 6-max Seat #1 is the button
Seat 1: 9c229fb3 ($11.18 in chips)
Seat 2: b52d1eec ($10.05 in chips)
Seat 3: 11499347 ($10 in chips)
Seat 4: Hero ($10 in chips)
Seat 5: 5fca6fb7 ($10 in chips)
Seat 6: 2796e1b2 ($10 in chips)
b52d1eec: posts small blind $0.05
11499347: posts big blind $0.1
*** HOLE CARDS ***
Dealt to 9c229fb3 
Dealt to b52d1eec 
Dealt to 11499347 
Dealt to Hero [Ah Js]
Dealt to 5fca6fb7 
Dealt to 2796e1b2 
Hero: raises $0.1 to $0.2
5fca6fb7: folds
2796e1b2: folds
9c229fb3: folds
b52d1eec: folds
11499347: folds
Uncalled bet ($0.1) returned to Hero
*** SHOWDOWN ***
Hero collected $0.25 from pot
*** SUMMARY ***
Total pot $0.25 | Rake $0 | Jackpot $0 | Bingo $0 | Fortune $0 | Tax $0
Seat 1: 9c229fb3 (button) folded before Flop (didn't bet)
Seat 2: b52d1eec (small blind) folded before Flop
Seat 3: 11499347 (big blind) folded before Flop
Seat 4: Hero collected ($0.25)
Seat 5: 5fca6fb7 folded before Flop (didn't bet)
Seat 6: 2796e1b2 folded before Flop (didn't bet)


Poker Hand #RC2709883649: Hold'em No Limit ($0.05/$0.1) - 2024/07/13 16:12:58
Table 'RushAndCash8568909' 6-max Seat #1 is the button
Seat 1: c3e8444d ($13.97 in chips)
Seat 2: 1457f0fd ($10.72 in chips)
Seat 3: 3aaffce5 ($38.84 in chips)
Seat 4: 5668b7d ($11.66 in chips)
Seat 5: Hero ($10 in chips)
Seat 6: af312f2b ($9.95 in chips)
1457f0fd: posts small blind $0.05
3aaffce5: posts big blind $0.1
*** HOLE CARDS ***
Dealt to c3e8444d 
Dealt to 1457f0fd 
Dealt to 3aaffce5 
Dealt to 5668b7d 
Dealt to Hero [Jh Ts]
Dealt to af312f2b 
5668b7d: folds
Hero: folds
af312f2b: folds
c3e8444d: folds
1457f0fd: folds
Uncalled bet ($0.05) returned to 3aaffce5
*** SHOWDOWN ***
3aaffce5 collected $0.1 from pot
*** SUMMARY ***
Total pot $0.1 | Rake $0 | Jackpot $0 | Bingo $0 | Fortune $0 | Tax $0
Seat 1: c3e8444d (button) folded before Flop (didn't bet)
Seat 2: 1457f0fd (small blind) folded before Flop
Seat 3: 3aaffce5 (big blind) collected ($0.1)
Seat 4: 5668b7d folded before Flop (didn't bet)
Seat 5: Hero folded before Flop (didn't bet)
Seat 6: af312f2b folded before Flop (didn't bet)


Poker Hand #RC2709883597: Hold'em No Limit ($0.05/$0.1) - 2024/07/13 16:12:51
Table 'RushAndCash8568857' 6-max Seat #1 is the button
Seat 1: Hero ($10 in chips)
Seat 2: 364a9600 ($52.4 in chips)
Seat 3: b12caf54 ($17.53 in chips)
Seat 4: b4ffd972 ($10 in chips)
Seat 5: 479ff9cb ($12.54 in chips)
Seat 6: a4446b95 ($18.89 in chips)
364a9600: posts small blind $0.05
b12caf54: posts big blind $0.1
*** HOLE CARDS ***
Dealt to Hero [4d Js]
Dealt to 364a9600 
Dealt to b12caf54 
Dealt to b4ffd972 
Dealt to 479ff9cb 
Dealt to a4446b95 
b4ffd972: folds
479ff9cb: folds
a4446b95: folds
Hero: folds
364a9600: folds
Uncalled bet ($0.05) returned to b12caf54
*** SHOWDOWN ***
b12caf54 collected $0.1 from pot
*** SUMMARY ***
Total pot $0.1 | Rake $0 | Jackpot $0 | Bingo $0 | Fortune $0 | Tax $0
Seat 1: Hero (button) folded before Flop (didn't bet)
Seat 2: 364a9600 (small blind) folded before Flop
Seat 3: b12caf54 (big blind) collected ($0.1)
Seat 4: b4ffd972 folded before Flop (didn't bet)
Seat 5: 479ff9cb folded before Flop (didn't bet)
Seat 6: a4446b95 folded before Flop (didn't bet)


Poker Hand #RC2709883529: Hold'em No Limit ($0.05/$0.1) - 2024/07/13 16:12:42
Table 'RushAndCash8568789' 6-max Seat #1 is the button
Seat 1: 660cd575 ($20.5 in chips)
Seat 2: Hero ($10 in chips)
Seat 3: 191dcd1e ($18.46 in chips)
Seat 4: dff87709 ($11.32 in chips)
Seat 5: d44ad9ed ($10.63 in chips)
Seat 6: 5f145382 ($11.44 in chips)
Hero: posts small blind $0.05
191dcd1e: posts big blind $0.1
*** HOLE CARDS ***
Dealt to 660cd575 
Dealt to Hero [Ts Jc]
Dealt to 191dcd1e 
Dealt to dff87709 
Dealt to d44ad9ed 
Dealt to 5f145382 
dff87709: folds
d44ad9ed: raises $0.14 to $0.24
5f145382: folds
660cd575: folds
Hero: folds
191dcd1e: folds
Uncalled bet ($0.14) returned to d44ad9ed
*** SHOWDOWN ***
d44ad9ed collected $0.25 from pot
*** SUMMARY ***
Total pot $0.25 | Rake $0 | Jackpot $0 | Bingo $0 | Fortune $0 | Tax $0
Seat 1: 660cd575 (button) folded before Flop (didn't bet)
Seat 2: Hero (small blind) folded before Flop
Seat 3: 191dcd1e (big blind) folded before Flop
Seat 4: dff87709 folded before Flop (didn't bet)
Seat 5: d44ad9ed collected ($0.25)
Seat 6: 5f145382 folded before Flop (didn't bet)


Poker Hand #RC2709883480: Hold'em No Limit ($0.05/$0.1) - 2024/07/13 16:12:36
Table 'RushAndCash8568740' 6-max Seat #1 is the button
Seat 1: c8b679d ($1.19 in chips)
Seat 2: a38530f1 ($23.32 in chips)
Seat 3: Hero ($10 in chips)
Seat 4: 7372f40b ($56.95 in chips)
Seat 5: 1a139c6c ($11.86 in chips)
Seat 6: 431d9c9b ($10 in chips)
a38530f1: posts small blind $0.05
Hero: posts big blind $0.1
*** HOLE CARDS ***
Dealt to c8b679d 
Dealt to a38530f1 
Dealt to Hero [7d 3c]
Dealt to 7372f40b 
Dealt to 1a139c6c 
Dealt to 431d9c9b 
7372f40b: folds
1a139c6c: raises $0.11 to $0.21
431d9c9b: folds
c8b679d: folds
a38530f1: calls $0.16
Hero: folds
*** FLOP *** [Kd 6d 5d]
a38530f1: checks
1a139c6c: bets $0.18
a38530f1: raises $0.3 to $0.48
1a139c6c: folds
Uncalled bet ($0.3) returned to a38530f1
*** SHOWDOWN ***
a38530f1 collected $0.84 from pot
*** SUMMARY ***
Total pot $0.88 | Rake $0.04 | Jackpot $0 | Bingo $0 | Fortune $0 | Tax $0
Board [Kd 6d 5d]
Seat 1: c8b679d (button) folded before Flop (didn't bet)
Seat 2: a38530f1 (small blind) won ($0.84)
Seat 3: Hero (big blind) folded before Flop
Seat 4: 7372f40b folded before Flop (didn't bet)
Seat 5: 1a139c6c folded on the Flop
Seat 6: 431d9c9b folded before Flop (didn't bet)


