Poker Hand #HD1808727970: Hold'em No Limit ($0.05/$0.1) - 2024/06/10 01:26:57
Table 'NLHRed12' 6-max Seat #2 is the button
Seat 1: Hero ($10.64 in chips)
Seat 2: 6a3cddfe ($27.61 in chips)
Seat 3: 21b26b1d ($10 in chips)
Seat 4: d390717b ($10.46 in chips)
Seat 5: f379676 ($12.31 in chips)
Seat 6: 441cc42e ($10.74 in chips)
21b26b1d: posts small blind $0.05
d390717b: posts big blind $0.1
*** HOLE CARDS ***
Dealt to Hero [Qd Tc]
Dealt to 6a3cddfe 
Dealt to 21b26b1d 
Dealt to d390717b 
Dealt to f379676 
Dealt to 441cc42e 
f379676: raises $0.15 to $0.25
441cc42e: folds
Hero: folds
6a3cddfe: calls $0.25
21b26b1d: folds
d390717b: calls $0.15
*** FLOP *** [7d 5s Jh]
d390717b: checks
f379676: bets $0.27
6a3cddfe: calls $0.27
d390717b: calls $0.27
*** TURN *** [7d 5s Jh] [6c]
d390717b: checks
f379676: bets $1.21
6a3cddfe: folds
d390717b: folds
Uncalled bet ($1.21) returned to f379676
*** SHOWDOWN ***
f379676 collected $1.53 from pot
*** SUMMARY ***
Total pot $1.61 | Rake $0.08 | Jackpot $0 | Bingo $0 | Fortune $0 | Tax $0
Board [7d 5s Jh 6c]
Seat 1: Hero folded before Flop (didn't bet)
Seat 2: 6a3cddfe (button) folded on the Turn
Seat 3: 21b26b1d (small blind) folded before Flop
Seat 4: d390717b (big blind) folded on the Turn
Seat 5: f379676 won ($1.53)
Seat 6: 441cc42e folded before Flop (didn't bet)


Poker Hand #HD1808727916: Hold'em No Limit ($0.05/$0.1) - 2024/06/10 01:26:11
Table 'NLHRed12' 6-max Seat #1 is the button
Seat 1: Hero ($10.64 in chips)
Seat 2: 6a3cddfe ($27.31 in chips)
Seat 3: 21b26b1d ($10 in chips)
Seat 4: d390717b ($10.68 in chips)
Seat 5: f379676 ($12.31 in chips)
Seat 6: 441cc42e ($10.74 in chips)
6a3cddfe: posts small blind $0.05
21b26b1d: posts big blind $0.1
*** HOLE CARDS ***
Dealt to Hero [4c Qh]
Dealt to 6a3cddfe 
Dealt to 21b26b1d 
Dealt to d390717b 
Dealt to f379676 
Dealt to 441cc42e 
d390717b: raises $0.12 to $0.22
f379676: folds
441cc42e: folds
Hero: folds
6a3cddfe: calls $0.17
21b26b1d: folds
*** FLOP *** [Kc Js Tc]
6a3cddfe: checks
d390717b: checks
*** TURN *** [Kc Js Tc] [3s]
6a3cddfe: bets $0.54
d390717b: folds
Uncalled bet ($0.54) returned to 6a3cddfe
*** SHOWDOWN ***
6a3cddfe collected $0.52 from pot
*** SUMMARY ***
Total pot $0.54 | Rake $0.02 | Jackpot $0 | Bingo $0 | Fortune $0 | Tax $0
Board [Kc Js Tc 3s]
Seat 1: Hero (button) folded before Flop (didn't bet)
Seat 2: 6a3cddfe (small blind) won ($0.52)
Seat 3: 21b26b1d (big blind) folded before Flop
Seat 4: d390717b folded on the Turn
Seat 5: f379676 folded before Flop (didn't bet)
Seat 6: 441cc42e folded before Flop (didn't bet)


Poker Hand #HD1808727859: Hold'em No Limit ($0.05/$0.1) - 2024/06/10 01:25:29
Table 'NLHRed12' 6-max Seat #6 is the button
Seat 1: Hero ($11.24 in chips)
Seat 2: 6a3cddfe ($26.77 in chips)
Seat 3: 21b26b1d ($10 in chips)
Seat 4: d390717b ($10.68 in chips)
Seat 5: f379676 ($12.31 in chips)
Seat 6: 441cc42e ($10.74 in chips)
Hero: posts small blind $0.05
6a3cddfe: posts big blind $0.1
*** HOLE CARDS ***
Dealt to Hero [Ad Th]
Dealt to 6a3cddfe 
Dealt to 21b26b1d 
Dealt to d390717b 
Dealt to f379676 
Dealt to 441cc42e 
21b26b1d: folds
d390717b: folds
f379676: folds
441cc42e: folds
Hero: raises $0.2 to $0.3
6a3cddfe: calls $0.2
*** FLOP *** [5d 5s Jd]
Hero: checks
6a3cddfe: bets $0.3
Hero: calls $0.3
*** TURN *** [5d 5s Jd] [9h]
Hero: checks
6a3cddfe: bets $0.6
Hero: folds
Uncalled bet ($0.6) returned to 6a3cddfe
*** SHOWDOWN ***
6a3cddfe collected $1.14 from pot
*** SUMMARY ***
Total pot $1.2 | Rake $0.06 | Jackpot $0 | Bingo $0 | Fortune $0 | Tax $0
Board [5d 5s Jd 9h]
Seat 1: Hero (small blind) folded on the Turn
Seat 2: 6a3cddfe (big blind) won ($1.14)
Seat 3: 21b26b1d folded before Flop (didn't bet)
Seat 4: d390717b folded before Flop (didn't bet)
Seat 5: f379676 folded before Flop (didn't bet)
Seat 6: 441cc42e (button) folded before Flop (didn't bet)


Poker Hand #HD1808727834: Hold'em No Limit ($0.05/$0.1) - 2024/06/10 01:25:07
Table 'NLHRed12' 6-max Seat #5 is the button
Seat 1: Hero ($11.34 in chips)
Seat 2: 6a3cddfe ($26.77 in chips)
Seat 3: 21b26b1d ($10 in chips)
Seat 4: d390717b ($10.53 in chips)
Seat 5: f379676 ($12.31 in chips)
Seat 6: 441cc42e ($10.79 in chips)
441cc42e: posts small blind $0.05
Hero: posts big blind $0.1
*** HOLE CARDS ***
Dealt to Hero [6d 3d]
Dealt to 6a3cddfe 
Dealt to 21b26b1d 
Dealt to d390717b 
Dealt to f379676 
Dealt to 441cc42e 
6a3cddfe: folds
21b26b1d: folds
d390717b: raises $0.16 to $0.26
f379676: folds
441cc42e: folds
Hero: folds
Uncalled bet ($0.16) returned to d390717b
*** SHOWDOWN ***
d390717b collected $0.25 from pot
*** SUMMARY ***
Total pot $0.25 | Rake $0 | Jackpot $0 | Bingo $0 | Fortune $0 | Tax $0
Seat 1: Hero (big blind) folded before Flop
Seat 2: 6a3cddfe folded before Flop (didn't bet)
Seat 3: 21b26b1d folded before Flop (didn't bet)
Seat 4: d390717b collected ($0.25)
Seat 5: f379676 (button) folded before Flop (didn't bet)
Seat 6: 441cc42e (small blind) folded before Flop


Poker Hand #HD1808727774: Hold'em No Limit ($0.05/$0.1) - 2024/06/10 01:24:14
Table 'NLHRed12' 6-max Seat #4 is the button
Seat 1: Hero ($11.34 in chips)
Seat 2: 6a3cddfe ($25.27 in chips)
Seat 3: 21b26b1d ($10 in chips)
Seat 4: d390717b ($10.53 in chips)
Seat 5: f379676 ($12.36 in chips)
Seat 6: 441cc42e ($12.51 in chips)
f379676: posts small blind $0.05
441cc42e: posts big blind $0.1
*** HOLE CARDS ***
Dealt to Hero [7s 4h]
Dealt to 6a3cddfe 
Dealt to 21b26b1d 
Dealt to d390717b 
Dealt to f379676 
Dealt to 441cc42e 
Hero: folds
6a3cddfe: raises $0.15 to $0.25
21b26b1d: folds
d390717b: folds
f379676: folds
441cc42e: calls $0.15
*** FLOP *** [Jd Kd Qc]
441cc42e: checks
6a3cddfe: bets $0.42
441cc42e: calls $0.42
*** TURN *** [Jd Kd Qc] [3h]
441cc42e: checks
6a3cddfe: bets $1.05
441cc42e: calls $1.05
*** RIVER *** [Jd Kd Qc 3h] [3d]
441cc42e: checks
6a3cddfe: bets $3.49
441cc42e: folds
Uncalled bet ($3.49) returned to 6a3cddfe
*** SHOWDOWN ***
6a3cddfe collected $3.22 from pot
*** SUMMARY ***
Total pot $3.49 | Rake $0.17 | Jackpot $0.1 | Bingo $0 | Fortune $0 | Tax $0
Board [Jd Kd Qc 3h 3d]
Seat 1: Hero folded before Flop (didn't bet)
Seat 2: 6a3cddfe won ($3.22)
Seat 3: 21b26b1d folded before Flop (didn't bet)
Seat 4: d390717b (button) folded before Flop (didn't bet)
Seat 5: f379676 (small blind) folded before Flop
Seat 6: 441cc42e (big blind) folded on the River


Poker Hand #HD1808727726: Hold'em No Limit ($0.05/$0.1) - 2024/06/10 01:23:32
Table 'NLHRed12' 6-max Seat #3 is the button
Seat 1: Hero ($11.34 in chips)
Seat 2: 6a3cddfe ($25.27 in chips)
Seat 3: 21b26b1d ($10 in chips)
Seat 4: d390717b ($10.58 in chips)
Seat 5: f379676 ($12.08 in chips)
Seat 6: 441cc42e ($12.51 in chips)
d390717b: posts small blind $0.05
f379676: posts big blind $0.1
*** HOLE CARDS ***
Dealt to Hero [As 8h]
Dealt to 6a3cddfe 
Dealt to 21b26b1d 
Dealt to d390717b 
Dealt to f379676 
Dealt to 441cc42e 
441cc42e: folds
Hero: folds
6a3cddfe: folds
21b26b1d: raises $0.15 to $0.25
d390717b: folds
f379676: raises $0.9 to $1.15
21b26b1d: folds
Uncalled bet ($0.9) returned to f379676
*** SHOWDOWN ***
f379676 collected $0.53 from pot
*** SUMMARY ***
Total pot $0.55 | Rake $0.02 | Jackpot $0 | Bingo $0 | Fortune $0 | Tax $0
Seat 1: Hero folded before Flop (didn't bet)
Seat 2: 6a3cddfe folded before Flop (didn't bet)
Seat 3: 21b26b1d (button) folded before Flop
Seat 4: d390717b (small blind) folded before Flop
Seat 5: f379676 (big blind) collected ($0.53)
Seat 6: 441cc42e folded before Flop (didn't bet)


Poker Hand #HD1808727705: Hold'em No Limit ($0.05/$0.1) - 2024/06/10 01:23:21
Table 'NLHRed12' 6-max Seat #2 is the button
Seat 1: Hero ($11.34 in chips)
Seat 2: 6a3cddfe ($25.27 in chips)
Seat 3: 21b26b1d ($10 in chips)
Seat 4: d390717b ($10.53 in chips)
Seat 5: f379676 ($12.08 in chips)
Seat 6: 441cc42e ($12.51 in chips)
21b26b1d: posts small blind $0.05
d390717b: posts big blind $0.1
*** HOLE CARDS ***
Dealt to Hero [4c 5h]
Dealt to 6a3cddfe 
Dealt to 21b26b1d 
Dealt to d390717b 
Dealt to f379676 
Dealt to 441cc42e 
f379676: folds
441cc42e: folds
Hero: folds
6a3cddfe: folds
21b26b1d: folds
Uncalled bet ($0.05) returned to d390717b
*** SHOWDOWN ***
d390717b collected $0.1 from pot
*** SUMMARY ***
Total pot $0.1 | Rake $0 | Jackpot $0 | Bingo $0 | Fortune $0 | Tax $0
Seat 1: Hero folded before Flop (didn't bet)
Seat 2: 6a3cddfe (button) folded before Flop (didn't bet)
Seat 3: 21b26b1d (small blind) folded before Flop
Seat 4: d390717b (big blind) collected ($0.1)
Seat 5: f379676 folded before Flop (didn't bet)
Seat 6: 441cc42e folded before Flop (didn't bet)


Poker Hand #HD1808727678: Hold'em No Limit ($0.05/$0.1) - 2024/06/10 01:23:04
Table 'NLHRed12' 6-max Seat #1 is the button
Seat 1: Hero ($11.34 in chips)
Seat 2: 6a3cddfe ($25.32 in chips)
Seat 3: 21b26b1d ($10 in chips)
Seat 4: d390717b ($10.38 in chips)
Seat 5: f379676 ($12.08 in chips)
Seat 6: 441cc42e ($12.51 in chips)
6a3cddfe: posts small blind $0.05
21b26b1d: posts big blind $0.1
*** HOLE CARDS ***
Dealt to Hero [Ac 9s]
Dealt to 6a3cddfe 
Dealt to 21b26b1d 
Dealt to d390717b 
Dealt to f379676 
Dealt to 441cc42e 
d390717b: raises $0.12 to $0.22
f379676: folds
441cc42e: folds
Hero: folds
6a3cddfe: folds
21b26b1d: folds
Uncalled bet ($0.12) returned to d390717b
*** SHOWDOWN ***
d390717b collected $0.25 from pot
*** SUMMARY ***
Total pot $0.25 | Rake $0 | Jackpot $0 | Bingo $0 | Fortune $0 | Tax $0
Seat 1: Hero (button) folded before Flop (didn't bet)
Seat 2: 6a3cddfe (small blind) folded before Flop
Seat 3: 21b26b1d (big blind) folded before Flop
Seat 4: d390717b collected ($0.25)
Seat 5: f379676 folded before Flop (didn't bet)
Seat 6: 441cc42e folded before Flop (didn't bet)


Poker Hand #HD1808727664: Hold'em No Limit ($0.05/$0.1) - 2024/06/10 01:22:50
Table 'NLHRed12' 6-max Seat #6 is the button
Seat 1: Hero ($11.39 in chips)
Seat 2: 6a3cddfe ($25.27 in chips)
Seat 3: 21b26b1d ($10 in chips)
Seat 4: d390717b ($10.38 in chips)
Seat 5: f379676 ($12.08 in chips)
Seat 6: 441cc42e ($12.51 in chips)
Hero: posts small blind $0.05
6a3cddfe: posts big blind $0.1
*** HOLE CARDS ***
Dealt to Hero [Th 2c]
Dealt to 6a3cddfe 
Dealt to 21b26b1d 
Dealt to d390717b 
Dealt to f379676 
Dealt to 441cc42e 
21b26b1d: folds
d390717b: folds
f379676: folds
441cc42e: folds
Hero: folds
Uncalled bet ($0.05) returned to 6a3cddfe
*** SHOWDOWN ***
6a3cddfe collected $0.1 from pot
*** SUMMARY ***
Total pot $0.1 | Rake $0 | Jackpot $0 | Bingo $0 | Fortune $0 | Tax $0
Seat 1: Hero (small blind) folded before Flop
Seat 2: 6a3cddfe (big blind) collected ($0.1)
Seat 3: 21b26b1d folded before Flop (didn't bet)
Seat 4: d390717b folded before Flop (didn't bet)
Seat 5: f379676 folded before Flop (didn't bet)
Seat 6: 441cc42e (button) folded before Flop (didn't bet)


Poker Hand #HD1808727625: Hold'em No Limit ($0.05/$0.1) - 2024/06/10 01:22:16
Table 'NLHRed12' 6-max Seat #5 is the button
Seat 1: Hero ($11.49 in chips)
Seat 2: 6a3cddfe ($25.27 in chips)
Seat 3: 21b26b1d ($10 in chips)
Seat 4: d390717b ($10 in chips)
Seat 5: f379676 ($12.34 in chips)
Seat 6: 441cc42e ($12.56 in chips)
441cc42e: posts small blind $0.05
Hero: posts big blind $0.1
*** HOLE CARDS ***
Dealt to Hero [5d Td]
Dealt to 6a3cddfe 
Dealt to 21b26b1d 
Dealt to d390717b 
Dealt to f379676 
Dealt to 441cc42e 
6a3cddfe: folds
21b26b1d: folds
d390717b: raises $0.16 to $0.26
f379676: calls $0.26
441cc42e: folds
Hero: folds
*** FLOP *** [Ks 4c Kd]
d390717b: bets $0.34
f379676: folds
Uncalled bet ($0.34) returned to d390717b
*** SHOWDOWN ***
d390717b collected $0.64 from pot
*** SUMMARY ***
Total pot $0.67 | Rake $0.03 | Jackpot $0 | Bingo $0 | Fortune $0 | Tax $0
Board [Ks 4c Kd]
Seat 1: Hero (big blind) folded before Flop
Seat 2: 6a3cddfe folded before Flop (didn't bet)
Seat 3: 21b26b1d folded before Flop (didn't bet)
Seat 4: d390717b won ($0.64)
Seat 5: f379676 (button) folded on the Flop
Seat 6: 441cc42e (small blind) folded before Flop


Poker Hand #HD1808727596: Hold'em No Limit ($0.05/$0.1) - 2024/06/10 01:22:01
Table 'NLHRed12' 6-max Seat #4 is the button
Seat 1: Hero ($11.49 in chips)
Seat 2: 6a3cddfe ($25.12 in chips)
Seat 3: 21b26b1d ($10 in chips)
Seat 4: d390717b ($10 in chips)
Seat 5: f379676 ($12.39 in chips)
Seat 6: 441cc42e ($12.66 in chips)
f379676: posts small blind $0.05
441cc42e: posts big blind $0.1
*** HOLE CARDS ***
Dealt to Hero [Td 8d]
Dealt to 6a3cddfe 
Dealt to 21b26b1d 
Dealt to d390717b 
Dealt to f379676 
Dealt to 441cc42e 
Hero: folds
6a3cddfe: raises $0.15 to $0.25
21b26b1d: folds
d390717b: folds
f379676: folds
441cc42e: folds
Uncalled bet ($0.15) returned to 6a3cddfe
*** SHOWDOWN ***
6a3cddfe collected $0.25 from pot
*** SUMMARY ***
Total pot $0.25 | Rake $0 | Jackpot $0 | Bingo $0 | Fortune $0 | Tax $0
Seat 1: Hero folded before Flop (didn't bet)
Seat 2: 6a3cddfe collected ($0.25)
Seat 3: 21b26b1d folded before Flop (didn't bet)
Seat 4: d390717b (button) folded before Flop (didn't bet)
Seat 5: f379676 (small blind) folded before Flop
Seat 6: 441cc42e (big blind) folded before Flop


Poker Hand #HD1808727540: Hold'em No Limit ($0.05/$0.1) - 2024/06/10 01:21:15
Table 'NLHRed12' 6-max Seat #3 is the button
Seat 1: Hero ($11.49 in chips)
Seat 2: 6a3cddfe ($26 in chips)
Seat 3: 21b26b1d ($10 in chips)
Seat 4: d390717b ($10 in chips)
Seat 5: f379676 ($12.49 in chips)
Seat 6: 441cc42e ($11.72 in chips)
d390717b: posts small blind $0.05
f379676: posts big blind $0.1
*** HOLE CARDS ***
Dealt to Hero [Jh Qd]
Dealt to 6a3cddfe 
Dealt to 21b26b1d 
Dealt to d390717b 
Dealt to f379676 
Dealt to 441cc42e 
441cc42e: raises $0.2 to $0.3
Hero: folds
6a3cddfe: calls $0.3
21b26b1d: folds
d390717b: folds
f379676: folds
*** FLOP *** [9d 6d 2h]
441cc42e: bets $0.58
6a3cddfe: calls $0.58
*** TURN *** [9d 6d 2h] [3c]
441cc42e: bets $1.48
6a3cddfe: folds
Uncalled bet ($1.48) returned to 441cc42e
*** SHOWDOWN ***
441cc42e collected $1.82 from pot
*** SUMMARY ***
Total pot $1.91 | Rake $0.09 | Jackpot $0 | Bingo $0 | Fortune $0 | Tax $0
Board [9d 6d 2h 3c]
Seat 1: Hero folded before Flop (didn't bet)
Seat 2: 6a3cddfe folded on the Turn
Seat 3: 21b26b1d (button) folded before Flop (didn't bet)
Seat 4: d390717b (small blind) folded before Flop
Seat 5: f379676 (big blind) folded before Flop
Seat 6: 441cc42e won ($1.82)


Poker Hand #HD1808727394: Hold'em No Limit ($0.05/$0.1) - 2024/06/10 01:19:26
Table 'NLHRed12' 6-max Seat #2 is the button
Seat 1: Hero ($11.49 in chips)
Seat 2: 6a3cddfe ($14.01 in chips)
Seat 3: 21b26b1d ($10 in chips)
Seat 4: d390717b ($12.84 in chips)
Seat 5: f379676 ($12.49 in chips)
Seat 6: 441cc42e ($11.72 in chips)
21b26b1d: posts small blind $0.05
d390717b: posts big blind $0.1
*** HOLE CARDS ***
Dealt to Hero [6c Kh]
Dealt to 6a3cddfe 
Dealt to 21b26b1d 
Dealt to d390717b 
Dealt to f379676 
Dealt to 441cc42e 
f379676: folds
441cc42e: folds
Hero: folds
6a3cddfe: raises $0.15 to $0.25
21b26b1d: calls $0.2
d390717b: calls $0.15
*** FLOP *** [2h 9s 8h]
21b26b1d: checks
d390717b: checks
6a3cddfe: bets $0.57
21b26b1d: folds
d390717b: raises $1.42 to $1.99
6a3cddfe: calls $1.42
*** TURN *** [2h 9s 8h] [3s]
d390717b: bets $2.77
6a3cddfe: calls $2.77
*** RIVER *** [2h 9s 8h 3s] [Qh]
d390717b: bets $7.83 and is all-in
6a3cddfe: calls $7.83
d390717b: shows [2c 2s] (Three Twos)
6a3cddfe: shows [Th 4h] (Queen High Flush)
*** SHOWDOWN ***
6a3cddfe collected $24.83 from pot
*** SUMMARY ***
Total pot $25.93 | Rake $1 | Jackpot $0.1 | Bingo $0 | Fortune $0 | Tax $0
Board [2h 9s 8h 3s Qh]
Seat 1: Hero folded before Flop (didn't bet)
Seat 2: 6a3cddfe (button) showed [Th 4h] and won ($24.83) with Queen High Flush
Seat 3: 21b26b1d (small blind) folded on the Flop
Seat 4: d390717b (big blind) showed [2c 2s] and lost with Three Twos
Seat 5: f379676 folded before Flop (didn't bet)
Seat 6: 441cc42e folded before Flop (didn't bet)


Poker Hand #HD1808727300: Hold'em No Limit ($0.05/$0.1) - 2024/06/10 01:18:18
Table 'NLHRed12' 6-max Seat #1 is the button
Seat 1: Hero ($11.49 in chips)
Seat 2: 6a3cddfe ($15.92 in chips)
Seat 3: 21b26b1d ($10 in chips)
Seat 4: d390717b ($12.84 in chips)
Seat 5: f379676 ($12.49 in chips)
Seat 6: 441cc42e ($10 in chips)
6a3cddfe: posts small blind $0.05
21b26b1d: posts big blind $0.1
*** HOLE CARDS ***
Dealt to Hero [8s 6c]
Dealt to 6a3cddfe 
Dealt to 21b26b1d 
Dealt to d390717b 
Dealt to f379676 
Dealt to 441cc42e 
d390717b: folds
f379676: folds
441cc42e: raises $0.15 to $0.25
Hero: folds
6a3cddfe: calls $0.2
21b26b1d: folds
*** FLOP *** [6h Ad Tc]
6a3cddfe: checks
441cc42e: bets $0.47
6a3cddfe: calls $0.47
*** TURN *** [6h Ad Tc] [8c]
6a3cddfe: checks
441cc42e: bets $1.19
6a3cddfe: calls $1.19
*** RIVER *** [6h Ad Tc 8c] [2c]
6a3cddfe: checks
441cc42e: bets $3.02
6a3cddfe: folds
Uncalled bet ($3.02) returned to 441cc42e
*** SHOWDOWN ***
441cc42e collected $3.63 from pot
*** SUMMARY ***
Total pot $3.92 | Rake $0.19 | Jackpot $0.1 | Bingo $0 | Fortune $0 | Tax $0
Board [6h Ad Tc 8c 2c]
Seat 1: Hero (button) folded before Flop (didn't bet)
Seat 2: 6a3cddfe (small blind) folded on the River
Seat 3: 21b26b1d (big blind) folded before Flop
Seat 4: d390717b folded before Flop (didn't bet)
Seat 5: f379676 folded before Flop (didn't bet)
Seat 6: 441cc42e won ($3.63)


Poker Hand #HD1808727282: Hold'em No Limit ($0.05/$0.1) - 2024/06/10 01:18:07
Table 'NLHRed12' 6-max Seat #6 is the button
Seat 1: Hero ($11.54 in chips)
Seat 2: 6a3cddfe ($15.87 in chips)
Seat 3: 21b26b1d ($10 in chips)
Seat 4: d390717b ($12.84 in chips)
Seat 5: f379676 ($12.49 in chips)
Seat 6: 441cc42e ($10 in chips)
Hero: posts small blind $0.05
6a3cddfe: posts big blind $0.1
*** HOLE CARDS ***
Dealt to Hero [Jd 8h]
Dealt to 6a3cddfe 
Dealt to 21b26b1d 
Dealt to d390717b 
Dealt to f379676 
Dealt to 441cc42e 
21b26b1d: folds
d390717b: folds
f379676: folds
441cc42e: folds
Hero: folds
Uncalled bet ($0.05) returned to 6a3cddfe
*** SHOWDOWN ***
6a3cddfe collected $0.1 from pot
*** SUMMARY ***
Total pot $0.1 | Rake $0 | Jackpot $0 | Bingo $0 | Fortune $0 | Tax $0
Seat 1: Hero (small blind) folded before Flop
Seat 2: 6a3cddfe (big blind) collected ($0.1)
Seat 3: 21b26b1d folded before Flop (didn't bet)
Seat 4: d390717b folded before Flop (didn't bet)
Seat 5: f379676 folded before Flop (didn't bet)
Seat 6: 441cc42e (button) folded before Flop (didn't bet)


Poker Hand #HD1808727259: Hold'em No Limit ($0.05/$0.1) - 2024/06/10 01:17:54
Table 'NLHRed12' 6-max Seat #5 is the button
Seat 1: Hero ($11.49 in chips)
Seat 2: 6a3cddfe ($15.87 in chips)
Seat 3: 21b26b1d ($10 in chips)
Seat 4: d390717b ($12.84 in chips)
Seat 5: f379676 ($12.49 in chips)
Seat 6: 441cc42e ($10 in chips)
441cc42e: posts small blind $0.05
Hero: posts big blind $0.1
*** HOLE CARDS ***
Dealt to Hero [Tc Ts]
Dealt to 6a3cddfe 
Dealt to 21b26b1d 
Dealt to d390717b 
Dealt to f379676 
Dealt to 441cc42e 
6a3cddfe: folds
21b26b1d: folds
d390717b: folds
f379676: folds
441cc42e: folds
Uncalled bet ($0.05) returned to Hero
*** SHOWDOWN ***
Hero collected $0.1 from pot
*** SUMMARY ***
Total pot $0.1 | Rake $0 | Jackpot $0 | Bingo $0 | Fortune $0 | Tax $0
Seat 1: Hero (big blind) collected ($0.1)
Seat 2: 6a3cddfe folded before Flop (didn't bet)
Seat 3: 21b26b1d folded before Flop (didn't bet)
Seat 4: d390717b folded before Flop (didn't bet)
Seat 5: f379676 (button) folded before Flop (didn't bet)
Seat 6: 441cc42e (small blind) folded before Flop


Poker Hand #HD1808727213: Hold'em No Limit ($0.05/$0.1) - 2024/06/10 01:17:20
Table 'NLHRed12' 6-max Seat #4 is the button
Seat 1: Hero ($11.49 in chips)
Seat 2: 6a3cddfe ($15.36 in chips)
Seat 3: 21b26b1d ($10.15 in chips)
Seat 4: d390717b ($12.84 in chips)
Seat 5: f379676 ($12.54 in chips)
Seat 6: 441cc42e ($10 in chips)
f379676: posts small blind $0.05
441cc42e: posts big blind $0.1
*** HOLE CARDS ***
Dealt to Hero [3s 8h]
Dealt to 6a3cddfe 
Dealt to 21b26b1d 
Dealt to d390717b 
Dealt to f379676 
Dealt to 441cc42e 
Hero: folds
6a3cddfe: raises $0.3 to $0.4
21b26b1d: calls $0.4
d390717b: folds
f379676: folds
441cc42e: folds
*** FLOP *** [Th 7c 4h]
6a3cddfe: bets $0.72
21b26b1d: folds
Uncalled bet ($0.72) returned to 6a3cddfe
*** SHOWDOWN ***
6a3cddfe collected $0.91 from pot
*** SUMMARY ***
Total pot $0.95 | Rake $0.04 | Jackpot $0 | Bingo $0 | Fortune $0 | Tax $0
Board [Th 7c 4h]
Seat 1: Hero folded before Flop (didn't bet)
Seat 2: 6a3cddfe won ($0.91)
Seat 3: 21b26b1d folded on the Flop
Seat 4: d390717b (button) folded before Flop (didn't bet)
Seat 5: f379676 (small blind) folded before Flop
Seat 6: 441cc42e (big blind) folded before Flop


Poker Hand #HD1808727192: Hold'em No Limit ($0.05/$0.1) - 2024/06/10 01:17:04
Table 'NLHRed12' 6-max Seat #3 is the button
Seat 1: Hero ($11.49 in chips)
Seat 2: 6a3cddfe ($15.36 in chips)
Seat 3: 21b26b1d ($10.15 in chips)
Seat 4: d390717b ($12.89 in chips)
Seat 5: f379676 ($12.49 in chips)
Seat 6: 441cc42e ($10 in chips)
d390717b: posts small blind $0.05
f379676: posts big blind $0.1
*** HOLE CARDS ***
Dealt to Hero [9s 5s]
Dealt to 6a3cddfe 
Dealt to 21b26b1d 
Dealt to d390717b 
Dealt to f379676 
Dealt to 441cc42e 
441cc42e: folds
Hero: folds
6a3cddfe: folds
21b26b1d: folds
d390717b: folds
Uncalled bet ($0.05) returned to f379676
*** SHOWDOWN ***
f379676 collected $0.1 from pot
*** SUMMARY ***
Total pot $0.1 | Rake $0 | Jackpot $0 | Bingo $0 | Fortune $0 | Tax $0
Seat 1: Hero folded before Flop (didn't bet)
Seat 2: 6a3cddfe folded before Flop (didn't bet)
Seat 3: 21b26b1d (button) folded before Flop (didn't bet)
Seat 4: d390717b (small blind) folded before Flop
Seat 5: f379676 (big blind) collected ($0.1)
Seat 6: 441cc42e folded before Flop (didn't bet)


Poker Hand #HD1808727179: Hold'em No Limit ($0.05/$0.1) - 2024/06/10 01:16:52
Table 'NLHRed12' 6-max Seat #2 is the button
Seat 1: Hero ($11.49 in chips)
Seat 2: 6a3cddfe ($15.36 in chips)
Seat 3: 21b26b1d ($10.2 in chips)
Seat 4: d390717b ($12.84 in chips)
Seat 5: f379676 ($12.49 in chips)
Seat 6: 441cc42e ($10 in chips)
21b26b1d: posts small blind $0.05
d390717b: posts big blind $0.1
*** HOLE CARDS ***
Dealt to Hero [6d 5h]
Dealt to 6a3cddfe 
Dealt to 21b26b1d 
Dealt to d390717b 
Dealt to f379676 
Dealt to 441cc42e 
f379676: folds
441cc42e: folds
Hero: folds
6a3cddfe: folds
21b26b1d: folds
Uncalled bet ($0.05) returned to d390717b
*** SHOWDOWN ***
d390717b collected $0.1 from pot
*** SUMMARY ***
Total pot $0.1 | Rake $0 | Jackpot $0 | Bingo $0 | Fortune $0 | Tax $0
Seat 1: Hero folded before Flop (didn't bet)
Seat 2: 6a3cddfe (button) folded before Flop (didn't bet)
Seat 3: 21b26b1d (small blind) folded before Flop
Seat 4: d390717b (big blind) collected ($0.1)
Seat 5: f379676 folded before Flop (didn't bet)
Seat 6: 441cc42e folded before Flop (didn't bet)


Poker Hand #HD1808727156: Hold'em No Limit ($0.05/$0.1) - 2024/06/10 01:16:38
Table 'NLHRed12' 6-max Seat #1 is the button
Seat 1: Hero ($11.49 in chips)
Seat 2: 6a3cddfe ($15.41 in chips)
Seat 3: 21b26b1d ($10.15 in chips)
Seat 4: d390717b ($12.84 in chips)
Seat 5: f379676 ($12.49 in chips)
Seat 6: 441cc42e ($10 in chips)
6a3cddfe: posts small blind $0.05
21b26b1d: posts big blind $0.1
*** HOLE CARDS ***
Dealt to Hero [8d Jh]
Dealt to 6a3cddfe 
Dealt to 21b26b1d 
Dealt to d390717b 
Dealt to f379676 
Dealt to 441cc42e 
d390717b: folds
f379676: folds
441cc42e: folds
Hero: folds
6a3cddfe: folds
Uncalled bet ($0.05) returned to 21b26b1d
*** SHOWDOWN ***
21b26b1d collected $0.1 from pot
*** SUMMARY ***
Total pot $0.1 | Rake $0 | Jackpot $0 | Bingo $0 | Fortune $0 | Tax $0
Seat 1: Hero (button) folded before Flop (didn't bet)
Seat 2: 6a3cddfe (small blind) folded before Flop
Seat 3: 21b26b1d (big blind) collected ($0.1)
Seat 4: d390717b folded before Flop (didn't bet)
Seat 5: f379676 folded before Flop (didn't bet)
Seat 6: 441cc42e folded before Flop (didn't bet)


Poker Hand #HD1808727123: Hold'em No Limit ($0.05/$0.1) - 2024/06/10 01:16:08
Table 'NLHRed12' 6-max Seat #6 is the button
Seat 1: Hero ($11.54 in chips)
Seat 2: 6a3cddfe ($15.13 in chips)
Seat 3: 21b26b1d ($10.15 in chips)
Seat 4: d390717b ($12.84 in chips)
Seat 5: f379676 ($12.49 in chips)
Seat 6: 441cc42e ($10 in chips)
Hero: posts small blind $0.05
6a3cddfe: posts big blind $0.1
*** HOLE CARDS ***
Dealt to Hero [Qd 4h]
Dealt to 6a3cddfe 
Dealt to 21b26b1d 
Dealt to d390717b 
Dealt to f379676 
Dealt to 441cc42e 
21b26b1d: folds
d390717b: folds
f379676: folds
441cc42e: raises $0.15 to $0.25
Hero: folds
6a3cddfe: calls $0.15
*** FLOP *** [Kc Qh 5s]
6a3cddfe: bets $0.42
441cc42e: folds
Uncalled bet ($0.42) returned to 6a3cddfe
*** SHOWDOWN ***
6a3cddfe collected $0.53 from pot
*** SUMMARY ***
Total pot $0.55 | Rake $0.02 | Jackpot $0 | Bingo $0 | Fortune $0 | Tax $0
Board [Kc Qh 5s]
Seat 1: Hero (small blind) folded before Flop
Seat 2: 6a3cddfe (big blind) won ($0.53)
Seat 3: 21b26b1d folded before Flop (didn't bet)
Seat 4: d390717b folded before Flop (didn't bet)
Seat 5: f379676 folded before Flop (didn't bet)
Seat 6: 441cc42e (button) folded on the Flop


Poker Hand #HD1808727116: Hold'em No Limit ($0.05/$0.1) - 2024/06/10 01:15:55
Table 'NLHRed12' 6-max Seat #5 is the button
Seat 1: Hero ($11.64 in chips)
Seat 2: 6a3cddfe ($15.13 in chips)
Seat 3: 21b26b1d ($10.15 in chips)
Seat 4: d390717b ($12.84 in chips)
Seat 5: f379676 ($12.34 in chips)
Seat 6: 441cc42e ($10 in chips)
441cc42e: posts small blind $0.05
Hero: posts big blind $0.1
*** HOLE CARDS ***
Dealt to Hero [2d Tc]
Dealt to 6a3cddfe 
Dealt to 21b26b1d 
Dealt to d390717b 
Dealt to f379676 
Dealt to 441cc42e 
6a3cddfe: folds
21b26b1d: folds
d390717b: folds
f379676: raises $0.15 to $0.25
441cc42e: folds
Hero: folds
Uncalled bet ($0.15) returned to f379676
*** SHOWDOWN ***
f379676 collected $0.25 from pot
*** SUMMARY ***
Total pot $0.25 | Rake $0 | Jackpot $0 | Bingo $0 | Fortune $0 | Tax $0
Seat 1: Hero (big blind) folded before Flop
Seat 2: 6a3cddfe folded before Flop (didn't bet)
Seat 3: 21b26b1d folded before Flop (didn't bet)
Seat 4: d390717b folded before Flop (didn't bet)
Seat 5: f379676 (button) collected ($0.25)
Seat 6: 441cc42e (small blind) folded before Flop


Poker Hand #HD1808727092: Hold'em No Limit ($0.05/$0.1) - 2024/06/10 01:15:34
Table 'NLHRed12' 6-max Seat #4 is the button
Seat 1: Hero ($11.64 in chips)
Seat 2: 6a3cddfe ($15.13 in chips)
Seat 3: 21b26b1d ($10 in chips)
Seat 4: d390717b ($12.84 in chips)
Seat 5: f379676 ($12.39 in chips)
Seat 6: 441cc42e ($10 in chips)
f379676: posts small blind $0.05
441cc42e: posts big blind $0.1
*** HOLE CARDS ***
Dealt to Hero [Ks 5d]
Dealt to 6a3cddfe 
Dealt to 21b26b1d 
Dealt to d390717b 
Dealt to f379676 
Dealt to 441cc42e 
Hero: folds
6a3cddfe: folds
21b26b1d: raises $0.15 to $0.25
d390717b: folds
f379676: folds
441cc42e: folds
Uncalled bet ($0.15) returned to 21b26b1d
*** SHOWDOWN ***
21b26b1d collected $0.25 from pot
*** SUMMARY ***
Total pot $0.25 | Rake $0 | Jackpot $0 | Bingo $0 | Fortune $0 | Tax $0
Seat 1: Hero folded before Flop (didn't bet)
Seat 2: 6a3cddfe folded before Flop (didn't bet)
Seat 3: 21b26b1d collected ($0.25)
Seat 4: d390717b (button) folded before Flop (didn't bet)
Seat 5: f379676 (small blind) folded before Flop
Seat 6: 441cc42e (big blind) folded before Flop


Poker Hand #HD1808727070: Hold'em No Limit ($0.05/$0.1) - 2024/06/10 01:15:19
Table 'NLHRed12' 6-max Seat #3 is the button
Seat 1: Hero ($11.64 in chips)
Seat 2: 6a3cddfe ($14.98 in chips)
Seat 3: 21b26b1d ($10 in chips)
Seat 4: d390717b ($12.89 in chips)
Seat 5: f379676 ($12.49 in chips)
Seat 6: 441cc42e ($10 in chips)
d390717b: posts small blind $0.05
f379676: posts big blind $0.1
*** HOLE CARDS ***
Dealt to Hero [4s 2h]
Dealt to 6a3cddfe 
Dealt to 21b26b1d 
Dealt to d390717b 
Dealt to f379676 
Dealt to 441cc42e 
441cc42e: folds
Hero: folds
6a3cddfe: raises $0.3 to $0.4
21b26b1d: folds
d390717b: folds
f379676: folds
Uncalled bet ($0.3) returned to 6a3cddfe
*** SHOWDOWN ***
6a3cddfe collected $0.25 from pot
*** SUMMARY ***
Total pot $0.25 | Rake $0 | Jackpot $0 | Bingo $0 | Fortune $0 | Tax $0
Seat 1: Hero folded before Flop (didn't bet)
Seat 2: 6a3cddfe collected ($0.25)
Seat 3: 21b26b1d (button) folded before Flop (didn't bet)
Seat 4: d390717b (small blind) folded before Flop
Seat 5: f379676 (big blind) folded before Flop
Seat 6: 441cc42e folded before Flop (didn't bet)


Poker Hand #HD1808727045: Hold'em No Limit ($0.05/$0.1) - 2024/06/10 01:15:03
Table 'NLHRed12' 6-max Seat #2 is the button
Seat 1: Hero ($11.64 in chips)
Seat 2: 6a3cddfe ($14.83 in chips)
Seat 3: 21b26b1d ($10.05 in chips)
Seat 4: d390717b ($12.99 in chips)
Seat 5: f379676 ($12.49 in chips)
Seat 6: 441cc42e ($10 in chips)
21b26b1d: posts small blind $0.05
d390717b: posts big blind $0.1
*** HOLE CARDS ***
Dealt to Hero [6s 9h]
Dealt to 6a3cddfe 
Dealt to 21b26b1d 
Dealt to d390717b 
Dealt to f379676 
Dealt to 441cc42e 
f379676: folds
441cc42e: folds
Hero: folds
6a3cddfe: raises $0.15 to $0.25
21b26b1d: folds
d390717b: folds
Uncalled bet ($0.15) returned to 6a3cddfe
*** SHOWDOWN ***
6a3cddfe collected $0.25 from pot
*** SUMMARY ***
Total pot $0.25 | Rake $0 | Jackpot $0 | Bingo $0 | Fortune $0 | Tax $0
Seat 1: Hero folded before Flop (didn't bet)
Seat 2: 6a3cddfe (button) collected ($0.25)
Seat 3: 21b26b1d (small blind) folded before Flop
Seat 4: d390717b (big blind) folded before Flop
Seat 5: f379676 folded before Flop (didn't bet)
Seat 6: 441cc42e folded before Flop (didn't bet)


Poker Hand #HD1808727021: Hold'em No Limit ($0.05/$0.1) - 2024/06/10 01:14:46
Table 'NLHRed12' 6-max Seat #1 is the button
Seat 1: Hero ($11.49 in chips)
Seat 2: 6a3cddfe ($14.88 in chips)
Seat 3: 21b26b1d ($10.15 in chips)
Seat 4: d390717b ($12.99 in chips)
Seat 5: f379676 ($12.49 in chips)
Seat 6: 441cc42e ($10 in chips)
6a3cddfe: posts small blind $0.05
21b26b1d: posts big blind $0.1
*** HOLE CARDS ***
Dealt to Hero [Jh As]
Dealt to 6a3cddfe 
Dealt to 21b26b1d 
Dealt to d390717b 
Dealt to f379676 
Dealt to 441cc42e 
d390717b: folds
f379676: folds
441cc42e: folds
Hero: raises $0.14 to $0.24
6a3cddfe: folds
21b26b1d: folds
Uncalled bet ($0.14) returned to Hero
*** SHOWDOWN ***
Hero collected $0.25 from pot
*** SUMMARY ***
Total pot $0.25 | Rake $0 | Jackpot $0 | Bingo $0 | Fortune $0 | Tax $0
Seat 1: Hero (button) collected ($0.25)
Seat 2: 6a3cddfe (small blind) folded before Flop
Seat 3: 21b26b1d (big blind) folded before Flop
Seat 4: d390717b folded before Flop (didn't bet)
Seat 5: f379676 folded before Flop (didn't bet)
Seat 6: 441cc42e folded before Flop (didn't bet)


Poker Hand #HD1808726987: Hold'em No Limit ($0.05/$0.1) - 2024/06/10 01:14:20
Table 'NLHRed12' 6-max Seat #6 is the button
Seat 1: Hero ($11.54 in chips)
Seat 2: 6a3cddfe ($14.6 in chips)
Seat 3: 21b26b1d ($10.15 in chips)
Seat 4: d390717b ($12.99 in chips)
Seat 5: f379676 ($12.49 in chips)
Seat 6: 441cc42e ($10 in chips)
Hero: posts small blind $0.05
6a3cddfe: posts big blind $0.1
*** HOLE CARDS ***
Dealt to Hero [9c Qd]
Dealt to 6a3cddfe 
Dealt to 21b26b1d 
Dealt to d390717b 
Dealt to f379676 
Dealt to 441cc42e 
21b26b1d: folds
d390717b: folds
f379676: folds
441cc42e: raises $0.15 to $0.25
Hero: folds
6a3cddfe: calls $0.15
*** FLOP *** [3c 2s Ts]
6a3cddfe: bets $0.28
441cc42e: folds
Uncalled bet ($0.28) returned to 6a3cddfe
*** SHOWDOWN ***
6a3cddfe collected $0.53 from pot
*** SUMMARY ***
Total pot $0.55 | Rake $0.02 | Jackpot $0 | Bingo $0 | Fortune $0 | Tax $0
Board [3c 2s Ts]
Seat 1: Hero (small blind) folded before Flop
Seat 2: 6a3cddfe (big blind) won ($0.53)
Seat 3: 21b26b1d folded before Flop (didn't bet)
Seat 4: d390717b folded before Flop (didn't bet)
Seat 5: f379676 folded before Flop (didn't bet)
Seat 6: 441cc42e (button) folded on the Flop


Poker Hand #HD1808726966: Hold'em No Limit ($0.05/$0.1) - 2024/06/10 01:14:05
Table 'NLHRed12' 6-max Seat #5 is the button
Seat 1: Hero ($11.64 in chips)
Seat 2: 6a3cddfe ($14.6 in chips)
Seat 3: 21b26b1d ($10 in chips)
Seat 4: d390717b ($12.99 in chips)
Seat 5: f379676 ($12.49 in chips)
Seat 6: 441cc42e ($10 in chips)
441cc42e: posts small blind $0.05
Hero: posts big blind $0.1
*** HOLE CARDS ***
Dealt to Hero [Qc 8s]
Dealt to 6a3cddfe 
Dealt to 21b26b1d 
Dealt to d390717b 
Dealt to f379676 
Dealt to 441cc42e 
6a3cddfe: folds
21b26b1d: raises $0.15 to $0.25
d390717b: folds
f379676: folds
441cc42e: folds
Hero: folds
Uncalled bet ($0.15) returned to 21b26b1d
*** SHOWDOWN ***
21b26b1d collected $0.25 from pot
*** SUMMARY ***
Total pot $0.25 | Rake $0 | Jackpot $0 | Bingo $0 | Fortune $0 | Tax $0
Seat 1: Hero (big blind) folded before Flop
Seat 2: 6a3cddfe folded before Flop (didn't bet)
Seat 3: 21b26b1d collected ($0.25)
Seat 4: d390717b folded before Flop (didn't bet)
Seat 5: f379676 (button) folded before Flop (didn't bet)
Seat 6: 441cc42e (small blind) folded before Flop


Poker Hand #HD1808726913: Hold'em No Limit ($0.05/$0.1) - 2024/06/10 01:13:29
Table 'NLHRed12' 6-max Seat #4 is the button
Seat 1: Hero ($11.64 in chips)
Seat 2: 6a3cddfe ($14.6 in chips)
Seat 3: 21b26b1d ($10 in chips)
Seat 4: d390717b ($13.24 in chips)
Seat 5: f379676 ($12.17 in chips)
Seat 6: 441cc42e ($10 in chips)
f379676: posts small blind $0.05
441cc42e: posts big blind $0.1
*** HOLE CARDS ***
Dealt to Hero [4s Ts]
Dealt to 6a3cddfe 
Dealt to 21b26b1d 
Dealt to d390717b 
Dealt to f379676 
Dealt to 441cc42e 
Hero: folds
6a3cddfe: folds
21b26b1d: folds
d390717b: raises $0.15 to $0.25
f379676: raises $0.9 to $1.15
441cc42e: folds
d390717b: folds
Uncalled bet ($0.9) returned to f379676
*** SHOWDOWN ***
f379676 collected $0.57 from pot
*** SUMMARY ***
Total pot $0.6 | Rake $0.03 | Jackpot $0 | Bingo $0 | Fortune $0 | Tax $0
Seat 1: Hero folded before Flop (didn't bet)
Seat 2: 6a3cddfe folded before Flop (didn't bet)
Seat 3: 21b26b1d folded before Flop (didn't bet)
Seat 4: d390717b (button) folded before Flop
Seat 5: f379676 (small blind) collected ($0.57)
Seat 6: 441cc42e (big blind) folded before Flop


Poker Hand #HD1808726898: Hold'em No Limit ($0.05/$0.1) - 2024/06/10 01:13:16
Table 'NLHRed12' 6-max Seat #3 is the button
Seat 1: Hero ($11.49 in chips)
Seat 2: 6a3cddfe ($14.6 in chips)
Seat 3: 21b26b1d ($10 in chips)
Seat 4: d390717b ($13.29 in chips)
Seat 5: f379676 ($12.27 in chips)
Seat 6: 441cc42e ($10 in chips)
d390717b: posts small blind $0.05
f379676: posts big blind $0.1
*** HOLE CARDS ***
Dealt to Hero [Qc Kd]
Dealt to 6a3cddfe 
Dealt to 21b26b1d 
Dealt to d390717b 
Dealt to f379676 
Dealt to 441cc42e 
441cc42e: folds
Hero: raises $0.1 to $0.2
6a3cddfe: folds
21b26b1d: folds
d390717b: folds
f379676: folds
Uncalled bet ($0.1) returned to Hero
*** SHOWDOWN ***
Hero collected $0.25 from pot
*** SUMMARY ***
Total pot $0.25 | Rake $0 | Jackpot $0 | Bingo $0 | Fortune $0 | Tax $0
Seat 1: Hero collected ($0.25)
Seat 2: 6a3cddfe folded before Flop (didn't bet)
Seat 3: 21b26b1d (button) folded before Flop (didn't bet)
Seat 4: d390717b (small blind) folded before Flop
Seat 5: f379676 (big blind) folded before Flop
Seat 6: 441cc42e folded before Flop (didn't bet)


Poker Hand #HD1808726860: Hold'em No Limit ($0.05/$0.1) - 2024/06/10 01:12:50
Table 'NLHRed12' 6-max Seat #2 is the button
Seat 1: Hero ($11.34 in chips)
Seat 2: 6a3cddfe ($14.6 in chips)
Seat 3: 21b26b1d ($10 in chips)
Seat 4: d390717b ($13.39 in chips)
Seat 5: f379676 ($12.27 in chips)
Seat 6: 441cc42e ($10 in chips)
21b26b1d: posts small blind $0.05
d390717b: posts big blind $0.1
*** HOLE CARDS ***
Dealt to Hero [7d 7s]
Dealt to 6a3cddfe 
Dealt to 21b26b1d 
Dealt to d390717b 
Dealt to f379676 
Dealt to 441cc42e 
f379676: folds
441cc42e: folds
Hero: raises $0.14 to $0.24
6a3cddfe: folds
21b26b1d: folds
d390717b: folds
Uncalled bet ($0.14) returned to Hero
*** SHOWDOWN ***
Hero collected $0.25 from pot
*** SUMMARY ***
Total pot $0.25 | Rake $0 | Jackpot $0 | Bingo $0 | Fortune $0 | Tax $0
Seat 1: Hero collected ($0.25)
Seat 2: 6a3cddfe (button) folded before Flop (didn't bet)
Seat 3: 21b26b1d (small blind) folded before Flop
Seat 4: d390717b (big blind) folded before Flop
Seat 5: f379676 folded before Flop (didn't bet)
Seat 6: 441cc42e folded before Flop (didn't bet)


Poker Hand #HD1808726837: Hold'em No Limit ($0.05/$0.1) - 2024/06/10 01:12:31
Table 'NLHRed12' 6-max Seat #1 is the button
Seat 1: Hero ($11.19 in chips)
Seat 2: 6a3cddfe ($14.65 in chips)
Seat 3: 21b26b1d ($10 in chips)
Seat 4: d390717b ($13.39 in chips)
Seat 5: f379676 ($12.27 in chips)
Seat 6: 441cc42e ($10 in chips)
6a3cddfe: posts small blind $0.05
21b26b1d: posts big blind $0.1
*** HOLE CARDS ***
Dealt to Hero [Ad Qd]
Dealt to 6a3cddfe 
Dealt to 21b26b1d 
Dealt to d390717b 
Dealt to f379676 
Dealt to 441cc42e 
d390717b: folds
f379676: folds
441cc42e: folds
Hero: raises $0.14 to $0.24
6a3cddfe: folds
21b26b1d: folds
Uncalled bet ($0.14) returned to Hero
*** SHOWDOWN ***
Hero collected $0.25 from pot
*** SUMMARY ***
Total pot $0.25 | Rake $0 | Jackpot $0 | Bingo $0 | Fortune $0 | Tax $0
Seat 1: Hero (button) collected ($0.25)
Seat 2: 6a3cddfe (small blind) folded before Flop
Seat 3: 21b26b1d (big blind) folded before Flop
Seat 4: d390717b folded before Flop (didn't bet)
Seat 5: f379676 folded before Flop (didn't bet)
Seat 6: 441cc42e folded before Flop (didn't bet)


Poker Hand #HD1808726800: Hold'em No Limit ($0.05/$0.1) - 2024/06/10 01:12:05
Table 'NLHRed12' 6-max Seat #6 is the button
Seat 1: Hero ($11.09 in chips)
Seat 2: 6a3cddfe ($14.75 in chips)
Seat 3: 21b26b1d ($10 in chips)
Seat 4: d390717b ($13.39 in chips)
Seat 5: f379676 ($12.27 in chips)
Seat 6: 441cc42e ($10 in chips)
Hero: posts small blind $0.05
6a3cddfe: posts big blind $0.1
*** HOLE CARDS ***
Dealt to Hero [Qd Ad]
Dealt to 6a3cddfe 
Dealt to 21b26b1d 
Dealt to d390717b 
Dealt to f379676 
Dealt to 441cc42e 
21b26b1d: folds
d390717b: folds
f379676: folds
441cc42e: folds
Hero: raises $0.2 to $0.3
6a3cddfe: folds
Uncalled bet ($0.2) returned to Hero
*** SHOWDOWN ***
Hero collected $0.2 from pot
*** SUMMARY ***
Total pot $0.2 | Rake $0 | Jackpot $0 | Bingo $0 | Fortune $0 | Tax $0
Seat 1: Hero (small blind) collected ($0.2)
Seat 2: 6a3cddfe (big blind) folded before Flop
Seat 3: 21b26b1d folded before Flop (didn't bet)
Seat 4: d390717b folded before Flop (didn't bet)
Seat 5: f379676 folded before Flop (didn't bet)
Seat 6: 441cc42e (button) folded before Flop (didn't bet)


Poker Hand #HD1808726769: Hold'em No Limit ($0.05/$0.1) - 2024/06/10 01:11:48
Table 'NLHRed12' 6-max Seat #5 is the button
Seat 1: Hero ($11.04 in chips)
Seat 2: 6a3cddfe ($14.75 in chips)
Seat 3: 21b26b1d ($10 in chips)
Seat 4: d390717b ($13.39 in chips)
Seat 5: f379676 ($12.27 in chips)
Seat 6: 441cc42e ($10 in chips)
441cc42e: posts small blind $0.05
Hero: posts big blind $0.1
*** HOLE CARDS ***
Dealt to Hero [4c 9s]
Dealt to 6a3cddfe 
Dealt to 21b26b1d 
Dealt to d390717b 
Dealt to f379676 
Dealt to 441cc42e 
6a3cddfe: folds
21b26b1d: folds
d390717b: folds
f379676: folds
441cc42e: folds
Uncalled bet ($0.05) returned to Hero
*** SHOWDOWN ***
Hero collected $0.1 from pot
*** SUMMARY ***
Total pot $0.1 | Rake $0 | Jackpot $0 | Bingo $0 | Fortune $0 | Tax $0
Seat 1: Hero (big blind) collected ($0.1)
Seat 2: 6a3cddfe folded before Flop (didn't bet)
Seat 3: 21b26b1d folded before Flop (didn't bet)
Seat 4: d390717b folded before Flop (didn't bet)
Seat 5: f379676 (button) folded before Flop (didn't bet)
Seat 6: 441cc42e (small blind) folded before Flop


Poker Hand #HD1808726733: Hold'em No Limit ($0.05/$0.1) - 2024/06/10 01:11:28
Table 'NLHRed12' 6-max Seat #4 is the button
Seat 1: Hero ($11.04 in chips)
Seat 2: 6a3cddfe ($14.75 in chips)
Seat 3: 21b26b1d ($10 in chips)
Seat 4: d390717b ($13.39 in chips)
Seat 5: f379676 ($12.17 in chips)
Seat 6: 441cc42e ($10 in chips)
f379676: posts small blind $0.05
441cc42e: posts big blind $0.1
*** HOLE CARDS ***
Dealt to Hero [Td Qh]
Dealt to 6a3cddfe 
Dealt to 21b26b1d 
Dealt to d390717b 
Dealt to f379676 
Dealt to 441cc42e 
Hero: folds
6a3cddfe: folds
21b26b1d: folds
d390717b: folds
f379676: raises $0.2 to $0.3
441cc42e: folds
Uncalled bet ($0.2) returned to f379676
*** SHOWDOWN ***
f379676 collected $0.2 from pot
*** SUMMARY ***
Total pot $0.2 | Rake $0 | Jackpot $0 | Bingo $0 | Fortune $0 | Tax $0
Seat 1: Hero folded before Flop (didn't bet)
Seat 2: 6a3cddfe folded before Flop (didn't bet)
Seat 3: 21b26b1d folded before Flop (didn't bet)
Seat 4: d390717b (button) folded before Flop (didn't bet)
Seat 5: f379676 (small blind) collected ($0.2)
Seat 6: 441cc42e (big blind) folded before Flop


Poker Hand #HD1808726688: Hold'em No Limit ($0.05/$0.1) - 2024/06/10 01:10:53
Table 'NLHRed12' 6-max Seat #3 is the button
Seat 1: Hero ($11.04 in chips)
Seat 2: 6a3cddfe ($15.05 in chips)
Seat 3: 21b26b1d ($10 in chips)
Seat 4: d390717b ($13.44 in chips)
Seat 5: f379676 ($11.85 in chips)
Seat 6: 441cc42e ($10 in chips)
d390717b: posts small blind $0.05
f379676: posts big blind $0.1
*** HOLE CARDS ***
Dealt to Hero [8s 6h]
Dealt to 6a3cddfe 
Dealt to 21b26b1d 
Dealt to d390717b 
Dealt to f379676 
Dealt to 441cc42e 
441cc42e: folds
Hero: folds
6a3cddfe: raises $0.2 to $0.3
21b26b1d: folds
d390717b: folds
f379676: calls $0.2
*** FLOP *** [5h 7c Ad]
f379676: checks
6a3cddfe: checks
*** TURN *** [5h 7c Ad] [Ts]
f379676: checks
6a3cddfe: checks
*** RIVER *** [5h 7c Ad Ts] [5c]
f379676: checks
6a3cddfe: checks
f379676: shows [4h Ah] (Pair of Aces and Pair of Fives)
6a3cddfe: shows [Th 8h] (Pair of Tens and Pair of Fives)
*** SHOWDOWN ***
f379676 collected $0.62 from pot
*** SUMMARY ***
Total pot $0.65 | Rake $0.03 | Jackpot $0 | Bingo $0 | Fortune $0 | Tax $0
Board [5h 7c Ad Ts 5c]
Seat 1: Hero folded before Flop (didn't bet)
Seat 2: 6a3cddfe showed [Th 8h] and lost with Pair of Tens and Pair of Fives
Seat 3: 21b26b1d (button) folded before Flop (didn't bet)
Seat 4: d390717b (small blind) folded before Flop
Seat 5: f379676 (big blind) showed [4h Ah] and won ($0.62) with Pair of Aces and Pair of Fives
Seat 6: 441cc42e folded before Flop (didn't bet)


Poker Hand #HD1808726626: Hold'em No Limit ($0.05/$0.1) - 2024/06/10 01:10:09
Table 'NLHRed12' 6-max Seat #2 is the button
Seat 1: Hero ($10.44 in chips)
Seat 2: 6a3cddfe ($15.05 in chips)
Seat 3: 21b26b1d ($10 in chips)
Seat 4: d390717b ($13.54 in chips)
Seat 5: f379676 ($11.85 in chips)
Seat 6: 441cc42e ($10 in chips)
21b26b1d: posts small blind $0.05
d390717b: posts big blind $0.1
*** HOLE CARDS ***
Dealt to Hero [Kc Jc]
Dealt to 6a3cddfe 
Dealt to 21b26b1d 
Dealt to d390717b 
Dealt to f379676 
Dealt to 441cc42e 
f379676: folds
441cc42e: raises $0.2 to $0.3
Hero: raises $0.2 to $0.5
6a3cddfe: folds
21b26b1d: folds
d390717b: folds
441cc42e: calls $0.2
*** FLOP *** [9d 7h Ad]
441cc42e: checks
Hero: bets $0.4
441cc42e: folds
Uncalled bet ($0.4) returned to Hero
*** SHOWDOWN ***
Hero collected $1.1 from pot
*** SUMMARY ***
Total pot $1.15 | Rake $0.05 | Jackpot $0 | Bingo $0 | Fortune $0 | Tax $0
Board [9d 7h Ad]
Seat 1: Hero won ($1.1)
Seat 2: 6a3cddfe (button) folded before Flop (didn't bet)
Seat 3: 21b26b1d (small blind) folded before Flop
Seat 4: d390717b (big blind) folded before Flop
Seat 5: f379676 folded before Flop (didn't bet)
Seat 6: 441cc42e folded on the Flop


Poker Hand #HD1808726591: Hold'em No Limit ($0.05/$0.1) - 2024/06/10 01:09:48
Table 'NLHRed12' 6-max Seat #1 is the button
Seat 1: Hero ($10.44 in chips)
Seat 2: 6a3cddfe ($14.96 in chips)
Seat 3: 21b26b1d ($10 in chips)
Seat 4: d390717b ($13.54 in chips)
Seat 5: f379676 ($11.85 in chips)
Seat 6: 441cc42e ($10 in chips)
6a3cddfe: posts small blind $0.05
21b26b1d: posts big blind $0.1
*** HOLE CARDS ***
Dealt to Hero [8d Kh]
Dealt to 6a3cddfe 
Dealt to 21b26b1d 
Dealt to d390717b 
Dealt to f379676 
Dealt to 441cc42e 
d390717b: folds
f379676: folds
441cc42e: folds
Hero: folds
6a3cddfe: calls $0.05
21b26b1d: checks
*** FLOP *** [3h 7s 6h]
6a3cddfe: bets $0.15
21b26b1d: folds
Uncalled bet ($0.15) returned to 6a3cddfe
*** SHOWDOWN ***
6a3cddfe collected $0.19 from pot
*** SUMMARY ***
Total pot $0.2 | Rake $0.01 | Jackpot $0 | Bingo $0 | Fortune $0 | Tax $0
Board [3h 7s 6h]
Seat 1: Hero (button) folded before Flop (didn't bet)
Seat 2: 6a3cddfe (small blind) won ($0.19)
Seat 3: 21b26b1d (big blind) folded on the Flop
Seat 4: d390717b folded before Flop (didn't bet)
Seat 5: f379676 folded before Flop (didn't bet)
Seat 6: 441cc42e folded before Flop (didn't bet)


Poker Hand #HD1808726580: Hold'em No Limit ($0.05/$0.1) - 2024/06/10 01:09:39
Table 'NLHRed12' 6-max Seat #6 is the button
Seat 1: Hero ($10.49 in chips)
Seat 2: 6a3cddfe ($14.91 in chips)
Seat 3: 21b26b1d ($10 in chips)
Seat 4: d390717b ($13.54 in chips)
Seat 5: f379676 ($11.85 in chips)
Seat 6: 441cc42e ($10 in chips)
Hero: posts small blind $0.05
6a3cddfe: posts big blind $0.1
*** HOLE CARDS ***
Dealt to Hero [7h Tc]
Dealt to 6a3cddfe 
Dealt to 21b26b1d 
Dealt to d390717b 
Dealt to f379676 
Dealt to 441cc42e 
21b26b1d: folds
d390717b: folds
f379676: folds
441cc42e: folds
Hero: folds
Uncalled bet ($0.05) returned to 6a3cddfe
*** SHOWDOWN ***
6a3cddfe collected $0.1 from pot
*** SUMMARY ***
Total pot $0.1 | Rake $0 | Jackpot $0 | Bingo $0 | Fortune $0 | Tax $0
Seat 1: Hero (small blind) folded before Flop
Seat 2: 6a3cddfe (big blind) collected ($0.1)
Seat 3: 21b26b1d folded before Flop (didn't bet)
Seat 4: d390717b folded before Flop (didn't bet)
Seat 5: f379676 folded before Flop (didn't bet)
Seat 6: 441cc42e (button) folded before Flop (didn't bet)


Poker Hand #HD1808726514: Hold'em No Limit ($0.05/$0.1) - 2024/06/10 01:08:51
Table 'NLHRed12' 6-max Seat #5 is the button
Seat 1: Hero ($10.59 in chips)
Seat 2: 6a3cddfe ($14.91 in chips)
Seat 3: 21b26b1d ($10 in chips)
Seat 4: d390717b ($13.54 in chips)
Seat 5: f379676 ($10 in chips)
Seat 6: 441cc42e ($11.18 in chips)
441cc42e: posts small blind $0.05
Hero: posts big blind $0.1
*** HOLE CARDS ***
Dealt to Hero [2c 6c]
Dealt to 6a3cddfe 
Dealt to 21b26b1d 
Dealt to d390717b 
Dealt to f379676 
Dealt to 441cc42e 
6a3cddfe: folds
21b26b1d: folds
d390717b: folds
f379676: raises $0.15 to $0.25
441cc42e: raises $0.75 to $1
Hero: folds
f379676: calls $0.75
*** FLOP *** [6h 7s Jd]
441cc42e: bets $1.05
f379676: calls $1.05
*** TURN *** [6h 7s Jd] [4d]
441cc42e: checks
f379676: bets $1.39
441cc42e: folds
Uncalled bet ($1.39) returned to f379676
*** SHOWDOWN ***
f379676 collected $3.9 from pot
*** SUMMARY ***
Total pot $4.2 | Rake $0.2 | Jackpot $0.1 | Bingo $0 | Fortune $0 | Tax $0
Board [6h 7s Jd 4d]
Seat 1: Hero (big blind) folded before Flop
Seat 2: 6a3cddfe folded before Flop (didn't bet)
Seat 3: 21b26b1d folded before Flop (didn't bet)
Seat 4: d390717b folded before Flop (didn't bet)
Seat 5: f379676 (button) won ($3.9)
Seat 6: 441cc42e (small blind) folded on the Turn


Poker Hand #HD1808726460: Hold'em No Limit ($0.05/$0.1) - 2024/06/10 01:08:11
Table 'NLHRed12' 6-max Seat #4 is the button
Seat 1: Hero ($10.59 in chips)
Seat 2: 6a3cddfe ($14.91 in chips)
Seat 3: 21b26b1d ($10 in chips)
Seat 4: d390717b ($13.79 in chips)
Seat 5: f379676 ($10 in chips)
Seat 6: 441cc42e ($10.9 in chips)
f379676: posts small blind $0.05
441cc42e: posts big blind $0.1
*** HOLE CARDS ***
Dealt to Hero [4h Jd]
Dealt to 6a3cddfe 
Dealt to 21b26b1d 
Dealt to d390717b 
Dealt to f379676 
Dealt to 441cc42e 
Hero: folds
6a3cddfe: folds
21b26b1d: folds
d390717b: raises $0.15 to $0.25
f379676: folds
441cc42e: calls $0.15
*** FLOP *** [7d 7s 7c]
441cc42e: bets $0.33
d390717b: folds
Uncalled bet ($0.33) returned to 441cc42e
*** SHOWDOWN ***
441cc42e collected $0.53 from pot
*** SUMMARY ***
Total pot $0.55 | Rake $0.02 | Jackpot $0 | Bingo $0 | Fortune $0 | Tax $0
Board [7d 7s 7c]
Seat 1: Hero folded before Flop (didn't bet)
Seat 2: 6a3cddfe folded before Flop (didn't bet)
Seat 3: 21b26b1d folded before Flop (didn't bet)
Seat 4: d390717b (button) folded on the Flop
Seat 5: f379676 (small blind) folded before Flop
Seat 6: 441cc42e (big blind) won ($0.53)


Poker Hand #HD1808726440: Hold'em No Limit ($0.05/$0.1) - 2024/06/10 01:07:55
Table 'NLHRed12' 6-max Seat #3 is the button
Seat 1: Hero ($10.59 in chips)
Seat 2: 6a3cddfe ($14.76 in chips)
Seat 3: 21b26b1d ($10 in chips)
Seat 4: d390717b ($13.84 in chips)
Seat 5: f379676 ($10 in chips)
Seat 6: 441cc42e ($10.9 in chips)
d390717b: posts small blind $0.05
f379676: posts big blind $0.1
*** HOLE CARDS ***
Dealt to Hero [8c Th]
Dealt to 6a3cddfe 
Dealt to 21b26b1d 
Dealt to d390717b 
Dealt to f379676 
Dealt to 441cc42e 
441cc42e: folds
Hero: folds
6a3cddfe: raises $0.2 to $0.3
21b26b1d: folds
d390717b: folds
f379676: folds
Uncalled bet ($0.2) returned to 6a3cddfe
*** SHOWDOWN ***
6a3cddfe collected $0.25 from pot
*** SUMMARY ***
Total pot $0.25 | Rake $0 | Jackpot $0 | Bingo $0 | Fortune $0 | Tax $0
Seat 1: Hero folded before Flop (didn't bet)
Seat 2: 6a3cddfe collected ($0.25)
Seat 3: 21b26b1d (button) folded before Flop (didn't bet)
Seat 4: d390717b (small blind) folded before Flop
Seat 5: f379676 (big blind) folded before Flop
Seat 6: 441cc42e folded before Flop (didn't bet)


Poker Hand #HD1808726335: Hold'em No Limit ($0.05/$0.1) - 2024/06/10 01:06:40
Table 'NLHRed12' 6-max Seat #2 is the button
Seat 1: Hero ($10.59 in chips)
Seat 2: 6a3cddfe ($14.76 in chips)
Seat 3: 21b26b1d ($10.05 in chips)
Seat 4: d390717b ($12.56 in chips)
Seat 5: f379676 ($10 in chips)
Seat 6: 441cc42e ($10.9 in chips)
21b26b1d: posts small blind $0.05
d390717b: posts big blind $0.1
*** HOLE CARDS ***
Dealt to Hero [9d 2d]
Dealt to 6a3cddfe 
Dealt to 21b26b1d 
Dealt to d390717b 
Dealt to f379676 
Dealt to 441cc42e 
f379676: raises $0.15 to $0.25
441cc42e: folds
Hero: folds
6a3cddfe: folds
21b26b1d: folds
d390717b: calls $0.15
*** FLOP *** [5c 7h Kh]
d390717b: checks
f379676: checks
*** TURN *** [5c 7h Kh] [2h]
d390717b: bets $0.28
f379676: calls $0.28
*** RIVER *** [5c 7h Kh 2h] [9s]
d390717b: bets $0.84
f379676: calls $0.84
d390717b: shows [Ah 8h] (Ace High Flush)
f379676: shows [Th Tc] (Pair of Tens)
*** SHOWDOWN ***
d390717b collected $2.65 from pot
*** SUMMARY ***
Total pot $2.79 | Rake $0.14 | Jackpot $0 | Bingo $0 | Fortune $0 | Tax $0
Board [5c 7h Kh 2h 9s]
Seat 1: Hero folded before Flop (didn't bet)
Seat 2: 6a3cddfe (button) folded before Flop (didn't bet)
Seat 3: 21b26b1d (small blind) folded before Flop
Seat 4: d390717b (big blind) showed [Ah 8h] and won ($2.65) with Ace High Flush
Seat 5: f379676 showed [Th Tc] and lost with Pair of Tens
Seat 6: 441cc42e folded before Flop (didn't bet)


Poker Hand #HD1808726284: Hold'em No Limit ($0.05/$0.1) - 2024/06/10 01:06:05
Table 'NLHRed12' 6-max Seat #1 is the button
Seat 1: Hero ($10.59 in chips)
Seat 2: 6a3cddfe ($15.48 in chips)
Seat 3: 21b26b1d ($10.15 in chips)
Seat 4: d390717b ($12.56 in chips)
Seat 5: f379676 ($10 in chips)
Seat 6: 441cc42e ($10.15 in chips)
6a3cddfe: posts small blind $0.05
21b26b1d: posts big blind $0.1
*** HOLE CARDS ***
Dealt to Hero [2h 4s]
Dealt to 6a3cddfe 
Dealt to 21b26b1d 
Dealt to d390717b 
Dealt to f379676 
Dealt to 441cc42e 
d390717b: folds
f379676: folds
441cc42e: raises $0.15 to $0.25
Hero: folds
6a3cddfe: calls $0.2
21b26b1d: folds
*** FLOP *** [3c 4d Ad]
6a3cddfe: checks
441cc42e: bets $0.47
6a3cddfe: calls $0.47
*** TURN *** [3c 4d Ad] [4h]
6a3cddfe: checks
441cc42e: checks
*** RIVER *** [3c 4d Ad 4h] [Ts]
6a3cddfe: checks
441cc42e: checks
6a3cddfe: shows [Kh Kd] (Pair of Kings and Pair of Fours)
441cc42e: shows [Ac 6s] (Pair of Aces and Pair of Fours)
*** SHOWDOWN ***
441cc42e collected $1.47 from pot
*** SUMMARY ***
Total pot $1.54 | Rake $0.07 | Jackpot $0 | Bingo $0 | Fortune $0 | Tax $0
Board [3c 4d Ad 4h Ts]
Seat 1: Hero (button) folded before Flop (didn't bet)
Seat 2: 6a3cddfe (small blind) showed [Kh Kd] and lost with Pair of Kings and Pair of Fours
Seat 3: 21b26b1d (big blind) folded before Flop
Seat 4: d390717b folded before Flop (didn't bet)
Seat 5: f379676 folded before Flop (didn't bet)
Seat 6: 441cc42e showed [Ac 6s] and won ($1.47) with Pair of Aces and Pair of Fours


Poker Hand #HD1808726255: Hold'em No Limit ($0.05/$0.1) - 2024/06/10 01:05:47
Table 'NLHRed12' 6-max Seat #6 is the button
Seat 1: Hero ($10.64 in chips)
Seat 2: 6a3cddfe ($15.58 in chips)
Seat 3: 21b26b1d ($10.15 in chips)
Seat 4: d390717b ($12.56 in chips)
Seat 5: f379676 ($10 in chips)
Seat 6: 441cc42e ($10 in chips)
Hero: posts small blind $0.05
6a3cddfe: posts big blind $0.1
*** HOLE CARDS ***
Dealt to Hero [Th 7c]
Dealt to 6a3cddfe 
Dealt to 21b26b1d 
Dealt to d390717b 
Dealt to f379676 
Dealt to 441cc42e 
21b26b1d: folds
d390717b: folds
f379676: folds
441cc42e: raises $0.15 to $0.25
Hero: folds
6a3cddfe: folds
Uncalled bet ($0.15) returned to 441cc42e
*** SHOWDOWN ***
441cc42e collected $0.25 from pot
*** SUMMARY ***
Total pot $0.25 | Rake $0 | Jackpot $0 | Bingo $0 | Fortune $0 | Tax $0
Seat 1: Hero (small blind) folded before Flop
Seat 2: 6a3cddfe (big blind) folded before Flop
Seat 3: 21b26b1d folded before Flop (didn't bet)
Seat 4: d390717b folded before Flop (didn't bet)
Seat 5: f379676 folded before Flop (didn't bet)
Seat 6: 441cc42e (button) collected ($0.25)


Poker Hand #HD1808726234: Hold'em No Limit ($0.05/$0.1) - 2024/06/10 01:05:35
Table 'NLHRed12' 6-max Seat #5 is the button
Seat 1: Hero ($10.74 in chips)
Seat 2: 6a3cddfe ($15.58 in chips)
Seat 3: 21b26b1d ($10 in chips)
Seat 4: d390717b ($12.56 in chips)
Seat 5: f379676 ($10 in chips)
Seat 6: 441cc42e ($10.05 in chips)
441cc42e: posts small blind $0.05
Hero: posts big blind $0.1
*** HOLE CARDS ***
Dealt to Hero [3d 8c]
Dealt to 6a3cddfe 
Dealt to 21b26b1d 
Dealt to d390717b 
Dealt to f379676 
Dealt to 441cc42e 
6a3cddfe: folds
21b26b1d: raises $0.15 to $0.25
d390717b: folds
f379676: folds
441cc42e: folds
Hero: folds
Uncalled bet ($0.15) returned to 21b26b1d
*** SHOWDOWN ***
21b26b1d collected $0.25 from pot
*** SUMMARY ***
Total pot $0.25 | Rake $0 | Jackpot $0 | Bingo $0 | Fortune $0 | Tax $0
Seat 1: Hero (big blind) folded before Flop
Seat 2: 6a3cddfe folded before Flop (didn't bet)
Seat 3: 21b26b1d collected ($0.25)
Seat 4: d390717b folded before Flop (didn't bet)
Seat 5: f379676 (button) folded before Flop (didn't bet)
Seat 6: 441cc42e (small blind) folded before Flop


Poker Hand #HD1808726211: Hold'em No Limit ($0.05/$0.1) - 2024/06/10 01:05:21
Table 'NLHRed12' 6-max Seat #4 is the button
Seat 1: Hero ($10.59 in chips)
Seat 2: 6a3cddfe ($15.58 in chips)
Seat 3: 21b26b1d ($10 in chips)
Seat 4: d390717b ($12.56 in chips)
Seat 5: f379676 ($10.05 in chips)
Seat 6: 441cc42e ($10.15 in chips)
f379676: posts small blind $0.05
441cc42e: posts big blind $0.1
*** HOLE CARDS ***
Dealt to Hero [7c 7h]
Dealt to 6a3cddfe 
Dealt to 21b26b1d 
Dealt to d390717b 
Dealt to f379676 
Dealt to 441cc42e 
Hero: raises $0.1 to $0.2
6a3cddfe: folds
21b26b1d: folds
d390717b: folds
f379676: folds
441cc42e: folds
Uncalled bet ($0.1) returned to Hero
*** SHOWDOWN ***
Hero collected $0.25 from pot
*** SUMMARY ***
Total pot $0.25 | Rake $0 | Jackpot $0 | Bingo $0 | Fortune $0 | Tax $0
Seat 1: Hero collected ($0.25)
Seat 2: 6a3cddfe folded before Flop (didn't bet)
Seat 3: 21b26b1d folded before Flop (didn't bet)
Seat 4: d390717b (button) folded before Flop (didn't bet)
Seat 5: f379676 (small blind) folded before Flop
Seat 6: 441cc42e (big blind) folded before Flop


Poker Hand #HD1808726197: Hold'em No Limit ($0.05/$0.1) - 2024/06/10 01:05:08
Table 'NLHRed12' 6-max Seat #3 is the button
Seat 1: Hero ($10.59 in chips)
Seat 2: 6a3cddfe ($15.58 in chips)
Seat 3: 21b26b1d ($10 in chips)
Seat 4: d390717b ($12.61 in chips)
Seat 5: f379676 ($10 in chips)
Seat 6: 441cc42e ($10.15 in chips)
d390717b: posts small blind $0.05
f379676: posts big blind $0.1
*** HOLE CARDS ***
Dealt to Hero [6h 8h]
Dealt to 6a3cddfe 
Dealt to 21b26b1d 
Dealt to d390717b 
Dealt to f379676 
Dealt to 441cc42e 
441cc42e: folds
Hero: folds
6a3cddfe: folds
21b26b1d: folds
d390717b: folds
Uncalled bet ($0.05) returned to f379676
*** SHOWDOWN ***
f379676 collected $0.1 from pot
*** SUMMARY ***
Total pot $0.1 | Rake $0 | Jackpot $0 | Bingo $0 | Fortune $0 | Tax $0
Seat 1: Hero folded before Flop (didn't bet)
Seat 2: 6a3cddfe folded before Flop (didn't bet)
Seat 3: 21b26b1d (button) folded before Flop (didn't bet)
Seat 4: d390717b (small blind) folded before Flop
Seat 5: f379676 (big blind) collected ($0.1)
Seat 6: 441cc42e folded before Flop (didn't bet)


Poker Hand #HD1808726172: Hold'em No Limit ($0.05/$0.1) - 2024/06/10 01:04:49
Table 'NLHRed12' 6-max Seat #2 is the button
Seat 1: Hero ($10.59 in chips)
Seat 2: 6a3cddfe ($15.58 in chips)
Seat 3: 21b26b1d ($10 in chips)
Seat 4: d390717b ($12.71 in chips)
Seat 5: f379676 ($10 in chips)
Seat 6: 441cc42e ($10 in chips)
21b26b1d: posts small blind $0.05
d390717b: posts big blind $0.1
*** HOLE CARDS ***
Dealt to Hero [6c Qc]
Dealt to 6a3cddfe 
Dealt to 21b26b1d 
Dealt to d390717b 
Dealt to f379676 
Dealt to 441cc42e 
f379676: folds
441cc42e: raises $0.2 to $0.3
Hero: folds
6a3cddfe: folds
21b26b1d: folds
d390717b: folds
Uncalled bet ($0.2) returned to 441cc42e
*** SHOWDOWN ***
441cc42e collected $0.25 from pot
*** SUMMARY ***
Total pot $0.25 | Rake $0 | Jackpot $0 | Bingo $0 | Fortune $0 | Tax $0
Seat 1: Hero folded before Flop (didn't bet)
Seat 2: 6a3cddfe (button) folded before Flop (didn't bet)
Seat 3: 21b26b1d (small blind) folded before Flop
Seat 4: d390717b (big blind) folded before Flop
Seat 5: f379676 folded before Flop (didn't bet)
Seat 6: 441cc42e collected ($0.25)


Poker Hand #HD1808726052: Hold'em No Limit ($0.05/$0.1) - 2024/06/10 01:03:23
Table 'NLHRed12' 6-max Seat #1 is the button
Seat 1: Hero ($10.59 in chips)
Seat 2: 6a3cddfe ($16.08 in chips)
Seat 3: 21b26b1d ($10 in chips)
Seat 4: d390717b ($12.71 in chips)
Seat 5: f379676 ($10.03 in chips)
Seat 6: 441cc42e ($10 in chips)
6a3cddfe: posts small blind $0.05
21b26b1d: posts big blind $0.1
*** HOLE CARDS ***
Dealt to Hero [6h 3c]
Dealt to 6a3cddfe 
Dealt to 21b26b1d 
Dealt to d390717b 
Dealt to f379676 
Dealt to 441cc42e 
d390717b: folds
f379676: raises $0.15 to $0.25
441cc42e: folds
Hero: folds
6a3cddfe: raises $0.45 to $0.7
21b26b1d: folds
f379676: raises $1.5 to $2.2
6a3cddfe: calls $1.5
*** FLOP *** [6d 6s 8h]
6a3cddfe: checks
f379676: bets $1.2
6a3cddfe: raises $1.2 to $2.4
f379676: calls $1.2
*** TURN *** [6d 6s 8h] [2d]
6a3cddfe: bets $6.98
f379676: calls $5.43 and is all-in
Uncalled bet ($1.55) returned to 6a3cddfe
6a3cddfe: shows [8c 8s] (Eights Full over Sixes)
f379676: shows [Ks Kd] (Pair of Kings and Pair of Sixes)
*** FIRST RIVER *** [6d 6s 8h 2d] [5h]
*** SECOND RIVER *** [6d 6s 8h 2d] [Kc]
*** FIRST SHOWDOWN ***
6a3cddfe collected $9.53 from pot
*** SECOND SHOWDOWN ***
f379676 collected $9.53 from pot
*** SUMMARY ***
Total pot $20.16 | Rake $1 | Jackpot $0.1 | Bingo $0 | Fortune $0 | Tax $0
Hand was run two times
FIRST Board [6d 6s 8h 2d 5h]
SECOND Board [Kc]
Seat 1: Hero (button) folded before Flop (didn't bet)
Seat 2: 6a3cddfe (small blind) showed [8c 8s] and won ($9.53) with Eights Full over Sixes, and lost
Seat 3: 21b26b1d (big blind) folded before Flop
Seat 4: d390717b folded before Flop (didn't bet)
Seat 5: f379676 showed [Ks Kd] and lost with Pair of Kings and Pair of Sixes, and won ($9.53)
Seat 6: 441cc42e folded before Flop (didn't bet)


Poker Hand #HD1808726029: Hold'em No Limit ($0.05/$0.1) - 2024/06/10 01:03:07
Table 'NLHRed12' 6-max Seat #6 is the button
Seat 1: Hero ($10.49 in chips)
Seat 2: 6a3cddfe ($16.18 in chips)
Seat 3: 21b26b1d ($10 in chips)
Seat 4: d390717b ($12.71 in chips)
Seat 5: f379676 ($10.03 in chips)
Seat 6: 441cc42e ($10 in chips)
Hero: posts small blind $0.05
6a3cddfe: posts big blind $0.1
*** HOLE CARDS ***
Dealt to Hero [Ah 5c]
Dealt to 6a3cddfe 
Dealt to 21b26b1d 
Dealt to d390717b 
Dealt to f379676 
Dealt to 441cc42e 
21b26b1d: folds
d390717b: folds
f379676: folds
441cc42e: folds
Hero: raises $0.2 to $0.3
6a3cddfe: folds
Uncalled bet ($0.2) returned to Hero
*** SHOWDOWN ***
Hero collected $0.2 from pot
*** SUMMARY ***
Total pot $0.2 | Rake $0 | Jackpot $0 | Bingo $0 | Fortune $0 | Tax $0
Seat 1: Hero (small blind) collected ($0.2)
Seat 2: 6a3cddfe (big blind) folded before Flop
Seat 3: 21b26b1d folded before Flop (didn't bet)
Seat 4: d390717b folded before Flop (didn't bet)
Seat 5: f379676 folded before Flop (didn't bet)
Seat 6: 441cc42e (button) folded before Flop (didn't bet)


Poker Hand #HD1808725930: Hold'em No Limit ($0.05/$0.1) - 2024/06/10 01:01:55
Table 'NLHRed12' 6-max Seat #5 is the button
Seat 1: Hero ($10.59 in chips)
Seat 2: 6a3cddfe ($8.49 in chips)
Seat 3: 21b26b1d ($11.53 in chips)
Seat 4: d390717b ($12.71 in chips)
Seat 5: f379676 ($10.03 in chips)
Seat 6: 441cc42e ($10.05 in chips)
441cc42e: posts small blind $0.05
Hero: posts big blind $0.1
*** HOLE CARDS ***
Dealt to Hero [Ac 3d]
Dealt to 6a3cddfe 
Dealt to 21b26b1d 
Dealt to d390717b 
Dealt to f379676 
Dealt to 441cc42e 
6a3cddfe: raises $0.3 to $0.4
21b26b1d: raises $0.72 to $1.12
d390717b: folds
f379676: folds
441cc42e: folds
Hero: folds
6a3cddfe: calls $0.72
*** FLOP *** [Kh 5d 5c]
6a3cddfe: checks
21b26b1d: bets $1.58
6a3cddfe: calls $1.58
*** TURN *** [Kh 5d 5c] [7c]
6a3cddfe: checks
21b26b1d: bets $8.83 and is all-in
6a3cddfe: calls $5.79 and is all-in
Uncalled bet ($3.04) returned to 21b26b1d
21b26b1d: shows [Kd Qd] (Pair of Kings and Pair of Fives)
6a3cddfe: shows [5h 5s] (Four Fives)
*** RIVER *** [Kh 5d 5c 7c] [Jd]
*** SHOWDOWN ***
6a3cddfe collected $16.18 from pot
*** SUMMARY ***
Total pot $17.13 | Rake $0.85 | Jackpot $0.1 | Bingo $0 | Fortune $0 | Tax $0
Board [Kh 5d 5c 7c Jd]
Seat 1: Hero (big blind) folded before Flop
Seat 2: 6a3cddfe showed [5h 5s] and won ($16.18) with Four Fives
Seat 3: 21b26b1d showed [Kd Qd] and lost with Pair of Kings and Pair of Fives
Seat 4: d390717b folded before Flop (didn't bet)
Seat 5: f379676 (button) folded before Flop (didn't bet)
Seat 6: 441cc42e (small blind) folded before Flop


Poker Hand #HD1808725896: Hold'em No Limit ($0.05/$0.1) - 2024/06/10 01:01:30
Table 'NLHRed12' 6-max Seat #4 is the button
Seat 1: Hero ($10.59 in chips)
Seat 2: 6a3cddfe ($8.49 in chips)
Seat 3: 21b26b1d ($11.53 in chips)
Seat 4: d390717b ($12.56 in chips)
Seat 5: f379676 ($10.08 in chips)
Seat 6: 441cc42e ($10.15 in chips)
f379676: posts small blind $0.05
441cc42e: posts big blind $0.1
*** HOLE CARDS ***
Dealt to Hero [5h Qh]
Dealt to 6a3cddfe 
Dealt to 21b26b1d 
Dealt to d390717b 
Dealt to f379676 
Dealt to 441cc42e 
Hero: folds
6a3cddfe: folds
21b26b1d: folds
d390717b: raises $0.15 to $0.25
f379676: folds
441cc42e: folds
Uncalled bet ($0.15) returned to d390717b
*** SHOWDOWN ***
d390717b collected $0.25 from pot
*** SUMMARY ***
Total pot $0.25 | Rake $0 | Jackpot $0 | Bingo $0 | Fortune $0 | Tax $0
Seat 1: Hero folded before Flop (didn't bet)
Seat 2: 6a3cddfe folded before Flop (didn't bet)
Seat 3: 21b26b1d folded before Flop (didn't bet)
Seat 4: d390717b (button) collected ($0.25)
Seat 5: f379676 (small blind) folded before Flop
Seat 6: 441cc42e (big blind) folded before Flop


Poker Hand #HD1808725865: Hold'em No Limit ($0.05/$0.1) - 2024/06/10 01:01:13
Table 'NLHRed12' 6-max Seat #3 is the button
Seat 1: Hero ($10.59 in chips)
Seat 2: 6a3cddfe ($8.49 in chips)
Seat 3: 21b26b1d ($11.38 in chips)
Seat 4: d390717b ($12.61 in chips)
Seat 5: f379676 ($10.18 in chips)
Seat 6: 441cc42e ($10.15 in chips)
d390717b: posts small blind $0.05
f379676: posts big blind $0.1
*** HOLE CARDS ***
Dealt to Hero [2d 3s]
Dealt to 6a3cddfe 
Dealt to 21b26b1d 
Dealt to d390717b 
Dealt to f379676 
Dealt to 441cc42e 
441cc42e: folds
Hero: folds
6a3cddfe: folds
21b26b1d: raises $0.15 to $0.25
d390717b: folds
f379676: folds
Uncalled bet ($0.15) returned to 21b26b1d
*** SHOWDOWN ***
21b26b1d collected $0.25 from pot
*** SUMMARY ***
Total pot $0.25 | Rake $0 | Jackpot $0 | Bingo $0 | Fortune $0 | Tax $0
Seat 1: Hero folded before Flop (didn't bet)
Seat 2: 6a3cddfe folded before Flop (didn't bet)
Seat 3: 21b26b1d (button) collected ($0.25)
Seat 4: d390717b (small blind) folded before Flop
Seat 5: f379676 (big blind) folded before Flop
Seat 6: 441cc42e folded before Flop (didn't bet)


Poker Hand #HD1808725831: Hold'em No Limit ($0.05/$0.1) - 2024/06/10 01:00:56
Table 'NLHRed12' 6-max Seat #2 is the button
Seat 1: Hero ($10.44 in chips)
Seat 2: 6a3cddfe ($8.49 in chips)
Seat 3: 21b26b1d ($11.43 in chips)
Seat 4: d390717b ($12.71 in chips)
Seat 5: f379676 ($10.18 in chips)
Seat 6: 441cc42e ($10.15 in chips)
21b26b1d: posts small blind $0.05
d390717b: posts big blind $0.1
*** HOLE CARDS ***
Dealt to Hero [Qh Ac]
Dealt to 6a3cddfe 
Dealt to 21b26b1d 
Dealt to d390717b 
Dealt to f379676 
Dealt to 441cc42e 
f379676: folds
441cc42e: folds
Hero: raises $0.14 to $0.24
6a3cddfe: folds
21b26b1d: folds
d390717b: folds
Uncalled bet ($0.14) returned to Hero
*** SHOWDOWN ***
Hero collected $0.25 from pot
*** SUMMARY ***
Total pot $0.25 | Rake $0 | Jackpot $0 | Bingo $0 | Fortune $0 | Tax $0
Seat 1: Hero collected ($0.25)
Seat 2: 6a3cddfe (button) folded before Flop (didn't bet)
Seat 3: 21b26b1d (small blind) folded before Flop
Seat 4: d390717b (big blind) folded before Flop
Seat 5: f379676 folded before Flop (didn't bet)
Seat 6: 441cc42e folded before Flop (didn't bet)


Poker Hand #HD1808725804: Hold'em No Limit ($0.05/$0.1) - 2024/06/10 01:00:36
Table 'NLHRed12' 6-max Seat #1 is the button
Seat 1: Hero ($10.44 in chips)
Seat 2: 6a3cddfe ($8.54 in chips)
Seat 3: 21b26b1d ($11.53 in chips)
Seat 4: d390717b ($12.71 in chips)
Seat 5: f379676 ($10.18 in chips)
Seat 6: 441cc42e ($10 in chips)
6a3cddfe: posts small blind $0.05
21b26b1d: posts big blind $0.1
*** HOLE CARDS ***
Dealt to Hero [4d 4h]
Dealt to 6a3cddfe 
Dealt to 21b26b1d 
Dealt to d390717b 
Dealt to f379676 
Dealt to 441cc42e 
d390717b: folds
f379676: folds
441cc42e: raises $0.15 to $0.25
Hero: folds
6a3cddfe: folds
21b26b1d: folds
Uncalled bet ($0.15) returned to 441cc42e
*** SHOWDOWN ***
441cc42e collected $0.25 from pot
*** SUMMARY ***
Total pot $0.25 | Rake $0 | Jackpot $0 | Bingo $0 | Fortune $0 | Tax $0
Seat 1: Hero (button) folded before Flop (didn't bet)
Seat 2: 6a3cddfe (small blind) folded before Flop
Seat 3: 21b26b1d (big blind) folded before Flop
Seat 4: d390717b folded before Flop (didn't bet)
Seat 5: f379676 folded before Flop (didn't bet)
Seat 6: 441cc42e collected ($0.25)


Poker Hand #HD1808725787: Hold'em No Limit ($0.05/$0.1) - 2024/06/10 01:00:21
Table 'NLHRed12' 6-max Seat #6 is the button
Seat 1: Hero ($10.49 in chips)
Seat 2: 6a3cddfe ($8.49 in chips)
Seat 3: 21b26b1d ($11.53 in chips)
Seat 4: d390717b ($12.71 in chips)
Seat 5: f379676 ($10.18 in chips)
Seat 6: 441cc42e ($10 in chips)
Hero: posts small blind $0.05
6a3cddfe: posts big blind $0.1
*** HOLE CARDS ***
Dealt to Hero [2c Ts]
Dealt to 6a3cddfe 
Dealt to 21b26b1d 
Dealt to d390717b 
Dealt to f379676 
Dealt to 441cc42e 
21b26b1d: folds
d390717b: folds
f379676: folds
441cc42e: folds
Hero: folds
Uncalled bet ($0.05) returned to 6a3cddfe
*** SHOWDOWN ***
6a3cddfe collected $0.1 from pot
*** SUMMARY ***
Total pot $0.1 | Rake $0 | Jackpot $0 | Bingo $0 | Fortune $0 | Tax $0
Seat 1: Hero (small blind) folded before Flop
Seat 2: 6a3cddfe (big blind) collected ($0.1)
Seat 3: 21b26b1d folded before Flop (didn't bet)
Seat 4: d390717b folded before Flop (didn't bet)
Seat 5: f379676 folded before Flop (didn't bet)
Seat 6: 441cc42e (button) folded before Flop (didn't bet)


Poker Hand #HD1808725706: Hold'em No Limit ($0.05/$0.1) - 2024/06/10 00:59:20
Table 'NLHRed12' 6-max Seat #5 is the button
Seat 1: Hero ($10.59 in chips)
Seat 2: 6a3cddfe ($8.49 in chips)
Seat 3: 21b26b1d ($10 in chips)
Seat 4: d390717b ($12.71 in chips)
Seat 5: f379676 ($10.18 in chips)
Seat 6: 441cc42e ($10.97 in chips)
441cc42e: posts small blind $0.05
Hero: posts big blind $0.1
*** HOLE CARDS ***
Dealt to Hero [2d Js]
Dealt to 6a3cddfe 
Dealt to 21b26b1d 
Dealt to d390717b 
Dealt to f379676 
Dealt to 441cc42e 
6a3cddfe: folds
21b26b1d: raises $0.15 to $0.25
d390717b: folds
f379676: folds
441cc42e: calls $0.2
Hero: folds
*** FLOP *** [Jh 8h 5c]
441cc42e: checks
21b26b1d: bets $0.4
441cc42e: calls $0.4
*** TURN *** [Jh 8h 5c] [6d]
441cc42e: checks
21b26b1d: bets $1.05
441cc42e: calls $1.05
*** RIVER *** [Jh 8h 5c 6d] [3h]
441cc42e: checks
21b26b1d: checks
441cc42e: shows [7c 8c] (Pair of Eights)
21b26b1d: shows [Jd Jc] (Three Jacks)
*** SHOWDOWN ***
21b26b1d collected $3.23 from pot
*** SUMMARY ***
Total pot $3.5 | Rake $0.17 | Jackpot $0.1 | Bingo $0 | Fortune $0 | Tax $0
Board [Jh 8h 5c 6d 3h]
Seat 1: Hero (big blind) folded before Flop
Seat 2: 6a3cddfe folded before Flop (didn't bet)
Seat 3: 21b26b1d showed [Jd Jc] and won ($3.23) with Three Jacks
Seat 4: d390717b folded before Flop (didn't bet)
Seat 5: f379676 (button) folded before Flop (didn't bet)
Seat 6: 441cc42e (small blind) showed [7c 8c] and lost with Pair of Eights


Poker Hand #HD1808725691: Hold'em No Limit ($0.05/$0.1) - 2024/06/10 00:59:09
Table 'NLHRed12' 6-max Seat #4 is the button
Seat 1: Hero ($10.59 in chips)
Seat 2: 6a3cddfe ($8.49 in chips)
Seat 3: 21b26b1d ($10 in chips)
Seat 4: d390717b ($12.71 in chips)
Seat 5: f379676 ($10.23 in chips)
Seat 6: 441cc42e ($10.92 in chips)
f379676: posts small blind $0.05
441cc42e: posts big blind $0.1
*** HOLE CARDS ***
Dealt to Hero [Ts 5d]
Dealt to 6a3cddfe 
Dealt to 21b26b1d 
Dealt to d390717b 
Dealt to f379676 
Dealt to 441cc42e 
Hero: folds
6a3cddfe: folds
21b26b1d: folds
d390717b: folds
f379676: folds
Uncalled bet ($0.05) returned to 441cc42e
*** SHOWDOWN ***
441cc42e collected $0.1 from pot
*** SUMMARY ***
Total pot $0.1 | Rake $0 | Jackpot $0 | Bingo $0 | Fortune $0 | Tax $0
Seat 1: Hero folded before Flop (didn't bet)
Seat 2: 6a3cddfe folded before Flop (didn't bet)
Seat 3: 21b26b1d folded before Flop (didn't bet)
Seat 4: d390717b (button) folded before Flop (didn't bet)
Seat 5: f379676 (small blind) folded before Flop
Seat 6: 441cc42e (big blind) collected ($0.1)


Poker Hand #HD1808635630: Hold'em No Limit ($0.05/$0.1) - 2024/06/10 00:58:26
Table 'NLHRed12' 6-max Seat #3 is the button
Seat 1: Hero ($10.59 in chips)
Seat 2: 6a3cddfe ($8.49 in chips)
Seat 3: 21b26b1d ($10 in chips)
Seat 4: d390717b ($12.44 in chips)
Seat 5: f379676 ($10.53 in chips)
Seat 6: 441cc42e ($10.92 in chips)
d390717b: posts small blind $0.05
f379676: posts big blind $0.1
*** HOLE CARDS ***
Dealt to Hero [4d 5c]
Dealt to 6a3cddfe 
Dealt to 21b26b1d 
Dealt to d390717b 
Dealt to f379676 
Dealt to 441cc42e 
441cc42e: folds
Hero: folds
6a3cddfe: folds
21b26b1d: folds
d390717b: raises $0.2 to $0.3
f379676: calls $0.2
*** FLOP *** [9c Ks 7s]
d390717b: checks
f379676: checks
*** TURN *** [9c Ks 7s] [Qs]
d390717b: bets $0.45
f379676: folds
Uncalled bet ($0.45) returned to d390717b
*** SHOWDOWN ***
d390717b collected $0.57 from pot
*** SUMMARY ***
Total pot $0.6 | Rake $0.03 | Jackpot $0 | Bingo $0 | Fortune $0 | Tax $0
Board [9c Ks 7s Qs]
Seat 1: Hero folded before Flop (didn't bet)
Seat 2: 6a3cddfe folded before Flop (didn't bet)
Seat 3: 21b26b1d (button) folded before Flop (didn't bet)
Seat 4: d390717b (small blind) won ($0.57)
Seat 5: f379676 (big blind) folded on the Turn
Seat 6: 441cc42e folded before Flop (didn't bet)


Poker Hand #HD1808635597: Hold'em No Limit ($0.05/$0.1) - 2024/06/10 00:58:01
Table 'NLHRed12' 6-max Seat #2 is the button
Seat 1: Hero ($10.59 in chips)
Seat 2: 6a3cddfe ($8.49 in chips)
Seat 3: 21b26b1d ($10 in chips)
Seat 4: d390717b ($12.54 in chips)
Seat 5: f379676 ($10.53 in chips)
Seat 6: 441cc42e ($10.77 in chips)
21b26b1d: posts small blind $0.05
d390717b: posts big blind $0.1
*** HOLE CARDS ***
Dealt to Hero [Ah 6h]
Dealt to 6a3cddfe 
Dealt to 21b26b1d 
Dealt to d390717b 
Dealt to f379676 
Dealt to 441cc42e 
f379676: folds
441cc42e: raises $0.2 to $0.3
Hero: folds
6a3cddfe: folds
21b26b1d: folds
d390717b: folds
Uncalled bet ($0.2) returned to 441cc42e
*** SHOWDOWN ***
441cc42e collected $0.25 from pot
*** SUMMARY ***
Total pot $0.25 | Rake $0 | Jackpot $0 | Bingo $0 | Fortune $0 | Tax $0
Seat 1: Hero folded before Flop (didn't bet)
Seat 2: 6a3cddfe (button) folded before Flop (didn't bet)
Seat 3: 21b26b1d (small blind) folded before Flop
Seat 4: d390717b (big blind) folded before Flop
Seat 5: f379676 folded before Flop (didn't bet)
Seat 6: 441cc42e collected ($0.25)


Poker Hand #HD1808635574: Hold'em No Limit ($0.05/$0.1) - 2024/06/10 00:57:44
Table 'NLHRed12' 6-max Seat #1 is the button
Seat 1: Hero ($10.44 in chips)
Seat 2: 6a3cddfe ($8.54 in chips)
Seat 3: 21b26b1d ($10 in chips)
Seat 4: d390717b ($12.54 in chips)
Seat 5: f379676 ($10.53 in chips)
Seat 6: 441cc42e ($10.77 in chips)
6a3cddfe: posts small blind $0.05
21b26b1d: posts big blind $0.1
*** HOLE CARDS ***
Dealt to Hero [Ad Td]
Dealt to 6a3cddfe 
Dealt to 21b26b1d 
Dealt to d390717b 
Dealt to f379676 
Dealt to 441cc42e 
d390717b: folds
f379676: folds
441cc42e: folds
Hero: raises $0.14 to $0.24
6a3cddfe: folds
21b26b1d: folds
Uncalled bet ($0.14) returned to Hero
*** SHOWDOWN ***
Hero collected $0.25 from pot
*** SUMMARY ***
Total pot $0.25 | Rake $0 | Jackpot $0 | Bingo $0 | Fortune $0 | Tax $0
Seat 1: Hero (button) collected ($0.25)
Seat 2: 6a3cddfe (small blind) folded before Flop
Seat 3: 21b26b1d (big blind) folded before Flop
Seat 4: d390717b folded before Flop (didn't bet)
Seat 5: f379676 folded before Flop (didn't bet)
Seat 6: 441cc42e folded before Flop (didn't bet)


Poker Hand #HD1808635542: Hold'em No Limit ($0.05/$0.1) - 2024/06/10 00:57:21
Table 'NLHRed12' 6-max Seat #6 is the button
Seat 1: Hero ($10.12 in chips)
Seat 2: 6a3cddfe ($8.64 in chips)
Seat 4: d390717b ($12.54 in chips)
Seat 5: f379676 ($10.53 in chips)
Seat 6: 441cc42e ($11.02 in chips)
Hero: posts small blind $0.05
6a3cddfe: posts big blind $0.1
*** HOLE CARDS ***
Dealt to Hero [8h Ah]
Dealt to 6a3cddfe 
Dealt to d390717b 
Dealt to f379676 
Dealt to 441cc42e 
d390717b: folds
f379676: folds
441cc42e: raises $0.15 to $0.25
Hero: raises $0.85 to $1.1
6a3cddfe: folds
441cc42e: folds
Uncalled bet ($0.85) returned to Hero
*** SHOWDOWN ***
Hero collected $0.57 from pot
*** SUMMARY ***
Total pot $0.6 | Rake $0.03 | Jackpot $0 | Bingo $0 | Fortune $0 | Tax $0
Seat 1: Hero (small blind) collected ($0.57)
Seat 2: 6a3cddfe (big blind) folded before Flop
Seat 4: d390717b folded before Flop (didn't bet)
Seat 5: f379676 folded before Flop (didn't bet)
Seat 6: 441cc42e (button) folded before Flop


Poker Hand #HD1808635522: Hold'em No Limit ($0.05/$0.1) - 2024/06/10 00:57:07
Table 'NLHRed12' 6-max Seat #5 is the button
Seat 1: Hero ($10.22 in chips)
Seat 2: 6a3cddfe ($8.49 in chips)
Seat 4: d390717b ($12.54 in chips)
Seat 5: f379676 ($10.53 in chips)
Seat 6: 441cc42e ($11.07 in chips)
441cc42e: posts small blind $0.05
Hero: posts big blind $0.1
*** HOLE CARDS ***
Dealt to Hero [Ah 7s]
Dealt to 6a3cddfe 
Dealt to d390717b 
Dealt to f379676 
Dealt to 441cc42e 
6a3cddfe: raises $0.2 to $0.3
d390717b: folds
f379676: folds
441cc42e: folds
Hero: folds
Uncalled bet ($0.2) returned to 6a3cddfe
*** SHOWDOWN ***
6a3cddfe collected $0.25 from pot
*** SUMMARY ***
Total pot $0.25 | Rake $0 | Jackpot $0 | Bingo $0 | Fortune $0 | Tax $0
Seat 1: Hero (big blind) folded before Flop
Seat 2: 6a3cddfe collected ($0.25)
Seat 4: d390717b folded before Flop (didn't bet)
Seat 5: f379676 (button) folded before Flop (didn't bet)
Seat 6: 441cc42e (small blind) folded before Flop


Poker Hand #HD1808635473: Hold'em No Limit ($0.05/$0.1) - 2024/06/10 00:56:31
Table 'NLHRed12' 6-max Seat #4 is the button
Seat 1: Hero ($10.22 in chips)
Seat 2: 6a3cddfe ($9.12 in chips)
Seat 4: d390717b ($12.54 in chips)
Seat 5: f379676 ($10.58 in chips)
Seat 6: 441cc42e ($10.45 in chips)
f379676: posts small blind $0.05
441cc42e: posts big blind $0.1
*** HOLE CARDS ***
Dealt to Hero [6h 3s]
Dealt to 6a3cddfe 
Dealt to d390717b 
Dealt to f379676 
Dealt to 441cc42e 
Hero: folds
6a3cddfe: raises $0.2 to $0.3
d390717b: folds
f379676: folds
441cc42e: calls $0.2
*** FLOP *** [7s 2c Td]
441cc42e: checks
6a3cddfe: bets $0.33
441cc42e: raises $0.79 to $1.12
6a3cddfe: folds
Uncalled bet ($0.79) returned to 441cc42e
*** SHOWDOWN ***
441cc42e collected $1.25 from pot
*** SUMMARY ***
Total pot $1.31 | Rake $0.06 | Jackpot $0 | Bingo $0 | Fortune $0 | Tax $0
Board [7s 2c Td]
Seat 1: Hero folded before Flop (didn't bet)
Seat 2: 6a3cddfe folded on the Flop
Seat 4: d390717b (button) folded before Flop (didn't bet)
Seat 5: f379676 (small blind) folded before Flop
Seat 6: 441cc42e (big blind) won ($1.25)


Poker Hand #HD1808635451: Hold'em No Limit ($0.05/$0.1) - 2024/06/10 00:56:13
Table 'NLHRed12' 6-max Seat #2 is the button
Seat 1: Hero ($10.22 in chips)
Seat 2: 6a3cddfe ($8.97 in chips)
Seat 4: d390717b ($12.59 in chips)
Seat 5: f379676 ($10.68 in chips)
Seat 6: 441cc42e ($10.45 in chips)
d390717b: posts small blind $0.05
f379676: posts big blind $0.1
*** HOLE CARDS ***
Dealt to Hero [5s 8s]
Dealt to 6a3cddfe 
Dealt to d390717b 
Dealt to f379676 
Dealt to 441cc42e 
441cc42e: folds
Hero: folds
6a3cddfe: raises $0.3 to $0.4
d390717b: folds
f379676: folds
Uncalled bet ($0.3) returned to 6a3cddfe
*** SHOWDOWN ***
6a3cddfe collected $0.25 from pot
*** SUMMARY ***
Total pot $0.25 | Rake $0 | Jackpot $0 | Bingo $0 | Fortune $0 | Tax $0
Seat 1: Hero folded before Flop (didn't bet)
Seat 2: 6a3cddfe (button) collected ($0.25)
Seat 4: d390717b (small blind) folded before Flop
Seat 5: f379676 (big blind) folded before Flop
Seat 6: 441cc42e folded before Flop (didn't bet)


Poker Hand #HD1808635421: Hold'em No Limit ($0.05/$0.1) - 2024/06/10 00:55:56
Table 'NLHRed12' 6-max Seat #1 is the button
Seat 1: Hero ($10.22 in chips)
Seat 2: 6a3cddfe ($8.87 in chips)
Seat 4: d390717b ($12.69 in chips)
Seat 5: f379676 ($10.68 in chips)
Seat 6: 441cc42e ($10.45 in chips)
6a3cddfe: posts small blind $0.05
d390717b: posts big blind $0.1
*** HOLE CARDS ***
Dealt to Hero [9s 8d]
Dealt to 6a3cddfe 
Dealt to d390717b 
Dealt to f379676 
Dealt to 441cc42e 
f379676: folds
441cc42e: folds
Hero: folds
6a3cddfe: raises $0.2 to $0.3
d390717b: folds
Uncalled bet ($0.2) returned to 6a3cddfe
*** SHOWDOWN ***
6a3cddfe collected $0.2 from pot
*** SUMMARY ***
Total pot $0.2 | Rake $0 | Jackpot $0 | Bingo $0 | Fortune $0 | Tax $0
Seat 1: Hero (button) folded before Flop (didn't bet)
Seat 2: 6a3cddfe (small blind) collected ($0.2)
Seat 4: d390717b (big blind) folded before Flop
Seat 5: f379676 folded before Flop (didn't bet)
Seat 6: 441cc42e folded before Flop (didn't bet)


Poker Hand #HD1808635397: Hold'em No Limit ($0.05/$0.1) - 2024/06/10 00:55:41
Table 'NLHRed12' 6-max Seat #6 is the button
Seat 1: Hero ($10.27 in chips)
Seat 2: 6a3cddfe ($8.82 in chips)
Seat 3: 3d82201c ($10.69 in chips)
Seat 4: d390717b ($12.69 in chips)
Seat 5: f379676 ($10.68 in chips)
Seat 6: 441cc42e ($10.45 in chips)
Hero: posts small blind $0.05
6a3cddfe: posts big blind $0.1
*** HOLE CARDS ***
Dealt to Hero [3s 8c]
Dealt to 6a3cddfe 
Dealt to 3d82201c 
Dealt to d390717b 
Dealt to f379676 
Dealt to 441cc42e 
3d82201c: folds
d390717b: folds
f379676: folds
441cc42e: folds
Hero: folds
Uncalled bet ($0.05) returned to 6a3cddfe
*** SHOWDOWN ***
6a3cddfe collected $0.1 from pot
*** SUMMARY ***
Total pot $0.1 | Rake $0 | Jackpot $0 | Bingo $0 | Fortune $0 | Tax $0
Seat 1: Hero (small blind) folded before Flop
Seat 2: 6a3cddfe (big blind) collected ($0.1)
Seat 3: 3d82201c folded before Flop (didn't bet)
Seat 4: d390717b folded before Flop (didn't bet)
Seat 5: f379676 folded before Flop (didn't bet)
Seat 6: 441cc42e (button) folded before Flop (didn't bet)


Poker Hand #HD1808635316: Hold'em No Limit ($0.05/$0.1) - 2024/06/10 00:54:40
Table 'NLHRed12' 6-max Seat #5 is the button
Seat 1: Hero ($10.37 in chips)
Seat 2: 6a3cddfe ($9.07 in chips)
Seat 3: 3d82201c ($10.32 in chips)
Seat 4: d390717b ($12.69 in chips)
Seat 5: f379676 ($10.68 in chips)
Seat 6: 441cc42e ($10.5 in chips)
441cc42e: posts small blind $0.05
Hero: posts big blind $0.1
*** HOLE CARDS ***
Dealt to Hero [3c 9s]
Dealt to 6a3cddfe 
Dealt to 3d82201c 
Dealt to d390717b 
Dealt to f379676 
Dealt to 441cc42e 
6a3cddfe: raises $0.15 to $0.25
3d82201c: calls $0.25
d390717b: folds
f379676: folds
441cc42e: folds
Hero: folds
*** FLOP *** [4h 6d Qs]
6a3cddfe: checks
3d82201c: checks
*** TURN *** [4h 6d Qs] [3h]
6a3cddfe: checks
3d82201c: checks
*** RIVER *** [4h 6d Qs 3h] [2d]
6a3cddfe: checks
3d82201c: bets $0.33
6a3cddfe: folds
Uncalled bet ($0.33) returned to 3d82201c
*** SHOWDOWN ***
3d82201c collected $0.62 from pot
*** SUMMARY ***
Total pot $0.65 | Rake $0.03 | Jackpot $0 | Bingo $0 | Fortune $0 | Tax $0
Board [4h 6d Qs 3h 2d]
Seat 1: Hero (big blind) folded before Flop
Seat 2: 6a3cddfe folded on the River
Seat 3: 3d82201c won ($0.62)
Seat 4: d390717b folded before Flop (didn't bet)
Seat 5: f379676 (button) folded before Flop (didn't bet)
Seat 6: 441cc42e (small blind) folded before Flop


Poker Hand #HD1808635279: Hold'em No Limit ($0.05/$0.1) - 2024/06/10 00:54:15
Table 'NLHRed12' 6-max Seat #4 is the button
Seat 1: Hero ($10.37 in chips)
Seat 2: 6a3cddfe ($9.07 in chips)
Seat 3: 3d82201c ($10.62 in chips)
Seat 4: d390717b ($12.69 in chips)
Seat 5: f379676 ($10.73 in chips)
Seat 6: 441cc42e ($10.18 in chips)
f379676: posts small blind $0.05
441cc42e: posts big blind $0.1
*** HOLE CARDS ***
Dealt to Hero [4d Jd]
Dealt to 6a3cddfe 
Dealt to 3d82201c 
Dealt to d390717b 
Dealt to f379676 
Dealt to 441cc42e 
Hero: folds
6a3cddfe: folds
3d82201c: raises $0.2 to $0.3
d390717b: folds
f379676: folds
441cc42e: raises $0.9 to $1.2
3d82201c: folds
Uncalled bet ($0.9) returned to 441cc42e
*** SHOWDOWN ***
441cc42e collected $0.62 from pot
*** SUMMARY ***
Total pot $0.65 | Rake $0.03 | Jackpot $0 | Bingo $0 | Fortune $0 | Tax $0
Seat 1: Hero folded before Flop (didn't bet)
Seat 2: 6a3cddfe folded before Flop (didn't bet)
Seat 3: 3d82201c folded before Flop
Seat 4: d390717b (button) folded before Flop (didn't bet)
Seat 5: f379676 (small blind) folded before Flop
Seat 6: 441cc42e (big blind) collected ($0.62)


Poker Hand #HD1808635234: Hold'em No Limit ($0.05/$0.1) - 2024/06/10 00:53:44
Table 'NLHRed12' 6-max Seat #3 is the button
Seat 1: Hero ($10.37 in chips)
Seat 2: 6a3cddfe ($8.92 in chips)
Seat 3: 3d82201c ($10.62 in chips)
Seat 4: d390717b ($12.74 in chips)
Seat 5: f379676 ($10.83 in chips)
Seat 6: 441cc42e ($10.18 in chips)
d390717b: posts small blind $0.05
f379676: posts big blind $0.1
*** HOLE CARDS ***
Dealt to Hero [Kd 3c]
Dealt to 6a3cddfe 
Dealt to 3d82201c 
Dealt to d390717b 
Dealt to f379676 
Dealt to 441cc42e 
441cc42e: folds
Hero: folds
6a3cddfe: raises $0.2 to $0.3
3d82201c: folds
d390717b: folds
f379676: folds
Uncalled bet ($0.2) returned to 6a3cddfe
*** SHOWDOWN ***
6a3cddfe collected $0.25 from pot
*** SUMMARY ***
Total pot $0.25 | Rake $0 | Jackpot $0 | Bingo $0 | Fortune $0 | Tax $0
Seat 1: Hero folded before Flop (didn't bet)
Seat 2: 6a3cddfe collected ($0.25)
Seat 3: 3d82201c (button) folded before Flop (didn't bet)
Seat 4: d390717b (small blind) folded before Flop
Seat 5: f379676 (big blind) folded before Flop
Seat 6: 441cc42e folded before Flop (didn't bet)


Poker Hand #HD1808635195: Hold'em No Limit ($0.05/$0.1) - 2024/06/10 00:53:17
Table 'NLHRed12' 6-max Seat #2 is the button
Seat 1: Hero ($10.37 in chips)
Seat 2: 6a3cddfe ($8.77 in chips)
Seat 3: 3d82201c ($10.67 in chips)
Seat 4: d390717b ($12.84 in chips)
Seat 5: f379676 ($10.83 in chips)
Seat 6: 441cc42e ($10.18 in chips)
3d82201c: posts small blind $0.05
d390717b: posts big blind $0.1
*** HOLE CARDS ***
Dealt to Hero [4s Kd]
Dealt to 6a3cddfe 
Dealt to 3d82201c 
Dealt to d390717b 
Dealt to f379676 
Dealt to 441cc42e 
f379676: folds
441cc42e: folds
Hero: folds
6a3cddfe: raises $0.2 to $0.3
3d82201c: folds
d390717b: folds
Uncalled bet ($0.2) returned to 6a3cddfe
*** SHOWDOWN ***
6a3cddfe collected $0.25 from pot
*** SUMMARY ***
Total pot $0.25 | Rake $0 | Jackpot $0 | Bingo $0 | Fortune $0 | Tax $0
Seat 1: Hero folded before Flop (didn't bet)
Seat 2: 6a3cddfe (button) collected ($0.25)
Seat 3: 3d82201c (small blind) folded before Flop
Seat 4: d390717b (big blind) folded before Flop
Seat 5: f379676 folded before Flop (didn't bet)
Seat 6: 441cc42e folded before Flop (didn't bet)


Poker Hand #HD1808635130: Hold'em No Limit ($0.05/$0.1) - 2024/06/10 00:52:34
Table 'NLHRed12' 6-max Seat #1 is the button
Seat 1: Hero ($10 in chips)
Seat 2: 6a3cddfe ($8.82 in chips)
Seat 3: 3d82201c ($10.77 in chips)
Seat 4: d390717b ($12.84 in chips)
Seat 5: f379676 ($11.08 in chips)
Seat 6: 441cc42e ($10.18 in chips)
6a3cddfe: posts small blind $0.05
3d82201c: posts big blind $0.1
*** HOLE CARDS ***
Dealt to Hero [As Ks]
Dealt to 6a3cddfe 
Dealt to 3d82201c 
Dealt to d390717b 
Dealt to f379676 
Dealt to 441cc42e 
d390717b: folds
f379676: raises $0.15 to $0.25
441cc42e: folds
Hero: raises $0.65 to $0.9
6a3cddfe: folds
3d82201c: folds
f379676: folds
Uncalled bet ($0.65) returned to Hero
*** SHOWDOWN ***
Hero collected $0.62 from pot
*** SUMMARY ***
Total pot $0.65 | Rake $0.03 | Jackpot $0 | Bingo $0 | Fortune $0 | Tax $0
Seat 1: Hero (button) collected ($0.62)
Seat 2: 6a3cddfe (small blind) folded before Flop
Seat 3: 3d82201c (big blind) folded before Flop
Seat 4: d390717b folded before Flop (didn't bet)
Seat 5: f379676 folded before Flop
Seat 6: 441cc42e folded before Flop (didn't bet)


Poker Hand #HD1808635080: Hold'em No Limit ($0.05/$0.1) - 2024/06/10 00:51:56
Table 'NLHRed12' 6-max Seat #6 is the button
Seat 1: Hero ($10 in chips)
Seat 2: 6a3cddfe ($8.67 in chips)
Seat 3: 3d82201c ($10.87 in chips)
Seat 4: d390717b ($12.84 in chips)
Seat 5: f379676 ($11.08 in chips)
Seat 6: 441cc42e ($10.18 in chips)
Hero: posts small blind $0.05
6a3cddfe: posts big blind $0.1
*** HOLE CARDS ***
Dealt to Hero [3s 8h]
Dealt to 6a3cddfe 
Dealt to 3d82201c 
Dealt to d390717b 
Dealt to f379676 
Dealt to 441cc42e 
3d82201c: calls $0.1
d390717b: folds
f379676: folds
441cc42e: folds
Hero: folds
6a3cddfe: raises $0.25 to $0.35
3d82201c: folds
Uncalled bet ($0.25) returned to 6a3cddfe
*** SHOWDOWN ***
6a3cddfe collected $0.25 from pot
*** SUMMARY ***
Total pot $0.25 | Rake $0 | Jackpot $0 | Bingo $0 | Fortune $0 | Tax $0
Seat 1: Hero (small blind) folded before Flop
Seat 2: 6a3cddfe (big blind) collected ($0.25)
Seat 3: 3d82201c folded before Flop
Seat 4: d390717b folded before Flop (didn't bet)
Seat 5: f379676 folded before Flop (didn't bet)
Seat 6: 441cc42e (button) folded before Flop (didn't bet)


Poker Hand #HD1808635011: Hold'em No Limit ($0.05/$0.1) - 2024/06/10 00:50:58
Table 'NLHRed12' 6-max Seat #5 is the button
Seat 1: Hero ($10.01 in chips)
Seat 2: 6a3cddfe ($7.74 in chips)
Seat 3: 3d82201c ($10.87 in chips)
Seat 4: d390717b ($13.71 in chips)
Seat 5: f379676 ($11.08 in chips)
Seat 6: 441cc42e ($10.23 in chips)
441cc42e: posts small blind $0.05
Hero: posts big blind $0.1
*** HOLE CARDS ***
Dealt to Hero [8s 7c]
Dealt to 6a3cddfe 
Dealt to 3d82201c 
Dealt to d390717b 
Dealt to f379676 
Dealt to 441cc42e 
6a3cddfe: raises $0.2 to $0.3
3d82201c: folds
d390717b: calls $0.3
f379676: folds
441cc42e: folds
Hero: folds
*** FLOP *** [Ad Qh 9s]
6a3cddfe: checks
d390717b: checks
*** TURN *** [Ad Qh 9s] [7h]
6a3cddfe: checks
d390717b: bets $0.57
6a3cddfe: calls $0.57
*** RIVER *** [Ad Qh 9s 7h] [Th]
6a3cddfe: checks
d390717b: checks
6a3cddfe: shows [2h 5h] (Queen High Flush)
d390717b: shows [Qc Kc] (Pair of Queens)
*** SHOWDOWN ***
6a3cddfe collected $1.8 from pot
*** SUMMARY ***
Total pot $1.89 | Rake $0.09 | Jackpot $0 | Bingo $0 | Fortune $0 | Tax $0
Board [Ad Qh 9s 7h Th]
Seat 1: Hero (big blind) folded before Flop
Seat 2: 6a3cddfe showed [2h 5h] and won ($1.8) with Queen High Flush
Seat 3: 3d82201c folded before Flop (didn't bet)
Seat 4: d390717b showed [Qc Kc] and lost with Pair of Queens
Seat 5: f379676 (button) folded before Flop (didn't bet)
Seat 6: 441cc42e (small blind) folded before Flop


Poker Hand #HD1808634976: Hold'em No Limit ($0.05/$0.1) - 2024/06/10 00:50:27
Table 'NLHRed12' 6-max Seat #4 is the button
Seat 1: Hero ($10.21 in chips)
Seat 2: 6a3cddfe ($7.74 in chips)
Seat 3: 3d82201c ($10.87 in chips)
Seat 4: d390717b ($13.71 in chips)
Seat 5: f379676 ($11.13 in chips)
Seat 6: 441cc42e ($10 in chips)
f379676: posts small blind $0.05
441cc42e: posts big blind $0.1
*** HOLE CARDS ***
Dealt to Hero [7h 7d]
Dealt to 6a3cddfe 
Dealt to 3d82201c 
Dealt to d390717b 
Dealt to f379676 
Dealt to 441cc42e 
Hero: raises $0.1 to $0.2
6a3cddfe: folds
3d82201c: folds
d390717b: folds
f379676: folds
441cc42e: raises $0.8 to $1
Hero: folds
Uncalled bet ($0.8) returned to 441cc42e
*** SHOWDOWN ***
441cc42e collected $0.43 from pot
*** SUMMARY ***
Total pot $0.45 | Rake $0.02 | Jackpot $0 | Bingo $0 | Fortune $0 | Tax $0
Seat 1: Hero folded before Flop
Seat 2: 6a3cddfe folded before Flop (didn't bet)
Seat 3: 3d82201c folded before Flop (didn't bet)
Seat 4: d390717b (button) folded before Flop (didn't bet)
Seat 5: f379676 (small blind) folded before Flop
Seat 6: 441cc42e (big blind) collected ($0.43)


Poker Hand #HD1808634931: Hold'em No Limit ($0.05/$0.1) - 2024/06/10 00:49:53
Table 'NLHRed12' 6-max Seat #3 is the button
Seat 1: Hero ($10.41 in chips)
Seat 2: 6a3cddfe ($7.94 in chips)
Seat 3: 3d82201c ($10.87 in chips)
Seat 4: d390717b ($13.76 in chips)
Seat 5: f379676 ($10.71 in chips)
d390717b: posts small blind $0.05
f379676: posts big blind $0.1
*** HOLE CARDS ***
Dealt to Hero [Jc 9c]
Dealt to 6a3cddfe 
Dealt to 3d82201c 
Dealt to d390717b 
Dealt to f379676 
Hero: raises $0.1 to $0.2
6a3cddfe: calls $0.2
3d82201c: folds
d390717b: folds
f379676: calls $0.1
*** FLOP *** [5h Ah 2s]
f379676: checks
Hero: checks
6a3cddfe: checks
*** TURN *** [5h Ah 2s] [3h]
f379676: bets $0.49
Hero: folds
6a3cddfe: folds
Uncalled bet ($0.49) returned to f379676
*** SHOWDOWN ***
f379676 collected $0.62 from pot
*** SUMMARY ***
Total pot $0.65 | Rake $0.03 | Jackpot $0 | Bingo $0 | Fortune $0 | Tax $0
Board [5h Ah 2s 3h]
Seat 1: Hero folded on the Turn
Seat 2: 6a3cddfe folded on the Turn
Seat 3: 3d82201c (button) folded before Flop (didn't bet)
Seat 4: d390717b (small blind) folded before Flop
Seat 5: f379676 (big blind) won ($0.62)


Poker Hand #HD1808634877: Hold'em No Limit ($0.05/$0.1) - 2024/06/10 00:49:10
Table 'NLHRed12' 6-max Seat #2 is the button
Seat 1: Hero ($10.09 in chips)
Seat 2: 6a3cddfe ($7.94 in chips)
Seat 3: 3d82201c ($11.11 in chips)
Seat 4: d390717b ($13.86 in chips)
Seat 5: f379676 ($10.71 in chips)
3d82201c: posts small blind $0.05
d390717b: posts big blind $0.1
*** HOLE CARDS ***
Dealt to Hero [9s 9c]
Dealt to 6a3cddfe 
Dealt to 3d82201c 
Dealt to d390717b 
Dealt to f379676 
f379676: folds
Hero: raises $0.14 to $0.24
6a3cddfe: folds
3d82201c: calls $0.19
d390717b: folds
*** FLOP *** [Qc 4s Qs]
3d82201c: checks
Hero: bets $0.3
3d82201c: folds
Uncalled bet ($0.3) returned to Hero
*** SHOWDOWN ***
Hero collected $0.56 from pot
*** SUMMARY ***
Total pot $0.58 | Rake $0.02 | Jackpot $0 | Bingo $0 | Fortune $0 | Tax $0
Board [Qc 4s Qs]
Seat 1: Hero won ($0.56)
Seat 2: 6a3cddfe (button) folded before Flop (didn't bet)
Seat 3: 3d82201c (small blind) folded on the Flop
Seat 4: d390717b (big blind) folded before Flop
Seat 5: f379676 folded before Flop (didn't bet)


Poker Hand #HD1808634841: Hold'em No Limit ($0.05/$0.1) - 2024/06/10 00:48:40
Table 'NLHRed12' 6-max Seat #1 is the button
Seat 1: Hero ($10.09 in chips)
Seat 2: 6a3cddfe ($8.19 in chips)
Seat 3: 3d82201c ($10.88 in chips)
Seat 4: d390717b ($13.86 in chips)
Seat 5: f379676 ($10.71 in chips)
6a3cddfe: posts small blind $0.05
3d82201c: posts big blind $0.1
*** HOLE CARDS ***
Dealt to Hero [Qd 5c]
Dealt to 6a3cddfe 
Dealt to 3d82201c 
Dealt to d390717b 
Dealt to f379676 
d390717b: folds
f379676: folds
Hero: folds
6a3cddfe: raises $0.15 to $0.25
3d82201c: calls $0.15
*** FLOP *** [6h Ac 3d]
6a3cddfe: checks
3d82201c: bets $0.25
6a3cddfe: folds
Uncalled bet ($0.25) returned to 3d82201c
*** SHOWDOWN ***
3d82201c collected $0.48 from pot
*** SUMMARY ***
Total pot $0.5 | Rake $0.02 | Jackpot $0 | Bingo $0 | Fortune $0 | Tax $0
Board [6h Ac 3d]
Seat 1: Hero (button) folded before Flop (didn't bet)
Seat 2: 6a3cddfe (small blind) folded on the Flop
Seat 3: 3d82201c (big blind) won ($0.48)
Seat 4: d390717b folded before Flop (didn't bet)
Seat 5: f379676 folded before Flop (didn't bet)


Poker Hand #HD1808634799: Hold'em No Limit ($0.05/$0.1) - 2024/06/10 00:48:15
Table 'NLHRed12' 6-max Seat #5 is the button
Seat 1: Hero ($10.14 in chips)
Seat 2: 6a3cddfe ($8.29 in chips)
Seat 3: 3d82201c ($10.88 in chips)
Seat 4: d390717b ($13.86 in chips)
Seat 5: f379676 ($10.56 in chips)
Hero: posts small blind $0.05
6a3cddfe: posts big blind $0.1
*** HOLE CARDS ***
Dealt to Hero [4c Td]
Dealt to 6a3cddfe 
Dealt to 3d82201c 
Dealt to d390717b 
Dealt to f379676 
3d82201c: folds
d390717b: folds
f379676: raises $0.1 to $0.2
Hero: folds
6a3cddfe: folds
Uncalled bet ($0.1) returned to f379676
*** SHOWDOWN ***
f379676 collected $0.25 from pot
*** SUMMARY ***
Total pot $0.25 | Rake $0 | Jackpot $0 | Bingo $0 | Fortune $0 | Tax $0
Seat 1: Hero (small blind) folded before Flop
Seat 2: 6a3cddfe (big blind) folded before Flop
Seat 3: 3d82201c folded before Flop (didn't bet)
Seat 4: d390717b folded before Flop (didn't bet)
Seat 5: f379676 (button) collected ($0.25)


Poker Hand #HD1808634729: Hold'em No Limit ($0.05/$0.1) - 2024/06/10 00:47:17
Table 'NLHRed12' 6-max Seat #4 is the button
Seat 1: Hero ($10.14 in chips)
Seat 2: 6a3cddfe ($10 in chips)
Seat 3: 3d82201c ($10.88 in chips)
Seat 4: d390717b ($12.27 in chips)
Seat 5: f379676 ($10.61 in chips)
Seat 6: e8ebd7b4 ($18.19 in chips)
f379676: posts small blind $0.05
e8ebd7b4: posts big blind $0.1
*** HOLE CARDS ***
Dealt to Hero [5h 8d]
Dealt to 6a3cddfe 
Dealt to 3d82201c 
Dealt to d390717b 
Dealt to f379676 
Dealt to e8ebd7b4 
Hero: folds
6a3cddfe: raises $0.25 to $0.35
3d82201c: folds
d390717b: raises $0.65 to $1
f379676: folds
e8ebd7b4: folds
6a3cddfe: calls $0.65
*** FLOP *** [2c Th 3d]
6a3cddfe: checks
d390717b: bets $0.71
6a3cddfe: calls $0.71
*** TURN *** [2c Th 3d] [9d]
6a3cddfe: checks
d390717b: bets $2.09
6a3cddfe: folds
Uncalled bet ($2.09) returned to d390717b
3d82201c: shows [Kd] (King-High)
*** SHOWDOWN ***
d390717b collected $3.3 from pot
*** SUMMARY ***
Total pot $3.57 | Rake $0.17 | Jackpot $0.1 | Bingo $0 | Fortune $0 | Tax $0
Board [2c Th 3d 9d]
Seat 1: Hero folded before Flop (didn't bet)
Seat 2: 6a3cddfe folded on the Turn
Seat 3: 3d82201c folded before Flop (didn't bet)
Seat 4: d390717b (button) won ($3.3)
Seat 5: f379676 (small blind) folded before Flop
Seat 6: e8ebd7b4 (big blind) folded before Flop


Poker Hand #HD1808634686: Hold'em No Limit ($0.05/$0.1) - 2024/06/10 00:46:40
Table 'NLHRed12' 6-max Seat #3 is the button
Seat 1: Hero ($10.38 in chips)
Seat 3: 3d82201c ($10.52 in chips)
Seat 4: d390717b ($12.32 in chips)
Seat 5: f379676 ($10.71 in chips)
Seat 6: e8ebd7b4 ($18.19 in chips)
d390717b: posts small blind $0.05
f379676: posts big blind $0.1
*** HOLE CARDS ***
Dealt to Hero [9s Ad]
Dealt to 3d82201c 
Dealt to d390717b 
Dealt to f379676 
Dealt to e8ebd7b4 
e8ebd7b4: folds
Hero: raises $0.14 to $0.24
3d82201c: raises $10.28 to $10.52 and is all-in
d390717b: folds
f379676: folds
Hero: folds
Uncalled bet ($10.28) returned to 3d82201c
*** SHOWDOWN ***
3d82201c collected $0.6 from pot
*** SUMMARY ***
Total pot $0.63 | Rake $0.03 | Jackpot $0 | Bingo $0 | Fortune $0 | Tax $0
Seat 1: Hero folded before Flop
Seat 3: 3d82201c (button) collected ($0.6)
Seat 4: d390717b (small blind) folded before Flop
Seat 5: f379676 (big blind) folded before Flop
Seat 6: e8ebd7b4 folded before Flop (didn't bet)


Poker Hand #HD1808634616: Hold'em No Limit ($0.05/$0.1) - 2024/06/10 00:45:44
Table 'NLHRed12' 6-max Seat #2 is the button
Seat 1: Hero ($10.38 in chips)
Seat 2: 6a3cddfe ($8.76 in chips)
Seat 3: 3d82201c ($10.57 in chips)
Seat 4: d390717b ($12.42 in chips)
Seat 5: f379676 ($10.71 in chips)
Seat 6: e8ebd7b4 ($10.25 in chips)
3d82201c: posts small blind $0.05
d390717b: posts big blind $0.1
*** HOLE CARDS ***
Dealt to Hero [3h 9c]
Dealt to 6a3cddfe 
Dealt to 3d82201c 
Dealt to d390717b 
Dealt to f379676 
Dealt to e8ebd7b4 
f379676: folds
e8ebd7b4: raises $0.15 to $0.25
Hero: folds
6a3cddfe: calls $0.25
3d82201c: folds
d390717b: folds
*** FLOP *** [7s Qc Jd]
e8ebd7b4: bets $0.49
6a3cddfe: raises $1.23 to $1.72
e8ebd7b4: calls $1.23
*** TURN *** [7s Qc Jd] [Ts]
e8ebd7b4: checks
6a3cddfe: checks
*** RIVER *** [7s Qc Jd Ts] [As]
e8ebd7b4: bets $6.8
6a3cddfe: calls $6.79 and is all-in
Uncalled bet ($0.01) returned to e8ebd7b4
e8ebd7b4: shows [Qh Kh] (Aces-High Straight)
6a3cddfe: shows [Ac Ah] (Three Aces)
*** SHOWDOWN ***
e8ebd7b4 collected $16.7 from pot
*** SUMMARY ***
Total pot $17.67 | Rake $0.87 | Jackpot $0.1 | Bingo $0 | Fortune $0 | Tax $0
Board [7s Qc Jd Ts As]
Seat 1: Hero folded before Flop (didn't bet)
Seat 2: 6a3cddfe (button) showed [Ac Ah] and lost with Three Aces
Seat 3: 3d82201c (small blind) folded before Flop
Seat 4: d390717b (big blind) folded before Flop
Seat 5: f379676 folded before Flop (didn't bet)
Seat 6: e8ebd7b4 showed [Qh Kh] and won ($16.7) with Aces-High Straight


Poker Hand #HD1808634583: Hold'em No Limit ($0.05/$0.1) - 2024/06/10 00:45:17
Table 'NLHRed12' 6-max Seat #1 is the button
Seat 1: Hero ($10.23 in chips)
Seat 2: 6a3cddfe ($8.81 in chips)
Seat 3: 3d82201c ($10.67 in chips)
Seat 4: d390717b ($12.42 in chips)
Seat 5: f379676 ($10.71 in chips)
Seat 6: e8ebd7b4 ($10.25 in chips)
6a3cddfe: posts small blind $0.05
3d82201c: posts big blind $0.1
*** HOLE CARDS ***
Dealt to Hero [Th Ks]
Dealt to 6a3cddfe 
Dealt to 3d82201c 
Dealt to d390717b 
Dealt to f379676 
Dealt to e8ebd7b4 
d390717b: folds
f379676: folds
e8ebd7b4: folds
Hero: raises $0.14 to $0.24
6a3cddfe: folds
3d82201c: folds
Uncalled bet ($0.14) returned to Hero
*** SHOWDOWN ***
Hero collected $0.25 from pot
*** SUMMARY ***
Total pot $0.25 | Rake $0 | Jackpot $0 | Bingo $0 | Fortune $0 | Tax $0
Seat 1: Hero (button) collected ($0.25)
Seat 2: 6a3cddfe (small blind) folded before Flop
Seat 3: 3d82201c (big blind) folded before Flop
Seat 4: d390717b folded before Flop (didn't bet)
Seat 5: f379676 folded before Flop (didn't bet)
Seat 6: e8ebd7b4 folded before Flop (didn't bet)


Poker Hand #HD1808634463: Hold'em No Limit ($0.05/$0.1) - 2024/06/10 00:43:40
Table 'NLHRed12' 6-max Seat #6 is the button
Seat 1: Hero ($10.28 in chips)
Seat 2: 6a3cddfe ($8.19 in chips)
Seat 3: 3d82201c ($11.3 in chips)
Seat 4: d390717b ($12.42 in chips)
Seat 5: f379676 ($10.71 in chips)
Seat 6: e8ebd7b4 ($10.25 in chips)
Hero: posts small blind $0.05
6a3cddfe: posts big blind $0.1
*** HOLE CARDS ***
Dealt to Hero [3h Jc]
Dealt to 6a3cddfe 
Dealt to 3d82201c 
Dealt to d390717b 
Dealt to f379676 
Dealt to e8ebd7b4 
3d82201c: raises $0.2 to $0.3
d390717b: folds
f379676: folds
e8ebd7b4: folds
Hero: folds
6a3cddfe: calls $0.2
*** FLOP *** [9h Kc Kd]
6a3cddfe: checks
3d82201c: bets $0.33
6a3cddfe: calls $0.33
*** TURN *** [9h Kc Kd] [6h]
6a3cddfe: checks
3d82201c: checks
*** RIVER *** [9h Kc Kd 6h] [Qh]
6a3cddfe: bets $0.99
3d82201c: folds
Uncalled bet ($0.99) returned to 6a3cddfe
*** SHOWDOWN ***
6a3cddfe collected $1.25 from pot
*** SUMMARY ***
Total pot $1.31 | Rake $0.06 | Jackpot $0 | Bingo $0 | Fortune $0 | Tax $0
Board [9h Kc Kd 6h Qh]
Seat 1: Hero (small blind) folded before Flop
Seat 2: 6a3cddfe (big blind) won ($1.25)
Seat 3: 3d82201c folded on the River
Seat 4: d390717b folded before Flop (didn't bet)
Seat 5: f379676 folded before Flop (didn't bet)
Seat 6: e8ebd7b4 (button) folded before Flop (didn't bet)


Poker Hand #HD1808634435: Hold'em No Limit ($0.05/$0.1) - 2024/06/10 00:43:21
Table 'NLHRed12' 6-max Seat #5 is the button
Seat 1: Hero ($10.38 in chips)
Seat 2: 6a3cddfe ($8.19 in chips)
Seat 3: 3d82201c ($11.3 in chips)
Seat 4: d390717b ($12.42 in chips)
Seat 5: f379676 ($10.71 in chips)
Seat 6: e8ebd7b4 ($10.15 in chips)
e8ebd7b4: posts small blind $0.05
Hero: posts big blind $0.1
*** HOLE CARDS ***
Dealt to Hero [4s Ah]
Dealt to 6a3cddfe 
Dealt to 3d82201c 
Dealt to d390717b 
Dealt to f379676 
Dealt to e8ebd7b4 
6a3cddfe: folds
3d82201c: folds
d390717b: folds
f379676: folds
e8ebd7b4: raises $0.2 to $0.3
Hero: folds
Uncalled bet ($0.2) returned to e8ebd7b4
*** SHOWDOWN ***
e8ebd7b4 collected $0.2 from pot
*** SUMMARY ***
Total pot $0.2 | Rake $0 | Jackpot $0 | Bingo $0 | Fortune $0 | Tax $0
Seat 1: Hero (big blind) folded before Flop
Seat 2: 6a3cddfe folded before Flop (didn't bet)
Seat 3: 3d82201c folded before Flop (didn't bet)
Seat 4: d390717b folded before Flop (didn't bet)
Seat 5: f379676 (button) folded before Flop (didn't bet)
Seat 6: e8ebd7b4 (small blind) collected ($0.2)


Poker Hand #HD1808634406: Hold'em No Limit ($0.05/$0.1) - 2024/06/10 00:43:01
Table 'NLHRed12' 6-max Seat #4 is the button
Seat 1: Hero ($10.38 in chips)
Seat 2: 6a3cddfe ($8.19 in chips)
Seat 3: 3d82201c ($11.4 in chips)
Seat 4: d390717b ($12.42 in chips)
Seat 5: f379676 ($10.76 in chips)
Seat 6: e8ebd7b4 ($10 in chips)
f379676: posts small blind $0.05
e8ebd7b4: posts big blind $0.1
*** HOLE CARDS ***
Dealt to Hero [3h Ts]
Dealt to 6a3cddfe 
Dealt to 3d82201c 
Dealt to d390717b 
Dealt to f379676 
Dealt to e8ebd7b4 
Hero: folds
6a3cddfe: folds
3d82201c: calls $0.1
d390717b: folds
f379676: folds
e8ebd7b4: raises $0.5 to $0.6
3d82201c: folds
Uncalled bet ($0.5) returned to e8ebd7b4
*** SHOWDOWN ***
e8ebd7b4 collected $0.25 from pot
*** SUMMARY ***
Total pot $0.25 | Rake $0 | Jackpot $0 | Bingo $0 | Fortune $0 | Tax $0
Seat 1: Hero folded before Flop (didn't bet)
Seat 2: 6a3cddfe folded before Flop (didn't bet)
Seat 3: 3d82201c folded before Flop
Seat 4: d390717b (button) folded before Flop (didn't bet)
Seat 5: f379676 (small blind) folded before Flop
Seat 6: e8ebd7b4 (big blind) collected ($0.25)


Poker Hand #HD1808634319: Hold'em No Limit ($0.05/$0.1) - 2024/06/10 00:41:46
Table 'NLHRed12' 6-max Seat #3 is the button
Seat 1: Hero ($10.38 in chips)
Seat 2: 6a3cddfe ($9.87 in chips)
Seat 3: 3d82201c ($9.84 in chips)
Seat 4: d390717b ($12.47 in chips)
Seat 5: f379676 ($10.86 in chips)
d390717b: posts small blind $0.05
f379676: posts big blind $0.1
*** HOLE CARDS ***
Dealt to Hero [Jh 9d]
Dealt to 6a3cddfe 
Dealt to 3d82201c 
Dealt to d390717b 
Dealt to f379676 
Hero: folds
6a3cddfe: raises $0.2 to $0.3
3d82201c: calls $0.3
d390717b: folds
f379676: folds
*** FLOP *** [9h Kh 2d]
6a3cddfe: bets $0.38
3d82201c: calls $0.38
*** TURN *** [9h Kh 2d] [Ad]
6a3cddfe: bets $0.5
3d82201c: raises $0.5 to $1
6a3cddfe: calls $0.5
*** RIVER *** [9h Kh 2d Ad] [8d]
6a3cddfe: checks
3d82201c: checks
6a3cddfe: shows [5h 6h] (Ace-High)
3d82201c: shows [Qh Kd] (Pair of Kings)
*** SHOWDOWN ***
3d82201c collected $3.24 from pot
*** SUMMARY ***
Total pot $3.51 | Rake $0.17 | Jackpot $0.1 | Bingo $0 | Fortune $0 | Tax $0
Board [9h Kh 2d Ad 8d]
Seat 1: Hero folded before Flop (didn't bet)
Seat 2: 6a3cddfe showed [5h 6h] and lost with Ace-High
Seat 3: 3d82201c (button) showed [Qh Kd] and won ($3.24) with Pair of Kings
Seat 4: d390717b (small blind) folded before Flop
Seat 5: f379676 (big blind) folded before Flop


Poker Hand #HD1808634234: Hold'em No Limit ($0.05/$0.1) - 2024/06/10 00:40:37
Table 'NLHRed12' 6-max Seat #2 is the button
Seat 1: Hero ($10.38 in chips)
Seat 2: 6a3cddfe ($9.87 in chips)
Seat 3: 3d82201c ($10.94 in chips)
Seat 4: d390717b ($11.48 in chips)
Seat 5: f379676 ($10.86 in chips)
3d82201c: posts small blind $0.05
d390717b: posts big blind $0.1
*** HOLE CARDS ***
Dealt to Hero [2d 9d]
Dealt to 6a3cddfe 
Dealt to 3d82201c 
Dealt to d390717b 
Dealt to f379676 
f379676: folds
Hero: folds
6a3cddfe: folds
3d82201c: raises $0.2 to $0.3
d390717b: raises $0.6 to $0.9
3d82201c: calls $0.6
*** FLOP *** [7c Js Ac]
3d82201c: checks
d390717b: checks
*** TURN *** [7c Js Ac] [As]
3d82201c: checks
d390717b: checks
*** RIVER *** [7c Js Ac As] [5c]
3d82201c: bets $0.2
d390717b: raises $1.95 to $2.15
3d82201c: folds
Uncalled bet ($1.95) returned to d390717b
*** SHOWDOWN ***
d390717b collected $2.09 from pot
*** SUMMARY ***
Total pot $2.2 | Rake $0.11 | Jackpot $0 | Bingo $0 | Fortune $0 | Tax $0
Board [7c Js Ac As 5c]
Seat 1: Hero folded before Flop (didn't bet)
Seat 2: 6a3cddfe (button) folded before Flop (didn't bet)
Seat 3: 3d82201c (small blind) folded on the River
Seat 4: d390717b (big blind) won ($2.09)
Seat 5: f379676 folded before Flop (didn't bet)


Poker Hand #HD1808634204: Hold'em No Limit ($0.05/$0.1) - 2024/06/10 00:40:11
Table 'NLHRed12' 6-max Seat #1 is the button
Seat 1: Hero ($10.23 in chips)
Seat 2: 6a3cddfe ($9.92 in chips)
Seat 3: 3d82201c ($11.04 in chips)
Seat 4: d390717b ($11.48 in chips)
Seat 5: f379676 ($10.86 in chips)
6a3cddfe: posts small blind $0.05
3d82201c: posts big blind $0.1
*** HOLE CARDS ***
Dealt to Hero [Ah As]
Dealt to 6a3cddfe 
Dealt to 3d82201c 
Dealt to d390717b 
Dealt to f379676 
d390717b: folds
f379676: folds
Hero: raises $0.14 to $0.24
6a3cddfe: folds
3d82201c: folds
Uncalled bet ($0.14) returned to Hero
*** SHOWDOWN ***
Hero collected $0.25 from pot
*** SUMMARY ***
Total pot $0.25 | Rake $0 | Jackpot $0 | Bingo $0 | Fortune $0 | Tax $0
Seat 1: Hero (button) collected ($0.25)
Seat 2: 6a3cddfe (small blind) folded before Flop
Seat 3: 3d82201c (big blind) folded before Flop
Seat 4: d390717b folded before Flop (didn't bet)
Seat 5: f379676 folded before Flop (didn't bet)


Poker Hand #HD1808634124: Hold'em No Limit ($0.05/$0.1) - 2024/06/10 00:39:09
Table 'NLHRed12' 6-max Seat #6 is the button
Seat 1: Hero ($10.28 in chips)
Seat 2: 6a3cddfe ($10.29 in chips)
Seat 3: 3d82201c ($10.3 in chips)
Seat 4: d390717b ($11.48 in chips)
Seat 5: f379676 ($10.86 in chips)
Seat 6: 1307dd77 ($10.12 in chips)
Hero: posts small blind $0.05
6a3cddfe: posts big blind $0.1
*** HOLE CARDS ***
Dealt to Hero [4d Ah]
Dealt to 6a3cddfe 
Dealt to 3d82201c 
Dealt to d390717b 
Dealt to f379676 
Dealt to 1307dd77 
3d82201c: calls $0.1
d390717b: folds
f379676: folds
1307dd77: raises $0.27 to $0.37
Hero: folds
6a3cddfe: calls $0.27
3d82201c: calls $0.27
*** FLOP *** [7d Qh 6h]
6a3cddfe: checks
3d82201c: bets $0.58
1307dd77: folds
6a3cddfe: folds
Uncalled bet ($0.58) returned to 3d82201c
*** SHOWDOWN ***
3d82201c collected $1.11 from pot
*** SUMMARY ***
Total pot $1.16 | Rake $0.05 | Jackpot $0 | Bingo $0 | Fortune $0 | Tax $0
Board [7d Qh 6h]
Seat 1: Hero (small blind) folded before Flop
Seat 2: 6a3cddfe (big blind) folded on the Flop
Seat 3: 3d82201c won ($1.11)
Seat 4: d390717b folded before Flop (didn't bet)
Seat 5: f379676 folded before Flop (didn't bet)
Seat 6: 1307dd77 (button) folded on the Flop


Poker Hand #HD1808634097: Hold'em No Limit ($0.05/$0.1) - 2024/06/10 00:38:53
Table 'NLHRed12' 6-max Seat #5 is the button
Seat 1: Hero ($10.38 in chips)
Seat 2: 6a3cddfe ($10.29 in chips)
Seat 3: 3d82201c ($10.15 in chips)
Seat 4: d390717b ($11.48 in chips)
Seat 5: f379676 ($10.86 in chips)
Seat 6: 1307dd77 ($10.17 in chips)
1307dd77: posts small blind $0.05
Hero: posts big blind $0.1
*** HOLE CARDS ***
Dealt to Hero [8d 2s]
Dealt to 6a3cddfe 
Dealt to 3d82201c 
Dealt to d390717b 
Dealt to f379676 
Dealt to 1307dd77 
6a3cddfe: folds
3d82201c: raises $0.2 to $0.3
d390717b: folds
f379676: folds
1307dd77: folds
Hero: folds
Uncalled bet ($0.2) returned to 3d82201c
*** SHOWDOWN ***
3d82201c collected $0.25 from pot
*** SUMMARY ***
Total pot $0.25 | Rake $0 | Jackpot $0 | Bingo $0 | Fortune $0 | Tax $0
Seat 1: Hero (big blind) folded before Flop
Seat 2: 6a3cddfe folded before Flop (didn't bet)
Seat 3: 3d82201c collected ($0.25)
Seat 4: d390717b folded before Flop (didn't bet)
Seat 5: f379676 (button) folded before Flop (didn't bet)
Seat 6: 1307dd77 (small blind) folded before Flop


Poker Hand #HD1808634064: Hold'em No Limit ($0.05/$0.1) - 2024/06/10 00:38:34
Table 'NLHRed12' 6-max Seat #4 is the button
Seat 1: Hero ($10.38 in chips)
Seat 2: 6a3cddfe ($10.29 in chips)
Seat 3: 3d82201c ($10 in chips)
Seat 4: d390717b ($11.48 in chips)
Seat 5: f379676 ($10.91 in chips)
Seat 6: 1307dd77 ($10.27 in chips)
f379676: posts small blind $0.05
1307dd77: posts big blind $0.1
3d82201c: posts big blind $0.1
*** HOLE CARDS ***
Dealt to Hero [As 2d]
Dealt to 6a3cddfe 
Dealt to 3d82201c 
Dealt to d390717b 
Dealt to f379676 
Dealt to 1307dd77 
Hero: folds
6a3cddfe: folds
3d82201c: raises $0.1 to $0.2
d390717b: folds
f379676: folds
1307dd77: folds
Uncalled bet ($0.1) returned to 3d82201c
*** SHOWDOWN ***
3d82201c collected $0.25 from pot
*** SUMMARY ***
Total pot $0.25 | Rake $0 | Jackpot $0 | Bingo $0 | Fortune $0 | Tax $0
Seat 1: Hero folded before Flop (didn't bet)
Seat 2: 6a3cddfe folded before Flop (didn't bet)
Seat 3: 3d82201c collected ($0.25)
Seat 4: d390717b (button) folded before Flop (didn't bet)
Seat 5: f379676 (small blind) folded before Flop
Seat 6: 1307dd77 (big blind) folded before Flop


Poker Hand #HD1808634018: Hold'em No Limit ($0.05/$0.1) - 2024/06/10 00:38:01
Table 'NLHRed12' 6-max Seat #2 is the button
Seat 1: Hero ($10.38 in chips)
Seat 2: 6a3cddfe ($10.59 in chips)
Seat 3: 2ee9d58e ($10 in chips)
Seat 4: d390717b ($11.58 in chips)
Seat 5: f379676 ($10.91 in chips)
Seat 6: 1307dd77 ($9.85 in chips)
2ee9d58e: posts small blind $0.05
d390717b: posts big blind $0.1
*** HOLE CARDS ***
Dealt to Hero [9h Js]
Dealt to 6a3cddfe 
Dealt to 2ee9d58e 
Dealt to d390717b 
Dealt to f379676 
Dealt to 1307dd77 
f379676: folds
1307dd77: raises $0.2 to $0.3
Hero: folds
6a3cddfe: calls $0.3
2ee9d58e: folds
d390717b: folds
*** FLOP *** [Kh Qs 7d]
1307dd77: bets $0.57
6a3cddfe: folds
Uncalled bet ($0.57) returned to 1307dd77
*** SHOWDOWN ***
1307dd77 collected $0.72 from pot
*** SUMMARY ***
Total pot $0.75 | Rake $0.03 | Jackpot $0 | Bingo $0 | Fortune $0 | Tax $0
Board [Kh Qs 7d]
Seat 1: Hero folded before Flop (didn't bet)
Seat 2: 6a3cddfe (button) folded on the Flop
Seat 3: 2ee9d58e (small blind) folded before Flop
Seat 4: d390717b (big blind) folded before Flop
Seat 5: f379676 folded before Flop (didn't bet)
Seat 6: 1307dd77 won ($0.72)


Poker Hand #HD1808633971: Hold'em No Limit ($0.05/$0.1) - 2024/06/10 00:37:24
Table 'NLHRed12' 6-max Seat #1 is the button
Seat 1: Hero ($10.38 in chips)
Seat 2: 6a3cddfe ($10.05 in chips)
Seat 3: 2ee9d58e ($10 in chips)
Seat 4: d390717b ($11.58 in chips)
Seat 5: f379676 ($10.91 in chips)
Seat 6: 1307dd77 ($9.85 in chips)
6a3cddfe: posts small blind $0.05
2ee9d58e: posts big blind $0.1
*** HOLE CARDS ***
Dealt to Hero [7s 8h]
Dealt to 6a3cddfe 
Dealt to 2ee9d58e 
Dealt to d390717b 
Dealt to f379676 
Dealt to 1307dd77 
d390717b: folds
f379676: folds
1307dd77: folds
Hero: folds
6a3cddfe: raises $0.2 to $0.3
2ee9d58e: calls $0.2
*** FLOP *** [Qs 3d 4c]
6a3cddfe: bets $0.3
2ee9d58e: calls $0.3
*** TURN *** [Qs 3d 4c] [7h]
6a3cddfe: bets $0.6
2ee9d58e: folds
Uncalled bet ($0.6) returned to 6a3cddfe
*** SHOWDOWN ***
6a3cddfe collected $1.14 from pot
*** SUMMARY ***
Total pot $1.2 | Rake $0.06 | Jackpot $0 | Bingo $0 | Fortune $0 | Tax $0
Board [Qs 3d 4c 7h]
Seat 1: Hero (button) folded before Flop (didn't bet)
Seat 2: 6a3cddfe (small blind) won ($1.14)
Seat 3: 2ee9d58e (big blind) folded on the Turn
Seat 4: d390717b folded before Flop (didn't bet)
Seat 5: f379676 folded before Flop (didn't bet)
Seat 6: 1307dd77 folded before Flop (didn't bet)


Poker Hand #HD1808633953: Hold'em No Limit ($0.05/$0.1) - 2024/06/10 00:37:16
Table 'NLHRed12' 6-max Seat #6 is the button
Seat 1: Hero ($10.43 in chips)
Seat 2: 6a3cddfe ($10 in chips)
Seat 4: d390717b ($11.58 in chips)
Seat 5: f379676 ($10.91 in chips)
Seat 6: 1307dd77 ($9.85 in chips)
Hero: posts small blind $0.05
6a3cddfe: posts big blind $0.1
*** HOLE CARDS ***
Dealt to Hero [9c 6h]
Dealt to 6a3cddfe 
Dealt to d390717b 
Dealt to f379676 
Dealt to 1307dd77 
d390717b: folds
f379676: folds
1307dd77: folds
Hero: folds
Uncalled bet ($0.05) returned to 6a3cddfe
*** SHOWDOWN ***
6a3cddfe collected $0.1 from pot
*** SUMMARY ***
Total pot $0.1 | Rake $0 | Jackpot $0 | Bingo $0 | Fortune $0 | Tax $0
Seat 1: Hero (small blind) folded before Flop
Seat 2: 6a3cddfe (big blind) collected ($0.1)
Seat 4: d390717b folded before Flop (didn't bet)
Seat 5: f379676 folded before Flop (didn't bet)
Seat 6: 1307dd77 (button) folded before Flop (didn't bet)


Poker Hand #HD1808633908: Hold'em No Limit ($0.05/$0.1) - 2024/06/10 00:36:44
Table 'NLHRed12' 6-max Seat #5 is the button
Seat 1: Hero ($10.68 in chips)
Seat 2: 6a3cddfe ($10 in chips)
Seat 4: d390717b ($11.58 in chips)
Seat 5: f379676 ($10.63 in chips)
Seat 6: 1307dd77 ($9.9 in chips)
1307dd77: posts small blind $0.05
Hero: posts big blind $0.1
*** HOLE CARDS ***
Dealt to Hero [9s Qd]
Dealt to 6a3cddfe 
Dealt to d390717b 
Dealt to f379676 
Dealt to 1307dd77 
6a3cddfe: folds
d390717b: folds
f379676: raises $0.15 to $0.25
1307dd77: folds
Hero: calls $0.15
*** FLOP *** [Ad 5s Jh]
Hero: checks
f379676: bets $0.14
Hero: folds
Uncalled bet ($0.14) returned to f379676
*** SHOWDOWN ***
f379676 collected $0.53 from pot
*** SUMMARY ***
Total pot $0.55 | Rake $0.02 | Jackpot $0 | Bingo $0 | Fortune $0 | Tax $0
Board [Ad 5s Jh]
Seat 1: Hero (big blind) folded on the Flop
Seat 2: 6a3cddfe folded before Flop (didn't bet)
Seat 4: d390717b folded before Flop (didn't bet)
Seat 5: f379676 (button) won ($0.53)
Seat 6: 1307dd77 (small blind) folded before Flop


Poker Hand #HD1808633892: Hold'em No Limit ($0.05/$0.1) - 2024/06/10 00:36:31
Table 'NLHRed12' 6-max Seat #4 is the button
Seat 1: Hero ($10.68 in chips)
Seat 2: 6a3cddfe ($10 in chips)
Seat 4: d390717b ($11.43 in chips)
Seat 5: f379676 ($10.68 in chips)
Seat 6: 1307dd77 ($2 in chips)
f379676: posts small blind $0.05
1307dd77: posts big blind $0.1
*** HOLE CARDS ***
Dealt to Hero [3d 3s]
Dealt to 6a3cddfe 
Dealt to d390717b 
Dealt to f379676 
Dealt to 1307dd77 
Hero: folds
6a3cddfe: folds
d390717b: raises $0.15 to $0.25
f379676: folds
1307dd77: folds
Uncalled bet ($0.15) returned to d390717b
*** SHOWDOWN ***
d390717b collected $0.25 from pot
*** SUMMARY ***
Total pot $0.25 | Rake $0 | Jackpot $0 | Bingo $0 | Fortune $0 | Tax $0
Seat 1: Hero folded before Flop (didn't bet)
Seat 2: 6a3cddfe folded before Flop (didn't bet)
Seat 4: d390717b (button) collected ($0.25)
Seat 5: f379676 (small blind) folded before Flop
Seat 6: 1307dd77 (big blind) folded before Flop


Poker Hand #HD1808633816: Hold'em No Limit ($0.05/$0.1) - 2024/06/10 00:35:38
Table 'NLHRed12' 6-max Seat #2 is the button
Seat 1: Hero ($10 in chips)
Seat 2: 6a3cddfe ($10 in chips)
Seat 4: d390717b ($12.07 in chips)
Seat 5: f379676 ($10.78 in chips)
d390717b: posts small blind $0.05
f379676: posts big blind $0.1
*** HOLE CARDS ***
Dealt to Hero [9h 9c]
Dealt to 6a3cddfe 
Dealt to d390717b 
Dealt to f379676 
Hero: raises $0.14 to $0.24
6a3cddfe: folds
d390717b: calls $0.19
f379676: folds
*** FLOP *** [6d 6s Ad]
d390717b: checks
Hero: checks
*** TURN *** [6d 6s Ad] [2d]
d390717b: checks
Hero: bets $0.4
d390717b: calls $0.4
*** RIVER *** [6d 6s Ad 2d] [2h]
d390717b: checks
Hero: checks
d390717b: shows [7d 7c] (Pair of Sevens and Pair of Sixes)
Hero: shows [9h 9c] (Pair of Nines and Pair of Sixes)
*** SHOWDOWN ***
Hero collected $1.32 from pot
*** SUMMARY ***
Total pot $1.38 | Rake $0.06 | Jackpot $0 | Bingo $0 | Fortune $0 | Tax $0
Board [6d 6s Ad 2d 2h]
Seat 1: Hero showed [9h 9c] and won ($1.32) with Pair of Nines and Pair of Sixes
Seat 2: 6a3cddfe (button) folded before Flop (didn't bet)
Seat 4: d390717b (small blind) showed [7d 7c] and lost with Pair of Sevens and Pair of Sixes
Seat 5: f379676 (big blind) folded before Flop


Poker Hand #HD1808633744: Hold'em No Limit ($0.05/$0.1) - 2024/06/10 00:34:43
Table 'NLHRed12' 6-max Seat #1 is the button
Seat 1: Hero ($10.57 in chips)
Seat 2: 6a3cddfe ($10.05 in chips)
Seat 3: ef479bd3 ($10.31 in chips)
Seat 4: d390717b ($11.2 in chips)
Seat 5: f379676 ($10.78 in chips)
6a3cddfe: posts small blind $0.05
ef479bd3: posts big blind $0.1
*** HOLE CARDS ***
Dealt to Hero [Ac Kc]
Dealt to 6a3cddfe 
Dealt to ef479bd3 
Dealt to d390717b 
Dealt to f379676 
d390717b: raises $0.14 to $0.24
f379676: folds
Hero: raises $0.56 to $0.8
6a3cddfe: folds
ef479bd3: folds
d390717b: calls $0.56
*** FLOP *** [3s 4s 7h]
d390717b: checks
Hero: checks
*** TURN *** [3s 4s 7h] [3c]
d390717b: bets $1.32
Hero: folds
Uncalled bet ($1.32) returned to d390717b
*** SHOWDOWN ***
d390717b collected $1.67 from pot
*** SUMMARY ***
Total pot $1.75 | Rake $0.08 | Jackpot $0 | Bingo $0 | Fortune $0 | Tax $0
Board [3s 4s 7h 3c]
Seat 1: Hero (button) folded on the Turn
Seat 2: 6a3cddfe (small blind) folded before Flop
Seat 3: ef479bd3 (big blind) folded before Flop
Seat 4: d390717b won ($1.67)
Seat 5: f379676 folded before Flop (didn't bet)


Poker Hand #HD1808633730: Hold'em No Limit ($0.05/$0.1) - 2024/06/10 00:34:33
Table 'NLHRed12' 6-max Seat #5 is the button
Seat 1: Hero ($10.62 in chips)
Seat 2: 6a3cddfe ($10 in chips)
Seat 3: ef479bd3 ($10.31 in chips)
Seat 4: d390717b ($11.2 in chips)
Seat 5: f379676 ($10.78 in chips)
Hero: posts small blind $0.05
6a3cddfe: posts big blind $0.1
*** HOLE CARDS ***
Dealt to Hero [9s 2h]
Dealt to 6a3cddfe 
Dealt to ef479bd3 
Dealt to d390717b 
Dealt to f379676 
ef479bd3: folds
d390717b: folds
f379676: folds
Hero: folds
Uncalled bet ($0.05) returned to 6a3cddfe
*** SHOWDOWN ***
6a3cddfe collected $0.1 from pot
*** SUMMARY ***
Total pot $0.1 | Rake $0 | Jackpot $0 | Bingo $0 | Fortune $0 | Tax $0
Seat 1: Hero (small blind) folded before Flop
Seat 2: 6a3cddfe (big blind) collected ($0.1)
Seat 3: ef479bd3 folded before Flop (didn't bet)
Seat 4: d390717b folded before Flop (didn't bet)
Seat 5: f379676 (button) folded before Flop (didn't bet)


Poker Hand #HD1808633715: Hold'em No Limit ($0.05/$0.1) - 2024/06/10 00:34:23
Table 'NLHRed12' 6-max Seat #4 is the button
Seat 1: Hero ($10.72 in chips)
Seat 3: ef479bd3 ($10.16 in chips)
Seat 4: d390717b ($11.2 in chips)
Seat 5: f379676 ($10.83 in chips)
f379676: posts small blind $0.05
Hero: posts big blind $0.1
*** HOLE CARDS ***
Dealt to Hero [3c 2s]
Dealt to ef479bd3 
Dealt to d390717b 
Dealt to f379676 
ef479bd3: raises $0.1 to $0.2
d390717b: folds
f379676: folds
Hero: folds
Uncalled bet ($0.1) returned to ef479bd3
*** SHOWDOWN ***
ef479bd3 collected $0.25 from pot
*** SUMMARY ***
Total pot $0.25 | Rake $0 | Jackpot $0 | Bingo $0 | Fortune $0 | Tax $0
Seat 1: Hero (big blind) folded before Flop
Seat 3: ef479bd3 collected ($0.25)
Seat 4: d390717b (button) folded before Flop (didn't bet)
Seat 5: f379676 (small blind) folded before Flop


Poker Hand #HD1808633693: Hold'em No Limit ($0.05/$0.1) - 2024/06/10 00:34:05
Table 'NLHRed12' 6-max Seat #3 is the button
Seat 1: Hero ($10.72 in chips)
Seat 3: ef479bd3 ($10.01 in chips)
Seat 4: d390717b ($11.25 in chips)
Seat 5: f379676 ($10.93 in chips)
d390717b: posts small blind $0.05
f379676: posts big blind $0.1
*** HOLE CARDS ***
Dealt to Hero [6d 4c]
Dealt to ef479bd3 
Dealt to d390717b 
Dealt to f379676 
Hero: folds
ef479bd3: raises $0.1 to $0.2
d390717b: folds
f379676: folds
Uncalled bet ($0.1) returned to ef479bd3
*** SHOWDOWN ***
ef479bd3 collected $0.25 from pot
*** SUMMARY ***
Total pot $0.25 | Rake $0 | Jackpot $0 | Bingo $0 | Fortune $0 | Tax $0
Seat 1: Hero folded before Flop (didn't bet)
Seat 3: ef479bd3 (button) collected ($0.25)
Seat 4: d390717b (small blind) folded before Flop
Seat 5: f379676 (big blind) folded before Flop


Poker Hand #HD1808633622: Hold'em No Limit ($0.05/$0.1) - 2024/06/10 00:33:15
Table 'NLHRed12' 6-max Seat #1 is the button
Seat 1: Hero ($10.72 in chips)
Seat 3: ef479bd3 ($9.78 in chips)
Seat 4: d390717b ($11.5 in chips)
Seat 5: f379676 ($10.93 in chips)
ef479bd3: posts small blind $0.05
d390717b: posts big blind $0.1
*** HOLE CARDS ***
Dealt to Hero [4c 2h]
Dealt to ef479bd3 
Dealt to d390717b 
Dealt to f379676 
f379676: folds
Hero: folds
ef479bd3: raises $0.15 to $0.25
d390717b: calls $0.15
*** FLOP *** [Jd As 4s]
ef479bd3: bets $0.1
d390717b: folds
Uncalled bet ($0.1) returned to ef479bd3
*** SHOWDOWN ***
ef479bd3 collected $0.48 from pot
*** SUMMARY ***
Total pot $0.5 | Rake $0.02 | Jackpot $0 | Bingo $0 | Fortune $0 | Tax $0
Board [Jd As 4s]
Seat 1: Hero (button) folded before Flop (didn't bet)
Seat 3: ef479bd3 (small blind) won ($0.48)
Seat 4: d390717b (big blind) folded on the Flop
Seat 5: f379676 folded before Flop (didn't bet)


Poker Hand #HD1808633572: Hold'em No Limit ($0.05/$0.1) - 2024/06/10 00:32:41
Table 'NLHRed12' 6-max Seat #5 is the button
Seat 1: Hero ($10.62 in chips)
Seat 3: ef479bd3 ($9.88 in chips)
Seat 4: d390717b ($11.5 in chips)
Seat 5: f379676 ($10.93 in chips)
Hero: posts small blind $0.05
ef479bd3: posts big blind $0.1
*** HOLE CARDS ***
Dealt to Hero [Kd 6d]
Dealt to ef479bd3 
Dealt to d390717b 
Dealt to f379676 
d390717b: folds
f379676: folds
Hero: raises $0.2 to $0.3
ef479bd3: folds
Uncalled bet ($0.2) returned to Hero
*** SHOWDOWN ***
Hero collected $0.2 from pot
*** SUMMARY ***
Total pot $0.2 | Rake $0 | Jackpot $0 | Bingo $0 | Fortune $0 | Tax $0
Seat 1: Hero (small blind) collected ($0.2)
Seat 3: ef479bd3 (big blind) folded before Flop
Seat 4: d390717b folded before Flop (didn't bet)
Seat 5: f379676 (button) folded before Flop (didn't bet)


Poker Hand #HD1808633531: Hold'em No Limit ($0.05/$0.1) - 2024/06/10 00:32:09
Table 'NLHRed12' 6-max Seat #4 is the button
Seat 1: Hero ($10.87 in chips)
Seat 2: fcbadb16 ($19.79 in chips)
Seat 3: ef479bd3 ($9.6 in chips)
Seat 4: d390717b ($11.5 in chips)
Seat 5: f379676 ($10.98 in chips)
f379676: posts small blind $0.05
Hero: posts big blind $0.1
*** HOLE CARDS ***
Dealt to Hero [Tc Ad]
Dealt to fcbadb16 
Dealt to ef479bd3 
Dealt to d390717b 
Dealt to f379676 
fcbadb16: folds
ef479bd3: raises $0.15 to $0.25
d390717b: folds
f379676: folds
Hero: calls $0.15
*** FLOP *** [2d 3h 9h]
Hero: checks
ef479bd3: bets $0.13
Hero: folds
Uncalled bet ($0.13) returned to ef479bd3
*** SHOWDOWN ***
ef479bd3 collected $0.53 from pot
*** SUMMARY ***
Total pot $0.55 | Rake $0.02 | Jackpot $0 | Bingo $0 | Fortune $0 | Tax $0
Board [2d 3h 9h]
Seat 1: Hero (big blind) folded on the Flop
Seat 2: fcbadb16 folded before Flop (didn't bet)
Seat 3: ef479bd3 won ($0.53)
Seat 4: d390717b (button) folded before Flop (didn't bet)
Seat 5: f379676 (small blind) folded before Flop


Poker Hand #HD1808633457: Hold'em No Limit ($0.05/$0.1) - 2024/06/10 00:31:11
Table 'NLHRed12' 6-max Seat #3 is the button
Seat 1: Hero ($10.87 in chips)
Seat 2: fcbadb16 ($19.28 in chips)
Seat 3: ef479bd3 ($9.6 in chips)
Seat 4: d390717b ($11.55 in chips)
Seat 5: f379676 ($11.08 in chips)
Seat 6: 8bbdeb80 ($28.36 in chips)
d390717b: posts small blind $0.05
f379676: posts big blind $0.1
*** HOLE CARDS ***
Dealt to Hero [2c Qc]
Dealt to fcbadb16 
Dealt to ef479bd3 
Dealt to d390717b 
Dealt to f379676 
Dealt to 8bbdeb80 
8bbdeb80: calls $0.1
Hero: folds
fcbadb16: raises $0.3 to $0.4
ef479bd3: folds
d390717b: folds
f379676: folds
8bbdeb80: calls $0.3
*** FLOP *** [Kh 5d Qh]
8bbdeb80: checks
fcbadb16: bets $0.75
8bbdeb80: folds
Uncalled bet ($0.75) returned to fcbadb16
*** SHOWDOWN ***
fcbadb16 collected $0.91 from pot
*** SUMMARY ***
Total pot $0.95 | Rake $0.04 | Jackpot $0 | Bingo $0 | Fortune $0 | Tax $0
Board [Kh 5d Qh]
Seat 1: Hero folded before Flop (didn't bet)
Seat 2: fcbadb16 won ($0.91)
Seat 3: ef479bd3 (button) folded before Flop (didn't bet)
Seat 4: d390717b (small blind) folded before Flop
Seat 5: f379676 (big blind) folded before Flop
Seat 6: 8bbdeb80 folded on the Flop


Poker Hand #HD1808633356: Hold'em No Limit ($0.05/$0.1) - 2024/06/10 00:30:00
Table 'NLHRed12' 6-max Seat #2 is the button
Seat 1: Hero ($10.87 in chips)
Seat 2: fcbadb16 ($19.28 in chips)
Seat 3: ef479bd3 ($9.9 in chips)
Seat 4: d390717b ($10.99 in chips)
Seat 5: f379676 ($11.08 in chips)
Seat 6: 8bbdeb80 ($28.66 in chips)
ef479bd3: posts small blind $0.05
d390717b: posts big blind $0.1
*** HOLE CARDS ***
Dealt to Hero [8d 4d]
Dealt to fcbadb16 
Dealt to ef479bd3 
Dealt to d390717b 
Dealt to f379676 
Dealt to 8bbdeb80 
f379676: folds
8bbdeb80: calls $0.1
Hero: folds
fcbadb16: folds
ef479bd3: calls $0.05
d390717b: checks
*** FLOP *** [2s 2d 8h]
ef479bd3: bets $0.1
d390717b: calls $0.1
8bbdeb80: calls $0.1
*** TURN *** [2s 2d 8h] [Qd]
ef479bd3: bets $0.1
d390717b: calls $0.1
8bbdeb80: calls $0.1
*** RIVER *** [2s 2d 8h Qd] [7s]
ef479bd3: checks
d390717b: checks
8bbdeb80: checks
ef479bd3: shows [Jc Ts] (Pair of Twos)
d390717b: shows [3h 3d] (Pair of Treys and Pair of Twos)
8bbdeb80: shows [As Th] (Pair of Twos)
*** SHOWDOWN ***
d390717b collected $0.86 from pot
*** SUMMARY ***
Total pot $0.9 | Rake $0.04 | Jackpot $0 | Bingo $0 | Fortune $0 | Tax $0
Board [2s 2d 8h Qd 7s]
Seat 1: Hero folded before Flop (didn't bet)
Seat 2: fcbadb16 (button) folded before Flop (didn't bet)
Seat 3: ef479bd3 (small blind) showed [Jc Ts] and lost with Pair of Twos
Seat 4: d390717b (big blind) showed [3h 3d] and won ($0.86) with Pair of Treys and Pair of Twos
Seat 5: f379676 folded before Flop (didn't bet)
Seat 6: 8bbdeb80 showed [As Th] and lost with Pair of Twos


Poker Hand #HD1808633302: Hold'em No Limit ($0.05/$0.1) - 2024/06/10 00:29:21
Table 'NLHRed12' 6-max Seat #1 is the button
Seat 1: Hero ($10.87 in chips)
Seat 2: fcbadb16 ($19.33 in chips)
Seat 3: ef479bd3 ($10 in chips)
Seat 4: d390717b ($11.21 in chips)
Seat 5: f379676 ($11.08 in chips)
Seat 6: 8bbdeb80 ($28.32 in chips)
fcbadb16: posts small blind $0.05
ef479bd3: posts big blind $0.1
*** HOLE CARDS ***
Dealt to Hero [Ks 5c]
Dealt to fcbadb16 
Dealt to ef479bd3 
Dealt to d390717b 
Dealt to f379676 
Dealt to 8bbdeb80 
d390717b: raises $0.12 to $0.22
f379676: folds
8bbdeb80: calls $0.22
Hero: folds
fcbadb16: folds
ef479bd3: folds
*** FLOP *** [6s 7h 8h]
d390717b: checks
8bbdeb80: bets $0.5
d390717b: folds
Uncalled bet ($0.5) returned to 8bbdeb80
*** SHOWDOWN ***
8bbdeb80 collected $0.56 from pot
*** SUMMARY ***
Total pot $0.59 | Rake $0.03 | Jackpot $0 | Bingo $0 | Fortune $0 | Tax $0
Board [6s 7h 8h]
Seat 1: Hero (button) folded before Flop (didn't bet)
Seat 2: fcbadb16 (small blind) folded before Flop
Seat 3: ef479bd3 (big blind) folded before Flop
Seat 4: d390717b folded on the Flop
Seat 5: f379676 folded before Flop (didn't bet)
Seat 6: 8bbdeb80 won ($0.56)


Poker Hand #HD1808633231: Hold'em No Limit ($0.05/$0.1) - 2024/06/10 00:28:35
Table 'NLHRed12' 6-max Seat #6 is the button
Seat 1: Hero ($11.37 in chips)
Seat 2: fcbadb16 ($19.43 in chips)
Seat 4: d390717b ($11.21 in chips)
Seat 5: f379676 ($11.08 in chips)
Seat 6: 8bbdeb80 ($27.77 in chips)
Hero: posts small blind $0.05
fcbadb16: posts big blind $0.1
*** HOLE CARDS ***
Dealt to Hero [Ac 4c]
Dealt to fcbadb16 
Dealt to d390717b 
Dealt to f379676 
Dealt to 8bbdeb80 
d390717b: folds
f379676: folds
8bbdeb80: calls $0.1
Hero: raises $0.4 to $0.5
fcbadb16: folds
8bbdeb80: calls $0.4
*** FLOP *** [7h 6c 4d]
Hero: checks
8bbdeb80: checks
*** TURN *** [7h 6c 4d] [5s]
Hero: checks
8bbdeb80: checks
*** RIVER *** [7h 6c 4d 5s] [Kd]
Hero: checks
8bbdeb80: checks
Hero: shows [Ac 4c] (Pair of Fours)
8bbdeb80: shows [6h Th] (Pair of Sixes)
*** SHOWDOWN ***
8bbdeb80 collected $1.05 from pot
*** SUMMARY ***
Total pot $1.1 | Rake $0.05 | Jackpot $0 | Bingo $0 | Fortune $0 | Tax $0
Board [7h 6c 4d 5s Kd]
Seat 1: Hero (small blind) showed [Ac 4c] and lost with Pair of Fours
Seat 2: fcbadb16 (big blind) folded before Flop
Seat 4: d390717b folded before Flop (didn't bet)
Seat 5: f379676 folded before Flop (didn't bet)
Seat 6: 8bbdeb80 (button) showed [6h Th] and won ($1.05) with Pair of Sixes


Poker Hand #HD1808633147: Hold'em No Limit ($0.05/$0.1) - 2024/06/10 00:27:34
Table 'NLHRed12' 6-max Seat #5 is the button
Seat 1: Hero ($11.47 in chips)
Seat 2: fcbadb16 ($19.43 in chips)
Seat 4: d390717b ($10.15 in chips)
Seat 5: f379676 ($11.08 in chips)
Seat 6: 8bbdeb80 ($28.84 in chips)
8bbdeb80: posts small blind $0.05
Hero: posts big blind $0.1
*** HOLE CARDS ***
Dealt to Hero [4c Ah]
Dealt to fcbadb16 
Dealt to d390717b 
Dealt to f379676 
Dealt to 8bbdeb80 
fcbadb16: folds
d390717b: raises $0.16 to $0.26
f379676: folds
8bbdeb80: calls $0.21
Hero: folds
*** FLOP *** [Tc 6s 6h]
8bbdeb80: checks
d390717b: bets $0.31
8bbdeb80: calls $0.31
*** TURN *** [Tc 6s 6h] [7h]
8bbdeb80: bets $0.5
d390717b: calls $0.5
*** RIVER *** [Tc 6s 6h 7h] [4h]
8bbdeb80: checks
d390717b: checks
8bbdeb80: shows [8s Ac] (Pair of Sixes)
d390717b: shows [7c 9c] (Pair of Sevens and Pair of Sixes)
*** SHOWDOWN ***
d390717b collected $2.13 from pot
*** SUMMARY ***
Total pot $2.24 | Rake $0.11 | Jackpot $0 | Bingo $0 | Fortune $0 | Tax $0
Board [Tc 6s 6h 7h 4h]
Seat 1: Hero (big blind) folded before Flop
Seat 2: fcbadb16 folded before Flop (didn't bet)
Seat 4: d390717b showed [7c 9c] and won ($2.13) with Pair of Sevens and Pair of Sixes
Seat 5: f379676 (button) folded before Flop (didn't bet)
Seat 6: 8bbdeb80 (small blind) showed [8s Ac] and lost with Pair of Sixes


Poker Hand #HD1808633119: Hold'em No Limit ($0.05/$0.1) - 2024/06/10 00:27:18
Table 'NLHRed12' 6-max Seat #4 is the button
Seat 1: Hero ($11.47 in chips)
Seat 2: fcbadb16 ($19.43 in chips)
Seat 4: d390717b ($10 in chips)
Seat 5: f379676 ($11.13 in chips)
Seat 6: 8bbdeb80 ($28.94 in chips)
f379676: posts small blind $0.05
8bbdeb80: posts big blind $0.1
*** HOLE CARDS ***
Dealt to Hero [5d 3s]
Dealt to fcbadb16 
Dealt to d390717b 
Dealt to f379676 
Dealt to 8bbdeb80 
Hero: folds
fcbadb16: folds
d390717b: raises $0.15 to $0.25
f379676: folds
8bbdeb80: folds
Uncalled bet ($0.15) returned to d390717b
*** SHOWDOWN ***
d390717b collected $0.25 from pot
*** SUMMARY ***
Total pot $0.25 | Rake $0 | Jackpot $0 | Bingo $0 | Fortune $0 | Tax $0
Seat 1: Hero folded before Flop (didn't bet)
Seat 2: fcbadb16 folded before Flop (didn't bet)
Seat 4: d390717b (button) collected ($0.25)
Seat 5: f379676 (small blind) folded before Flop
Seat 6: 8bbdeb80 (big blind) folded before Flop


Poker Hand #HD1808633025: Hold'em No Limit ($0.05/$0.1) - 2024/06/10 00:26:17
Table 'NLHRed12' 6-max Seat #2 is the button
Seat 1: Hero ($11.47 in chips)
Seat 2: fcbadb16 ($19.43 in chips)
Seat 4: d390717b ($10 in chips)
Seat 5: f379676 ($10 in chips)
Seat 6: 8bbdeb80 ($30.14 in chips)
d390717b: posts small blind $0.05
f379676: posts big blind $0.1
*** HOLE CARDS ***
Dealt to Hero [9d 2s]
Dealt to fcbadb16 
Dealt to d390717b 
Dealt to f379676 
Dealt to 8bbdeb80 
8bbdeb80: calls $0.1
Hero: folds
fcbadb16: folds
d390717b: folds
f379676: checks
*** FLOP *** [9h 5s 5h]
f379676: checks
8bbdeb80: checks
*** TURN *** [9h 5s 5h] [Ts]
f379676: bets $0.2
8bbdeb80: raises $0.3 to $0.5
f379676: calls $0.3
*** RIVER *** [9h 5s 5h Ts] [8h]
f379676: checks
8bbdeb80: bets $0.6
f379676: calls $0.6
8bbdeb80: shows [Kc Jc] (Pair of Fives)
f379676: shows [5d 4h] (Three Fives)
*** SHOWDOWN ***
f379676 collected $2.33 from pot
*** SUMMARY ***
Total pot $2.45 | Rake $0.12 | Jackpot $0 | Bingo $0 | Fortune $0 | Tax $0
Board [9h 5s 5h Ts 8h]
Seat 1: Hero folded before Flop (didn't bet)
Seat 2: fcbadb16 (button) folded before Flop (didn't bet)
Seat 4: d390717b (small blind) folded before Flop
Seat 5: f379676 (big blind) showed [5d 4h] and won ($2.33) with Three Fives
Seat 6: 8bbdeb80 showed [Kc Jc] and lost with Pair of Fives


Poker Hand #HD1808632994: Hold'em No Limit ($0.05/$0.1) - 2024/06/10 00:25:57
Table 'NLHRed12' 6-max Seat #1 is the button
Seat 1: Hero ($11.47 in chips)
Seat 2: fcbadb16 ($19.48 in chips)
Seat 4: d390717b ($10 in chips)
Seat 5: f379676 ($10 in chips)
Seat 6: 8bbdeb80 ($30 in chips)
fcbadb16: posts small blind $0.05
d390717b: posts big blind $0.1
*** HOLE CARDS ***
Dealt to Hero [3s Kh]
Dealt to fcbadb16 
Dealt to d390717b 
Dealt to f379676 
Dealt to 8bbdeb80 
f379676: folds
8bbdeb80: calls $0.1
Hero: folds
fcbadb16: folds
d390717b: checks
*** FLOP *** [Kc 2s 2c]
d390717b: checks
8bbdeb80: bets $0.4
d390717b: folds
Uncalled bet ($0.4) returned to 8bbdeb80
*** SHOWDOWN ***
8bbdeb80 collected $0.24 from pot
*** SUMMARY ***
Total pot $0.25 | Rake $0.01 | Jackpot $0 | Bingo $0 | Fortune $0 | Tax $0
Board [Kc 2s 2c]
Seat 1: Hero (button) folded before Flop (didn't bet)
Seat 2: fcbadb16 (small blind) folded before Flop
Seat 4: d390717b (big blind) folded on the Flop
Seat 5: f379676 folded before Flop (didn't bet)
Seat 6: 8bbdeb80 won ($0.24)


Poker Hand #HD1808632982: Hold'em No Limit ($0.05/$0.1) - 2024/06/10 00:25:50
Table 'NLHRed12' 6-max Seat #6 is the button
Seat 1: Hero ($11.52 in chips)
Seat 2: fcbadb16 ($19.43 in chips)
Seat 4: d390717b ($10 in chips)
Seat 5: f379676 ($10 in chips)
Seat 6: 8bbdeb80 ($30 in chips)
Hero: posts small blind $0.05
fcbadb16: posts big blind $0.1
*** HOLE CARDS ***
Dealt to Hero [6h Jh]
Dealt to fcbadb16 
Dealt to d390717b 
Dealt to f379676 
Dealt to 8bbdeb80 
d390717b: folds
f379676: folds
8bbdeb80: folds
Hero: folds
Uncalled bet ($0.05) returned to fcbadb16
*** SHOWDOWN ***
fcbadb16 collected $0.1 from pot
*** SUMMARY ***
Total pot $0.1 | Rake $0 | Jackpot $0 | Bingo $0 | Fortune $0 | Tax $0
Seat 1: Hero (small blind) folded before Flop
Seat 2: fcbadb16 (big blind) collected ($0.1)
Seat 4: d390717b folded before Flop (didn't bet)
Seat 5: f379676 folded before Flop (didn't bet)
Seat 6: 8bbdeb80 (button) folded before Flop (didn't bet)


Poker Hand #HD1808632885: Hold'em No Limit ($0.05/$0.1) - 2024/06/10 00:24:38
Table 'NLHRed12' 6-max Seat #5 is the button
Seat 1: Hero ($10 in chips)
Seat 2: fcbadb16 ($19.43 in chips)
Seat 3: 924162ec ($1.37 in chips)
Seat 4: d390717b ($10 in chips)
Seat 5: f379676 ($10 in chips)
Seat 6: 8bbdeb80 ($30.4 in chips)
8bbdeb80: posts small blind $0.05
Hero: posts big blind $0.1
*** HOLE CARDS ***
Dealt to Hero [Ah 3h]
Dealt to fcbadb16 
Dealt to 924162ec 
Dealt to d390717b 
Dealt to f379676 
Dealt to 8bbdeb80 
fcbadb16: folds
924162ec: calls $0.1
d390717b: folds
f379676: folds
8bbdeb80: calls $0.05
Hero: raises $0.3 to $0.4
924162ec: calls $0.3
8bbdeb80: calls $0.3
*** FLOP *** [9c Kd Ac]
8bbdeb80: checks
Hero: checks
924162ec: checks
*** TURN *** [9c Kd Ac] [5c]
8bbdeb80: checks
Hero: bets $0.4
924162ec: calls $0.4
8bbdeb80: folds
*** RIVER *** [9c Kd Ac 5c] [5s]
Hero: checks
924162ec: bets $0.57 and is all-in
Hero: calls $0.57
924162ec: shows [8d Qc] (Pair of Fives)
Hero: shows [Ah 3h] (Pair of Aces and Pair of Fives)
*** SHOWDOWN ***
Hero collected $2.89 from pot
*** SUMMARY ***
Total pot $3.14 | Rake $0.15 | Jackpot $0.1 | Bingo $0 | Fortune $0 | Tax $0
Board [9c Kd Ac 5c 5s]
Seat 1: Hero (big blind) showed [Ah 3h] and won ($2.89) with Pair of Aces and Pair of Fives
Seat 2: fcbadb16 folded before Flop (didn't bet)
Seat 3: 924162ec showed [8d Qc] and lost with Pair of Fives
Seat 4: d390717b folded before Flop (didn't bet)
Seat 5: f379676 (button) folded before Flop (didn't bet)
Seat 6: 8bbdeb80 (small blind) folded on the Turn


Poker Hand #HD1808632820: Hold'em No Limit ($0.05/$0.1) - 2024/06/10 00:23:55
Table 'NLHRed12' 6-max Seat #4 is the button
Seat 1: Hero ($10 in chips)
Seat 2: fcbadb16 ($19.43 in chips)
Seat 3: 924162ec ($1.61 in chips)
Seat 4: d390717b ($10 in chips)
Seat 5: f379676 ($10 in chips)
Seat 6: 8bbdeb80 ($30.13 in chips)
f379676: posts small blind $0.05
8bbdeb80: posts big blind $0.1
*** HOLE CARDS ***
Dealt to Hero [Tc 9s]
Dealt to fcbadb16 
Dealt to 924162ec 
Dealt to d390717b 
Dealt to f379676 
Dealt to 8bbdeb80 
Hero: folds
fcbadb16: folds
924162ec: calls $0.1
d390717b: folds
f379676: folds
8bbdeb80: checks
*** FLOP *** [Qs 4h 6c]
8bbdeb80: checks
924162ec: bets $0.14
8bbdeb80: raises $0.14 to $0.28
924162ec: folds
Uncalled bet ($0.14) returned to 8bbdeb80
*** SHOWDOWN ***
8bbdeb80 collected $0.51 from pot
*** SUMMARY ***
Total pot $0.53 | Rake $0.02 | Jackpot $0 | Bingo $0 | Fortune $0 | Tax $0
Board [Qs 4h 6c]
Seat 1: Hero folded before Flop (didn't bet)
Seat 2: fcbadb16 folded before Flop (didn't bet)
Seat 3: 924162ec folded on the Flop
Seat 4: d390717b (button) folded before Flop (didn't bet)
Seat 5: f379676 (small blind) folded before Flop
Seat 6: 8bbdeb80 (big blind) won ($0.51)


Poker Hand #HD1808632647: Hold'em No Limit ($0.05/$0.1) - 2024/06/10 00:22:05
Table 'NLHRed12' 6-max Seat #3 is the button
Seat 1: Hero ($10 in chips)
Seat 2: fcbadb16 ($19.43 in chips)
Seat 3: 924162ec ($1.61 in chips)
Seat 4: d390717b ($10 in chips)
Seat 5: f379676 ($10 in chips)
Seat 6: 8bbdeb80 ($22.34 in chips)
d390717b: posts small blind $0.05
f379676: posts big blind $0.1
*** HOLE CARDS ***
Dealt to Hero [Qh Qd]
Dealt to fcbadb16 
Dealt to 924162ec 
Dealt to d390717b 
Dealt to f379676 
Dealt to 8bbdeb80 
8bbdeb80: calls $0.1
Hero: raises $0.24 to $0.34
fcbadb16: folds
924162ec: folds
d390717b: folds
f379676: folds
8bbdeb80: calls $0.24
*** FLOP *** [Ts 2h Jh]
8bbdeb80: checks
Hero: bets $0.6
8bbdeb80: calls $0.6
*** TURN *** [Ts 2h Jh] [6s]
8bbdeb80: checks
Hero: bets $1.6
8bbdeb80: calls $1.6
*** RIVER *** [Ts 2h Jh 6s] [4s]
8bbdeb80: checks
Hero: bets $3.03
8bbdeb80: raises $3.03 to $6.06
Hero: calls $3.03
8bbdeb80: shows [Ks Kd] (Pair of Kings)
Hero: shows [Qh Qd] (Pair of Queens)
*** SHOWDOWN ***
8bbdeb80 collected $16.39 from pot
*** SUMMARY ***
Total pot $17.35 | Rake $0.86 | Jackpot $0.1 | Bingo $0 | Fortune $0 | Tax $0
Board [Ts 2h Jh 6s 4s]
Seat 1: Hero showed [Qh Qd] and lost with Pair of Queens
Seat 2: fcbadb16 folded before Flop (didn't bet)
Seat 3: 924162ec (button) folded before Flop (didn't bet)
Seat 4: d390717b (small blind) folded before Flop
Seat 5: f379676 (big blind) folded before Flop
Seat 6: 8bbdeb80 showed [Ks Kd] and won ($16.39) with Pair of Kings


Poker Hand #HD1808632584: Hold'em No Limit ($0.05/$0.1) - 2024/06/10 00:21:14
Table 'NLHRed12' 6-max Seat #2 is the button
Seat 1: Hero ($10 in chips)
Seat 2: fcbadb16 ($18.34 in chips)
Seat 3: 924162ec ($1.66 in chips)
Seat 4: d390717b ($10 in chips)
Seat 6: 8bbdeb80 ($23.39 in chips)
924162ec: posts small blind $0.05
d390717b: posts big blind $0.1
*** HOLE CARDS ***
Dealt to Hero [5s Ad]
Dealt to fcbadb16 
Dealt to 924162ec 
Dealt to d390717b 
Dealt to 8bbdeb80 
8bbdeb80: raises $0.5 to $0.6
Hero: folds
fcbadb16: calls $0.6
924162ec: folds
d390717b: folds
*** FLOP *** [6d 3s As]
8bbdeb80: checks
fcbadb16: checks
*** TURN *** [6d 3s As] [2s]
8bbdeb80: checks
fcbadb16: bets $0.45
8bbdeb80: calls $0.45
*** RIVER *** [6d 3s As 2s] [Th]
8bbdeb80: checks
fcbadb16: checks
8bbdeb80: shows [5d Qd] (Ace-High)
fcbadb16: shows [8c 8s] (Pair of Eights)
*** SHOWDOWN ***
fcbadb16 collected $2.14 from pot
*** SUMMARY ***
Total pot $2.25 | Rake $0.11 | Jackpot $0 | Bingo $0 | Fortune $0 | Tax $0
Board [6d 3s As 2s Th]
Seat 1: Hero folded before Flop (didn't bet)
Seat 2: fcbadb16 (button) showed [8c 8s] and won ($2.14) with Pair of Eights
Seat 3: 924162ec (small blind) folded before Flop
Seat 4: d390717b (big blind) folded before Flop
Seat 6: 8bbdeb80 showed [5d Qd] and lost with Ace-High


Poker Hand #HD1808632529: Hold'em No Limit ($0.05/$0.1) - 2024/06/10 00:20:39
Table 'NLHRed12' 6-max Seat #1 is the button
Seat 1: Hero ($10 in chips)
Seat 2: fcbadb16 ($17.8 in chips)
Seat 3: 924162ec ($2.26 in chips)
Seat 4: d390717b ($10 in chips)
Seat 6: 8bbdeb80 ($23.39 in chips)
fcbadb16: posts small blind $0.05
924162ec: posts big blind $0.1
*** HOLE CARDS ***
Dealt to Hero [8s 5h]
Dealt to fcbadb16 
Dealt to 924162ec 
Dealt to d390717b 
Dealt to 8bbdeb80 
d390717b: folds
8bbdeb80: folds
Hero: folds
fcbadb16: raises $0.2 to $0.3
924162ec: calls $0.2
*** FLOP *** [7h 6s Td]
fcbadb16: checks
924162ec: checks
*** TURN *** [7h 6s Td] [Ks]
fcbadb16: bets $0.3
924162ec: calls $0.3
*** RIVER *** [7h 6s Td Ks] [6h]
fcbadb16: bets $0.9
924162ec: folds
Uncalled bet ($0.9) returned to fcbadb16
*** SHOWDOWN ***
fcbadb16 collected $1.14 from pot
*** SUMMARY ***
Total pot $1.2 | Rake $0.06 | Jackpot $0 | Bingo $0 | Fortune $0 | Tax $0
Board [7h 6s Td Ks 6h]
Seat 1: Hero (button) folded before Flop (didn't bet)
Seat 2: fcbadb16 (small blind) won ($1.14)
Seat 3: 924162ec (big blind) folded on the River
Seat 4: d390717b folded before Flop (didn't bet)
Seat 6: 8bbdeb80 folded before Flop (didn't bet)


Poker Hand #HD1808632479: Hold'em No Limit ($0.05/$0.1) - 2024/06/10 00:20:08
Table 'NLHRed12' 6-max Seat #6 is the button
Seat 1: Hero ($10 in chips)
Seat 2: fcbadb16 ($17.9 in chips)
Seat 3: 924162ec ($2.26 in chips)
Seat 4: d390717b ($10 in chips)
Seat 5: 5df52cfd ($11.97 in chips)
Seat 6: 8bbdeb80 ($23.25 in chips)
Hero: posts small blind $0.05
fcbadb16: posts big blind $0.1
*** HOLE CARDS ***
Dealt to Hero [8h Td]
Dealt to fcbadb16 
Dealt to 924162ec 
Dealt to d390717b 
Dealt to 5df52cfd 
Dealt to 8bbdeb80 
924162ec: folds
d390717b: folds
5df52cfd: folds
8bbdeb80: calls $0.1
Hero: folds
fcbadb16: checks
*** FLOP *** [6c 6d Ah]
fcbadb16: checks
8bbdeb80: bets $0.5
fcbadb16: folds
Uncalled bet ($0.5) returned to 8bbdeb80
*** SHOWDOWN ***
8bbdeb80 collected $0.24 from pot
*** SUMMARY ***
Total pot $0.25 | Rake $0.01 | Jackpot $0 | Bingo $0 | Fortune $0 | Tax $0
Board [6c 6d Ah]
Seat 1: Hero (small blind) folded before Flop
Seat 2: fcbadb16 (big blind) folded on the Flop
Seat 3: 924162ec folded before Flop (didn't bet)
Seat 4: d390717b folded before Flop (didn't bet)
Seat 5: 5df52cfd folded before Flop (didn't bet)
Seat 6: 8bbdeb80 (button) won ($0.24)


Poker Hand #HD1808632365: Hold'em No Limit ($0.05/$0.1) - 2024/06/10 00:18:45
Table 'NLHRed12' 6-max Seat #5 is the button
Seat 1: Hero ($10 in chips)
Seat 2: fcbadb16 ($17.9 in chips)
Seat 3: 924162ec ($1.47 in chips)
Seat 4: d390717b ($10.59 in chips)
Seat 5: 5df52cfd ($11.97 in chips)
Seat 6: 8bbdeb80 ($23.3 in chips)
8bbdeb80: posts small blind $0.05
Hero: posts big blind $0.1
*** HOLE CARDS ***
Dealt to Hero [8c 6h]
Dealt to fcbadb16 
Dealt to 924162ec 
Dealt to d390717b 
Dealt to 5df52cfd 
Dealt to 8bbdeb80 
fcbadb16: folds
924162ec: calls $0.1
d390717b: raises $0.3 to $0.4
5df52cfd: folds
8bbdeb80: folds
Hero: folds
924162ec: calls $0.3
*** FLOP *** [As 3c 5s]
924162ec: checks
d390717b: bets $0.32
924162ec: calls $0.32
*** TURN *** [As 3c 5s] [9s]
924162ec: checks
d390717b: checks
*** RIVER *** [As 3c 5s 9s] [7s]
924162ec: checks
d390717b: checks
924162ec: shows [Ad 8d] (Pair of Aces)
d390717b: shows [Jd Qd] (Ace-High)
*** SHOWDOWN ***
924162ec collected $1.51 from pot
*** SUMMARY ***
Total pot $1.59 | Rake $0.08 | Jackpot $0 | Bingo $0 | Fortune $0 | Tax $0
Board [As 3c 5s 9s 7s]
Seat 1: Hero (big blind) folded before Flop
Seat 2: fcbadb16 folded before Flop (didn't bet)
Seat 3: 924162ec showed [Ad 8d] and won ($1.51) with Pair of Aces
Seat 4: d390717b showed [Jd Qd] and lost with Ace-High
Seat 5: 5df52cfd (button) folded before Flop (didn't bet)
Seat 6: 8bbdeb80 (small blind) folded before Flop


Poker Hand #HD1808632303: Hold'em No Limit ($0.05/$0.1) - 2024/06/10 00:18:02
Table 'NLHRed12' 6-max Seat #4 is the button
Seat 1: Hero ($10 in chips)
Seat 2: fcbadb16 ($17.9 in chips)
Seat 3: 924162ec ($1.47 in chips)
Seat 4: d390717b ($10.59 in chips)
Seat 5: 5df52cfd ($11.77 in chips)
Seat 6: 8bbdeb80 ($23.52 in chips)
5df52cfd: posts small blind $0.05
8bbdeb80: posts big blind $0.1
*** HOLE CARDS ***
Dealt to Hero [6d Ah]
Dealt to fcbadb16 
Dealt to 924162ec 
Dealt to d390717b 
Dealt to 5df52cfd 
Dealt to 8bbdeb80 
Hero: folds
fcbadb16: folds
924162ec: folds
d390717b: folds
5df52cfd: raises $0.12 to $0.22
8bbdeb80: calls $0.12
*** FLOP *** [6h 5d Th]
5df52cfd: bets $0.22
8bbdeb80: folds
Uncalled bet ($0.22) returned to 5df52cfd
*** SHOWDOWN ***
5df52cfd collected $0.42 from pot
*** SUMMARY ***
Total pot $0.44 | Rake $0.02 | Jackpot $0 | Bingo $0 | Fortune $0 | Tax $0
Board [6h 5d Th]
Seat 1: Hero folded before Flop (didn't bet)
Seat 2: fcbadb16 folded before Flop (didn't bet)
Seat 3: 924162ec folded before Flop (didn't bet)
Seat 4: d390717b (button) folded before Flop (didn't bet)
Seat 5: 5df52cfd (small blind) won ($0.42)
Seat 6: 8bbdeb80 (big blind) folded on the Flop


Poker Hand #HD1808632292: Hold'em No Limit ($0.05/$0.1) - 2024/06/10 00:17:53
Table 'NLHRed12' 6-max Seat #3 is the button
Seat 1: Hero ($10 in chips)
Seat 2: fcbadb16 ($17.9 in chips)
Seat 3: 924162ec ($1.47 in chips)
Seat 4: d390717b ($10.64 in chips)
Seat 5: 5df52cfd ($11.72 in chips)
Seat 6: 8bbdeb80 ($23.52 in chips)
d390717b: posts small blind $0.05
5df52cfd: posts big blind $0.1
*** HOLE CARDS ***
Dealt to Hero [9d Ah]
Dealt to fcbadb16 
Dealt to 924162ec 
Dealt to d390717b 
Dealt to 5df52cfd 
Dealt to 8bbdeb80 
8bbdeb80: folds
Hero: folds
fcbadb16: folds
924162ec: folds
d390717b: folds
Uncalled bet ($0.05) returned to 5df52cfd
*** SHOWDOWN ***
5df52cfd collected $0.1 from pot
*** SUMMARY ***
Total pot $0.1 | Rake $0 | Jackpot $0 | Bingo $0 | Fortune $0 | Tax $0
Seat 1: Hero folded before Flop (didn't bet)
Seat 2: fcbadb16 folded before Flop (didn't bet)
Seat 3: 924162ec (button) folded before Flop (didn't bet)
Seat 4: d390717b (small blind) folded before Flop
Seat 5: 5df52cfd (big blind) collected ($0.1)
Seat 6: 8bbdeb80 folded before Flop (didn't bet)


Poker Hand #HD1808632234: Hold'em No Limit ($0.05/$0.1) - 2024/06/10 00:17:22
Table 'NLHRed12' 6-max Seat #2 is the button
Seat 1: Hero ($10 in chips)
Seat 2: fcbadb16 ($17.9 in chips)
Seat 3: 924162ec ($1.52 in chips)
Seat 4: d390717b ($10.74 in chips)
Seat 5: 5df52cfd ($11.72 in chips)
Seat 6: 8bbdeb80 ($23.38 in chips)
924162ec: posts small blind $0.05
d390717b: posts big blind $0.1
*** HOLE CARDS ***
Dealt to Hero [8h 6c]
Dealt to fcbadb16 
Dealt to 924162ec 
Dealt to d390717b 
Dealt to 5df52cfd 
Dealt to 8bbdeb80 
5df52cfd: folds
8bbdeb80: calls $0.1
Hero: folds
fcbadb16: folds
924162ec: folds
d390717b: checks
*** FLOP *** [2d 5c Jc]
d390717b: checks
8bbdeb80: bets $0.5
d390717b: folds
Uncalled bet ($0.5) returned to 8bbdeb80
*** SHOWDOWN ***
8bbdeb80 collected $0.24 from pot
*** SUMMARY ***
Total pot $0.25 | Rake $0.01 | Jackpot $0 | Bingo $0 | Fortune $0 | Tax $0
Board [2d 5c Jc]
Seat 1: Hero folded before Flop (didn't bet)
Seat 2: fcbadb16 (button) folded before Flop (didn't bet)
Seat 3: 924162ec (small blind) folded before Flop
Seat 4: d390717b (big blind) folded on the Flop
Seat 5: 5df52cfd folded before Flop (didn't bet)
Seat 6: 8bbdeb80 won ($0.24)


Poker Hand #HD1808632166: Hold'em No Limit ($0.05/$0.1) - 2024/06/10 00:16:36
Table 'NLHRed12' 6-max Seat #1 is the button
Seat 1: Hero ($10 in chips)
Seat 2: fcbadb16 ($17.95 in chips)
Seat 3: 924162ec ($1.74 in chips)
Seat 4: d390717b ($10.74 in chips)
Seat 5: 5df52cfd ($11.47 in chips)
Seat 6: 8bbdeb80 ($23.38 in chips)
fcbadb16: posts small blind $0.05
924162ec: posts big blind $0.1
*** HOLE CARDS ***
Dealt to Hero [5s Qc]
Dealt to fcbadb16 
Dealt to 924162ec 
Dealt to d390717b 
Dealt to 5df52cfd 
Dealt to 8bbdeb80 
d390717b: folds
5df52cfd: raises $0.12 to $0.22
8bbdeb80: folds
Hero: folds
fcbadb16: folds
924162ec: calls $0.12
*** FLOP *** [7s Ks Kc]
924162ec: checks
5df52cfd: bets $1.52
924162ec: folds
Uncalled bet ($1.52) returned to 5df52cfd
*** SHOWDOWN ***
5df52cfd collected $0.47 from pot
*** SUMMARY ***
Total pot $0.49 | Rake $0.02 | Jackpot $0 | Bingo $0 | Fortune $0 | Tax $0
Board [7s Ks Kc]
Seat 1: Hero (button) folded before Flop (didn't bet)
Seat 2: fcbadb16 (small blind) folded before Flop
Seat 3: 924162ec (big blind) folded on the Flop
Seat 4: d390717b folded before Flop (didn't bet)
Seat 5: 5df52cfd won ($0.47)
Seat 6: 8bbdeb80 folded before Flop (didn't bet)


Poker Hand #HD1808632128: Hold'em No Limit ($0.05/$0.1) - 2024/06/10 00:16:10
Table 'NLHRed12' 6-max Seat #6 is the button
Seat 1: Hero ($10 in chips)
Seat 2: fcbadb16 ($18.05 in chips)
Seat 3: 924162ec ($1.84 in chips)
Seat 4: d390717b ($10.74 in chips)
Seat 5: 5df52cfd ($11.47 in chips)
Seat 6: 8bbdeb80 ($23.14 in chips)
Hero: posts small blind $0.05
fcbadb16: posts big blind $0.1
*** HOLE CARDS ***
Dealt to Hero [7d 8h]
Dealt to fcbadb16 
Dealt to 924162ec 
Dealt to d390717b 
Dealt to 5df52cfd 
Dealt to 8bbdeb80 
924162ec: calls $0.1
d390717b: folds
5df52cfd: folds
8bbdeb80: raises $0.4 to $0.5
Hero: folds
fcbadb16: folds
924162ec: folds
Uncalled bet ($0.4) returned to 8bbdeb80
*** SHOWDOWN ***
8bbdeb80 collected $0.34 from pot
*** SUMMARY ***
Total pot $0.35 | Rake $0.01 | Jackpot $0 | Bingo $0 | Fortune $0 | Tax $0
Seat 1: Hero (small blind) folded before Flop
Seat 2: fcbadb16 (big blind) folded before Flop
Seat 3: 924162ec folded before Flop
Seat 4: d390717b folded before Flop (didn't bet)
Seat 5: 5df52cfd folded before Flop (didn't bet)
Seat 6: 8bbdeb80 (button) collected ($0.34)


Poker Hand #HD1808632093: Hold'em No Limit ($0.05/$0.1) - 2024/06/10 00:15:50
Table 'NLHRed12' 6-max Seat #5 is the button
Seat 1: Hero ($10 in chips)
Seat 2: fcbadb16 ($18.05 in chips)
Seat 3: 924162ec ($1.84 in chips)
Seat 4: d390717b ($10.74 in chips)
Seat 5: 5df52cfd ($11.47 in chips)
Seat 6: 8bbdeb80 ($23.05 in chips)
8bbdeb80: posts small blind $0.05
Hero: posts big blind $0.1
*** HOLE CARDS ***
Dealt to Hero [2d Qc]
Dealt to fcbadb16 
Dealt to 924162ec 
Dealt to d390717b 
Dealt to 5df52cfd 
Dealt to 8bbdeb80 
fcbadb16: folds
924162ec: folds
d390717b: folds
5df52cfd: folds
8bbdeb80: calls $0.05
Hero: checks
*** FLOP *** [Kc 3c Ah]
8bbdeb80: bets $0.4
Hero: folds
Uncalled bet ($0.4) returned to 8bbdeb80
*** SHOWDOWN ***
8bbdeb80 collected $0.19 from pot
*** SUMMARY ***
Total pot $0.2 | Rake $0.01 | Jackpot $0 | Bingo $0 | Fortune $0 | Tax $0
Board [Kc 3c Ah]
Seat 1: Hero (big blind) folded on the Flop
Seat 2: fcbadb16 folded before Flop (didn't bet)
Seat 3: 924162ec folded before Flop (didn't bet)
Seat 4: d390717b folded before Flop (didn't bet)
Seat 5: 5df52cfd (button) folded before Flop (didn't bet)
Seat 6: 8bbdeb80 (small blind) won ($0.19)


Poker Hand #HD1808632045: Hold'em No Limit ($0.05/$0.1) - 2024/06/10 00:15:22
Table 'NLHRed12' 6-max Seat #4 is the button
Seat 1: Hero ($10 in chips)
Seat 2: fcbadb16 ($18.05 in chips)
Seat 3: 924162ec ($2.04 in chips)
Seat 4: d390717b ($10.74 in chips)
Seat 5: 5df52cfd ($11.52 in chips)
Seat 6: 8bbdeb80 ($22.82 in chips)
5df52cfd: posts small blind $0.05
8bbdeb80: posts big blind $0.1
924162ec: posts big blind $0.1
*** HOLE CARDS ***
Dealt to Hero [6d 9s]
Dealt to fcbadb16 
Dealt to 924162ec 
Dealt to d390717b 
Dealt to 5df52cfd 
Dealt to 8bbdeb80 
Hero: folds
fcbadb16: folds
924162ec: raises $0.1 to $0.2
d390717b: folds
5df52cfd: folds
8bbdeb80: calls $0.1
*** FLOP *** [As Qs 4s]
8bbdeb80: bets $0.4
924162ec: folds
Uncalled bet ($0.4) returned to 8bbdeb80
*** SHOWDOWN ***
8bbdeb80 collected $0.43 from pot
*** SUMMARY ***
Total pot $0.45 | Rake $0.02 | Jackpot $0 | Bingo $0 | Fortune $0 | Tax $0
Board [As Qs 4s]
Seat 1: Hero folded before Flop (didn't bet)
Seat 2: fcbadb16 folded before Flop (didn't bet)
Seat 3: 924162ec folded on the Flop
Seat 4: d390717b (button) folded before Flop (didn't bet)
Seat 5: 5df52cfd (small blind) folded before Flop
Seat 6: 8bbdeb80 (big blind) won ($0.43)


Poker Hand #HD1808632003: Hold'em No Limit ($0.05/$0.1) - 2024/06/10 00:14:51
Table 'NLHRed12' 6-max Seat #2 is the button
Seat 1: Hero ($10 in chips)
Seat 2: fcbadb16 ($17.69 in chips)
Seat 4: d390717b ($10.79 in chips)
Seat 5: 5df52cfd ($11.62 in chips)
Seat 6: 8bbdeb80 ($22.82 in chips)
d390717b: posts small blind $0.05
5df52cfd: posts big blind $0.1
*** HOLE CARDS ***
Dealt to Hero [2s As]
Dealt to fcbadb16 
Dealt to d390717b 
Dealt to 5df52cfd 
Dealt to 8bbdeb80 
8bbdeb80: folds
Hero: raises $0.14 to $0.24
fcbadb16: raises $0.48 to $0.72
d390717b: folds
5df52cfd: folds
Hero: folds
Uncalled bet ($0.48) returned to fcbadb16
*** SHOWDOWN ***
fcbadb16 collected $0.6 from pot
*** SUMMARY ***
Total pot $0.63 | Rake $0.03 | Jackpot $0 | Bingo $0 | Fortune $0 | Tax $0
Seat 1: Hero folded before Flop
Seat 2: fcbadb16 (button) collected ($0.6)
Seat 4: d390717b (small blind) folded before Flop
Seat 5: 5df52cfd (big blind) folded before Flop
Seat 6: 8bbdeb80 folded before Flop (didn't bet)


Poker Hand #HD1808631921: Hold'em No Limit ($0.05/$0.1) - 2024/06/10 00:13:48
Table 'NLHRed12' 6-max Seat #1 is the button
Seat 1: Hero ($10 in chips)
Seat 4: d390717b ($12.04 in chips)
Seat 5: 5df52cfd ($10.49 in chips)
d390717b: posts small blind $0.05
5df52cfd: posts big blind $0.1
*** HOLE CARDS ***
Dealt to Hero [6h Jc]
Dealt to d390717b 
Dealt to 5df52cfd 
Hero: folds
d390717b: raises $0.2 to $0.3
5df52cfd: calls $0.2
*** FLOP *** [2c 5s 8s]
d390717b: bets $0.2
5df52cfd: calls $0.2
*** TURN *** [2c 5s 8s] [4s]
d390717b: checks
5df52cfd: bets $0.75
d390717b: calls $0.75
*** RIVER *** [2c 5s 8s 4s] [9s]
d390717b: checks
5df52cfd: checks
d390717b: shows [8h Kh] (Pair of Eights)
5df52cfd: shows [7d 6c] (Nines-High Straight)
*** SHOWDOWN ***
5df52cfd collected $2.38 from pot
*** SUMMARY ***
Total pot $2.5 | Rake $0.12 | Jackpot $0 | Bingo $0 | Fortune $0 | Tax $0
Board [2c 5s 8s 4s 9s]
Seat 1: Hero (button) folded before Flop (didn't bet)
Seat 4: d390717b (small blind) showed [8h Kh] and lost with Pair of Eights
Seat 5: 5df52cfd (big blind) showed [7d 6c] and won ($2.38) with Nines-High Straight


Poker Hand #HD1808631912: Hold'em No Limit ($0.05/$0.1) - 2024/06/10 00:13:40
Table 'NLHRed12' 6-max Seat #5 is the button
Seat 1: Hero ($10 in chips)
Seat 4: d390717b ($11.99 in chips)
Seat 5: 5df52cfd ($10.49 in chips)
Hero: posts small blind $0.05
d390717b: posts big blind $0.1
*** HOLE CARDS ***
Dealt to Hero [Ks 4c]
Dealt to d390717b 
Dealt to 5df52cfd 
5df52cfd: folds
Hero: folds
Uncalled bet ($0.05) returned to d390717b
*** SHOWDOWN ***
d390717b collected $0.1 from pot
*** SUMMARY ***
Total pot $0.1 | Rake $0 | Jackpot $0 | Bingo $0 | Fortune $0 | Tax $0
Seat 1: Hero (small blind) folded before Flop
Seat 4: d390717b (big blind) collected ($0.1)
Seat 5: 5df52cfd (button) folded before Flop (didn't bet)


Poker Hand #HD1808631894: Hold'em No Limit ($0.05/$0.1) - 2024/06/10 00:13:30
Table 'NLHRed12' 6-max Seat #4 is the button
Seat 1: Hero ($10 in chips)
Seat 4: d390717b ($11.84 in chips)
Seat 5: 5df52cfd ($10.54 in chips)
5df52cfd: posts small blind $0.05
Hero: posts big blind $0.1
*** HOLE CARDS ***
Dealt to Hero [8s Qd]
Dealt to d390717b 
Dealt to 5df52cfd 
d390717b: raises $0.15 to $0.25
5df52cfd: folds
Hero: folds
Uncalled bet ($0.15) returned to d390717b
*** SHOWDOWN ***
d390717b collected $0.25 from pot
*** SUMMARY ***
Total pot $0.25 | Rake $0 | Jackpot $0 | Bingo $0 | Fortune $0 | Tax $0
Seat 1: Hero (big blind) folded before Flop
Seat 4: d390717b (button) collected ($0.25)
Seat 5: 5df52cfd (small blind) folded before Flop


Poker Hand #HD1808631839: Hold'em No Limit ($0.05/$0.1) - 2024/06/10 00:12:49
Table 'NLHRed12' 6-max Seat #1 is the button
Seat 1: Hero ($10.1 in chips)
Seat 4: d390717b ($11.89 in chips)
Seat 5: 5df52cfd ($10 in chips)
d390717b: posts small blind $0.05
5df52cfd: posts big blind $0.1
*** HOLE CARDS ***
Dealt to Hero [As 7s]
Dealt to d390717b 
Dealt to 5df52cfd 
Hero: raises $0.14 to $0.24
d390717b: folds
5df52cfd: calls $0.14
*** FLOP *** [5c 6d 9s]
5df52cfd: checks
Hero: bets $0.3
5df52cfd: raises $0.85 to $1.15
Hero: folds
Uncalled bet ($0.85) returned to 5df52cfd
*** SHOWDOWN ***
5df52cfd collected $1.08 from pot
*** SUMMARY ***
Total pot $1.13 | Rake $0.05 | Jackpot $0 | Bingo $0 | Fortune $0 | Tax $0
Board [5c 6d 9s]
Seat 1: Hero (button) folded on the Flop
Seat 4: d390717b (small blind) folded before Flop
Seat 5: 5df52cfd (big blind) won ($1.08)


Poker Hand #HD1808631820: Hold'em No Limit ($0.05/$0.1) - 2024/06/10 00:12:37
Table 'NLHRed12' 6-max Seat #6 is the button
Seat 1: Hero ($10 in chips)
Seat 4: d390717b ($11.99 in chips)
Seat 5: 5df52cfd ($10 in chips)
Seat 6: 13916820 ($10.1 in chips)
Hero: posts small blind $0.05
d390717b: posts big blind $0.1
*** HOLE CARDS ***
Dealt to Hero [Ac Kc]
Dealt to d390717b 
Dealt to 5df52cfd 
Dealt to 13916820 
5df52cfd: folds
13916820: folds
Hero: raises $0.2 to $0.3
d390717b: folds
Uncalled bet ($0.2) returned to Hero
*** SHOWDOWN ***
Hero collected $0.2 from pot
*** SUMMARY ***
Total pot $0.2 | Rake $0 | Jackpot $0 | Bingo $0 | Fortune $0 | Tax $0
Seat 1: Hero (small blind) collected ($0.2)
Seat 4: d390717b (big blind) folded before Flop
Seat 5: 5df52cfd folded before Flop (didn't bet)
Seat 6: 13916820 (button) folded before Flop (didn't bet)


Poker Hand #HD1808631797: Hold'em No Limit ($0.05/$0.1) - 2024/06/10 00:12:21
Table 'NLHRed12' 6-max Seat #5 is the button
Seat 1: Hero ($10 in chips)
Seat 4: d390717b ($11.99 in chips)
Seat 5: 5df52cfd ($9.65 in chips)
Seat 6: 13916820 ($10 in chips)
13916820: posts small blind $0.05
Hero: posts big blind $0.1
*** HOLE CARDS ***
Dealt to Hero [4c 7d]
Dealt to d390717b 
Dealt to 5df52cfd 
Dealt to 13916820 
d390717b: folds
5df52cfd: folds
13916820: raises $0.2 to $0.3
Hero: folds
Uncalled bet ($0.2) returned to 13916820
*** SHOWDOWN ***
13916820 collected $0.2 from pot
*** SUMMARY ***
Total pot $0.2 | Rake $0 | Jackpot $0 | Bingo $0 | Fortune $0 | Tax $0
Seat 1: Hero (big blind) folded before Flop
Seat 4: d390717b folded before Flop (didn't bet)
Seat 5: 5df52cfd (button) folded before Flop (didn't bet)
Seat 6: 13916820 (small blind) collected ($0.2)


Poker Hand #HD1808631717: Hold'em No Limit ($0.05/$0.1) - 2024/06/10 00:11:22
Table 'NLHRed12' 6-max Seat #4 is the button
Seat 1: Hero ($10 in chips)
Seat 4: d390717b ($11.52 in chips)
Seat 5: 5df52cfd ($9.9 in chips)
Seat 6: 13916820 ($10 in chips)
5df52cfd: posts small blind $0.05
13916820: posts big blind $0.1
*** HOLE CARDS ***
Dealt to Hero [2s 4d]
Dealt to d390717b 
Dealt to 5df52cfd 
Dealt to 13916820 
Hero: folds
d390717b: raises $0.15 to $0.25
5df52cfd: calls $0.2
13916820: calls $0.15
*** FLOP *** [6s Kh 7h]
5df52cfd: checks
13916820: checks
d390717b: checks
*** TURN *** [6s Kh 7h] [9h]
5df52cfd: checks
13916820: checks
d390717b: checks
*** RIVER *** [6s Kh 7h 9h] [4h]
5df52cfd: checks
13916820: checks
d390717b: checks
5df52cfd: shows [9s Jd] (Pair of Nines)
13916820: shows [Ac 5s] (Ace-High)
d390717b: shows [Tc Th] (King High Flush)
*** SHOWDOWN ***
d390717b collected $0.72 from pot
*** SUMMARY ***
Total pot $0.75 | Rake $0.03 | Jackpot $0 | Bingo $0 | Fortune $0 | Tax $0
Board [6s Kh 7h 9h 4h]
Seat 1: Hero folded before Flop (didn't bet)
Seat 4: d390717b (button) showed [Tc Th] and won ($0.72) with King High Flush
Seat 5: 5df52cfd (small blind) showed [9s Jd] and lost with Pair of Nines
Seat 6: 13916820 (big blind) showed [Ac 5s] and lost with Ace-High


Poker Hand #HD1808631698: Hold'em No Limit ($0.05/$0.1) - 2024/06/10 00:11:12
Table 'NLHRed12' 6-max Seat #1 is the button
Seat 1: Hero ($10 in chips)
Seat 4: d390717b ($11.42 in chips)
Seat 5: 5df52cfd ($10 in chips)
d390717b: posts small blind $0.05
5df52cfd: posts big blind $0.1
*** HOLE CARDS ***
Dealt to Hero [2c Qd]
Dealt to d390717b 
Dealt to 5df52cfd 
Hero: folds
d390717b: raises $0.2 to $0.3
5df52cfd: folds
Uncalled bet ($0.2) returned to d390717b
*** SHOWDOWN ***
d390717b collected $0.2 from pot
*** SUMMARY ***
Total pot $0.2 | Rake $0 | Jackpot $0 | Bingo $0 | Fortune $0 | Tax $0
Seat 1: Hero (button) folded before Flop (didn't bet)
Seat 4: d390717b (small blind) collected ($0.2)
Seat 5: 5df52cfd (big blind) folded before Flop


Poker Hand #HD1808631591: Hold'em No Limit ($0.05/$0.1) - 2024/06/10 00:09:52
Table 'NLHRed12' 6-max Seat #4 is the button
Seat 1: Hero ($10.33 in chips)
Seat 2: ad651946 ($10.38 in chips)
Seat 3: 39fb9e7 ($10.25 in chips)
Seat 4: d390717b ($10.21 in chips)
Seat 5: 3e69a9cd ($11.27 in chips)
3e69a9cd: posts small blind $0.05
Hero: posts big blind $0.1
*** HOLE CARDS ***
Dealt to Hero [9s Kd]
Dealt to ad651946 
Dealt to 39fb9e7 
Dealt to d390717b 
Dealt to 3e69a9cd 
ad651946: folds
39fb9e7: folds
d390717b: raises $0.15 to $0.25
3e69a9cd: folds
Hero: calls $0.15
*** FLOP *** [9d 2c 7h]
Hero: checks
d390717b: bets $0.28
Hero: calls $0.28
*** TURN *** [9d 2c 7h] [5s]
Hero: checks
d390717b: bets $0.76
Hero: calls $0.76
*** RIVER *** [9d 2c 7h 5s] [Ac]
Hero: checks
d390717b: bets $1.98
Hero: folds
Uncalled bet ($1.98) returned to d390717b
*** SHOWDOWN ***
d390717b collected $2.5 from pot
*** SUMMARY ***
Total pot $2.63 | Rake $0.13 | Jackpot $0 | Bingo $0 | Fortune $0 | Tax $0
Board [9d 2c 7h 5s Ac]
Seat 1: Hero (big blind) folded on the River
Seat 2: ad651946 folded before Flop (didn't bet)
Seat 3: 39fb9e7 folded before Flop (didn't bet)
Seat 4: d390717b (button) won ($2.5)
Seat 5: 3e69a9cd (small blind) folded before Flop


Poker Hand #HD1808631556: Hold'em No Limit ($0.05/$0.1) - 2024/06/10 00:09:33
Table 'NLHRed12' 6-max Seat #3 is the button
Seat 1: Hero ($10.33 in chips)
Seat 2: ad651946 ($10.38 in chips)
Seat 3: 39fb9e7 ($10.1 in chips)
Seat 4: d390717b ($10.26 in chips)
Seat 5: 3e69a9cd ($11.37 in chips)
Seat 6: f4d44c3a ($24.19 in chips)
d390717b: posts small blind $0.05
3e69a9cd: posts big blind $0.1
*** HOLE CARDS ***
Dealt to Hero [Ah 6d]
Dealt to ad651946 
Dealt to 39fb9e7 
Dealt to d390717b 
Dealt to 3e69a9cd 
Dealt to f4d44c3a 
f4d44c3a: folds
Hero: folds
ad651946: folds
39fb9e7: raises $0.2 to $0.3
d390717b: folds
3e69a9cd: folds
Uncalled bet ($0.2) returned to 39fb9e7
*** SHOWDOWN ***
39fb9e7 collected $0.25 from pot
*** SUMMARY ***
Total pot $0.25 | Rake $0 | Jackpot $0 | Bingo $0 | Fortune $0 | Tax $0
Seat 1: Hero folded before Flop (didn't bet)
Seat 2: ad651946 folded before Flop (didn't bet)
Seat 3: 39fb9e7 (button) collected ($0.25)
Seat 4: d390717b (small blind) folded before Flop
Seat 5: 3e69a9cd (big blind) folded before Flop
Seat 6: f4d44c3a folded before Flop (didn't bet)


Poker Hand #HD1808631504: Hold'em No Limit ($0.05/$0.1) - 2024/06/10 00:08:50
Table 'NLHRed12' 6-max Seat #2 is the button
Seat 1: Hero ($10 in chips)
Seat 2: ad651946 ($10.38 in chips)
Seat 3: 39fb9e7 ($10.15 in chips)
Seat 4: d390717b ($10.36 in chips)
Seat 5: 3e69a9cd ($11.57 in chips)
Seat 6: f4d44c3a ($24.19 in chips)
39fb9e7: posts small blind $0.05
d390717b: posts big blind $0.1
*** HOLE CARDS ***
Dealt to Hero [As Kc]
Dealt to ad651946 
Dealt to 39fb9e7 
Dealt to d390717b 
Dealt to 3e69a9cd 
Dealt to f4d44c3a 
3e69a9cd: raises $0.1 to $0.2
f4d44c3a: folds
Hero: raises $0.5 to $0.7
ad651946: folds
39fb9e7: folds
d390717b: folds
3e69a9cd: folds
Uncalled bet ($0.5) returned to Hero
*** SHOWDOWN ***
Hero collected $0.53 from pot
*** SUMMARY ***
Total pot $0.55 | Rake $0.02 | Jackpot $0 | Bingo $0 | Fortune $0 | Tax $0
Seat 1: Hero collected ($0.53)
Seat 2: ad651946 (button) folded before Flop (didn't bet)
Seat 3: 39fb9e7 (small blind) folded before Flop
Seat 4: d390717b (big blind) folded before Flop
Seat 5: 3e69a9cd folded before Flop
Seat 6: f4d44c3a folded before Flop (didn't bet)


Poker Hand #HD1808631380: Hold'em No Limit ($0.05/$0.1) - 2024/06/10 00:07:23
Table 'NLHRed12' 6-max Seat #1 is the button
Seat 1: Hero ($10 in chips)
Seat 2: ad651946 ($10.43 in chips)
Seat 3: 39fb9e7 ($10.25 in chips)
Seat 4: d390717b ($11.78 in chips)
Seat 5: 3e69a9cd ($10.15 in chips)
Seat 6: f4d44c3a ($24.19 in chips)
ad651946: posts small blind $0.05
39fb9e7: posts big blind $0.1
*** HOLE CARDS ***
Dealt to Hero [9d 7d]
Dealt to ad651946 
Dealt to 39fb9e7 
Dealt to d390717b 
Dealt to 3e69a9cd 
Dealt to f4d44c3a 
d390717b: raises $0.12 to $0.22
3e69a9cd: calls $0.22
f4d44c3a: folds
Hero: folds
ad651946: folds
39fb9e7: folds
*** FLOP *** [Js 6h Jh]
d390717b: bets $0.3
3e69a9cd: calls $0.3
*** TURN *** [Js 6h Jh] [4s]
d390717b: checks
3e69a9cd: bets $0.9
d390717b: calls $0.9
*** RIVER *** [Js 6h Jh 4s] [9h]
d390717b: checks
3e69a9cd: bets $2.45
d390717b: folds
Uncalled bet ($2.45) returned to 3e69a9cd
*** SHOWDOWN ***
3e69a9cd collected $2.84 from pot
*** SUMMARY ***
Total pot $2.99 | Rake $0.15 | Jackpot $0 | Bingo $0 | Fortune $0 | Tax $0
Board [Js 6h Jh 4s 9h]
Seat 1: Hero (button) folded before Flop (didn't bet)
Seat 2: ad651946 (small blind) folded before Flop
Seat 3: 39fb9e7 (big blind) folded before Flop
Seat 4: d390717b folded on the River
Seat 5: 3e69a9cd won ($2.84)
Seat 6: f4d44c3a folded before Flop (didn't bet)


Poker Hand #HD1808631354: Hold'em No Limit ($0.05/$0.1) - 2024/06/10 00:07:07
Table 'NLHRed12' 6-max Seat #6 is the button
Seat 1: Hero ($10 in chips)
Seat 2: ad651946 ($10.38 in chips)
Seat 3: 39fb9e7 ($10.25 in chips)
Seat 4: d390717b ($11.78 in chips)
Seat 5: 3e69a9cd ($10.15 in chips)
Seat 6: f4d44c3a ($24.19 in chips)
Hero: posts small blind $0.05
ad651946: posts big blind $0.1
*** HOLE CARDS ***
Dealt to Hero [Ts 5d]
Dealt to ad651946 
Dealt to 39fb9e7 
Dealt to d390717b 
Dealt to 3e69a9cd 
Dealt to f4d44c3a 
39fb9e7: folds
d390717b: folds
3e69a9cd: folds
f4d44c3a: folds
Hero: folds
Uncalled bet ($0.05) returned to ad651946
*** SHOWDOWN ***
ad651946 collected $0.1 from pot
*** SUMMARY ***
Total pot $0.1 | Rake $0 | Jackpot $0 | Bingo $0 | Fortune $0 | Tax $0
Seat 1: Hero (small blind) folded before Flop
Seat 2: ad651946 (big blind) collected ($0.1)
Seat 3: 39fb9e7 folded before Flop (didn't bet)
Seat 4: d390717b folded before Flop (didn't bet)
Seat 5: 3e69a9cd folded before Flop (didn't bet)
Seat 6: f4d44c3a (button) folded before Flop (didn't bet)


Poker Hand #HD1808631318: Hold'em No Limit ($0.05/$0.1) - 2024/06/10 00:06:43
Table 'NLHRed12' 6-max Seat #5 is the button
Seat 1: Hero ($10 in chips)
Seat 2: ad651946 ($10.38 in chips)
Seat 3: 39fb9e7 ($10.25 in chips)
Seat 4: d390717b ($11.78 in chips)
Seat 5: 3e69a9cd ($10 in chips)
Seat 6: f4d44c3a ($24.24 in chips)
f4d44c3a: posts small blind $0.05
Hero: posts big blind $0.1
*** HOLE CARDS ***
Dealt to Hero [6h Qh]
Dealt to ad651946 
Dealt to 39fb9e7 
Dealt to d390717b 
Dealt to 3e69a9cd 
Dealt to f4d44c3a 
ad651946: folds
39fb9e7: folds
d390717b: folds
3e69a9cd: raises $0.15 to $0.25
f4d44c3a: folds
Hero: folds
Uncalled bet ($0.15) returned to 3e69a9cd
*** SHOWDOWN ***
3e69a9cd collected $0.25 from pot
*** SUMMARY ***
Total pot $0.25 | Rake $0 | Jackpot $0 | Bingo $0 | Fortune $0 | Tax $0
Seat 1: Hero (big blind) folded before Flop
Seat 2: ad651946 folded before Flop (didn't bet)
Seat 3: 39fb9e7 folded before Flop (didn't bet)
Seat 4: d390717b folded before Flop (didn't bet)
Seat 5: 3e69a9cd (button) collected ($0.25)
Seat 6: f4d44c3a (small blind) folded before Flop


