Poker Hand #HD1846901396: Hold'em No Limit ($0.05/$0.1) - 2024/07/07 15:35:14
Table 'NLHRed20' 6-max Seat #1 is the button
Seat 1: 4681d202 ($10.07 in chips)
Seat 2: Hero ($10.45 in chips)
Seat 3: 5af3c595 ($19.81 in chips)
Seat 4: 2510f9ea ($7.62 in chips)
Seat 5: 278431d0 ($9.39 in chips)
Seat 6: b8da5e4f ($36.16 in chips)
Hero: posts small blind $0.05
5af3c595: posts big blind $0.1
*** HOLE CARDS ***
Dealt to 4681d202 
Dealt to Hero [Ac 5s]
Dealt to 5af3c595 
Dealt to 2510f9ea 
Dealt to 278431d0 
Dealt to b8da5e4f 
2510f9ea: raises $0.15 to $0.25
278431d0: folds
b8da5e4f: folds
4681d202: folds
Hero: folds
5af3c595: folds
Uncalled bet ($0.15) returned to 2510f9ea
*** SHOWDOWN ***
2510f9ea collected $0.25 from pot
*** SUMMARY ***
Total pot $0.25 | Rake $0 | Jackpot $0 | Bingo $0 | Fortune $0 | Tax $0
Seat 1: 4681d202 (button) folded before Flop (didn't bet)
Seat 2: Hero (small blind) folded before Flop
Seat 3: 5af3c595 (big blind) folded before Flop
Seat 4: 2510f9ea collected ($0.25)
Seat 5: 278431d0 folded before Flop (didn't bet)
Seat 6: b8da5e4f folded before Flop (didn't bet)


Poker Hand #HD1846901297: Hold'em No Limit ($0.05/$0.1) - 2024/07/07 15:34:25
Table 'NLHRed20' 6-max Seat #6 is the button
Seat 1: 4681d202 ($10.12 in chips)
Seat 2: Hero ($10 in chips)
Seat 3: 5af3c595 ($20.25 in chips)
Seat 4: 2510f9ea ($7.62 in chips)
Seat 5: 278431d0 ($9.39 in chips)
Seat 6: b8da5e4f ($36.16 in chips)
4681d202: posts small blind $0.05
Hero: posts big blind $0.1
*** HOLE CARDS ***
Dealt to 4681d202 
Dealt to Hero [Qc As]
Dealt to 5af3c595 
Dealt to 2510f9ea 
Dealt to 278431d0 
Dealt to b8da5e4f 
5af3c595: raises $0.15 to $0.25
2510f9ea: folds
278431d0: folds
b8da5e4f: folds
4681d202: folds
Hero: calls $0.15
*** FLOP *** [6s Qh Ah]
Hero: checks
5af3c595: bets $0.19
Hero: raises $0.51 to $0.7
5af3c595: folds
Uncalled bet ($0.51) returned to Hero
*** SHOWDOWN ***
Hero collected $0.89 from pot
*** SUMMARY ***
Total pot $0.93 | Rake $0.04 | Jackpot $0 | Bingo $0 | Fortune $0 | Tax $0
Board [6s Qh Ah]
Seat 1: 4681d202 (small blind) folded before Flop
Seat 2: Hero (big blind) won ($0.89)
Seat 3: 5af3c595 folded on the Flop
Seat 4: 2510f9ea folded before Flop (didn't bet)
Seat 5: 278431d0 folded before Flop (didn't bet)
Seat 6: b8da5e4f (button) folded before Flop (didn't bet)


Poker Hand #HD1846901285: Hold'em No Limit ($0.05/$0.1) - 2024/07/07 15:34:16
Table 'NLHRed20' 6-max Seat #5 is the button
Seat 1: 4681d202 ($10.07 in chips)
Seat 2: Hero ($10 in chips)
Seat 3: 5af3c595 ($20.25 in chips)
Seat 4: 2510f9ea ($7.62 in chips)
Seat 5: 278431d0 ($9.39 in chips)
Seat 6: b8da5e4f ($36.21 in chips)
b8da5e4f: posts small blind $0.05
4681d202: posts big blind $0.1
*** HOLE CARDS ***
Dealt to 4681d202 
Dealt to Hero [9c 5h]
Dealt to 5af3c595 
Dealt to 2510f9ea 
Dealt to 278431d0 
Dealt to b8da5e4f 
Hero: folds
5af3c595: folds
2510f9ea: folds
278431d0: folds
b8da5e4f: folds
Uncalled bet ($0.05) returned to 4681d202
*** SHOWDOWN ***
4681d202 collected $0.1 from pot
*** SUMMARY ***
Total pot $0.1 | Rake $0 | Jackpot $0 | Bingo $0 | Fortune $0 | Tax $0
Seat 1: 4681d202 (big blind) collected ($0.1)
Seat 2: Hero folded before Flop (didn't bet)
Seat 3: 5af3c595 folded before Flop (didn't bet)
Seat 4: 2510f9ea folded before Flop (didn't bet)
Seat 5: 278431d0 (button) folded before Flop (didn't bet)
Seat 6: b8da5e4f (small blind) folded before Flop


Poker Hand #HD1846901246: Hold'em No Limit ($0.05/$0.1) - 2024/07/07 15:33:58
Table 'NLHRed20' 6-max Seat #4 is the button
Seat 1: 4681d202 ($10.07 in chips)
Seat 2: Hero ($10 in chips)
Seat 3: 5af3c595 ($20.25 in chips)
Seat 4: 2510f9ea ($7.47 in chips)
Seat 5: 278431d0 ($9.44 in chips)
Seat 6: b8da5e4f ($36.31 in chips)
278431d0: posts small blind $0.05
b8da5e4f: posts big blind $0.1
*** HOLE CARDS ***
Dealt to 4681d202 
Dealt to Hero [4h Ad]
Dealt to 5af3c595 
Dealt to 2510f9ea 
Dealt to 278431d0 
Dealt to b8da5e4f 
4681d202: folds
Hero: folds
5af3c595: folds
2510f9ea: raises $0.15 to $0.25
278431d0: folds
b8da5e4f: folds
Uncalled bet ($0.15) returned to 2510f9ea
*** SHOWDOWN ***
2510f9ea collected $0.25 from pot
*** SUMMARY ***
Total pot $0.25 | Rake $0 | Jackpot $0 | Bingo $0 | Fortune $0 | Tax $0
Seat 1: 4681d202 folded before Flop (didn't bet)
Seat 2: Hero folded before Flop (didn't bet)
Seat 3: 5af3c595 folded before Flop (didn't bet)
Seat 4: 2510f9ea (button) collected ($0.25)
Seat 5: 278431d0 (small blind) folded before Flop
Seat 6: b8da5e4f (big blind) folded before Flop


Poker Hand #HD1846901232: Hold'em No Limit ($0.05/$0.1) - 2024/07/07 15:33:50
Table 'NLHRed20' 6-max Seat #3 is the button
Seat 1: 4681d202 ($10.07 in chips)
Seat 2: Hero ($10 in chips)
Seat 3: 5af3c595 ($20.25 in chips)
Seat 4: 2510f9ea ($7.52 in chips)
Seat 5: 278431d0 ($9.39 in chips)
Seat 6: b8da5e4f ($36.31 in chips)
2510f9ea: posts small blind $0.05
278431d0: posts big blind $0.1
*** HOLE CARDS ***
Dealt to 4681d202 
Dealt to Hero [5s 6c]
Dealt to 5af3c595 
Dealt to 2510f9ea 
Dealt to 278431d0 
Dealt to b8da5e4f 
b8da5e4f: folds
4681d202: folds
Hero: folds
5af3c595: folds
2510f9ea: folds
Uncalled bet ($0.05) returned to 278431d0
*** SHOWDOWN ***
278431d0 collected $0.1 from pot
*** SUMMARY ***
Total pot $0.1 | Rake $0 | Jackpot $0 | Bingo $0 | Fortune $0 | Tax $0
Seat 1: 4681d202 folded before Flop (didn't bet)
Seat 2: Hero folded before Flop (didn't bet)
Seat 3: 5af3c595 (button) folded before Flop (didn't bet)
Seat 4: 2510f9ea (small blind) folded before Flop
Seat 5: 278431d0 (big blind) collected ($0.1)
Seat 6: b8da5e4f folded before Flop (didn't bet)


Poker Hand #HD1846901178: Hold'em No Limit ($0.05/$0.1) - 2024/07/07 15:33:28
Table 'NLHRed20' 6-max Seat #2 is the button
Seat 1: 4681d202 ($10.32 in chips)
Seat 2: Hero ($10.44 in chips)
Seat 3: 5af3c595 ($20.3 in chips)
Seat 4: 2510f9ea ($6.51 in chips)
Seat 5: 278431d0 ($9.39 in chips)
Seat 6: b8da5e4f ($36.31 in chips)
5af3c595: posts small blind $0.05
2510f9ea: posts big blind $0.1
*** HOLE CARDS ***
Dealt to 4681d202 
Dealt to Hero [Js Ks]
Dealt to 5af3c595 
Dealt to 2510f9ea 
Dealt to 278431d0 
Dealt to b8da5e4f 
278431d0: folds
b8da5e4f: folds
4681d202: raises $0.15 to $0.25
Hero: raises $0.55 to $0.8
5af3c595: folds
2510f9ea: raises $5.71 to $6.51 and is all-in
4681d202: folds
Hero: folds
Uncalled bet ($5.71) returned to 2510f9ea
*** SHOWDOWN ***
2510f9ea collected $1.81 from pot
*** SUMMARY ***
Total pot $1.9 | Rake $0.09 | Jackpot $0 | Bingo $0 | Fortune $0 | Tax $0
Seat 1: 4681d202 folded before Flop
Seat 2: Hero (button) folded before Flop
Seat 3: 5af3c595 (small blind) folded before Flop
Seat 4: 2510f9ea (big blind) collected ($1.81)
Seat 5: 278431d0 folded before Flop (didn't bet)
Seat 6: b8da5e4f folded before Flop (didn't bet)


Poker Hand #HD1846901158: Hold'em No Limit ($0.05/$0.1) - 2024/07/07 15:33:14
Table 'NLHRed20' 6-max Seat #1 is the button
Seat 1: 4681d202 ($10.32 in chips)
Seat 2: Hero ($10.34 in chips)
Seat 3: 5af3c595 ($20.4 in chips)
Seat 4: 2510f9ea ($6.51 in chips)
Seat 5: 278431d0 ($9.39 in chips)
Seat 6: b8da5e4f ($36.31 in chips)
Hero: posts small blind $0.05
5af3c595: posts big blind $0.1
*** HOLE CARDS ***
Dealt to 4681d202 
Dealt to Hero [Jh Qs]
Dealt to 5af3c595 
Dealt to 2510f9ea 
Dealt to 278431d0 
Dealt to b8da5e4f 
2510f9ea: folds
278431d0: folds
b8da5e4f: folds
4681d202: folds
Hero: raises $0.2 to $0.3
5af3c595: folds
Uncalled bet ($0.2) returned to Hero
*** SHOWDOWN ***
Hero collected $0.2 from pot
*** SUMMARY ***
Total pot $0.2 | Rake $0 | Jackpot $0 | Bingo $0 | Fortune $0 | Tax $0
Seat 1: 4681d202 (button) folded before Flop (didn't bet)
Seat 2: Hero (small blind) collected ($0.2)
Seat 3: 5af3c595 (big blind) folded before Flop
Seat 4: 2510f9ea folded before Flop (didn't bet)
Seat 5: 278431d0 folded before Flop (didn't bet)
Seat 6: b8da5e4f folded before Flop (didn't bet)


Poker Hand #HD1846901066: Hold'em No Limit ($0.05/$0.1) - 2024/07/07 15:32:31
Table 'NLHRed20' 6-max Seat #6 is the button
Seat 1: 4681d202 ($10.37 in chips)
Seat 2: Hero ($10.44 in chips)
Seat 3: 5af3c595 ($20.4 in chips)
Seat 4: 2510f9ea ($6.76 in chips)
Seat 5: 278431d0 ($9.02 in chips)
Seat 6: b8da5e4f ($36.31 in chips)
4681d202: posts small blind $0.05
Hero: posts big blind $0.1
*** HOLE CARDS ***
Dealt to 4681d202 
Dealt to Hero [4c Jh]
Dealt to 5af3c595 
Dealt to 2510f9ea 
Dealt to 278431d0 
Dealt to b8da5e4f 
5af3c595: folds
2510f9ea: raises $0.15 to $0.25
278431d0: calls $0.25
b8da5e4f: folds
4681d202: folds
Hero: folds
*** FLOP *** [Ts Th 7s]
2510f9ea: checks
278431d0: bets $0.22
2510f9ea: folds
Uncalled bet ($0.22) returned to 278431d0
*** SHOWDOWN ***
278431d0 collected $0.62 from pot
*** SUMMARY ***
Total pot $0.65 | Rake $0.03 | Jackpot $0 | Bingo $0 | Fortune $0 | Tax $0
Board [Ts Th 7s]
Seat 1: 4681d202 (small blind) folded before Flop
Seat 2: Hero (big blind) folded before Flop
Seat 3: 5af3c595 folded before Flop (didn't bet)
Seat 4: 2510f9ea folded on the Flop
Seat 5: 278431d0 won ($0.62)
Seat 6: b8da5e4f (button) folded before Flop (didn't bet)


Poker Hand #HD1846900978: Hold'em No Limit ($0.05/$0.1) - 2024/07/07 15:31:53
Table 'NLHRed20' 6-max Seat #5 is the button
Seat 1: 4681d202 ($10 in chips)
Seat 2: Hero ($10.64 in chips)
Seat 3: 5af3c595 ($20.4 in chips)
Seat 4: 2510f9ea ($6.76 in chips)
Seat 5: 278431d0 ($9.02 in chips)
Seat 6: b8da5e4f ($36.51 in chips)
b8da5e4f: posts small blind $0.05
4681d202: posts big blind $0.1
*** HOLE CARDS ***
Dealt to 4681d202 
Dealt to Hero [Ad Jh]
Dealt to 5af3c595 
Dealt to 2510f9ea 
Dealt to 278431d0 
Dealt to b8da5e4f 
Hero: raises $0.1 to $0.2
5af3c595: folds
2510f9ea: folds
278431d0: folds
b8da5e4f: calls $0.15
4681d202: raises $1.1 to $1.3
Hero: folds
b8da5e4f: folds
Uncalled bet ($1.1) returned to 4681d202
*** SHOWDOWN ***
4681d202 collected $0.57 from pot
*** SUMMARY ***
Total pot $0.6 | Rake $0.03 | Jackpot $0 | Bingo $0 | Fortune $0 | Tax $0
Seat 1: 4681d202 (big blind) collected ($0.57)
Seat 2: Hero folded before Flop
Seat 3: 5af3c595 folded before Flop (didn't bet)
Seat 4: 2510f9ea folded before Flop (didn't bet)
Seat 5: 278431d0 (button) folded before Flop (didn't bet)
Seat 6: b8da5e4f (small blind) folded before Flop


Poker Hand #HD1846900916: Hold'em No Limit ($0.05/$0.1) - 2024/07/07 15:31:24
Table 'NLHRed20' 6-max Seat #4 is the button
Seat 1: 4681d202 ($10 in chips)
Seat 2: Hero ($10.64 in chips)
Seat 3: 5af3c595 ($20.4 in chips)
Seat 4: 2510f9ea ($6.39 in chips)
Seat 5: 278431d0 ($9.32 in chips)
Seat 6: b8da5e4f ($36.61 in chips)
278431d0: posts small blind $0.05
b8da5e4f: posts big blind $0.1
*** HOLE CARDS ***
Dealt to 4681d202 
Dealt to Hero [Ac 2d]
Dealt to 5af3c595 
Dealt to 2510f9ea 
Dealt to 278431d0 
Dealt to b8da5e4f 
4681d202: folds
Hero: folds
5af3c595: folds
2510f9ea: raises $0.2 to $0.3
278431d0: calls $0.25
b8da5e4f: folds
*** FLOP *** [2h As 5s]
278431d0: checks
2510f9ea: bets $0.35
278431d0: folds
Uncalled bet ($0.35) returned to 2510f9ea
*** SHOWDOWN ***
2510f9ea collected $0.67 from pot
*** SUMMARY ***
Total pot $0.7 | Rake $0.03 | Jackpot $0 | Bingo $0 | Fortune $0 | Tax $0
Board [2h As 5s]
Seat 1: 4681d202 folded before Flop (didn't bet)
Seat 2: Hero folded before Flop (didn't bet)
Seat 3: 5af3c595 folded before Flop (didn't bet)
Seat 4: 2510f9ea (button) won ($0.67)
Seat 5: 278431d0 (small blind) folded on the Flop
Seat 6: b8da5e4f (big blind) folded before Flop


Poker Hand #HD1846900883: Hold'em No Limit ($0.05/$0.1) - 2024/07/07 15:31:08
Table 'NLHRed20' 6-max Seat #3 is the button
Seat 1: 4681d202 ($10 in chips)
Seat 2: Hero ($10.64 in chips)
Seat 3: 5af3c595 ($20.4 in chips)
Seat 4: 2510f9ea ($6.29 in chips)
Seat 5: 278431d0 ($9.42 in chips)
Seat 6: b8da5e4f ($36.61 in chips)
2510f9ea: posts small blind $0.05
278431d0: posts big blind $0.1
*** HOLE CARDS ***
Dealt to 4681d202 
Dealt to Hero [6h Jd]
Dealt to 5af3c595 
Dealt to 2510f9ea 
Dealt to 278431d0 
Dealt to b8da5e4f 
b8da5e4f: folds
4681d202: folds
Hero: folds
5af3c595: folds
2510f9ea: raises $0.2 to $0.3
278431d0: folds
Uncalled bet ($0.2) returned to 2510f9ea
*** SHOWDOWN ***
2510f9ea collected $0.2 from pot
*** SUMMARY ***
Total pot $0.2 | Rake $0 | Jackpot $0 | Bingo $0 | Fortune $0 | Tax $0
Seat 1: 4681d202 folded before Flop (didn't bet)
Seat 2: Hero folded before Flop (didn't bet)
Seat 3: 5af3c595 (button) folded before Flop (didn't bet)
Seat 4: 2510f9ea (small blind) collected ($0.2)
Seat 5: 278431d0 (big blind) folded before Flop
Seat 6: b8da5e4f folded before Flop (didn't bet)


Poker Hand #HD1846900855: Hold'em No Limit ($0.05/$0.1) - 2024/07/07 15:30:56
Table 'NLHRed20' 6-max Seat #2 is the button
Seat 1: 4681d202 ($10 in chips)
Seat 2: Hero ($10.64 in chips)
Seat 3: 5af3c595 ($20.45 in chips)
Seat 4: 2510f9ea ($6.24 in chips)
Seat 5: 278431d0 ($9.42 in chips)
Seat 6: b8da5e4f ($36.61 in chips)
5af3c595: posts small blind $0.05
2510f9ea: posts big blind $0.1
*** HOLE CARDS ***
Dealt to 4681d202 
Dealt to Hero [5c Kh]
Dealt to 5af3c595 
Dealt to 2510f9ea 
Dealt to 278431d0 
Dealt to b8da5e4f 
278431d0: folds
b8da5e4f: folds
4681d202: folds
Hero: folds
5af3c595: folds
Uncalled bet ($0.05) returned to 2510f9ea
*** SHOWDOWN ***
2510f9ea collected $0.1 from pot
*** SUMMARY ***
Total pot $0.1 | Rake $0 | Jackpot $0 | Bingo $0 | Fortune $0 | Tax $0
Seat 1: 4681d202 folded before Flop (didn't bet)
Seat 2: Hero (button) folded before Flop (didn't bet)
Seat 3: 5af3c595 (small blind) folded before Flop
Seat 4: 2510f9ea (big blind) collected ($0.1)
Seat 5: 278431d0 folded before Flop (didn't bet)
Seat 6: b8da5e4f folded before Flop (didn't bet)


Poker Hand #HD1846900825: Hold'em No Limit ($0.05/$0.1) - 2024/07/07 15:30:43
Table 'NLHRed20' 6-max Seat #1 is the button
Seat 1: 4681d202 ($10 in chips)
Seat 2: Hero ($10.54 in chips)
Seat 3: 5af3c595 ($20.55 in chips)
Seat 4: 2510f9ea ($6.24 in chips)
Seat 5: 278431d0 ($9.42 in chips)
Seat 6: b8da5e4f ($36.61 in chips)
Hero: posts small blind $0.05
5af3c595: posts big blind $0.1
*** HOLE CARDS ***
Dealt to 4681d202 
Dealt to Hero [6s 6h]
Dealt to 5af3c595 
Dealt to 2510f9ea 
Dealt to 278431d0 
Dealt to b8da5e4f 
2510f9ea: folds
278431d0: folds
b8da5e4f: folds
4681d202: folds
Hero: raises $0.2 to $0.3
5af3c595: folds
Uncalled bet ($0.2) returned to Hero
*** SHOWDOWN ***
Hero collected $0.2 from pot
*** SUMMARY ***
Total pot $0.2 | Rake $0 | Jackpot $0 | Bingo $0 | Fortune $0 | Tax $0
Seat 1: 4681d202 (button) folded before Flop (didn't bet)
Seat 2: Hero (small blind) collected ($0.2)
Seat 3: 5af3c595 (big blind) folded before Flop
Seat 4: 2510f9ea folded before Flop (didn't bet)
Seat 5: 278431d0 folded before Flop (didn't bet)
Seat 6: b8da5e4f folded before Flop (didn't bet)


Poker Hand #HD1846900789: Hold'em No Limit ($0.05/$0.1) - 2024/07/07 15:30:27
Table 'NLHRed20' 6-max Seat #6 is the button
Seat 1: 4681d202 ($10.05 in chips)
Seat 2: Hero ($10.49 in chips)
Seat 3: 5af3c595 ($20.55 in chips)
Seat 4: 2510f9ea ($6.24 in chips)
Seat 5: 278431d0 ($9.42 in chips)
Seat 6: b8da5e4f ($36.61 in chips)
4681d202: posts small blind $0.05
Hero: posts big blind $0.1
*** HOLE CARDS ***
Dealt to 4681d202 
Dealt to Hero [8d 9s]
Dealt to 5af3c595 
Dealt to 2510f9ea 
Dealt to 278431d0 
Dealt to b8da5e4f 
5af3c595: folds
2510f9ea: folds
278431d0: folds
b8da5e4f: folds
4681d202: folds
Uncalled bet ($0.05) returned to Hero
*** SHOWDOWN ***
Hero collected $0.1 from pot
*** SUMMARY ***
Total pot $0.1 | Rake $0 | Jackpot $0 | Bingo $0 | Fortune $0 | Tax $0
Seat 1: 4681d202 (small blind) folded before Flop
Seat 2: Hero (big blind) collected ($0.1)
Seat 3: 5af3c595 folded before Flop (didn't bet)
Seat 4: 2510f9ea folded before Flop (didn't bet)
Seat 5: 278431d0 folded before Flop (didn't bet)
Seat 6: b8da5e4f (button) folded before Flop (didn't bet)


Poker Hand #HD1846900766: Hold'em No Limit ($0.05/$0.1) - 2024/07/07 15:30:16
Table 'NLHRed20' 6-max Seat #5 is the button
Seat 1: 4681d202 ($10 in chips)
Seat 2: Hero ($10.49 in chips)
Seat 3: 5af3c595 ($20.55 in chips)
Seat 4: 2510f9ea ($6.24 in chips)
Seat 5: 278431d0 ($9.42 in chips)
Seat 6: b8da5e4f ($36.66 in chips)
b8da5e4f: posts small blind $0.05
4681d202: posts big blind $0.1
*** HOLE CARDS ***
Dealt to 4681d202 
Dealt to Hero [4c Kh]
Dealt to 5af3c595 
Dealt to 2510f9ea 
Dealt to 278431d0 
Dealt to b8da5e4f 
Hero: folds
5af3c595: folds
2510f9ea: folds
278431d0: folds
b8da5e4f: folds
Uncalled bet ($0.05) returned to 4681d202
*** SHOWDOWN ***
4681d202 collected $0.1 from pot
*** SUMMARY ***
Total pot $0.1 | Rake $0 | Jackpot $0 | Bingo $0 | Fortune $0 | Tax $0
Seat 1: 4681d202 (big blind) collected ($0.1)
Seat 2: Hero folded before Flop (didn't bet)
Seat 3: 5af3c595 folded before Flop (didn't bet)
Seat 4: 2510f9ea folded before Flop (didn't bet)
Seat 5: 278431d0 (button) folded before Flop (didn't bet)
Seat 6: b8da5e4f (small blind) folded before Flop


Poker Hand #HD1846900662: Hold'em No Limit ($0.05/$0.1) - 2024/07/07 15:29:28
Table 'NLHRed20' 6-max Seat #4 is the button
Seat 1: 4681d202 ($10 in chips)
Seat 2: Hero ($10.49 in chips)
Seat 3: 5af3c595 ($19.14 in chips)
Seat 4: 2510f9ea ($7.64 in chips)
Seat 5: 278431d0 ($9.47 in chips)
Seat 6: b8da5e4f ($36.76 in chips)
278431d0: posts small blind $0.05
b8da5e4f: posts big blind $0.1
*** HOLE CARDS ***
Dealt to 4681d202 
Dealt to Hero [4s 6h]
Dealt to 5af3c595 
Dealt to 2510f9ea 
Dealt to 278431d0 
Dealt to b8da5e4f 
4681d202: folds
Hero: folds
5af3c595: raises $0.15 to $0.25
2510f9ea: calls $0.25
278431d0: folds
b8da5e4f: folds
*** FLOP *** [Ts 5s 9h]
5af3c595: checks
2510f9ea: bets $0.33
5af3c595: raises $0.82 to $1.15
2510f9ea: calls $0.82
*** TURN *** [Ts 5s 9h] [7h]
5af3c595: bets $2.55
2510f9ea: folds
Uncalled bet ($2.55) returned to 5af3c595
*** SHOWDOWN ***
5af3c595 collected $2.81 from pot
*** SUMMARY ***
Total pot $2.95 | Rake $0.14 | Jackpot $0 | Bingo $0 | Fortune $0 | Tax $0
Board [Ts 5s 9h 7h]
Seat 1: 4681d202 folded before Flop (didn't bet)
Seat 2: Hero folded before Flop (didn't bet)
Seat 3: 5af3c595 won ($2.81)
Seat 4: 2510f9ea (button) folded on the Turn
Seat 5: 278431d0 (small blind) folded before Flop
Seat 6: b8da5e4f (big blind) folded before Flop


Poker Hand #HD1846900577: Hold'em No Limit ($0.05/$0.1) - 2024/07/07 15:28:50
Table 'NLHRed20' 6-max Seat #3 is the button
Seat 1: 4681d202 ($10 in chips)
Seat 2: Hero ($10.15 in chips)
Seat 3: 5af3c595 ($19.14 in chips)
Seat 4: 2510f9ea ($7.69 in chips)
Seat 5: 278431d0 ($9.57 in chips)
Seat 6: b8da5e4f ($36.98 in chips)
2510f9ea: posts small blind $0.05
278431d0: posts big blind $0.1
*** HOLE CARDS ***
Dealt to 4681d202 
Dealt to Hero [9c 9h]
Dealt to 5af3c595 
Dealt to 2510f9ea 
Dealt to 278431d0 
Dealt to b8da5e4f 
b8da5e4f: raises $0.12 to $0.22
4681d202: folds
Hero: raises $0.39 to $0.61
5af3c595: folds
2510f9ea: folds
278431d0: folds
b8da5e4f: folds
Uncalled bet ($0.39) returned to Hero
*** SHOWDOWN ***
Hero collected $0.56 from pot
*** SUMMARY ***
Total pot $0.59 | Rake $0.03 | Jackpot $0 | Bingo $0 | Fortune $0 | Tax $0
Seat 1: 4681d202 folded before Flop (didn't bet)
Seat 2: Hero collected ($0.56)
Seat 3: 5af3c595 (button) folded before Flop (didn't bet)
Seat 4: 2510f9ea (small blind) folded before Flop
Seat 5: 278431d0 (big blind) folded before Flop
Seat 6: b8da5e4f folded before Flop


Poker Hand #HD1846900518: Hold'em No Limit ($0.05/$0.1) - 2024/07/07 15:28:27
Table 'NLHRed20' 6-max Seat #2 is the button
Seat 1: 4681d202 ($10 in chips)
Seat 2: Hero ($10 in chips)
Seat 3: 5af3c595 ($19.19 in chips)
Seat 4: 2510f9ea ($7.79 in chips)
Seat 5: 278431d0 ($9.57 in chips)
Seat 6: b8da5e4f ($36.98 in chips)
5af3c595: posts small blind $0.05
2510f9ea: posts big blind $0.1
*** HOLE CARDS ***
Dealt to 4681d202 
Dealt to Hero [9s Ts]
Dealt to 5af3c595 
Dealt to 2510f9ea 
Dealt to 278431d0 
Dealt to b8da5e4f 
278431d0: folds
b8da5e4f: folds
4681d202: folds
Hero: raises $0.14 to $0.24
5af3c595: folds
2510f9ea: folds
Uncalled bet ($0.14) returned to Hero
*** SHOWDOWN ***
Hero collected $0.25 from pot
*** SUMMARY ***
Total pot $0.25 | Rake $0 | Jackpot $0 | Bingo $0 | Fortune $0 | Tax $0
Seat 1: 4681d202 folded before Flop (didn't bet)
Seat 2: Hero (button) collected ($0.25)
Seat 3: 5af3c595 (small blind) folded before Flop
Seat 4: 2510f9ea (big blind) folded before Flop
Seat 5: 278431d0 folded before Flop (didn't bet)
Seat 6: b8da5e4f folded before Flop (didn't bet)


Poker Hand #HD1846900495: Hold'em No Limit ($0.05/$0.1) - 2024/07/07 15:28:17
Table 'NLHRed20' 6-max Seat #1 is the button
Seat 1: 4681d202 ($10 in chips)
Seat 2: Hero ($10 in chips)
Seat 3: 5af3c595 ($19.14 in chips)
Seat 4: 2510f9ea ($7.79 in chips)
Seat 5: 278431d0 ($9.57 in chips)
Seat 6: b8da5e4f ($36.98 in chips)
Hero: posts small blind $0.05
5af3c595: posts big blind $0.1
*** HOLE CARDS ***
Dealt to 4681d202 
Dealt to Hero [2h 4s]
Dealt to 5af3c595 
Dealt to 2510f9ea 
Dealt to 278431d0 
Dealt to b8da5e4f 
2510f9ea: folds
278431d0: folds
b8da5e4f: folds
4681d202: folds
Hero: folds
Uncalled bet ($0.05) returned to 5af3c595
*** SHOWDOWN ***
5af3c595 collected $0.1 from pot
*** SUMMARY ***
Total pot $0.1 | Rake $0 | Jackpot $0 | Bingo $0 | Fortune $0 | Tax $0
Seat 1: 4681d202 (button) folded before Flop (didn't bet)
Seat 2: Hero (small blind) folded before Flop
Seat 3: 5af3c595 (big blind) collected ($0.1)
Seat 4: 2510f9ea folded before Flop (didn't bet)
Seat 5: 278431d0 folded before Flop (didn't bet)
Seat 6: b8da5e4f folded before Flop (didn't bet)


Poker Hand #HD1846900469: Hold'em No Limit ($0.05/$0.1) - 2024/07/07 15:28:00
Table 'NLHRed20' 6-max Seat #6 is the button
Seat 1: 4681d202 ($10.05 in chips)
Seat 2: Hero ($10 in chips)
Seat 3: 5af3c595 ($19.14 in chips)
Seat 4: 2510f9ea ($7.64 in chips)
Seat 5: 278431d0 ($9.57 in chips)
Seat 6: b8da5e4f ($36.98 in chips)
4681d202: posts small blind $0.05
Hero: posts big blind $0.1
*** HOLE CARDS ***
Dealt to 4681d202 
Dealt to Hero [8s 3c]
Dealt to 5af3c595 
Dealt to 2510f9ea 
Dealt to 278431d0 
Dealt to b8da5e4f 
5af3c595: folds
2510f9ea: raises $0.2 to $0.3
278431d0: folds
b8da5e4f: folds
4681d202: folds
Hero: folds
Uncalled bet ($0.2) returned to 2510f9ea
*** SHOWDOWN ***
2510f9ea collected $0.25 from pot
*** SUMMARY ***
Total pot $0.25 | Rake $0 | Jackpot $0 | Bingo $0 | Fortune $0 | Tax $0
Seat 1: 4681d202 (small blind) folded before Flop
Seat 2: Hero (big blind) folded before Flop
Seat 3: 5af3c595 folded before Flop (didn't bet)
Seat 4: 2510f9ea collected ($0.25)
Seat 5: 278431d0 folded before Flop (didn't bet)
Seat 6: b8da5e4f (button) folded before Flop (didn't bet)


