Poker Hand #RC2771885740: Hold'em No Limit ($0.05/$0.1) - 2024/08/04 11:34:18
Table 'RushAndCash20821000' 6-max Seat #1 is the button
Seat 1: d4026d9c ($10 in chips)
Seat 2: Hero ($35.3 in chips)
Seat 3: ac41646d ($10.87 in chips)
Seat 4: ed6119d7 ($8.56 in chips)
Seat 5: 8afbb278 ($10 in chips)
Seat 6: 584d6443 ($17.67 in chips)
Hero: posts small blind $0.05
ac41646d: posts big blind $0.1
*** HOLE CARDS ***
Dealt to d4026d9c 
Dealt to Hero [9h 3h]
Dealt to ac41646d 
Dealt to ed6119d7 
Dealt to 8afbb278 
Dealt to 584d6443 
ed6119d7: folds
8afbb278: folds
584d6443: folds
d4026d9c: raises $0.13 to $0.23
Hero: folds
ac41646d: folds
Uncalled bet ($0.13) returned to d4026d9c
*** SHOWDOWN ***
d4026d9c collected $0.25 from pot
*** SUMMARY ***
Total pot $0.25 | Rake $0 | Jackpot $0 | Bingo $0 | Fortune $0 | Tax $0
Seat 1: d4026d9c (button) collected ($0.25)
Seat 2: Hero (small blind) folded before Flop
Seat 3: ac41646d (big blind) folded before Flop
Seat 4: ed6119d7 folded before Flop (didn't bet)
Seat 5: 8afbb278 folded before Flop (didn't bet)
Seat 6: 584d6443 folded before Flop (didn't bet)


Poker Hand #RC2771885563: Hold'em No Limit ($0.05/$0.1) - 2024/08/04 11:33:54
Table 'RushAndCash20820823' 6-max Seat #1 is the button
Seat 1: 8f9294ae ($5.45 in chips)
Seat 2: fed4e3cf ($10.3 in chips)
Seat 3: Hero ($35.25 in chips)
Seat 4: fd5037a1 ($18.63 in chips)
Seat 5: 4e0deb91 ($11.89 in chips)
Seat 6: eee2529e ($31.58 in chips)
fed4e3cf: posts small blind $0.05
Hero: posts big blind $0.1
*** HOLE CARDS ***
Dealt to 8f9294ae 
Dealt to fed4e3cf 
Dealt to Hero [3h Qh]
Dealt to fd5037a1 
Dealt to 4e0deb91 
Dealt to eee2529e 
fd5037a1: folds
4e0deb91: folds
eee2529e: folds
8f9294ae: folds
fed4e3cf: folds
Uncalled bet ($0.05) returned to Hero
*** SHOWDOWN ***
Hero collected $0.1 from pot
*** SUMMARY ***
Total pot $0.1 | Rake $0 | Jackpot $0 | Bingo $0 | Fortune $0 | Tax $0
Seat 1: 8f9294ae (button) folded before Flop (didn't bet)
Seat 2: fed4e3cf (small blind) folded before Flop
Seat 3: Hero (big blind) collected ($0.1)
Seat 4: fd5037a1 folded before Flop (didn't bet)
Seat 5: 4e0deb91 folded before Flop (didn't bet)
Seat 6: eee2529e folded before Flop (didn't bet)


Poker Hand #RC2771885537: Hold'em No Limit ($0.05/$0.1) - 2024/08/04 11:33:50
Table 'RushAndCash20820797' 6-max Seat #1 is the button
Seat 1: f8a5426b ($10.52 in chips)
Seat 2: 3ca3a29e ($10.05 in chips)
Seat 3: 52bfa349 ($10 in chips)
Seat 4: fbc8e0fb ($4.59 in chips)
Seat 5: Hero ($35.25 in chips)
Seat 6: b432c242 ($10.77 in chips)
3ca3a29e: posts small blind $0.05
52bfa349: posts big blind $0.1
*** HOLE CARDS ***
Dealt to f8a5426b 
Dealt to 3ca3a29e 
Dealt to 52bfa349 
Dealt to fbc8e0fb 
Dealt to Hero [7h 8c]
Dealt to b432c242 
fbc8e0fb: folds
Hero: folds
b432c242: raises $0.11 to $0.21
f8a5426b: folds
3ca3a29e: folds
52bfa349: folds
Uncalled bet ($0.11) returned to b432c242
*** SHOWDOWN ***
b432c242 collected $0.25 from pot
*** SUMMARY ***
Total pot $0.25 | Rake $0 | Jackpot $0 | Bingo $0 | Fortune $0 | Tax $0
Seat 1: f8a5426b (button) folded before Flop (didn't bet)
Seat 2: 3ca3a29e (small blind) folded before Flop
Seat 3: 52bfa349 (big blind) folded before Flop
Seat 4: fbc8e0fb folded before Flop (didn't bet)
Seat 5: Hero folded before Flop (didn't bet)
Seat 6: b432c242 collected ($0.25)


Poker Hand #RC2771885510: Hold'em No Limit ($0.05/$0.1) - 2024/08/04 11:33:47
Table 'RushAndCash20820770' 6-max Seat #1 is the button
Seat 1: 37c65204 ($12.04 in chips)
Seat 2: c01bdbe3 ($20.22 in chips)
Seat 3: 49db9bf6 ($11.15 in chips)
Seat 4: 84bdbe67 ($12.4 in chips)
Seat 5: 6e38ebef ($27.5 in chips)
Seat 6: Hero ($35.25 in chips)
c01bdbe3: posts small blind $0.05
49db9bf6: posts big blind $0.1
*** HOLE CARDS ***
Dealt to 37c65204 
Dealt to c01bdbe3 
Dealt to 49db9bf6 
Dealt to 84bdbe67 
Dealt to 6e38ebef 
Dealt to Hero [5s 2s]
84bdbe67: folds
6e38ebef: raises $0.15 to $0.25
Hero: folds
37c65204: folds
c01bdbe3: folds
49db9bf6: calls $0.15
*** FLOP *** [Jh Ah Kd]
49db9bf6: checks
6e38ebef: bets $0.28
49db9bf6: raises $0.5 to $0.78
6e38ebef: raises $1.69 to $2.47
49db9bf6: folds
Uncalled bet ($1.69) returned to 6e38ebef
*** SHOWDOWN ***
6e38ebef collected $2.01 from pot
*** SUMMARY ***
Total pot $2.11 | Rake $0.1 | Jackpot $0 | Bingo $0 | Fortune $0 | Tax $0
Board [Jh Ah Kd]
Seat 1: 37c65204 (button) folded before Flop (didn't bet)
Seat 2: c01bdbe3 (small blind) folded before Flop
Seat 3: 49db9bf6 (big blind) folded on the Flop
Seat 4: 84bdbe67 folded before Flop (didn't bet)
Seat 5: 6e38ebef won ($2.01)
Seat 6: Hero folded before Flop (didn't bet)


Poker Hand #RC2771885485: Hold'em No Limit ($0.05/$0.1) - 2024/08/04 11:33:44
Table 'RushAndCash20820745' 6-max Seat #1 is the button
Seat 1: c1846ab6 ($8.97 in chips)
Seat 2: 9db18e17 ($25.26 in chips)
Seat 3: 528614ee ($9.38 in chips)
Seat 4: ffc88672 ($11.56 in chips)
Seat 5: Hero ($35.25 in chips)
Seat 6: fbc8e0fb ($4.64 in chips)
9db18e17: posts small blind $0.05
528614ee: posts big blind $0.1
*** HOLE CARDS ***
Dealt to c1846ab6 
Dealt to 9db18e17 
Dealt to 528614ee 
Dealt to ffc88672 
Dealt to Hero [9c 4h]
Dealt to fbc8e0fb 
ffc88672: folds
Hero: folds
fbc8e0fb: folds
c1846ab6: folds
9db18e17: folds
Uncalled bet ($0.05) returned to 528614ee
*** SHOWDOWN ***
528614ee collected $0.1 from pot
*** SUMMARY ***
Total pot $0.1 | Rake $0 | Jackpot $0 | Bingo $0 | Fortune $0 | Tax $0
Seat 1: c1846ab6 (button) folded before Flop (didn't bet)
Seat 2: 9db18e17 (small blind) folded before Flop
Seat 3: 528614ee (big blind) collected ($0.1)
Seat 4: ffc88672 folded before Flop (didn't bet)
Seat 5: Hero folded before Flop (didn't bet)
Seat 6: fbc8e0fb folded before Flop (didn't bet)


Poker Hand #RC2771885462: Hold'em No Limit ($0.05/$0.1) - 2024/08/04 11:33:41
Table 'RushAndCash20820722' 6-max Seat #1 is the button
Seat 1: Hero ($35.25 in chips)
Seat 2: 45bf4575 ($12.46 in chips)
Seat 3: c527a092 ($20.33 in chips)
Seat 4: 12006fa6 ($10.4 in chips)
Seat 5: ba9c6f92 ($13.03 in chips)
Seat 6: f4c04bd9 ($37.55 in chips)
45bf4575: posts small blind $0.05
c527a092: posts big blind $0.1
*** HOLE CARDS ***
Dealt to Hero [Jd 2c]
Dealt to 45bf4575 
Dealt to c527a092 
Dealt to 12006fa6 
Dealt to ba9c6f92 
Dealt to f4c04bd9 
12006fa6: folds
ba9c6f92: raises $0.1 to $0.2
f4c04bd9: folds
Hero: folds
45bf4575: folds
c527a092: folds
Uncalled bet ($0.1) returned to ba9c6f92
*** SHOWDOWN ***
ba9c6f92 collected $0.25 from pot
*** SUMMARY ***
Total pot $0.25 | Rake $0 | Jackpot $0 | Bingo $0 | Fortune $0 | Tax $0
Seat 1: Hero (button) folded before Flop (didn't bet)
Seat 2: 45bf4575 (small blind) folded before Flop
Seat 3: c527a092 (big blind) folded before Flop
Seat 4: 12006fa6 folded before Flop (didn't bet)
Seat 5: ba9c6f92 collected ($0.25)
Seat 6: f4c04bd9 folded before Flop (didn't bet)


Poker Hand #RC2771885419: Hold'em No Limit ($0.05/$0.1) - 2024/08/04 11:33:35
Table 'RushAndCash20820679' 6-max Seat #1 is the button
Seat 1: Hero ($35.25 in chips)
Seat 2: 3a38c27b ($22.64 in chips)
Seat 3: 4e88776f ($10 in chips)
Seat 4: d4e5d5b1 ($10.05 in chips)
Seat 5: 92e52966 ($10.96 in chips)
Seat 6: 837d1800 ($11.48 in chips)
3a38c27b: posts small blind $0.05
4e88776f: posts big blind $0.1
*** HOLE CARDS ***
Dealt to Hero [6s Jc]
Dealt to 3a38c27b 
Dealt to 4e88776f 
Dealt to d4e5d5b1 
Dealt to 92e52966 
Dealt to 837d1800 
d4e5d5b1: folds
92e52966: folds
837d1800: folds
Hero: folds
3a38c27b: raises $0.2 to $0.3
4e88776f: folds
Uncalled bet ($0.2) returned to 3a38c27b
*** SHOWDOWN ***
3a38c27b collected $0.2 from pot
*** SUMMARY ***
Total pot $0.2 | Rake $0 | Jackpot $0 | Bingo $0 | Fortune $0 | Tax $0
Seat 1: Hero (button) folded before Flop (didn't bet)
Seat 2: 3a38c27b (small blind) collected ($0.2)
Seat 3: 4e88776f (big blind) folded before Flop
Seat 4: d4e5d5b1 folded before Flop (didn't bet)
Seat 5: 92e52966 folded before Flop (didn't bet)
Seat 6: 837d1800 folded before Flop (didn't bet)


Poker Hand #RC2771885393: Hold'em No Limit ($0.05/$0.1) - 2024/08/04 11:33:32
Table 'RushAndCash20820653' 6-max Seat #1 is the button
Seat 1: 4c2eee3c ($10.15 in chips)
Seat 2: Hero ($35.3 in chips)
Seat 3: 5a57d649 ($10.18 in chips)
Seat 4: 3160adde ($11 in chips)
Seat 5: cec053d1 ($12.58 in chips)
Seat 6: fe0aec45 ($11.2 in chips)
Hero: posts small blind $0.05
5a57d649: posts big blind $0.1
*** HOLE CARDS ***
Dealt to 4c2eee3c 
Dealt to Hero [8s 3s]
Dealt to 5a57d649 
Dealt to 3160adde 
Dealt to cec053d1 
Dealt to fe0aec45 
3160adde: folds
cec053d1: raises $0.15 to $0.25
fe0aec45: folds
4c2eee3c: folds
Hero: folds
5a57d649: calls $0.15
*** FLOP *** [7c 6c 5c]
5a57d649: checks
cec053d1: bets $0.28
5a57d649: calls $0.28
*** TURN *** [7c 6c 5c] [3c]
5a57d649: checks
cec053d1: checks
*** RIVER *** [7c 6c 5c 3c] [Ad]
5a57d649: bets $0.56
cec053d1: calls $0.56
5a57d649: shows [2c 2s] (Seven High Flush)
cec053d1: shows [Kc Kd] (King High Flush)
*** SHOWDOWN ***
cec053d1 collected $2.12 from pot
*** SUMMARY ***
Total pot $2.23 | Rake $0.11 | Jackpot $0 | Bingo $0 | Fortune $0 | Tax $0
Board [7c 6c 5c 3c Ad]
Seat 1: 4c2eee3c (button) folded before Flop (didn't bet)
Seat 2: Hero (small blind) folded before Flop
Seat 3: 5a57d649 (big blind) showed [2c 2s] and lost with Seven High Flush
Seat 4: 3160adde folded before Flop (didn't bet)
Seat 5: cec053d1 showed [Kc Kd] and won ($2.12) with King High Flush
Seat 6: fe0aec45 folded before Flop (didn't bet)


Poker Hand #RC2771885328: Hold'em No Limit ($0.05/$0.1) - 2024/08/04 11:33:24
Table 'RushAndCash20820588' 6-max Seat #1 is the button
Seat 1: 5a57d649 ($10.18 in chips)
Seat 2: 483620e3 ($14.47 in chips)
Seat 3: Hero ($35.25 in chips)
Seat 4: 6e38ebef ($27.6 in chips)
Seat 5: daa20e9f ($11.48 in chips)
Seat 6: d1369028 ($10 in chips)
483620e3: posts small blind $0.05
Hero: posts big blind $0.1
*** HOLE CARDS ***
Dealt to 5a57d649 
Dealt to 483620e3 
Dealt to Hero [Js 6s]
Dealt to 6e38ebef 
Dealt to daa20e9f 
Dealt to d1369028 
6e38ebef: folds
daa20e9f: folds
d1369028: folds
5a57d649: folds
483620e3: folds
Uncalled bet ($0.05) returned to Hero
*** SHOWDOWN ***
Hero collected $0.1 from pot
*** SUMMARY ***
Total pot $0.1 | Rake $0 | Jackpot $0 | Bingo $0 | Fortune $0 | Tax $0
Seat 1: 5a57d649 (button) folded before Flop (didn't bet)
Seat 2: 483620e3 (small blind) folded before Flop
Seat 3: Hero (big blind) collected ($0.1)
Seat 4: 6e38ebef folded before Flop (didn't bet)
Seat 5: daa20e9f folded before Flop (didn't bet)
Seat 6: d1369028 folded before Flop (didn't bet)


Poker Hand #RC2771885206: Hold'em No Limit ($0.05/$0.1) - 2024/08/04 11:33:08
Table 'RushAndCash20820466' 6-max Seat #1 is the button
Seat 1: 70d39a9a ($11.05 in chips)
Seat 2: 12006fa6 ($10.67 in chips)
Seat 3: 9b94a525 ($12.54 in chips)
Seat 4: Hero ($35.1 in chips)
Seat 5: c2f798e3 ($10.72 in chips)
Seat 6: 3a38c27b ($22.49 in chips)
12006fa6: posts small blind $0.05
9b94a525: posts big blind $0.1
*** HOLE CARDS ***
Dealt to 70d39a9a 
Dealt to 12006fa6 
Dealt to 9b94a525 
Dealt to Hero [Ad Jc]
Dealt to c2f798e3 
Dealt to 3a38c27b 
Hero: raises $0.1 to $0.2
c2f798e3: folds
3a38c27b: folds
70d39a9a: folds
12006fa6: folds
9b94a525: folds
Uncalled bet ($0.1) returned to Hero
*** SHOWDOWN ***
Hero collected $0.25 from pot
*** SUMMARY ***
Total pot $0.25 | Rake $0 | Jackpot $0 | Bingo $0 | Fortune $0 | Tax $0
Seat 1: 70d39a9a (button) folded before Flop (didn't bet)
Seat 2: 12006fa6 (small blind) folded before Flop
Seat 3: 9b94a525 (big blind) folded before Flop
Seat 4: Hero collected ($0.25)
Seat 5: c2f798e3 folded before Flop (didn't bet)
Seat 6: 3a38c27b folded before Flop (didn't bet)


Poker Hand #RC2771885180: Hold'em No Limit ($0.05/$0.1) - 2024/08/04 11:33:04
Table 'RushAndCash20820440' 6-max Seat #1 is the button
Seat 1: 8adbca3d ($10.21 in chips)
Seat 2: Hero ($35.15 in chips)
Seat 3: bbe5b1db ($19.83 in chips)
Seat 4: 8bf101c5 ($11.33 in chips)
Seat 5: cad0ab4e ($22.46 in chips)
Seat 6: aa2f423d ($10.62 in chips)
Hero: posts small blind $0.05
bbe5b1db: posts big blind $0.1
*** HOLE CARDS ***
Dealt to 8adbca3d 
Dealt to Hero [2s 8h]
Dealt to bbe5b1db 
Dealt to 8bf101c5 
Dealt to cad0ab4e 
Dealt to aa2f423d 
8bf101c5: folds
cad0ab4e: folds
aa2f423d: raises $0.1 to $0.2
8adbca3d: folds
Hero: folds
bbe5b1db: folds
Uncalled bet ($0.1) returned to aa2f423d
*** SHOWDOWN ***
aa2f423d collected $0.25 from pot
*** SUMMARY ***
Total pot $0.25 | Rake $0 | Jackpot $0 | Bingo $0 | Fortune $0 | Tax $0
Seat 1: 8adbca3d (button) folded before Flop (didn't bet)
Seat 2: Hero (small blind) folded before Flop
Seat 3: bbe5b1db (big blind) folded before Flop
Seat 4: 8bf101c5 folded before Flop (didn't bet)
Seat 5: cad0ab4e folded before Flop (didn't bet)
Seat 6: aa2f423d collected ($0.25)


Poker Hand #RC2771885153: Hold'em No Limit ($0.05/$0.1) - 2024/08/04 11:33:01
Table 'RushAndCash20820413' 6-max Seat #1 is the button
Seat 1: 64c53507 ($10.18 in chips)
Seat 2: b7dd630b ($12.29 in chips)
Seat 3: d7bf0e55 ($13.65 in chips)
Seat 4: Hero ($35.15 in chips)
Seat 5: 727d850c ($29.03 in chips)
Seat 6: c487ee76 ($10.05 in chips)
b7dd630b: posts small blind $0.05
d7bf0e55: posts big blind $0.1
*** HOLE CARDS ***
Dealt to 64c53507 
Dealt to b7dd630b 
Dealt to d7bf0e55 
Dealt to Hero [7s 8c]
Dealt to 727d850c 
Dealt to c487ee76 
Hero: folds
727d850c: folds
c487ee76: folds
64c53507: raises $0.2 to $0.3
b7dd630b: folds
d7bf0e55: folds
Uncalled bet ($0.2) returned to 64c53507
*** SHOWDOWN ***
64c53507 collected $0.25 from pot
*** SUMMARY ***
Total pot $0.25 | Rake $0 | Jackpot $0 | Bingo $0 | Fortune $0 | Tax $0
Seat 1: 64c53507 (button) collected ($0.25)
Seat 2: b7dd630b (small blind) folded before Flop
Seat 3: d7bf0e55 (big blind) folded before Flop
Seat 4: Hero folded before Flop (didn't bet)
Seat 5: 727d850c folded before Flop (didn't bet)
Seat 6: c487ee76 folded before Flop (didn't bet)


Poker Hand #RC2771885117: Hold'em No Limit ($0.05/$0.1) - 2024/08/04 11:32:56
Table 'RushAndCash20820377' 6-max Seat #1 is the button
Seat 1: d50058e4 ($22.44 in chips)
Seat 2: c369fe87 ($23.53 in chips)
Seat 3: Hero ($35.25 in chips)
Seat 4: 4c3169c8 ($11.38 in chips)
Seat 5: ea0cddce ($10.7 in chips)
Seat 6: 384ab2e9 ($4.6 in chips)
c369fe87: posts small blind $0.05
Hero: posts big blind $0.1
*** HOLE CARDS ***
Dealt to d50058e4 
Dealt to c369fe87 
Dealt to Hero [9s Tc]
Dealt to 4c3169c8 
Dealt to ea0cddce 
Dealt to 384ab2e9 
4c3169c8: folds
ea0cddce: folds
384ab2e9: raises $0.1 to $0.2
d50058e4: folds
c369fe87: folds
Hero: folds
Uncalled bet ($0.1) returned to 384ab2e9
*** SHOWDOWN ***
384ab2e9 collected $0.25 from pot
*** SUMMARY ***
Total pot $0.25 | Rake $0 | Jackpot $0 | Bingo $0 | Fortune $0 | Tax $0
Seat 1: d50058e4 (button) folded before Flop (didn't bet)
Seat 2: c369fe87 (small blind) folded before Flop
Seat 3: Hero (big blind) folded before Flop
Seat 4: 4c3169c8 folded before Flop (didn't bet)
Seat 5: ea0cddce folded before Flop (didn't bet)
Seat 6: 384ab2e9 collected ($0.25)


Poker Hand #RC2771885069: Hold'em No Limit ($0.05/$0.1) - 2024/08/04 11:32:50
Table 'RushAndCash20820329' 6-max Seat #1 is the button
Seat 1: 4b94745b ($10.8 in chips)
Seat 2: 26893d1c ($10.94 in chips)
Seat 3: f85d7db2 ($24.28 in chips)
Seat 4: 2b943dd6 ($11.39 in chips)
Seat 5: Hero ($35.25 in chips)
Seat 6: fb9bf54a ($27.75 in chips)
26893d1c: posts small blind $0.05
f85d7db2: posts big blind $0.1
*** HOLE CARDS ***
Dealt to 4b94745b 
Dealt to 26893d1c 
Dealt to f85d7db2 
Dealt to 2b943dd6 
Dealt to Hero [5c 9c]
Dealt to fb9bf54a 
2b943dd6: raises $0.1 to $0.2
Hero: folds
fb9bf54a: folds
4b94745b: folds
26893d1c: folds
f85d7db2: folds
Uncalled bet ($0.1) returned to 2b943dd6
*** SHOWDOWN ***
2b943dd6 collected $0.25 from pot
*** SUMMARY ***
Total pot $0.25 | Rake $0 | Jackpot $0 | Bingo $0 | Fortune $0 | Tax $0
Seat 1: 4b94745b (button) folded before Flop (didn't bet)
Seat 2: 26893d1c (small blind) folded before Flop
Seat 3: f85d7db2 (big blind) folded before Flop
Seat 4: 2b943dd6 collected ($0.25)
Seat 5: Hero folded before Flop (didn't bet)
Seat 6: fb9bf54a folded before Flop (didn't bet)


Poker Hand #RC2771885032: Hold'em No Limit ($0.05/$0.1) - 2024/08/04 11:32:45
Table 'RushAndCash20820292' 6-max Seat #1 is the button
Seat 1: 4325ab1 ($11.03 in chips)
Seat 2: 24c4b23f ($24.99 in chips)
Seat 3: c40d6b6a ($15.28 in chips)
Seat 4: 5c2ef128 ($23.44 in chips)
Seat 5: Hero ($35.25 in chips)
Seat 6: 5e877199 ($10.4 in chips)
24c4b23f: posts small blind $0.05
c40d6b6a: posts big blind $0.1
*** HOLE CARDS ***
Dealt to 4325ab1 
Dealt to 24c4b23f 
Dealt to c40d6b6a 
Dealt to 5c2ef128 
Dealt to Hero [Jh 5s]
Dealt to 5e877199 
5c2ef128: folds
Hero: folds
5e877199: folds
4325ab1: raises $0.1 to $0.2
24c4b23f: raises $0.75 to $0.95
c40d6b6a: folds
4325ab1: calls $0.75
*** FLOP *** [5d 9s Ad]
24c4b23f: checks
4325ab1: checks
*** TURN *** [5d 9s Ad] [Qs]
24c4b23f: checks
4325ab1: bets $1.5
24c4b23f: folds
Uncalled bet ($1.5) returned to 4325ab1
*** SHOWDOWN ***
4325ab1 collected $1.9 from pot
*** SUMMARY ***
Total pot $2 | Rake $0.1 | Jackpot $0 | Bingo $0 | Fortune $0 | Tax $0
Board [5d 9s Ad Qs]
Seat 1: 4325ab1 (button) won ($1.9)
Seat 2: 24c4b23f (small blind) folded on the Turn
Seat 3: c40d6b6a (big blind) folded before Flop
Seat 4: 5c2ef128 folded before Flop (didn't bet)
Seat 5: Hero folded before Flop (didn't bet)
Seat 6: 5e877199 folded before Flop (didn't bet)


Poker Hand #RC2771884796: Hold'em No Limit ($0.05/$0.1) - 2024/08/04 11:32:14
Table 'RushAndCash20820056' 6-max Seat #1 is the button
Seat 1: 538aef45 ($8.57 in chips)
Seat 2: Hero ($35.55 in chips)
Seat 3: 5c2ef128 ($23.17 in chips)
Seat 4: 27c79a21 ($13.26 in chips)
Seat 5: 9016ed92 ($10 in chips)
Seat 6: 3aebb49d ($26.92 in chips)
Hero: posts small blind $0.05
5c2ef128: posts big blind $0.1
*** HOLE CARDS ***
Dealt to 538aef45 
Dealt to Hero [8d As]
Dealt to 5c2ef128 
Dealt to 27c79a21 
Dealt to 9016ed92 
Dealt to 3aebb49d 
27c79a21: folds
9016ed92: folds
3aebb49d: folds
538aef45: folds
Hero: raises $0.2 to $0.3
5c2ef128: calls $0.2
*** FLOP *** [9h 2c Kc]
Hero: checks
5c2ef128: bets $0.3
Hero: folds
Uncalled bet ($0.3) returned to 5c2ef128
*** SHOWDOWN ***
5c2ef128 collected $0.57 from pot
*** SUMMARY ***
Total pot $0.6 | Rake $0.03 | Jackpot $0 | Bingo $0 | Fortune $0 | Tax $0
Board [9h 2c Kc]
Seat 1: 538aef45 (button) folded before Flop (didn't bet)
Seat 2: Hero (small blind) folded on the Flop
Seat 3: 5c2ef128 (big blind) won ($0.57)
Seat 4: 27c79a21 folded before Flop (didn't bet)
Seat 5: 9016ed92 folded before Flop (didn't bet)
Seat 6: 3aebb49d folded before Flop (didn't bet)


Poker Hand #RC2771884760: Hold'em No Limit ($0.05/$0.1) - 2024/08/04 11:32:10
Table 'RushAndCash20820020' 6-max Seat #1 is the button
Seat 1: Hero ($35.55 in chips)
Seat 2: 4325ab1 ($11.23 in chips)
Seat 3: a4587f40 ($15.17 in chips)
Seat 4: 4fb5bda6 ($10 in chips)
Seat 5: c1846ab6 ($9.12 in chips)
Seat 6: 7c803d6d ($11.06 in chips)
4325ab1: posts small blind $0.05
a4587f40: posts big blind $0.1
*** HOLE CARDS ***
Dealt to Hero [7h Kc]
Dealt to 4325ab1 
Dealt to a4587f40 
Dealt to 4fb5bda6 
Dealt to c1846ab6 
Dealt to 7c803d6d 
4fb5bda6: folds
c1846ab6: folds
7c803d6d: raises $0.1 to $0.2
Hero: folds
4325ab1: folds
a4587f40: calls $0.1
*** FLOP *** [Jc 6h 9d]
a4587f40: checks
7c803d6d: bets $0.2
a4587f40: calls $0.2
*** TURN *** [Jc 6h 9d] [2h]
a4587f40: checks
7c803d6d: bets $0.4
a4587f40: calls $0.4
*** RIVER *** [Jc 6h 9d 2h] [4c]
a4587f40: checks
7c803d6d: bets $1
a4587f40: folds
Uncalled bet ($1) returned to 7c803d6d
*** SHOWDOWN ***
7c803d6d collected $1.57 from pot
*** SUMMARY ***
Total pot $1.65 | Rake $0.08 | Jackpot $0 | Bingo $0 | Fortune $0 | Tax $0
Board [Jc 6h 9d 2h 4c]
Seat 1: Hero (button) folded before Flop (didn't bet)
Seat 2: 4325ab1 (small blind) folded before Flop
Seat 3: a4587f40 (big blind) folded on the River
Seat 4: 4fb5bda6 folded before Flop (didn't bet)
Seat 5: c1846ab6 folded before Flop (didn't bet)
Seat 6: 7c803d6d won ($1.57)


Poker Hand #RC2771844703: Hold'em No Limit ($0.05/$0.1) - 2024/08/04 11:32:02
Table 'RushAndCash20819963' 6-max Seat #1 is the button
Seat 1: f8a5426b ($10 in chips)
Seat 2: d1369028 ($10.4 in chips)
Seat 3: 797548a7 ($10.37 in chips)
Seat 4: d47986ad ($5.9 in chips)
Seat 5: ab598596 ($11.52 in chips)
Seat 6: Hero ($35.55 in chips)
d1369028: posts small blind $0.05
797548a7: posts big blind $0.1
*** HOLE CARDS ***
Dealt to f8a5426b 
Dealt to d1369028 
Dealt to 797548a7 
Dealt to d47986ad 
Dealt to ab598596 
Dealt to Hero [3d Ts]
d47986ad: folds
ab598596: folds
Hero: folds
f8a5426b: raises $0.1 to $0.2
d1369028: folds
797548a7: folds
Uncalled bet ($0.1) returned to f8a5426b
*** SHOWDOWN ***
f8a5426b collected $0.25 from pot
*** SUMMARY ***
Total pot $0.25 | Rake $0 | Jackpot $0 | Bingo $0 | Fortune $0 | Tax $0
Seat 1: f8a5426b (button) collected ($0.25)
Seat 2: d1369028 (small blind) folded before Flop
Seat 3: 797548a7 (big blind) folded before Flop
Seat 4: d47986ad folded before Flop (didn't bet)
Seat 5: ab598596 folded before Flop (didn't bet)
Seat 6: Hero folded before Flop (didn't bet)


Poker Hand #RC2771844674: Hold'em No Limit ($0.05/$0.1) - 2024/08/04 11:31:59
Table 'RushAndCash20819934' 6-max Seat #1 is the button
Seat 1: 247af9e8 ($10.25 in chips)
Seat 2: d5f0e1f8 ($12.04 in chips)
Seat 3: ef551d4b ($26.27 in chips)
Seat 4: Hero ($35.55 in chips)
Seat 5: c64c4a14 ($9.25 in chips)
Seat 6: eeb70f39 ($10 in chips)
d5f0e1f8: posts small blind $0.05
ef551d4b: posts big blind $0.1
*** HOLE CARDS ***
Dealt to 247af9e8 
Dealt to d5f0e1f8 
Dealt to ef551d4b 
Dealt to Hero [3c Jh]
Dealt to c64c4a14 
Dealt to eeb70f39 
Hero: folds
c64c4a14: folds
eeb70f39: folds
247af9e8: folds
d5f0e1f8: folds
Uncalled bet ($0.05) returned to ef551d4b
*** SHOWDOWN ***
ef551d4b collected $0.1 from pot
*** SUMMARY ***
Total pot $0.1 | Rake $0 | Jackpot $0 | Bingo $0 | Fortune $0 | Tax $0
Seat 1: 247af9e8 (button) folded before Flop (didn't bet)
Seat 2: d5f0e1f8 (small blind) folded before Flop
Seat 3: ef551d4b (big blind) collected ($0.1)
Seat 4: Hero folded before Flop (didn't bet)
Seat 5: c64c4a14 folded before Flop (didn't bet)
Seat 6: eeb70f39 folded before Flop (didn't bet)


Poker Hand #RC2771844646: Hold'em No Limit ($0.05/$0.1) - 2024/08/04 11:31:55
Table 'RushAndCash20819906' 6-max Seat #1 is the button
Seat 1: aecf03be ($22.36 in chips)
Seat 2: 8a336bf2 ($9.7 in chips)
Seat 3: c7502fa9 ($10.12 in chips)
Seat 4: Hero ($35.55 in chips)
Seat 5: 78b72290 ($10 in chips)
Seat 6: ea0cddce ($10.47 in chips)
8a336bf2: posts small blind $0.05
c7502fa9: posts big blind $0.1
*** HOLE CARDS ***
Dealt to aecf03be 
Dealt to 8a336bf2 
Dealt to c7502fa9 
Dealt to Hero [3c Jc]
Dealt to 78b72290 
Dealt to ea0cddce 
Hero: folds
78b72290: raises $0.15 to $0.25
ea0cddce: folds
aecf03be: folds
8a336bf2: folds
c7502fa9: calls $0.15
*** FLOP *** [8h Kc Td]
c7502fa9: checks
78b72290: checks
*** TURN *** [8h Kc Td] [4s]
c7502fa9: checks
78b72290: checks
*** RIVER *** [8h Kc Td 4s] [2c]
c7502fa9: checks
78b72290: checks
c7502fa9: shows [Th 6h] (Pair of Tens)
78b72290: shows [9d 9s] (Pair of Nines)
*** SHOWDOWN ***
c7502fa9 collected $0.53 from pot
*** SUMMARY ***
Total pot $0.55 | Rake $0.02 | Jackpot $0 | Bingo $0 | Fortune $0 | Tax $0
Board [8h Kc Td 4s 2c]
Seat 1: aecf03be (button) folded before Flop (didn't bet)
Seat 2: 8a336bf2 (small blind) folded before Flop
Seat 3: c7502fa9 (big blind) showed [Th 6h] and won ($0.53) with Pair of Tens
Seat 4: Hero folded before Flop (didn't bet)
Seat 5: 78b72290 showed [9d 9s] and lost with Pair of Nines
Seat 6: ea0cddce folded before Flop (didn't bet)


Poker Hand #RC2771844464: Hold'em No Limit ($0.05/$0.1) - 2024/08/04 11:31:33
Table 'RushAndCash20819724' 6-max Seat #1 is the button
Seat 1: 6e1edbbc ($23.96 in chips)
Seat 2: a8504bc3 ($10 in chips)
Seat 3: Hero ($35.27 in chips)
Seat 4: 2bff48f1 ($16.76 in chips)
Seat 5: 95e39858 ($10.86 in chips)
Seat 6: c81bcc5 ($10 in chips)
a8504bc3: posts small blind $0.05
Hero: posts big blind $0.1
*** HOLE CARDS ***
Dealt to 6e1edbbc 
Dealt to a8504bc3 
Dealt to Hero [Qc Qh]
Dealt to 2bff48f1 
Dealt to 95e39858 
Dealt to c81bcc5 
2bff48f1: raises $0.15 to $0.25
95e39858: folds
c81bcc5: folds
6e1edbbc: folds
a8504bc3: folds
Hero: raises $0.75 to $1
2bff48f1: folds
Uncalled bet ($0.75) returned to Hero
*** SHOWDOWN ***
Hero collected $0.53 from pot
*** SUMMARY ***
Total pot $0.55 | Rake $0.02 | Jackpot $0 | Bingo $0 | Fortune $0 | Tax $0
Seat 1: 6e1edbbc (button) folded before Flop (didn't bet)
Seat 2: a8504bc3 (small blind) folded before Flop
Seat 3: Hero (big blind) collected ($0.53)
Seat 4: 2bff48f1 folded before Flop
Seat 5: 95e39858 folded before Flop (didn't bet)
Seat 6: c81bcc5 folded before Flop (didn't bet)


Poker Hand #RC2771844419: Hold'em No Limit ($0.05/$0.1) - 2024/08/04 11:31:27
Table 'RushAndCash20819679' 6-max Seat #1 is the button
Seat 1: Hero ($35.27 in chips)
Seat 2: 21561c8f ($11.3 in chips)
Seat 3: c72c5bbf ($19.75 in chips)
Seat 4: c64c4a14 ($10 in chips)
Seat 5: 9eddfbb6 ($10.4 in chips)
Seat 6: deb4b25 ($16.21 in chips)
21561c8f: posts small blind $0.05
c72c5bbf: posts big blind $0.1
*** HOLE CARDS ***
Dealt to Hero [Jh 5h]
Dealt to 21561c8f 
Dealt to c72c5bbf 
Dealt to c64c4a14 
Dealt to 9eddfbb6 
Dealt to deb4b25 
c64c4a14: folds
9eddfbb6: folds
deb4b25: folds
Hero: folds
21561c8f: folds
Uncalled bet ($0.05) returned to c72c5bbf
*** SHOWDOWN ***
c72c5bbf collected $0.1 from pot
*** SUMMARY ***
Total pot $0.1 | Rake $0 | Jackpot $0 | Bingo $0 | Fortune $0 | Tax $0
Seat 1: Hero (button) folded before Flop (didn't bet)
Seat 2: 21561c8f (small blind) folded before Flop
Seat 3: c72c5bbf (big blind) collected ($0.1)
Seat 4: c64c4a14 folded before Flop (didn't bet)
Seat 5: 9eddfbb6 folded before Flop (didn't bet)
Seat 6: deb4b25 folded before Flop (didn't bet)


Poker Hand #RC2771844396: Hold'em No Limit ($0.05/$0.1) - 2024/08/04 11:31:23
Table 'RushAndCash20819656' 6-max Seat #1 is the button
Seat 1: 21f46713 ($10 in chips)
Seat 2: 6bdcd702 ($9.24 in chips)
Seat 3: 2a3d22c6 ($15.55 in chips)
Seat 4: Hero ($35.27 in chips)
Seat 5: 8e50fe99 ($10 in chips)
Seat 6: 1d198da3 ($10 in chips)
6bdcd702: posts small blind $0.05
2a3d22c6: posts big blind $0.1
*** HOLE CARDS ***
Dealt to 21f46713 
Dealt to 6bdcd702 
Dealt to 2a3d22c6 
Dealt to Hero [3h Qh]
Dealt to 8e50fe99 
Dealt to 1d198da3 
Hero: folds
8e50fe99: raises $0.12 to $0.22
1d198da3: folds
21f46713: folds
6bdcd702: folds
2a3d22c6: calls $0.12
*** FLOP *** [Jc 5d 3d]
2a3d22c6: checks
8e50fe99: checks
*** TURN *** [Jc 5d 3d] [8c]
2a3d22c6: bets $0.17
8e50fe99: folds
Uncalled bet ($0.17) returned to 2a3d22c6
*** SHOWDOWN ***
2a3d22c6 collected $0.47 from pot
*** SUMMARY ***
Total pot $0.49 | Rake $0.02 | Jackpot $0 | Bingo $0 | Fortune $0 | Tax $0
Board [Jc 5d 3d 8c]
Seat 1: 21f46713 (button) folded before Flop (didn't bet)
Seat 2: 6bdcd702 (small blind) folded before Flop
Seat 3: 2a3d22c6 (big blind) won ($0.47)
Seat 4: Hero folded before Flop (didn't bet)
Seat 5: 8e50fe99 folded on the Turn
Seat 6: 1d198da3 folded before Flop (didn't bet)


Poker Hand #RC2771844371: Hold'em No Limit ($0.05/$0.1) - 2024/08/04 11:31:20
Table 'RushAndCash20819631' 6-max Seat #1 is the button
Seat 1: 1779d766 ($10 in chips)
Seat 2: 539a7153 ($10.27 in chips)
Seat 3: 6a1ebd35 ($9.8 in chips)
Seat 4: 2a3d22c6 ($15.55 in chips)
Seat 5: 1b0c40c2 ($13.25 in chips)
Seat 6: Hero ($35.27 in chips)
539a7153: posts small blind $0.05
6a1ebd35: posts big blind $0.1
*** HOLE CARDS ***
Dealt to 1779d766 
Dealt to 539a7153 
Dealt to 6a1ebd35 
Dealt to 2a3d22c6 
Dealt to 1b0c40c2 
Dealt to Hero [2d Ks]
2a3d22c6: folds
1b0c40c2: folds
Hero: folds
1779d766: raises $0.1 to $0.2
539a7153: folds
6a1ebd35: calls $0.1
*** FLOP *** [6d 7s 8c]
6a1ebd35: bets $0.34
1779d766: calls $0.34
*** TURN *** [6d 7s 8c] [6c]
6a1ebd35: bets $0.85
1779d766: calls $0.85
*** RIVER *** [6d 7s 8c 6c] [Jh]
6a1ebd35: bets $2.13
1779d766: folds
Uncalled bet ($2.13) returned to 6a1ebd35
*** SHOWDOWN ***
6a1ebd35 collected $2.69 from pot
*** SUMMARY ***
Total pot $2.83 | Rake $0.14 | Jackpot $0 | Bingo $0 | Fortune $0 | Tax $0
Board [6d 7s 8c 6c Jh]
Seat 1: 1779d766 (button) folded on the River
Seat 2: 539a7153 (small blind) folded before Flop
Seat 3: 6a1ebd35 (big blind) won ($2.69)
Seat 4: 2a3d22c6 folded before Flop (didn't bet)
Seat 5: 1b0c40c2 folded before Flop (didn't bet)
Seat 6: Hero folded before Flop (didn't bet)


Poker Hand #RC2771844335: Hold'em No Limit ($0.05/$0.1) - 2024/08/04 11:31:16
Table 'RushAndCash20819595' 6-max Seat #1 is the button
Seat 1: a3055d0a ($10.23 in chips)
Seat 2: Hero ($35.32 in chips)
Seat 3: cd9b5f04 ($13.45 in chips)
Seat 4: 48204666 ($4.18 in chips)
Seat 5: 7ceb484a ($12.25 in chips)
Seat 6: 215f4d7b ($12.63 in chips)
Hero: posts small blind $0.05
cd9b5f04: posts big blind $0.1
*** HOLE CARDS ***
Dealt to a3055d0a 
Dealt to Hero [9h 7c]
Dealt to cd9b5f04 
Dealt to 48204666 
Dealt to 7ceb484a 
Dealt to 215f4d7b 
48204666: folds
7ceb484a: folds
215f4d7b: folds
a3055d0a: folds
Hero: folds
Uncalled bet ($0.05) returned to cd9b5f04
*** SHOWDOWN ***
cd9b5f04 collected $0.1 from pot
*** SUMMARY ***
Total pot $0.1 | Rake $0 | Jackpot $0 | Bingo $0 | Fortune $0 | Tax $0
Seat 1: a3055d0a (button) folded before Flop (didn't bet)
Seat 2: Hero (small blind) folded before Flop
Seat 3: cd9b5f04 (big blind) collected ($0.1)
Seat 4: 48204666 folded before Flop (didn't bet)
Seat 5: 7ceb484a folded before Flop (didn't bet)
Seat 6: 215f4d7b folded before Flop (didn't bet)


Poker Hand #RC2771844298: Hold'em No Limit ($0.05/$0.1) - 2024/08/04 11:31:11
Table 'RushAndCash20819558' 6-max Seat #1 is the button
Seat 1: c01bdbe3 ($20.65 in chips)
Seat 2: 248ddfd3 ($9.96 in chips)
Seat 3: 5e597e13 ($10 in chips)
Seat 4: fed4e3cf ($10.01 in chips)
Seat 5: 2c4405a7 ($29.36 in chips)
Seat 6: Hero ($35.32 in chips)
248ddfd3: posts small blind $0.05
5e597e13: posts big blind $0.1
*** HOLE CARDS ***
Dealt to c01bdbe3 
Dealt to 248ddfd3 
Dealt to 5e597e13 
Dealt to fed4e3cf 
Dealt to 2c4405a7 
Dealt to Hero [7h 8s]
fed4e3cf: folds
2c4405a7: folds
Hero: folds
c01bdbe3: raises $0.12 to $0.22
248ddfd3: folds
5e597e13: folds
Uncalled bet ($0.12) returned to c01bdbe3
*** SHOWDOWN ***
c01bdbe3 collected $0.25 from pot
*** SUMMARY ***
Total pot $0.25 | Rake $0 | Jackpot $0 | Bingo $0 | Fortune $0 | Tax $0
Seat 1: c01bdbe3 (button) collected ($0.25)
Seat 2: 248ddfd3 (small blind) folded before Flop
Seat 3: 5e597e13 (big blind) folded before Flop
Seat 4: fed4e3cf folded before Flop (didn't bet)
Seat 5: 2c4405a7 folded before Flop (didn't bet)
Seat 6: Hero folded before Flop (didn't bet)


Poker Hand #RC2771844271: Hold'em No Limit ($0.05/$0.1) - 2024/08/04 11:31:08
Table 'RushAndCash20819531' 6-max Seat #1 is the button
Seat 1: f9dd4b13 ($10 in chips)
Seat 2: cfea9829 ($10 in chips)
Seat 3: Hero ($35.42 in chips)
Seat 4: 8a336bf2 ($7.38 in chips)
Seat 5: 24366bad ($10 in chips)
Seat 6: b334737c ($15.66 in chips)
cfea9829: posts small blind $0.05
Hero: posts big blind $0.1
*** HOLE CARDS ***
Dealt to f9dd4b13 
Dealt to cfea9829 
Dealt to Hero [5h 8s]
Dealt to 8a336bf2 
Dealt to 24366bad 
Dealt to b334737c 
8a336bf2: folds
24366bad: folds
b334737c: folds
f9dd4b13: raises $0.2 to $0.3
cfea9829: folds
Hero: folds
Uncalled bet ($0.2) returned to f9dd4b13
*** SHOWDOWN ***
f9dd4b13 collected $0.25 from pot
*** SUMMARY ***
Total pot $0.25 | Rake $0 | Jackpot $0 | Bingo $0 | Fortune $0 | Tax $0
Seat 1: f9dd4b13 (button) collected ($0.25)
Seat 2: cfea9829 (small blind) folded before Flop
Seat 3: Hero (big blind) folded before Flop
Seat 4: 8a336bf2 folded before Flop (didn't bet)
Seat 5: 24366bad folded before Flop (didn't bet)
Seat 6: b334737c folded before Flop (didn't bet)


Poker Hand #RC2771844244: Hold'em No Limit ($0.05/$0.1) - 2024/08/04 11:31:05
Table 'RushAndCash20819504' 6-max Seat #1 is the button
Seat 1: b97a9f2f ($17.7 in chips)
Seat 2: 2588758c ($16.71 in chips)
Seat 3: df577b55 ($10 in chips)
Seat 4: Hero ($35.42 in chips)
Seat 5: 84bdbe67 ($12.9 in chips)
Seat 6: 25e548bd ($11.39 in chips)
2588758c: posts small blind $0.05
df577b55: posts big blind $0.1
*** HOLE CARDS ***
Dealt to b97a9f2f 
Dealt to 2588758c 
Dealt to df577b55 
Dealt to Hero [3d 9d]
Dealt to 84bdbe67 
Dealt to 25e548bd 
Hero: folds
84bdbe67: folds
25e548bd: folds
b97a9f2f: folds
2588758c: calls $0.05
df577b55: checks
*** FLOP *** [Jd 2s Qd]
2588758c: checks
df577b55: checks
*** TURN *** [Jd 2s Qd] [Kd]
2588758c: bets $0.15
df577b55: folds
Uncalled bet ($0.15) returned to 2588758c
*** SHOWDOWN ***
2588758c collected $0.19 from pot
*** SUMMARY ***
Total pot $0.2 | Rake $0.01 | Jackpot $0 | Bingo $0 | Fortune $0 | Tax $0
Board [Jd 2s Qd Kd]
Seat 1: b97a9f2f (button) folded before Flop (didn't bet)
Seat 2: 2588758c (small blind) won ($0.19)
Seat 3: df577b55 (big blind) folded on the Turn
Seat 4: Hero folded before Flop (didn't bet)
Seat 5: 84bdbe67 folded before Flop (didn't bet)
Seat 6: 25e548bd folded before Flop (didn't bet)


Poker Hand #RC2771844073: Hold'em No Limit ($0.05/$0.1) - 2024/08/04 11:30:44
Table 'RushAndCash20819333' 6-max Seat #1 is the button
Seat 1: b432c242 ($7.84 in chips)
Seat 2: 84bdbe67 ($13.15 in chips)
Seat 3: Hero ($35.19 in chips)
Seat 4: 8adbca3d ($10.15 in chips)
Seat 5: 6d439f7f ($28.59 in chips)
Seat 6: 8e50fe99 ($10 in chips)
84bdbe67: posts small blind $0.05
Hero: posts big blind $0.1
*** HOLE CARDS ***
Dealt to b432c242 
Dealt to 84bdbe67 
Dealt to Hero [3s Ah]
Dealt to 8adbca3d 
Dealt to 6d439f7f 
Dealt to 8e50fe99 
8adbca3d: folds
6d439f7f: folds
8e50fe99: folds
b432c242: folds
84bdbe67: raises $0.15 to $0.25
Hero: raises $0.55 to $0.8
84bdbe67: folds
Uncalled bet ($0.55) returned to Hero
*** SHOWDOWN ***
Hero collected $0.48 from pot
*** SUMMARY ***
Total pot $0.5 | Rake $0.02 | Jackpot $0 | Bingo $0 | Fortune $0 | Tax $0
Seat 1: b432c242 (button) folded before Flop (didn't bet)
Seat 2: 84bdbe67 (small blind) folded before Flop
Seat 3: Hero (big blind) collected ($0.48)
Seat 4: 8adbca3d folded before Flop (didn't bet)
Seat 5: 6d439f7f folded before Flop (didn't bet)
Seat 6: 8e50fe99 folded before Flop (didn't bet)


Poker Hand #RC2771844045: Hold'em No Limit ($0.05/$0.1) - 2024/08/04 11:30:40
Table 'RushAndCash20819305' 6-max Seat #1 is the button
Seat 1: fcf928b1 ($10.6 in chips)
Seat 2: Hero ($35.24 in chips)
Seat 3: b3501fb9 ($12.56 in chips)
Seat 4: 6a1ebd35 ($10 in chips)
Seat 5: d0d2ca4c ($9.8 in chips)
Seat 6: 2f3f7137 ($10.36 in chips)
Hero: posts small blind $0.05
b3501fb9: posts big blind $0.1
*** HOLE CARDS ***
Dealt to fcf928b1 
Dealt to Hero [8d Jh]
Dealt to b3501fb9 
Dealt to 6a1ebd35 
Dealt to d0d2ca4c 
Dealt to 2f3f7137 
6a1ebd35: folds
d0d2ca4c: folds
2f3f7137: folds
fcf928b1: raises $0.14 to $0.24
Hero: folds
b3501fb9: raises $0.91 to $1.15
fcf928b1: folds
Uncalled bet ($0.91) returned to b3501fb9
*** SHOWDOWN ***
b3501fb9 collected $0.51 from pot
*** SUMMARY ***
Total pot $0.53 | Rake $0.02 | Jackpot $0 | Bingo $0 | Fortune $0 | Tax $0
Seat 1: fcf928b1 (button) folded before Flop
Seat 2: Hero (small blind) folded before Flop
Seat 3: b3501fb9 (big blind) collected ($0.51)
Seat 4: 6a1ebd35 folded before Flop (didn't bet)
Seat 5: d0d2ca4c folded before Flop (didn't bet)
Seat 6: 2f3f7137 folded before Flop (didn't bet)


Poker Hand #RC2771844017: Hold'em No Limit ($0.05/$0.1) - 2024/08/04 11:30:37
Table 'RushAndCash20819277' 6-max Seat #1 is the button
Seat 1: f66e544f ($10 in chips)
Seat 2: d0f4fa1f ($11.35 in chips)
Seat 3: f2d586b8 ($10.15 in chips)
Seat 4: 41898db9 ($11.69 in chips)
Seat 5: Hero ($35.24 in chips)
Seat 6: 159a8d84 ($13.85 in chips)
d0f4fa1f: posts small blind $0.05
f2d586b8: posts big blind $0.1
*** HOLE CARDS ***
Dealt to f66e544f 
Dealt to d0f4fa1f 
Dealt to f2d586b8 
Dealt to 41898db9 
Dealt to Hero [3c 6d]
Dealt to 159a8d84 
41898db9: folds
Hero: folds
159a8d84: raises $0.1 to $0.2
f66e544f: folds
d0f4fa1f: raises $0.8 to $1
f2d586b8: folds
159a8d84: folds
Uncalled bet ($0.8) returned to d0f4fa1f
*** SHOWDOWN ***
d0f4fa1f collected $0.48 from pot
*** SUMMARY ***
Total pot $0.5 | Rake $0.02 | Jackpot $0 | Bingo $0 | Fortune $0 | Tax $0
Seat 1: f66e544f (button) folded before Flop (didn't bet)
Seat 2: d0f4fa1f (small blind) collected ($0.48)
Seat 3: f2d586b8 (big blind) folded before Flop
Seat 4: 41898db9 folded before Flop (didn't bet)
Seat 5: Hero folded before Flop (didn't bet)
Seat 6: 159a8d84 folded before Flop


Poker Hand #RC2771843980: Hold'em No Limit ($0.05/$0.1) - 2024/08/04 11:30:32
Table 'RushAndCash20819240' 6-max Seat #1 is the button
Seat 1: 5268fd37 ($6.77 in chips)
Seat 2: 7ceb484a ($11.75 in chips)
Seat 3: b5f0a875 ($12.12 in chips)
Seat 4: 5d043ad0 ($21.01 in chips)
Seat 5: Hero ($35.24 in chips)
Seat 6: 13c20591 ($10 in chips)
7ceb484a: posts small blind $0.05
b5f0a875: posts big blind $0.1
*** HOLE CARDS ***
Dealt to 5268fd37 
Dealt to 7ceb484a 
Dealt to b5f0a875 
Dealt to 5d043ad0 
Dealt to Hero [6d 9d]
Dealt to 13c20591 
5d043ad0: folds
Hero: folds
13c20591: folds
5268fd37: folds
7ceb484a: raises $0.15 to $0.25
b5f0a875: calls $0.15
*** FLOP *** [2h Jh Qs]
7ceb484a: bets $0.3
b5f0a875: calls $0.3
*** TURN *** [2h Jh Qs] [7d]
7ceb484a: bets $0.83
b5f0a875: folds
Uncalled bet ($0.83) returned to 7ceb484a
*** SHOWDOWN ***
7ceb484a collected $1.05 from pot
*** SUMMARY ***
Total pot $1.1 | Rake $0.05 | Jackpot $0 | Bingo $0 | Fortune $0 | Tax $0
Board [2h Jh Qs 7d]
Seat 1: 5268fd37 (button) folded before Flop (didn't bet)
Seat 2: 7ceb484a (small blind) won ($1.05)
Seat 3: b5f0a875 (big blind) folded on the Turn
Seat 4: 5d043ad0 folded before Flop (didn't bet)
Seat 5: Hero folded before Flop (didn't bet)
Seat 6: 13c20591 folded before Flop (didn't bet)


Poker Hand #RC2771843955: Hold'em No Limit ($0.05/$0.1) - 2024/08/04 11:30:29
Table 'RushAndCash20819215' 6-max Seat #1 is the button
Seat 1: 33427f42 ($22.01 in chips)
Seat 2: 2a3d22c6 ($14.65 in chips)
Seat 3: c8875c30 ($11.4 in chips)
Seat 4: Hero ($35.24 in chips)
Seat 5: 5ab06e64 ($15.9 in chips)
Seat 6: bc812436 ($10.53 in chips)
2a3d22c6: posts small blind $0.05
c8875c30: posts big blind $0.1
*** HOLE CARDS ***
Dealt to 33427f42 
Dealt to 2a3d22c6 
Dealt to c8875c30 
Dealt to Hero [Ah 5d]
Dealt to 5ab06e64 
Dealt to bc812436 
Hero: folds
5ab06e64: folds
bc812436: folds
33427f42: raises $0.15 to $0.25
2a3d22c6: raises $0.75 to $1
c8875c30: folds
33427f42: calls $0.75
*** FLOP *** [6c Jd 4c]
2a3d22c6: bets $0.95
33427f42: folds
Uncalled bet ($0.95) returned to 2a3d22c6
*** SHOWDOWN ***
2a3d22c6 collected $2 from pot
*** SUMMARY ***
Total pot $2.1 | Rake $0.1 | Jackpot $0 | Bingo $0 | Fortune $0 | Tax $0
Board [6c Jd 4c]
Seat 1: 33427f42 (button) folded on the Flop
Seat 2: 2a3d22c6 (small blind) won ($2)
Seat 3: c8875c30 (big blind) folded before Flop
Seat 4: Hero folded before Flop (didn't bet)
Seat 5: 5ab06e64 folded before Flop (didn't bet)
Seat 6: bc812436 folded before Flop (didn't bet)


Poker Hand #RC2771843927: Hold'em No Limit ($0.05/$0.1) - 2024/08/04 11:30:26
Table 'RushAndCash20819187' 6-max Seat #1 is the button
Seat 1: Hero ($35.24 in chips)
Seat 2: 27a3f6e4 ($10.05 in chips)
Seat 3: 44165a65 ($8.22 in chips)
Seat 4: cec053d1 ($11.87 in chips)
Seat 5: aeffe5ed ($10.1 in chips)
Seat 6: 59da53d3 ($10.1 in chips)
27a3f6e4: posts small blind $0.05
44165a65: posts big blind $0.1
*** HOLE CARDS ***
Dealt to Hero [As 2h]
Dealt to 27a3f6e4 
Dealt to 44165a65 
Dealt to cec053d1 
Dealt to aeffe5ed 
Dealt to 59da53d3 
cec053d1: folds
aeffe5ed: folds
59da53d3: folds
Hero: folds
27a3f6e4: raises $0.12 to $0.22
44165a65: folds
Uncalled bet ($0.12) returned to 27a3f6e4
*** SHOWDOWN ***
27a3f6e4 collected $0.2 from pot
*** SUMMARY ***
Total pot $0.2 | Rake $0 | Jackpot $0 | Bingo $0 | Fortune $0 | Tax $0
Seat 1: Hero (button) folded before Flop (didn't bet)
Seat 2: 27a3f6e4 (small blind) collected ($0.2)
Seat 3: 44165a65 (big blind) folded before Flop
Seat 4: cec053d1 folded before Flop (didn't bet)
Seat 5: aeffe5ed folded before Flop (didn't bet)
Seat 6: 59da53d3 folded before Flop (didn't bet)


Poker Hand #RC2771843894: Hold'em No Limit ($0.05/$0.1) - 2024/08/04 11:30:22
Table 'RushAndCash20819154' 6-max Seat #1 is the button
Seat 1: d9f8d57b ($10.4 in chips)
Seat 2: 537dc97e ($10.23 in chips)
Seat 3: ff1689f8 ($10.3 in chips)
Seat 4: c6604e8 ($10.67 in chips)
Seat 5: Hero ($35.24 in chips)
Seat 6: cfb85aa9 ($10.14 in chips)
537dc97e: posts small blind $0.05
ff1689f8: posts big blind $0.1
*** HOLE CARDS ***
Dealt to d9f8d57b 
Dealt to 537dc97e 
Dealt to ff1689f8 
Dealt to c6604e8 
Dealt to Hero [Qd 4d]
Dealt to cfb85aa9 
c6604e8: raises $0.1 to $0.2
Hero: folds
cfb85aa9: raises $0.45 to $0.65
d9f8d57b: folds
537dc97e: folds
ff1689f8: folds
c6604e8: calls $0.45
*** FLOP *** [3s Td 2d]
c6604e8: checks
cfb85aa9: bets $0.73
c6604e8: calls $0.73
*** TURN *** [3s Td 2d] [7c]
c6604e8: checks
cfb85aa9: bets $2.19
c6604e8: calls $2.19
*** RIVER *** [3s Td 2d 7c] [6h]
c6604e8: checks
cfb85aa9: bets $6.57 and is all-in
c6604e8: calls $6.57
cfb85aa9: shows [Jh Js] (Pair of Jacks)
c6604e8: shows [6d 5d] (Pair of Sixes)
*** SHOWDOWN ***
cfb85aa9 collected $19.98 from pot
*** SUMMARY ***
Total pot $20.43 | Rake $0.3 | Jackpot $0.15 | Bingo $0 | Fortune $0 | Tax $0
Board [3s Td 2d 7c 6h]
Seat 1: d9f8d57b (button) folded before Flop (didn't bet)
Seat 2: 537dc97e (small blind) folded before Flop
Seat 3: ff1689f8 (big blind) folded before Flop
Seat 4: c6604e8 showed [6d 5d] and lost with Pair of Sixes
Seat 5: Hero folded before Flop (didn't bet)
Seat 6: cfb85aa9 showed [Jh Js] and won ($19.98) with Pair of Jacks


Poker Hand #RC2771843709: Hold'em No Limit ($0.05/$0.1) - 2024/08/04 11:29:59
Table 'RushAndCash20818969' 6-max Seat #1 is the button
Seat 1: bf806ca6 ($10.25 in chips)
Seat 2: cfb85aa9 ($10.39 in chips)
Seat 3: Hero ($34.77 in chips)
Seat 4: ac0338fb ($10.05 in chips)
Seat 5: dbeca9a2 ($10.92 in chips)
Seat 6: fa08c10 ($10 in chips)
cfb85aa9: posts small blind $0.05
Hero: posts big blind $0.1
*** HOLE CARDS ***
Dealt to bf806ca6 
Dealt to cfb85aa9 
Dealt to Hero [Ac As]
Dealt to ac0338fb 
Dealt to dbeca9a2 
Dealt to fa08c10 
ac0338fb: raises $0.15 to $0.25
dbeca9a2: folds
fa08c10: folds
bf806ca6: folds
cfb85aa9: calls $0.2
Hero: raises $1.05 to $1.3
ac0338fb: folds
cfb85aa9: folds
Uncalled bet ($1.05) returned to Hero
*** SHOWDOWN ***
Hero collected $0.72 from pot
*** SUMMARY ***
Total pot $0.75 | Rake $0.03 | Jackpot $0 | Bingo $0 | Fortune $0 | Tax $0
Seat 1: bf806ca6 (button) folded before Flop (didn't bet)
Seat 2: cfb85aa9 (small blind) folded before Flop
Seat 3: Hero (big blind) collected ($0.72)
Seat 4: ac0338fb folded before Flop
Seat 5: dbeca9a2 folded before Flop (didn't bet)
Seat 6: fa08c10 folded before Flop (didn't bet)


Poker Hand #RC2771843662: Hold'em No Limit ($0.05/$0.1) - 2024/08/04 11:29:52
Table 'RushAndCash20818922' 6-max Seat #1 is the button
Seat 1: df6eccf2 ($16.8 in chips)
Seat 2: c19bed42 ($36.68 in chips)
Seat 3: 989af457 ($17.68 in chips)
Seat 4: 402f8b4b ($10 in chips)
Seat 5: 76577d8b ($17.32 in chips)
Seat 6: Hero ($34.77 in chips)
c19bed42: posts small blind $0.05
989af457: posts big blind $0.1
*** HOLE CARDS ***
Dealt to df6eccf2 
Dealt to c19bed42 
Dealt to 989af457 
Dealt to 402f8b4b 
Dealt to 76577d8b 
Dealt to Hero [7h Td]
402f8b4b: folds
76577d8b: folds
Hero: folds
df6eccf2: raises $0.15 to $0.25
c19bed42: folds
989af457: calls $0.15
*** FLOP *** [Ts 2s 2c]
989af457: checks
df6eccf2: checks
*** TURN *** [Ts 2s 2c] [7d]
989af457: checks
df6eccf2: checks
*** RIVER *** [Ts 2s 2c 7d] [Ac]
989af457: checks
df6eccf2: bets $0.28
989af457: folds
Uncalled bet ($0.28) returned to df6eccf2
*** SHOWDOWN ***
df6eccf2 collected $0.53 from pot
*** SUMMARY ***
Total pot $0.55 | Rake $0.02 | Jackpot $0 | Bingo $0 | Fortune $0 | Tax $0
Board [Ts 2s 2c 7d Ac]
Seat 1: df6eccf2 (button) won ($0.53)
Seat 2: c19bed42 (small blind) folded before Flop
Seat 3: 989af457 (big blind) folded on the River
Seat 4: 402f8b4b folded before Flop (didn't bet)
Seat 5: 76577d8b folded before Flop (didn't bet)
Seat 6: Hero folded before Flop (didn't bet)


Poker Hand #RC2771843379: Hold'em No Limit ($0.05/$0.1) - 2024/08/04 11:29:16
Table 'RushAndCash20818639' 6-max Seat #1 is the button
Seat 1: Hero ($34.02 in chips)
Seat 2: fcf928b1 ($10 in chips)
Seat 3: 81491c9c ($10 in chips)
Seat 4: 989af457 ($18.35 in chips)
Seat 5: f814105e ($14.54 in chips)
Seat 6: 41898db9 ($11.44 in chips)
fcf928b1: posts small blind $0.05
81491c9c: posts big blind $0.1
*** HOLE CARDS ***
Dealt to Hero [Ac Tc]
Dealt to fcf928b1 
Dealt to 81491c9c 
Dealt to 989af457 
Dealt to f814105e 
Dealt to 41898db9 
989af457: raises $0.1 to $0.2
f814105e: folds
41898db9: folds
Hero: raises $0.47 to $0.67
fcf928b1: folds
81491c9c: folds
989af457: calls $0.47
*** FLOP *** [2c Jd 6c]
989af457: checks
Hero: bets $0.7
989af457: folds
Uncalled bet ($0.7) returned to Hero
*** SHOWDOWN ***
Hero collected $1.42 from pot
*** SUMMARY ***
Total pot $1.49 | Rake $0.07 | Jackpot $0 | Bingo $0 | Fortune $0 | Tax $0
Board [2c Jd 6c]
Seat 1: Hero (button) won ($1.42)
Seat 2: fcf928b1 (small blind) folded before Flop
Seat 3: 81491c9c (big blind) folded before Flop
Seat 4: 989af457 folded on the Flop
Seat 5: f814105e folded before Flop (didn't bet)
Seat 6: 41898db9 folded before Flop (didn't bet)


Poker Hand #RC2771843284: Hold'em No Limit ($0.05/$0.1) - 2024/08/04 11:29:04
Table 'RushAndCash20818544' 6-max Seat #1 is the button
Seat 1: 2c4405a7 ($29.21 in chips)
Seat 2: Hero ($34.07 in chips)
Seat 3: 1f0df17a ($11.27 in chips)
Seat 4: a631a0be ($10.1 in chips)
Seat 5: c832269d ($11.02 in chips)
Seat 6: deaca6c5 ($1.87 in chips)
Hero: posts small blind $0.05
1f0df17a: posts big blind $0.1
*** HOLE CARDS ***
Dealt to 2c4405a7 
Dealt to Hero [Tc Ad]
Dealt to 1f0df17a 
Dealt to a631a0be 
Dealt to c832269d 
Dealt to deaca6c5 
a631a0be: raises $0.12 to $0.22
c832269d: folds
deaca6c5: calls $0.22
2c4405a7: calls $0.22
Hero: folds
1f0df17a: folds
*** FLOP *** [Jh Kh 6d]
a631a0be: checks
deaca6c5: bets $0.41
2c4405a7: folds
a631a0be: folds
Uncalled bet ($0.41) returned to deaca6c5
*** SHOWDOWN ***
deaca6c5 collected $0.77 from pot
*** SUMMARY ***
Total pot $0.81 | Rake $0.04 | Jackpot $0 | Bingo $0 | Fortune $0 | Tax $0
Board [Jh Kh 6d]
Seat 1: 2c4405a7 (button) folded on the Flop
Seat 2: Hero (small blind) folded before Flop
Seat 3: 1f0df17a (big blind) folded before Flop
Seat 4: a631a0be folded on the Flop
Seat 5: c832269d folded before Flop (didn't bet)
Seat 6: deaca6c5 won ($0.77)


Poker Hand #RC2771843256: Hold'em No Limit ($0.05/$0.1) - 2024/08/04 11:29:01
Table 'RushAndCash20818516' 6-max Seat #1 is the button
Seat 1: c40d6b6a ($14.91 in chips)
Seat 2: a631a0be ($10.15 in chips)
Seat 3: 92f5a7b ($10.84 in chips)
Seat 4: Hero ($34.07 in chips)
Seat 5: 56e3c993 ($11.17 in chips)
Seat 6: 33183b07 ($10.1 in chips)
a631a0be: posts small blind $0.05
92f5a7b: posts big blind $0.1
*** HOLE CARDS ***
Dealt to c40d6b6a 
Dealt to a631a0be 
Dealt to 92f5a7b 
Dealt to Hero [Kh 2s]
Dealt to 56e3c993 
Dealt to 33183b07 
Hero: folds
56e3c993: folds
33183b07: folds
c40d6b6a: folds
a631a0be: folds
Uncalled bet ($0.05) returned to 92f5a7b
*** SHOWDOWN ***
92f5a7b collected $0.1 from pot
*** SUMMARY ***
Total pot $0.1 | Rake $0 | Jackpot $0 | Bingo $0 | Fortune $0 | Tax $0
Seat 1: c40d6b6a (button) folded before Flop (didn't bet)
Seat 2: a631a0be (small blind) folded before Flop
Seat 3: 92f5a7b (big blind) collected ($0.1)
Seat 4: Hero folded before Flop (didn't bet)
Seat 5: 56e3c993 folded before Flop (didn't bet)
Seat 6: 33183b07 folded before Flop (didn't bet)


Poker Hand #RC2771843228: Hold'em No Limit ($0.05/$0.1) - 2024/08/04 11:28:57
Table 'RushAndCash20818488' 6-max Seat #1 is the button
Seat 1: 539a7153 ($9.85 in chips)
Seat 2: 2731d46 ($4.46 in chips)
Seat 3: 3c3ff182 ($20.34 in chips)
Seat 4: c460565b ($16.42 in chips)
Seat 5: 8a570737 ($17.72 in chips)
Seat 6: Hero ($34.07 in chips)
2731d46: posts small blind $0.05
3c3ff182: posts big blind $0.1
*** HOLE CARDS ***
Dealt to 539a7153 
Dealt to 2731d46 
Dealt to 3c3ff182 
Dealt to c460565b 
Dealt to 8a570737 
Dealt to Hero [8c Kd]
c460565b: folds
8a570737: folds
Hero: folds
539a7153: raises $0.15 to $0.25
2731d46: folds
3c3ff182: folds
Uncalled bet ($0.15) returned to 539a7153
*** SHOWDOWN ***
539a7153 collected $0.25 from pot
*** SUMMARY ***
Total pot $0.25 | Rake $0 | Jackpot $0 | Bingo $0 | Fortune $0 | Tax $0
Seat 1: 539a7153 (button) collected ($0.25)
Seat 2: 2731d46 (small blind) folded before Flop
Seat 3: 3c3ff182 (big blind) folded before Flop
Seat 4: c460565b folded before Flop (didn't bet)
Seat 5: 8a570737 folded before Flop (didn't bet)
Seat 6: Hero folded before Flop (didn't bet)


Poker Hand #RC2771842805: Hold'em No Limit ($0.05/$0.1) - 2024/08/04 11:28:01
Table 'RushAndCash20818065' 6-max Seat #1 is the button
Seat 1: dbeca9a2 ($10 in chips)
Seat 2: Hero ($34.57 in chips)
Seat 3: 2731d46 ($4.01 in chips)
Seat 4: cd9b5f04 ($13.6 in chips)
Seat 5: 20360d24 ($10.37 in chips)
Seat 6: 5d516777 ($10.39 in chips)
Hero: posts small blind $0.05
2731d46: posts big blind $0.1
*** HOLE CARDS ***
Dealt to dbeca9a2 
Dealt to Hero [Ad 5s]
Dealt to 2731d46 
Dealt to cd9b5f04 
Dealt to 20360d24 
Dealt to 5d516777 
cd9b5f04: folds
20360d24: folds
5d516777: folds
dbeca9a2: folds
Hero: raises $0.2 to $0.3
2731d46: calls $0.2
*** FLOP *** [Qh 8c As]
Hero: checks
2731d46: checks
*** TURN *** [Qh 8c As] [Kc]
Hero: bets $0.2
2731d46: raises $1.1 to $1.3
Hero: folds
Uncalled bet ($1.1) returned to 2731d46
*** SHOWDOWN ***
2731d46 collected $0.95 from pot
*** SUMMARY ***
Total pot $1 | Rake $0.05 | Jackpot $0 | Bingo $0 | Fortune $0 | Tax $0
Board [Qh 8c As Kc]
Seat 1: dbeca9a2 (button) folded before Flop (didn't bet)
Seat 2: Hero (small blind) folded on the Turn
Seat 3: 2731d46 (big blind) won ($0.95)
Seat 4: cd9b5f04 folded before Flop (didn't bet)
Seat 5: 20360d24 folded before Flop (didn't bet)
Seat 6: 5d516777 folded before Flop (didn't bet)


Poker Hand #RC2771842576: Hold'em No Limit ($0.05/$0.1) - 2024/08/04 11:27:30
Table 'RushAndCash20817836' 6-max Seat #1 is the button
Seat 1: 20360d24 ($9.85 in chips)
Seat 2: 57313db2 ($10 in chips)
Seat 3: 4afaab23 ($10 in chips)
Seat 4: c21f392c ($11.32 in chips)
Seat 5: Hero ($34.77 in chips)
Seat 6: 5d043ad0 ($21.72 in chips)
57313db2: posts small blind $0.05
4afaab23: posts big blind $0.1
*** HOLE CARDS ***
Dealt to 20360d24 
Dealt to 57313db2 
Dealt to 4afaab23 
Dealt to c21f392c 
Dealt to Hero [Jd Ad]
Dealt to 5d043ad0 
c21f392c: folds
Hero: raises $0.1 to $0.2
5d043ad0: calls $0.2
20360d24: raises $0.8 to $1
57313db2: folds
4afaab23: folds
Hero: folds
5d043ad0: folds
Uncalled bet ($0.8) returned to 20360d24
*** SHOWDOWN ***
20360d24 collected $0.72 from pot
*** SUMMARY ***
Total pot $0.75 | Rake $0.03 | Jackpot $0 | Bingo $0 | Fortune $0 | Tax $0
Seat 1: 20360d24 (button) collected ($0.72)
Seat 2: 57313db2 (small blind) folded before Flop
Seat 3: 4afaab23 (big blind) folded before Flop
Seat 4: c21f392c folded before Flop (didn't bet)
Seat 5: Hero folded before Flop
Seat 6: 5d043ad0 folded before Flop


Poker Hand #RC2771842523: Hold'em No Limit ($0.05/$0.1) - 2024/08/04 11:27:22
Table 'RushAndCash20817783' 6-max Seat #1 is the button
Seat 1: Hero ($34.77 in chips)
Seat 2: 8cf8a919 ($10.2 in chips)
Seat 3: b3cb985 ($18.36 in chips)
Seat 4: 6bdcd702 ($10 in chips)
Seat 5: 248ddfd3 ($9.28 in chips)
Seat 6: 44212311 ($17.56 in chips)
8cf8a919: posts small blind $0.05
b3cb985: posts big blind $0.1
*** HOLE CARDS ***
Dealt to Hero [5s 6s]
Dealt to 8cf8a919 
Dealt to b3cb985 
Dealt to 6bdcd702 
Dealt to 248ddfd3 
Dealt to 44212311 
6bdcd702: folds
248ddfd3: folds
44212311: folds
Hero: folds
8cf8a919: raises $0.15 to $0.25
b3cb985: calls $0.15
*** FLOP *** [8d Tc 2h]
8cf8a919: bets $0.2
b3cb985: calls $0.2
*** TURN *** [8d Tc 2h] [Td]
8cf8a919: checks
b3cb985: bets $0.3
8cf8a919: raises $1.13 to $1.43
b3cb985: folds
Uncalled bet ($1.13) returned to 8cf8a919
*** SHOWDOWN ***
8cf8a919 collected $1.43 from pot
*** SUMMARY ***
Total pot $1.5 | Rake $0.07 | Jackpot $0 | Bingo $0 | Fortune $0 | Tax $0
Board [8d Tc 2h Td]
Seat 1: Hero (button) folded before Flop (didn't bet)
Seat 2: 8cf8a919 (small blind) won ($1.43)
Seat 3: b3cb985 (big blind) folded on the Turn
Seat 4: 6bdcd702 folded before Flop (didn't bet)
Seat 5: 248ddfd3 folded before Flop (didn't bet)
Seat 6: 44212311 folded before Flop (didn't bet)


Poker Hand #RC2771842497: Hold'em No Limit ($0.05/$0.1) - 2024/08/04 11:27:19
Table 'RushAndCash20817757' 6-max Seat #1 is the button
Seat 1: 8568d561 ($10.05 in chips)
Seat 2: ceac9e2 ($14.97 in chips)
Seat 3: Hero ($34.87 in chips)
Seat 4: 8cf8a919 ($10.2 in chips)
Seat 5: 5b390931 ($11.52 in chips)
Seat 6: 24e6aaf4 ($12.86 in chips)
ceac9e2: posts small blind $0.05
Hero: posts big blind $0.1
*** HOLE CARDS ***
Dealt to 8568d561 
Dealt to ceac9e2 
Dealt to Hero [3c 7s]
Dealt to 8cf8a919 
Dealt to 5b390931 
Dealt to 24e6aaf4 
8cf8a919: folds
5b390931: folds
24e6aaf4: raises $0.1 to $0.2
8568d561: folds
ceac9e2: folds
Hero: folds
Uncalled bet ($0.1) returned to 24e6aaf4
*** SHOWDOWN ***
24e6aaf4 collected $0.25 from pot
*** SUMMARY ***
Total pot $0.25 | Rake $0 | Jackpot $0 | Bingo $0 | Fortune $0 | Tax $0
Seat 1: 8568d561 (button) folded before Flop (didn't bet)
Seat 2: ceac9e2 (small blind) folded before Flop
Seat 3: Hero (big blind) folded before Flop
Seat 4: 8cf8a919 folded before Flop (didn't bet)
Seat 5: 5b390931 folded before Flop (didn't bet)
Seat 6: 24e6aaf4 collected ($0.25)


Poker Hand #RC2771842430: Hold'em No Limit ($0.05/$0.1) - 2024/08/04 11:27:11
Table 'RushAndCash20817690' 6-max Seat #1 is the button
Seat 1: 9e88a611 ($18.51 in chips)
Seat 2: 3728bbdd ($17.9 in chips)
Seat 3: 2f1f0972 ($12.53 in chips)
Seat 4: Hero ($34.87 in chips)
Seat 5: 3ee283e0 ($25.65 in chips)
Seat 6: 18ddc90b ($20.16 in chips)
3728bbdd: posts small blind $0.05
2f1f0972: posts big blind $0.1
*** HOLE CARDS ***
Dealt to 9e88a611 
Dealt to 3728bbdd 
Dealt to 2f1f0972 
Dealt to Hero [Tc Ks]
Dealt to 3ee283e0 
Dealt to 18ddc90b 
Hero: folds
3ee283e0: folds
18ddc90b: folds
9e88a611: folds
3728bbdd: folds
Uncalled bet ($0.05) returned to 2f1f0972
*** SHOWDOWN ***
2f1f0972 collected $0.1 from pot
*** SUMMARY ***
Total pot $0.1 | Rake $0 | Jackpot $0 | Bingo $0 | Fortune $0 | Tax $0
Seat 1: 9e88a611 (button) folded before Flop (didn't bet)
Seat 2: 3728bbdd (small blind) folded before Flop
Seat 3: 2f1f0972 (big blind) collected ($0.1)
Seat 4: Hero folded before Flop (didn't bet)
Seat 5: 3ee283e0 folded before Flop (didn't bet)
Seat 6: 18ddc90b folded before Flop (didn't bet)


Poker Hand #RC2771842396: Hold'em No Limit ($0.05/$0.1) - 2024/08/04 11:27:06
Table 'RushAndCash20817656' 6-max Seat #1 is the button
Seat 1: 466eccbc ($10.15 in chips)
Seat 2: b3cb985 ($18.41 in chips)
Seat 3: 538aef45 ($11.37 in chips)
Seat 4: Hero ($34.87 in chips)
Seat 5: 402f8b4b ($10.2 in chips)
Seat 6: b0b9f6e6 ($16.95 in chips)
b3cb985: posts small blind $0.05
538aef45: posts big blind $0.1
*** HOLE CARDS ***
Dealt to 466eccbc 
Dealt to b3cb985 
Dealt to 538aef45 
Dealt to Hero [Qh Jc]
Dealt to 402f8b4b 
Dealt to b0b9f6e6 
Hero: folds
402f8b4b: folds
b0b9f6e6: raises $0.15 to $0.25
466eccbc: folds
b3cb985: folds
538aef45: folds
Uncalled bet ($0.15) returned to b0b9f6e6
*** SHOWDOWN ***
b0b9f6e6 collected $0.25 from pot
*** SUMMARY ***
Total pot $0.25 | Rake $0 | Jackpot $0 | Bingo $0 | Fortune $0 | Tax $0
Seat 1: 466eccbc (button) folded before Flop (didn't bet)
Seat 2: b3cb985 (small blind) folded before Flop
Seat 3: 538aef45 (big blind) folded before Flop
Seat 4: Hero folded before Flop (didn't bet)
Seat 5: 402f8b4b folded before Flop (didn't bet)
Seat 6: b0b9f6e6 collected ($0.25)


Poker Hand #RC2771842338: Hold'em No Limit ($0.05/$0.1) - 2024/08/04 11:26:59
Table 'RushAndCash20817598' 6-max Seat #1 is the button
Seat 1: caa3c6ba ($10.72 in chips)
Seat 2: 70d39a9a ($10.2 in chips)
Seat 3: 2c4405a7 ($29.26 in chips)
Seat 4: 7dce9a50 ($4.41 in chips)
Seat 5: Hero ($34.87 in chips)
Seat 6: c460565b ($18.11 in chips)
70d39a9a: posts small blind $0.05
2c4405a7: posts big blind $0.1
*** HOLE CARDS ***
Dealt to caa3c6ba 
Dealt to 70d39a9a 
Dealt to 2c4405a7 
Dealt to 7dce9a50 
Dealt to Hero [4c 9c]
Dealt to c460565b 
7dce9a50: folds
Hero: folds
c460565b: raises $0.1 to $0.2
caa3c6ba: folds
70d39a9a: folds
2c4405a7: calls $0.1
*** FLOP *** [Qd As 8c]
2c4405a7: checks
c460565b: bets $0.34
2c4405a7: calls $0.34
*** TURN *** [Qd As 8c] [Jc]
2c4405a7: checks
c460565b: checks
*** RIVER *** [Qd As 8c Jc] [Td]
2c4405a7: checks
c460565b: checks
2c4405a7: shows [Jd 8d] (Pair of Jacks and Pair of Eights)
c460565b: shows [5d Ac] (Pair of Aces)
*** SHOWDOWN ***
2c4405a7 collected $1.08 from pot
*** SUMMARY ***
Total pot $1.13 | Rake $0.05 | Jackpot $0 | Bingo $0 | Fortune $0 | Tax $0
Board [Qd As 8c Jc Td]
Seat 1: caa3c6ba (button) folded before Flop (didn't bet)
Seat 2: 70d39a9a (small blind) folded before Flop
Seat 3: 2c4405a7 (big blind) showed [Jd 8d] and won ($1.08) with Pair of Jacks and Pair of Eights
Seat 4: 7dce9a50 folded before Flop (didn't bet)
Seat 5: Hero folded before Flop (didn't bet)
Seat 6: c460565b showed [5d Ac] and lost with Pair of Aces


Poker Hand #RC2771842285: Hold'em No Limit ($0.05/$0.1) - 2024/08/04 11:26:52
Table 'RushAndCash20817545' 6-max Seat #1 is the button
Seat 1: Hero ($34.87 in chips)
Seat 2: 483620e3 ($10 in chips)
Seat 3: 284ce5eb ($18.71 in chips)
Seat 4: db87dc85 ($9.27 in chips)
Seat 5: 1b0c40c2 ($10.65 in chips)
Seat 6: cfb85aa9 ($10.13 in chips)
483620e3: posts small blind $0.05
284ce5eb: posts big blind $0.1
*** HOLE CARDS ***
Dealt to Hero [8s 3h]
Dealt to 483620e3 
Dealt to 284ce5eb 
Dealt to db87dc85 
Dealt to 1b0c40c2 
Dealt to cfb85aa9 
db87dc85: folds
1b0c40c2: folds
cfb85aa9: folds
Hero: folds
483620e3: folds
Uncalled bet ($0.05) returned to 284ce5eb
*** SHOWDOWN ***
284ce5eb collected $0.1 from pot
*** SUMMARY ***
Total pot $0.1 | Rake $0 | Jackpot $0 | Bingo $0 | Fortune $0 | Tax $0
Seat 1: Hero (button) folded before Flop (didn't bet)
Seat 2: 483620e3 (small blind) folded before Flop
Seat 3: 284ce5eb (big blind) collected ($0.1)
Seat 4: db87dc85 folded before Flop (didn't bet)
Seat 5: 1b0c40c2 folded before Flop (didn't bet)
Seat 6: cfb85aa9 folded before Flop (didn't bet)


Poker Hand #RC2771842051: Hold'em No Limit ($0.05/$0.1) - 2024/08/04 11:26:20
Table 'RushAndCash20817311' 6-max Seat #1 is the button
Seat 1: c8875c30 ($10.18 in chips)
Seat 2: 581839e4 ($10.46 in chips)
Seat 3: Hero ($35.07 in chips)
Seat 4: d733c35f ($10 in chips)
Seat 5: ee97777c ($10 in chips)
Seat 6: db87dc85 ($9.04 in chips)
581839e4: posts small blind $0.05
Hero: posts big blind $0.1
*** HOLE CARDS ***
Dealt to c8875c30 
Dealt to 581839e4 
Dealt to Hero [Ad 7c]
Dealt to d733c35f 
Dealt to ee97777c 
Dealt to db87dc85 
d733c35f: folds
ee97777c: folds
db87dc85: raises $0.1 to $0.2
c8875c30: folds
581839e4: folds
Hero: calls $0.1
*** FLOP *** [6d Ts Qh]
Hero: checks
db87dc85: bets $0.15
Hero: folds
Uncalled bet ($0.15) returned to db87dc85
*** SHOWDOWN ***
db87dc85 collected $0.43 from pot
*** SUMMARY ***
Total pot $0.45 | Rake $0.02 | Jackpot $0 | Bingo $0 | Fortune $0 | Tax $0
Board [6d Ts Qh]
Seat 1: c8875c30 (button) folded before Flop (didn't bet)
Seat 2: 581839e4 (small blind) folded before Flop
Seat 3: Hero (big blind) folded on the Flop
Seat 4: d733c35f folded before Flop (didn't bet)
Seat 5: ee97777c folded before Flop (didn't bet)
Seat 6: db87dc85 won ($0.43)


Poker Hand #RC2771841520: Hold'em No Limit ($0.05/$0.1) - 2024/08/04 11:25:12
Table 'RushAndCash20816780' 6-max Seat #1 is the button
Seat 1: db87dc85 ($12.07 in chips)
Seat 2: Hero ($32.39 in chips)
Seat 3: 37e62a41 ($10.75 in chips)
Seat 4: 2bff48f1 ($16.29 in chips)
Seat 5: 7d4aa0c ($10 in chips)
Seat 6: 8604a0c0 ($10 in chips)
Hero: posts small blind $0.05
37e62a41: posts big blind $0.1
*** HOLE CARDS ***
Dealt to db87dc85 
Dealt to Hero [Tc Kc]
Dealt to 37e62a41 
Dealt to 2bff48f1 
Dealt to 7d4aa0c 
Dealt to 8604a0c0 
2bff48f1: folds
7d4aa0c: folds
8604a0c0: folds
db87dc85: raises $0.1 to $0.2
Hero: raises $0.7 to $0.9
37e62a41: folds
db87dc85: calls $0.7
*** FLOP *** [2s 4d Ks]
Hero: bets $0.63
db87dc85: calls $0.63
*** TURN *** [2s 4d Ks] [5d]
Hero: checks
db87dc85: checks
*** RIVER *** [2s 4d Ks 5d] [5h]
Hero: bets $1.5
db87dc85: calls $1.5
Hero: shows [Tc Kc] (Pair of Kings and Pair of Fives)
db87dc85: shows [Qh Ad] (Pair of Fives)
*** SHOWDOWN ***
Hero collected $5.71 from pot
*** SUMMARY ***
Total pot $6.16 | Rake $0.3 | Jackpot $0.15 | Bingo $0 | Fortune $0 | Tax $0
Board [2s 4d Ks 5d 5h]
Seat 1: db87dc85 (button) showed [Qh Ad] and lost with Pair of Fives
Seat 2: Hero (small blind) showed [Tc Kc] and won ($5.71) with Pair of Kings and Pair of Fives
Seat 3: 37e62a41 (big blind) folded before Flop
Seat 4: 2bff48f1 folded before Flop (didn't bet)
Seat 5: 7d4aa0c folded before Flop (didn't bet)
Seat 6: 8604a0c0 folded before Flop (didn't bet)


Poker Hand #RC2771841499: Hold'em No Limit ($0.05/$0.1) - 2024/08/04 11:25:08
Table 'RushAndCash20816759' 6-max Seat #1 is the button
Seat 1: 33183b07 ($10.32 in chips)
Seat 2: 32b875e3 ($12.76 in chips)
Seat 3: ceac9e2 ($19.58 in chips)
Seat 4: Hero ($32.39 in chips)
Seat 5: 78a7bc86 ($18.01 in chips)
Seat 6: 390adb07 ($45.12 in chips)
32b875e3: posts small blind $0.05
ceac9e2: posts big blind $0.1
*** HOLE CARDS ***
Dealt to 33183b07 
Dealt to 32b875e3 
Dealt to ceac9e2 
Dealt to Hero [3c 6h]
Dealt to 78a7bc86 
Dealt to 390adb07 
Hero: folds
78a7bc86: folds
390adb07: folds
33183b07: folds
32b875e3: raises $0.2 to $0.3
ceac9e2: folds
Uncalled bet ($0.2) returned to 32b875e3
*** SHOWDOWN ***
32b875e3 collected $0.2 from pot
*** SUMMARY ***
Total pot $0.2 | Rake $0 | Jackpot $0 | Bingo $0 | Fortune $0 | Tax $0
Seat 1: 33183b07 (button) folded before Flop (didn't bet)
Seat 2: 32b875e3 (small blind) collected ($0.2)
Seat 3: ceac9e2 (big blind) folded before Flop
Seat 4: Hero folded before Flop (didn't bet)
Seat 5: 78a7bc86 folded before Flop (didn't bet)
Seat 6: 390adb07 folded before Flop (didn't bet)


Poker Hand #RC2771841236: Hold'em No Limit ($0.05/$0.1) - 2024/08/04 11:24:34
Table 'RushAndCash20816496' 6-max Seat #1 is the button
Seat 1: Hero ($33.09 in chips)
Seat 2: 528614ee ($11.22 in chips)
Seat 3: 24e6aaf4 ($13.63 in chips)
Seat 4: c45836cd ($5.5 in chips)
Seat 5: 32b875e3 ($11.98 in chips)
Seat 6: 68d51957 ($12.38 in chips)
528614ee: posts small blind $0.05
24e6aaf4: posts big blind $0.1
*** HOLE CARDS ***
Dealt to Hero [Qc As]
Dealt to 528614ee 
Dealt to 24e6aaf4 
Dealt to c45836cd 
Dealt to 32b875e3 
Dealt to 68d51957 
c45836cd: folds
32b875e3: raises $0.12 to $0.22
68d51957: folds
Hero: raises $0.48 to $0.7
528614ee: folds
24e6aaf4: folds
32b875e3: raises $1.27 to $1.97
Hero: folds
Uncalled bet ($1.27) returned to 32b875e3
*** SHOWDOWN ***
32b875e3 collected $1.48 from pot
*** SUMMARY ***
Total pot $1.55 | Rake $0.07 | Jackpot $0 | Bingo $0 | Fortune $0 | Tax $0
Seat 1: Hero (button) folded before Flop
Seat 2: 528614ee (small blind) folded before Flop
Seat 3: 24e6aaf4 (big blind) folded before Flop
Seat 4: c45836cd folded before Flop (didn't bet)
Seat 5: 32b875e3 collected ($1.48)
Seat 6: 68d51957 folded before Flop (didn't bet)


Poker Hand #RC2771841209: Hold'em No Limit ($0.05/$0.1) - 2024/08/04 11:24:31
Table 'RushAndCash20816469' 6-max Seat #1 is the button
Seat 1: 368ebd2f ($10 in chips)
Seat 2: 56512c19 ($16.56 in chips)
Seat 3: Hero ($33.19 in chips)
Seat 4: 18ddc90b ($22.37 in chips)
Seat 5: f9814740 ($24.24 in chips)
Seat 6: 5cf87867 ($20.4 in chips)
56512c19: posts small blind $0.05
Hero: posts big blind $0.1
*** HOLE CARDS ***
Dealt to 368ebd2f 
Dealt to 56512c19 
Dealt to Hero [7d 4d]
Dealt to 18ddc90b 
Dealt to f9814740 
Dealt to 5cf87867 
18ddc90b: raises $0.12 to $0.22
f9814740: folds
5cf87867: folds
368ebd2f: folds
56512c19: folds
Hero: folds
Uncalled bet ($0.12) returned to 18ddc90b
*** SHOWDOWN ***
18ddc90b collected $0.25 from pot
*** SUMMARY ***
Total pot $0.25 | Rake $0 | Jackpot $0 | Bingo $0 | Fortune $0 | Tax $0
Seat 1: 368ebd2f (button) folded before Flop (didn't bet)
Seat 2: 56512c19 (small blind) folded before Flop
Seat 3: Hero (big blind) folded before Flop
Seat 4: 18ddc90b collected ($0.25)
Seat 5: f9814740 folded before Flop (didn't bet)
Seat 6: 5cf87867 folded before Flop (didn't bet)


Poker Hand #RC2771840928: Hold'em No Limit ($0.05/$0.1) - 2024/08/04 11:23:52
Table 'RushAndCash20816188' 6-max Seat #1 is the button
Seat 1: Hero ($32.25 in chips)
Seat 2: 31e37936 ($8.75 in chips)
Seat 3: 7111f0ad ($12.84 in chips)
Seat 4: e15705d4 ($11.76 in chips)
Seat 5: 3b1938f9 ($10.68 in chips)
Seat 6: f9814740 ($25.12 in chips)
31e37936: posts small blind $0.05
7111f0ad: posts big blind $0.1
*** HOLE CARDS ***
Dealt to Hero [Ac Kc]
Dealt to 31e37936 
Dealt to 7111f0ad 
Dealt to e15705d4 
Dealt to 3b1938f9 
Dealt to f9814740 
e15705d4: folds
3b1938f9: folds
f9814740: raises $0.15 to $0.25
Hero: raises $0.63 to $0.88
31e37936: folds
7111f0ad: folds
f9814740: calls $0.63
*** FLOP *** [8h Ts Qd]
f9814740: checks
Hero: bets $0.9
f9814740: folds
Uncalled bet ($0.9) returned to Hero
*** SHOWDOWN ***
Hero collected $1.82 from pot
*** SUMMARY ***
Total pot $1.91 | Rake $0.09 | Jackpot $0 | Bingo $0 | Fortune $0 | Tax $0
Board [8h Ts Qd]
Seat 1: Hero (button) won ($1.82)
Seat 2: 31e37936 (small blind) folded before Flop
Seat 3: 7111f0ad (big blind) folded before Flop
Seat 4: e15705d4 folded before Flop (didn't bet)
Seat 5: 3b1938f9 folded before Flop (didn't bet)
Seat 6: f9814740 folded on the Flop


Poker Hand #RC2771840902: Hold'em No Limit ($0.05/$0.1) - 2024/08/04 11:23:49
Table 'RushAndCash20816162' 6-max Seat #1 is the button
Seat 1: 3b1938f9 ($10.68 in chips)
Seat 2: fbc8e0fb ($5.51 in chips)
Seat 3: daa20e9f ($10 in chips)
Seat 4: 24c4b23f ($23.47 in chips)
Seat 5: Hero ($32.25 in chips)
Seat 6: 46d330d4 ($43.87 in chips)
fbc8e0fb: posts small blind $0.05
daa20e9f: posts big blind $0.1
*** HOLE CARDS ***
Dealt to 3b1938f9 
Dealt to fbc8e0fb 
Dealt to daa20e9f 
Dealt to 24c4b23f 
Dealt to Hero [5d 4s]
Dealt to 46d330d4 
24c4b23f: folds
Hero: folds
46d330d4: folds
3b1938f9: folds
fbc8e0fb: raises $0.1 to $0.2
daa20e9f: folds
Uncalled bet ($0.1) returned to fbc8e0fb
*** SHOWDOWN ***
fbc8e0fb collected $0.2 from pot
*** SUMMARY ***
Total pot $0.2 | Rake $0 | Jackpot $0 | Bingo $0 | Fortune $0 | Tax $0
Seat 1: 3b1938f9 (button) folded before Flop (didn't bet)
Seat 2: fbc8e0fb (small blind) collected ($0.2)
Seat 3: daa20e9f (big blind) folded before Flop
Seat 4: 24c4b23f folded before Flop (didn't bet)
Seat 5: Hero folded before Flop (didn't bet)
Seat 6: 46d330d4 folded before Flop (didn't bet)


Poker Hand #RC2771840874: Hold'em No Limit ($0.05/$0.1) - 2024/08/04 11:23:45
Table 'RushAndCash20816134' 6-max Seat #1 is the button
Seat 1: 49bff733 ($16.84 in chips)
Seat 2: Hero ($32.3 in chips)
Seat 3: 344bd79e ($10.34 in chips)
Seat 4: c7bec670 ($11.58 in chips)
Seat 5: d80a591f ($10 in chips)
Seat 6: c81bcc5 ($10.7 in chips)
Hero: posts small blind $0.05
344bd79e: posts big blind $0.1
*** HOLE CARDS ***
Dealt to 49bff733 
Dealt to Hero [7h Td]
Dealt to 344bd79e 
Dealt to c7bec670 
Dealt to d80a591f 
Dealt to c81bcc5 
c7bec670: raises $0.2 to $0.3
d80a591f: folds
c81bcc5: folds
49bff733: folds
Hero: folds
344bd79e: folds
Uncalled bet ($0.2) returned to c7bec670
*** SHOWDOWN ***
c7bec670 collected $0.25 from pot
*** SUMMARY ***
Total pot $0.25 | Rake $0 | Jackpot $0 | Bingo $0 | Fortune $0 | Tax $0
Seat 1: 49bff733 (button) folded before Flop (didn't bet)
Seat 2: Hero (small blind) folded before Flop
Seat 3: 344bd79e (big blind) folded before Flop
Seat 4: c7bec670 collected ($0.25)
Seat 5: d80a591f folded before Flop (didn't bet)
Seat 6: c81bcc5 folded before Flop (didn't bet)


Poker Hand #RC2771840844: Hold'em No Limit ($0.05/$0.1) - 2024/08/04 11:23:40
Table 'RushAndCash20816104' 6-max Seat #1 is the button
Seat 1: 7b61347e ($10.36 in chips)
Seat 2: 2cf9f9cf ($10 in chips)
Seat 3: 157d35a9 ($4.19 in chips)
Seat 4: a631a0be ($11.51 in chips)
Seat 5: Hero ($32.3 in chips)
Seat 6: d50058e4 ($24.91 in chips)
2cf9f9cf: posts small blind $0.05
157d35a9: posts big blind $0.1
*** HOLE CARDS ***
Dealt to 7b61347e 
Dealt to 2cf9f9cf 
Dealt to 157d35a9 
Dealt to a631a0be 
Dealt to Hero [Ad 4c]
Dealt to d50058e4 
a631a0be: folds
Hero: folds
d50058e4: folds
7b61347e: folds
2cf9f9cf: folds
Uncalled bet ($0.05) returned to 157d35a9
*** SHOWDOWN ***
157d35a9 collected $0.1 from pot
*** SUMMARY ***
Total pot $0.1 | Rake $0 | Jackpot $0 | Bingo $0 | Fortune $0 | Tax $0
Seat 1: 7b61347e (button) folded before Flop (didn't bet)
Seat 2: 2cf9f9cf (small blind) folded before Flop
Seat 3: 157d35a9 (big blind) collected ($0.1)
Seat 4: a631a0be folded before Flop (didn't bet)
Seat 5: Hero folded before Flop (didn't bet)
Seat 6: d50058e4 folded before Flop (didn't bet)


Poker Hand #RC2771840720: Hold'em No Limit ($0.05/$0.1) - 2024/08/04 11:23:23
Table 'RushAndCash20815980' 6-max Seat #1 is the button
Seat 1: a80d90a1 ($8.87 in chips)
Seat 2: Hero ($32.2 in chips)
Seat 3: f895a438 ($10.33 in chips)
Seat 4: b9c76347 ($18.71 in chips)
Seat 5: 44165a65 ($9.27 in chips)
Seat 6: 220209b8 ($9.98 in chips)
Hero: posts small blind $0.05
f895a438: posts big blind $0.1
*** HOLE CARDS ***
Dealt to a80d90a1 
Dealt to Hero [Kc Ks]
Dealt to f895a438 
Dealt to b9c76347 
Dealt to 44165a65 
Dealt to 220209b8 
b9c76347: folds
44165a65: folds
220209b8: folds
a80d90a1: folds
Hero: raises $0.2 to $0.3
f895a438: folds
Uncalled bet ($0.2) returned to Hero
*** SHOWDOWN ***
Hero collected $0.2 from pot
*** SUMMARY ***
Total pot $0.2 | Rake $0 | Jackpot $0 | Bingo $0 | Fortune $0 | Tax $0
Seat 1: a80d90a1 (button) folded before Flop (didn't bet)
Seat 2: Hero (small blind) collected ($0.2)
Seat 3: f895a438 (big blind) folded before Flop
Seat 4: b9c76347 folded before Flop (didn't bet)
Seat 5: 44165a65 folded before Flop (didn't bet)
Seat 6: 220209b8 folded before Flop (didn't bet)


Poker Hand #RC2771840701: Hold'em No Limit ($0.05/$0.1) - 2024/08/04 11:23:20
Table 'RushAndCash20815961' 6-max Seat #1 is the button
Seat 1: 49db9bf6 ($12.87 in chips)
Seat 2: c3dd531b ($10.63 in chips)
Seat 3: 8248540c ($10 in chips)
Seat 4: 220209b8 ($9.98 in chips)
Seat 5: 18ddc90b ($22.42 in chips)
Seat 6: Hero ($32.2 in chips)
c3dd531b: posts small blind $0.05
8248540c: posts big blind $0.1
*** HOLE CARDS ***
Dealt to 49db9bf6 
Dealt to c3dd531b 
Dealt to 8248540c 
Dealt to 220209b8 
Dealt to 18ddc90b 
Dealt to Hero [Kh 5d]
220209b8: folds
18ddc90b: folds
Hero: folds
49db9bf6: folds
c3dd531b: folds
Uncalled bet ($0.05) returned to 8248540c
*** SHOWDOWN ***
8248540c collected $0.1 from pot
*** SUMMARY ***
Total pot $0.1 | Rake $0 | Jackpot $0 | Bingo $0 | Fortune $0 | Tax $0
Seat 1: 49db9bf6 (button) folded before Flop (didn't bet)
Seat 2: c3dd531b (small blind) folded before Flop
Seat 3: 8248540c (big blind) collected ($0.1)
Seat 4: 220209b8 folded before Flop (didn't bet)
Seat 5: 18ddc90b folded before Flop (didn't bet)
Seat 6: Hero folded before Flop (didn't bet)


Poker Hand #RC2771840678: Hold'em No Limit ($0.05/$0.1) - 2024/08/04 11:23:16
Table 'RushAndCash20815938' 6-max Seat #1 is the button
Seat 1: 49bff733 ($16.74 in chips)
Seat 2: b2a50cfa ($12.73 in chips)
Seat 3: d1369028 ($12.39 in chips)
Seat 4: Hero ($32.2 in chips)
Seat 5: d50058e4 ($24.96 in chips)
Seat 6: 5a3ca36e ($21.09 in chips)
b2a50cfa: posts small blind $0.05
d1369028: posts big blind $0.1
*** HOLE CARDS ***
Dealt to 49bff733 
Dealt to b2a50cfa 
Dealt to d1369028 
Dealt to Hero [2d 8c]
Dealt to d50058e4 
Dealt to 5a3ca36e 
Hero: folds
d50058e4: folds
5a3ca36e: folds
49bff733: folds
b2a50cfa: raises $0.2 to $0.3
d1369028: folds
Uncalled bet ($0.2) returned to b2a50cfa
*** SHOWDOWN ***
b2a50cfa collected $0.2 from pot
*** SUMMARY ***
Total pot $0.2 | Rake $0 | Jackpot $0 | Bingo $0 | Fortune $0 | Tax $0
Seat 1: 49bff733 (button) folded before Flop (didn't bet)
Seat 2: b2a50cfa (small blind) collected ($0.2)
Seat 3: d1369028 (big blind) folded before Flop
Seat 4: Hero folded before Flop (didn't bet)
Seat 5: d50058e4 folded before Flop (didn't bet)
Seat 6: 5a3ca36e folded before Flop (didn't bet)


Poker Hand #RC2771840547: Hold'em No Limit ($0.05/$0.1) - 2024/08/04 11:22:57
Table 'RushAndCash20815807' 6-max Seat #1 is the button
Seat 1: 5c2ef128 ($10 in chips)
Seat 2: ea536622 ($25.32 in chips)
Seat 3: Hero ($32.3 in chips)
Seat 4: 46679d48 ($10.67 in chips)
Seat 5: b2f6194b ($19.95 in chips)
Seat 6: 33427f42 ($18.29 in chips)
ea536622: posts small blind $0.05
Hero: posts big blind $0.1
*** HOLE CARDS ***
Dealt to 5c2ef128 
Dealt to ea536622 
Dealt to Hero [9s Js]
Dealt to 46679d48 
Dealt to b2f6194b 
Dealt to 33427f42 
46679d48: folds
b2f6194b: folds
33427f42: raises $0.2 to $0.3
5c2ef128: raises $0.57 to $0.87
ea536622: folds
Hero: folds
33427f42: folds
Uncalled bet ($0.57) returned to 5c2ef128
*** SHOWDOWN ***
5c2ef128 collected $0.72 from pot
*** SUMMARY ***
Total pot $0.75 | Rake $0.03 | Jackpot $0 | Bingo $0 | Fortune $0 | Tax $0
Seat 1: 5c2ef128 (button) collected ($0.72)
Seat 2: ea536622 (small blind) folded before Flop
Seat 3: Hero (big blind) folded before Flop
Seat 4: 46679d48 folded before Flop (didn't bet)
Seat 5: b2f6194b folded before Flop (didn't bet)
Seat 6: 33427f42 folded before Flop


Poker Hand #RC2771840346: Hold'em No Limit ($0.05/$0.1) - 2024/08/04 11:22:29
Table 'RushAndCash20815606' 6-max Seat #1 is the button
Seat 1: 4a91de04 ($4.55 in chips)
Seat 2: 72d77855 ($9.9 in chips)
Seat 3: 483620e3 ($10.08 in chips)
Seat 4: a3d20374 ($14.66 in chips)
Seat 5: Hero ($32.5 in chips)
Seat 6: 8a336bf2 ($10 in chips)
72d77855: posts small blind $0.05
483620e3: posts big blind $0.1
*** HOLE CARDS ***
Dealt to 4a91de04 
Dealt to 72d77855 
Dealt to 483620e3 
Dealt to a3d20374 
Dealt to Hero [Jc Qc]
Dealt to 8a336bf2 
a3d20374: folds
Hero: raises $0.1 to $0.2
8a336bf2: folds
4a91de04: raises $0.95 to $1.15
72d77855: folds
483620e3: folds
Hero: folds
Uncalled bet ($0.95) returned to 4a91de04
*** SHOWDOWN ***
4a91de04 collected $0.53 from pot
*** SUMMARY ***
Total pot $0.55 | Rake $0.02 | Jackpot $0 | Bingo $0 | Fortune $0 | Tax $0
Seat 1: 4a91de04 (button) collected ($0.53)
Seat 2: 72d77855 (small blind) folded before Flop
Seat 3: 483620e3 (big blind) folded before Flop
Seat 4: a3d20374 folded before Flop (didn't bet)
Seat 5: Hero folded before Flop
Seat 6: 8a336bf2 folded before Flop (didn't bet)


Poker Hand #RC2771840249: Hold'em No Limit ($0.05/$0.1) - 2024/08/04 11:22:15
Table 'RushAndCash20815509' 6-max Seat #1 is the button
Seat 1: 21561c8f ($10 in chips)
Seat 2: efaabdb5 ($10.69 in chips)
Seat 3: 8568d561 ($10.15 in chips)
Seat 4: 11f6010d ($10.55 in chips)
Seat 5: Hero ($32.35 in chips)
Seat 6: 2c4405a7 ($30.7 in chips)
efaabdb5: posts small blind $0.05
8568d561: posts big blind $0.1
*** HOLE CARDS ***
Dealt to 21561c8f 
Dealt to efaabdb5 
Dealt to 8568d561 
Dealt to 11f6010d 
Dealt to Hero [Kd Qc]
Dealt to 2c4405a7 
11f6010d: folds
Hero: raises $0.1 to $0.2
2c4405a7: folds
21561c8f: folds
efaabdb5: folds
8568d561: folds
Uncalled bet ($0.1) returned to Hero
*** SHOWDOWN ***
Hero collected $0.25 from pot
*** SUMMARY ***
Total pot $0.25 | Rake $0 | Jackpot $0 | Bingo $0 | Fortune $0 | Tax $0
Seat 1: 21561c8f (button) folded before Flop (didn't bet)
Seat 2: efaabdb5 (small blind) folded before Flop
Seat 3: 8568d561 (big blind) folded before Flop
Seat 4: 11f6010d folded before Flop (didn't bet)
Seat 5: Hero collected ($0.25)
Seat 6: 2c4405a7 folded before Flop (didn't bet)


Poker Hand #RC2771840192: Hold'em No Limit ($0.05/$0.1) - 2024/08/04 11:22:07
Table 'RushAndCash20815452' 6-max Seat #1 is the button
Seat 1: cec053d1 ($14.01 in chips)
Seat 2: f66e544f ($10.15 in chips)
Seat 3: 84bdbe67 ($11.28 in chips)
Seat 4: 4fb5bda6 ($10 in chips)
Seat 5: f3c9e305 ($7.97 in chips)
Seat 6: Hero ($32.35 in chips)
f66e544f: posts small blind $0.05
84bdbe67: posts big blind $0.1
*** HOLE CARDS ***
Dealt to cec053d1 
Dealt to f66e544f 
Dealt to 84bdbe67 
Dealt to 4fb5bda6 
Dealt to f3c9e305 
Dealt to Hero [Kd 8d]
4fb5bda6: folds
f3c9e305: raises $0.1 to $0.2
Hero: folds
cec053d1: folds
f66e544f: folds
84bdbe67: calls $0.1
*** FLOP *** [5h 9c 3s]
84bdbe67: checks
f3c9e305: checks
*** TURN *** [5h 9c 3s] [6c]
84bdbe67: bets $0.15
f3c9e305: calls $0.15
*** RIVER *** [5h 9c 3s 6c] [4s]
84bdbe67: checks
f3c9e305: checks
84bdbe67: shows [8c 8h] (Pair of Eights)
f3c9e305: shows [Kc Ah] (Ace-High)
*** SHOWDOWN ***
84bdbe67 collected $0.72 from pot
*** SUMMARY ***
Total pot $0.75 | Rake $0.03 | Jackpot $0 | Bingo $0 | Fortune $0 | Tax $0
Board [5h 9c 3s 6c 4s]
Seat 1: cec053d1 (button) folded before Flop (didn't bet)
Seat 2: f66e544f (small blind) folded before Flop
Seat 3: 84bdbe67 (big blind) showed [8c 8h] and won ($0.72) with Pair of Eights
Seat 4: 4fb5bda6 folded before Flop (didn't bet)
Seat 5: f3c9e305 showed [Kc Ah] and lost with Ace-High
Seat 6: Hero folded before Flop (didn't bet)


Poker Hand #RC2771840175: Hold'em No Limit ($0.05/$0.1) - 2024/08/04 11:22:04
Table 'RushAndCash20815435' 6-max Seat #1 is the button
Seat 1: 18ddc90b ($22.64 in chips)
Seat 2: ca5ec18 ($23.33 in chips)
Seat 3: 29b9f6a8 ($11.96 in chips)
Seat 4: 96fac81b ($23.53 in chips)
Seat 5: Hero ($32.35 in chips)
Seat 6: 11208842 ($16.26 in chips)
ca5ec18: posts small blind $0.05
29b9f6a8: posts big blind $0.1
*** HOLE CARDS ***
Dealt to 18ddc90b 
Dealt to ca5ec18 
Dealt to 29b9f6a8 
Dealt to 96fac81b 
Dealt to Hero [Ac 2d]
Dealt to 11208842 
96fac81b: folds
Hero: folds
11208842: folds
18ddc90b: raises $0.12 to $0.22
ca5ec18: calls $0.17
29b9f6a8: calls $0.12
*** FLOP *** [Qs 4d 8h]
ca5ec18: checks
29b9f6a8: checks
18ddc90b: checks
*** TURN *** [Qs 4d 8h] [7s]
ca5ec18: checks
29b9f6a8: bets $0.33
18ddc90b: folds
ca5ec18: calls $0.33
*** RIVER *** [Qs 4d 8h 7s] [2s]
ca5ec18: checks
29b9f6a8: checks
ca5ec18: shows [9d 8d] (Pair of Eights)
29b9f6a8: shows [7h 6h] (Pair of Sevens)
*** SHOWDOWN ***
ca5ec18 collected $1.26 from pot
*** SUMMARY ***
Total pot $1.32 | Rake $0.06 | Jackpot $0 | Bingo $0 | Fortune $0 | Tax $0
Board [Qs 4d 8h 7s 2s]
Seat 1: 18ddc90b (button) folded on the Turn
Seat 2: ca5ec18 (small blind) showed [9d 8d] and won ($1.26) with Pair of Eights
Seat 3: 29b9f6a8 (big blind) showed [7h 6h] and lost with Pair of Sevens
Seat 4: 96fac81b folded before Flop (didn't bet)
Seat 5: Hero folded before Flop (didn't bet)
Seat 6: 11208842 folded before Flop (didn't bet)


Poker Hand #RC2771839929: Hold'em No Limit ($0.05/$0.1) - 2024/08/04 11:21:27
Table 'RushAndCash20815189' 6-max Seat #1 is the button
Seat 1: 6c0b7054 ($26.96 in chips)
Seat 2: 74cc7be7 ($8.09 in chips)
Seat 3: 18ddc90b ($22.88 in chips)
Seat 4: 8e50fe99 ($10 in chips)
Seat 5: 56a3f58b ($16.33 in chips)
Seat 6: Hero ($32.08 in chips)
74cc7be7: posts small blind $0.05
18ddc90b: posts big blind $0.1
*** HOLE CARDS ***
Dealt to 6c0b7054 
Dealt to 74cc7be7 
Dealt to 18ddc90b 
Dealt to 8e50fe99 
Dealt to 56a3f58b 
Dealt to Hero [As 9s]
8e50fe99: folds
56a3f58b: folds
Hero: raises $0.14 to $0.24
6c0b7054: folds
74cc7be7: folds
18ddc90b: calls $0.14
*** FLOP *** [Td Ks Kh]
18ddc90b: checks
Hero: checks
*** TURN *** [Td Ks Kh] [9d]
18ddc90b: checks
Hero: bets $0.28
18ddc90b: folds
Uncalled bet ($0.28) returned to Hero
*** SHOWDOWN ***
Hero collected $0.51 from pot
*** SUMMARY ***
Total pot $0.53 | Rake $0.02 | Jackpot $0 | Bingo $0 | Fortune $0 | Tax $0
Board [Td Ks Kh 9d]
Seat 1: 6c0b7054 (button) folded before Flop (didn't bet)
Seat 2: 74cc7be7 (small blind) folded before Flop
Seat 3: 18ddc90b (big blind) folded on the Turn
Seat 4: 8e50fe99 folded before Flop (didn't bet)
Seat 5: 56a3f58b folded before Flop (didn't bet)
Seat 6: Hero won ($0.51)


Poker Hand #RC2771839583: Hold'em No Limit ($0.05/$0.1) - 2024/08/04 11:20:39
Table 'RushAndCash20814843' 6-max Seat #1 is the button
Seat 1: Hero ($31.56 in chips)
Seat 2: 98725598 ($10 in chips)
Seat 3: 74cc7be7 ($8.61 in chips)
Seat 4: 5d5e7e95 ($11.45 in chips)
Seat 5: 24f8fa31 ($23.42 in chips)
Seat 6: aa44371a ($8.64 in chips)
98725598: posts small blind $0.05
74cc7be7: posts big blind $0.1
*** HOLE CARDS ***
Dealt to Hero [9s 5s]
Dealt to 98725598 
Dealt to 74cc7be7 
Dealt to 5d5e7e95 
Dealt to 24f8fa31 
Dealt to aa44371a 
5d5e7e95: folds
24f8fa31: folds
aa44371a: folds
Hero: raises $0.14 to $0.24
98725598: folds
74cc7be7: calls $0.14
*** FLOP *** [Td 5d 4d]
74cc7be7: checks
Hero: checks
*** TURN *** [Td 5d 4d] [Ac]
74cc7be7: bets $0.28
Hero: calls $0.28
*** RIVER *** [Td 5d 4d Ac] [3d]
74cc7be7: checks
Hero: checks
74cc7be7: shows [7s Kh] (Ace-High)
Hero: shows [9s 5s] (Pair of Fives)
*** SHOWDOWN ***
Hero collected $1.04 from pot
*** SUMMARY ***
Total pot $1.09 | Rake $0.05 | Jackpot $0 | Bingo $0 | Fortune $0 | Tax $0
Board [Td 5d 4d Ac 3d]
Seat 1: Hero (button) showed [9s 5s] and won ($1.04) with Pair of Fives
Seat 2: 98725598 (small blind) folded before Flop
Seat 3: 74cc7be7 (big blind) showed [7s Kh] and lost with Ace-High
Seat 4: 5d5e7e95 folded before Flop (didn't bet)
Seat 5: 24f8fa31 folded before Flop (didn't bet)
Seat 6: aa44371a folded before Flop (didn't bet)


Poker Hand #RC2771839429: Hold'em No Limit ($0.05/$0.1) - 2024/08/04 11:20:19
Table 'RushAndCash20814689' 6-max Seat #1 is the button
Seat 1: 6a2e5b66 ($10.36 in chips)
Seat 2: Hero ($31.61 in chips)
Seat 3: 44e483f7 ($45.49 in chips)
Seat 4: ccebd0b9 ($4.38 in chips)
Seat 5: f3c9e305 ($8.33 in chips)
Seat 6: 34d94a51 ($26.62 in chips)
Hero: posts small blind $0.05
44e483f7: posts big blind $0.1
*** HOLE CARDS ***
Dealt to 6a2e5b66 
Dealt to Hero [Jh Qc]
Dealt to 44e483f7 
Dealt to ccebd0b9 
Dealt to f3c9e305 
Dealt to 34d94a51 
ccebd0b9: folds
f3c9e305: raises $0.1 to $0.2
34d94a51: folds
6a2e5b66: folds
Hero: folds
44e483f7: calls $0.1
*** FLOP *** [2s 3s Jd]
44e483f7: checks
f3c9e305: checks
*** TURN *** [2s 3s Jd] [Ts]
44e483f7: checks
f3c9e305: checks
*** RIVER *** [2s 3s Jd Ts] [6d]
44e483f7: checks
f3c9e305: bets $0.36
44e483f7: calls $0.36
f3c9e305: shows [7h Kh] (King-High)
44e483f7: shows [Qh Ac] (Ace-High)
*** SHOWDOWN ***
44e483f7 collected $1.12 from pot
*** SUMMARY ***
Total pot $1.17 | Rake $0.05 | Jackpot $0 | Bingo $0 | Fortune $0 | Tax $0
Board [2s 3s Jd Ts 6d]
Seat 1: 6a2e5b66 (button) folded before Flop (didn't bet)
Seat 2: Hero (small blind) folded before Flop
Seat 3: 44e483f7 (big blind) showed [Qh Ac] and won ($1.12) with Ace-High
Seat 4: ccebd0b9 folded before Flop (didn't bet)
Seat 5: f3c9e305 showed [7h Kh] and lost with King-High
Seat 6: 34d94a51 folded before Flop (didn't bet)


Poker Hand #RC2771839378: Hold'em No Limit ($0.05/$0.1) - 2024/08/04 11:20:11
Table 'RushAndCash20814638' 6-max Seat #1 is the button
Seat 1: 850cb9a4 ($4.05 in chips)
Seat 2: 6fe61f4 ($22.28 in chips)
Seat 3: Hero ($31.56 in chips)
Seat 4: f3c9e305 ($8.33 in chips)
Seat 5: 5a57d649 ($10.76 in chips)
Seat 6: fbc8e0fb ($5.45 in chips)
6fe61f4: posts small blind $0.05
Hero: posts big blind $0.1
*** HOLE CARDS ***
Dealt to 850cb9a4 
Dealt to 6fe61f4 
Dealt to Hero [4h Tc]
Dealt to f3c9e305 
Dealt to 5a57d649 
Dealt to fbc8e0fb 
f3c9e305: folds
5a57d649: folds
fbc8e0fb: folds
850cb9a4: folds
6fe61f4: folds
Uncalled bet ($0.05) returned to Hero
*** SHOWDOWN ***
Hero collected $0.1 from pot
*** SUMMARY ***
Total pot $0.1 | Rake $0 | Jackpot $0 | Bingo $0 | Fortune $0 | Tax $0
Seat 1: 850cb9a4 (button) folded before Flop (didn't bet)
Seat 2: 6fe61f4 (small blind) folded before Flop
Seat 3: Hero (big blind) collected ($0.1)
Seat 4: f3c9e305 folded before Flop (didn't bet)
Seat 5: 5a57d649 folded before Flop (didn't bet)
Seat 6: fbc8e0fb folded before Flop (didn't bet)


Poker Hand #RC2771839355: Hold'em No Limit ($0.05/$0.1) - 2024/08/04 11:20:08
Table 'RushAndCash20814615' 6-max Seat #1 is the button
Seat 1: 6fe61f4 ($22.28 in chips)
Seat 2: fc925d96 ($11.73 in chips)
Seat 3: c111685e ($10.93 in chips)
Seat 4: 47424f52 ($13.87 in chips)
Seat 5: 7945aef4 ($10.62 in chips)
Seat 6: Hero ($31.56 in chips)
fc925d96: posts small blind $0.05
c111685e: posts big blind $0.1
*** HOLE CARDS ***
Dealt to 6fe61f4 
Dealt to fc925d96 
Dealt to c111685e 
Dealt to 47424f52 
Dealt to 7945aef4 
Dealt to Hero [2s Qh]
47424f52: folds
7945aef4: folds
Hero: folds
6fe61f4: folds
fc925d96: folds
Uncalled bet ($0.05) returned to c111685e
*** SHOWDOWN ***
c111685e collected $0.1 from pot
*** SUMMARY ***
Total pot $0.1 | Rake $0 | Jackpot $0 | Bingo $0 | Fortune $0 | Tax $0
Seat 1: 6fe61f4 (button) folded before Flop (didn't bet)
Seat 2: fc925d96 (small blind) folded before Flop
Seat 3: c111685e (big blind) collected ($0.1)
Seat 4: 47424f52 folded before Flop (didn't bet)
Seat 5: 7945aef4 folded before Flop (didn't bet)
Seat 6: Hero folded before Flop (didn't bet)


Poker Hand #RC2771839329: Hold'em No Limit ($0.05/$0.1) - 2024/08/04 11:20:05
Table 'RushAndCash20814589' 6-max Seat #1 is the button
Seat 1: 8d1cf37d ($24.65 in chips)
Seat 2: 4cf9b042 ($10.25 in chips)
Seat 3: cad0ab4e ($23.02 in chips)
Seat 4: 69a0d31 ($12.37 in chips)
Seat 5: Hero ($31.56 in chips)
Seat 6: d0d2ca4c ($9.42 in chips)
4cf9b042: posts small blind $0.05
cad0ab4e: posts big blind $0.1
*** HOLE CARDS ***
Dealt to 8d1cf37d 
Dealt to 4cf9b042 
Dealt to cad0ab4e 
Dealt to 69a0d31 
Dealt to Hero [6d Qc]
Dealt to d0d2ca4c 
69a0d31: folds
Hero: folds
d0d2ca4c: raises $0.1 to $0.2
8d1cf37d: folds
4cf9b042: raises $0.7 to $0.9
cad0ab4e: folds
d0d2ca4c: calls $0.7
*** FLOP *** [Kd Ah 4c]
4cf9b042: bets $0.63
d0d2ca4c: folds
Uncalled bet ($0.63) returned to 4cf9b042
*** SHOWDOWN ***
4cf9b042 collected $1.81 from pot
*** SUMMARY ***
Total pot $1.9 | Rake $0.09 | Jackpot $0 | Bingo $0 | Fortune $0 | Tax $0
Board [Kd Ah 4c]
Seat 1: 8d1cf37d (button) folded before Flop (didn't bet)
Seat 2: 4cf9b042 (small blind) won ($1.81)
Seat 3: cad0ab4e (big blind) folded before Flop
Seat 4: 69a0d31 folded before Flop (didn't bet)
Seat 5: Hero folded before Flop (didn't bet)
Seat 6: d0d2ca4c folded on the Flop


Poker Hand #RC2771839078: Hold'em No Limit ($0.05/$0.1) - 2024/08/04 11:19:28
Table 'RushAndCash20814338' 6-max Seat #1 is the button
Seat 1: d0d2ca4c ($9.64 in chips)
Seat 2: 6e1edbbc ($22.22 in chips)
Seat 3: Hero ($31.31 in chips)
Seat 4: 53a8982 ($7.54 in chips)
Seat 5: 5c2ef128 ($20.03 in chips)
Seat 6: 4afaab23 ($10 in chips)
6e1edbbc: posts small blind $0.05
Hero: posts big blind $0.1
*** HOLE CARDS ***
Dealt to d0d2ca4c 
Dealt to 6e1edbbc 
Dealt to Hero [Ac 2c]
Dealt to 53a8982 
Dealt to 5c2ef128 
Dealt to 4afaab23 
53a8982: folds
5c2ef128: folds
4afaab23: folds
d0d2ca4c: raises $0.12 to $0.22
6e1edbbc: folds
Hero: calls $0.12
*** FLOP *** [Jh 6c 7h]
Hero: checks
d0d2ca4c: checks
*** TURN *** [Jh 6c 7h] [7s]
Hero: bets $0.37
d0d2ca4c: folds
Uncalled bet ($0.37) returned to Hero
*** SHOWDOWN ***
Hero collected $0.47 from pot
*** SUMMARY ***
Total pot $0.49 | Rake $0.02 | Jackpot $0 | Bingo $0 | Fortune $0 | Tax $0
Board [Jh 6c 7h 7s]
Seat 1: d0d2ca4c (button) folded on the Turn
Seat 2: 6e1edbbc (small blind) folded before Flop
Seat 3: Hero (big blind) won ($0.47)
Seat 4: 53a8982 folded before Flop (didn't bet)
Seat 5: 5c2ef128 folded before Flop (didn't bet)
Seat 6: 4afaab23 folded before Flop (didn't bet)


Poker Hand #RC2771838711: Hold'em No Limit ($0.05/$0.1) - 2024/08/04 11:18:36
Table 'RushAndCash20813971' 6-max Seat #1 is the button
Seat 1: 24c4b23f ($23.02 in chips)
Seat 2: Hero ($30.41 in chips)
Seat 3: 6e1edbbc ($23.22 in chips)
Seat 4: 937b4f02 ($7.66 in chips)
Seat 5: e6e8601a ($26.72 in chips)
Seat 6: 6d439f7f ($22 in chips)
Hero: posts small blind $0.05
6e1edbbc: posts big blind $0.1
*** HOLE CARDS ***
Dealt to 24c4b23f 
Dealt to Hero [9h Qd]
Dealt to 6e1edbbc 
Dealt to 937b4f02 
Dealt to e6e8601a 
Dealt to 6d439f7f 
937b4f02: folds
e6e8601a: folds
6d439f7f: folds
24c4b23f: folds
Hero: raises $0.2 to $0.3
6e1edbbc: calls $0.2
*** FLOP *** [6s 9s Qs]
Hero: bets $0.3
6e1edbbc: calls $0.3
*** TURN *** [6s 9s Qs] [7d]
Hero: checks
6e1edbbc: bets $0.4
Hero: calls $0.4
*** RIVER *** [6s 9s Qs 7d] [Th]
Hero: checks
6e1edbbc: checks
Hero: shows [9h Qd] (Pair of Queens and Pair of Nines)
6e1edbbc: shows [Kh Td] (Pair of Tens)
*** SHOWDOWN ***
Hero collected $1.9 from pot
*** SUMMARY ***
Total pot $2 | Rake $0.1 | Jackpot $0 | Bingo $0 | Fortune $0 | Tax $0
Board [6s 9s Qs 7d Th]
Seat 1: 24c4b23f (button) folded before Flop (didn't bet)
Seat 2: Hero (small blind) showed [9h Qd] and won ($1.9) with Pair of Queens and Pair of Nines
Seat 3: 6e1edbbc (big blind) showed [Kh Td] and lost with Pair of Tens
Seat 4: 937b4f02 folded before Flop (didn't bet)
Seat 5: e6e8601a folded before Flop (didn't bet)
Seat 6: 6d439f7f folded before Flop (didn't bet)


Poker Hand #RC2771838603: Hold'em No Limit ($0.05/$0.1) - 2024/08/04 11:18:21
Table 'RushAndCash20813863' 6-max Seat #1 is the button
Seat 1: Hero ($30.41 in chips)
Seat 2: 9b94a525 ($10 in chips)
Seat 3: bb81dd1e ($8.85 in chips)
Seat 4: c369fe87 ($10 in chips)
Seat 5: 24ada796 ($10 in chips)
Seat 6: 45b05c97 ($15.22 in chips)
9b94a525: posts small blind $0.05
bb81dd1e: posts big blind $0.1
*** HOLE CARDS ***
Dealt to Hero [9h Jh]
Dealt to 9b94a525 
Dealt to bb81dd1e 
Dealt to c369fe87 
Dealt to 24ada796 
Dealt to 45b05c97 
c369fe87: folds
24ada796: raises $0.1 to $0.2
45b05c97: calls $0.2
Hero: folds
9b94a525: folds
bb81dd1e: folds
*** FLOP *** [3d Jc 3c]
24ada796: checks
45b05c97: checks
*** TURN *** [3d Jc 3c] [3s]
24ada796: checks
45b05c97: bets $0.28
24ada796: calls $0.28
*** RIVER *** [3d Jc 3c 3s] [2d]
24ada796: checks
45b05c97: bets $0.37
24ada796: calls $0.37
45b05c97: shows [5d 5h] (Treys Full over Fives)
24ada796: shows [Ac Qc] (Three Treys)
*** SHOWDOWN ***
45b05c97 collected $1.78 from pot
*** SUMMARY ***
Total pot $1.85 | Rake $0.07 | Jackpot $0 | Bingo $0 | Fortune $0 | Tax $0
Board [3d Jc 3c 3s 2d]
Seat 1: Hero (button) folded before Flop (didn't bet)
Seat 2: 9b94a525 (small blind) folded before Flop
Seat 3: bb81dd1e (big blind) folded before Flop
Seat 4: c369fe87 folded before Flop (didn't bet)
Seat 5: 24ada796 showed [Ac Qc] and lost with Three Treys
Seat 6: 45b05c97 showed [5d 5h] and won ($1.78) with Treys Full over Fives


Poker Hand #RC2771838568: Hold'em No Limit ($0.05/$0.1) - 2024/08/04 11:18:16
Table 'RushAndCash20813828' 6-max Seat #1 is the button
Seat 1: 850cb9a4 ($4.1 in chips)
Seat 2: 4603f18d ($11.86 in chips)
Seat 3: 3728bbdd ($18.55 in chips)
Seat 4: 210c58ca ($35.48 in chips)
Seat 5: Hero ($30.41 in chips)
Seat 6: 6ae4e262 ($14.69 in chips)
4603f18d: posts small blind $0.05
3728bbdd: posts big blind $0.1
*** HOLE CARDS ***
Dealt to 850cb9a4 
Dealt to 4603f18d 
Dealt to 3728bbdd 
Dealt to 210c58ca 
Dealt to Hero [5h 4h]
Dealt to 6ae4e262 
210c58ca: folds
Hero: folds
6ae4e262: folds
850cb9a4: raises $0.13 to $0.23
4603f18d: raises $0.88 to $1.11
3728bbdd: folds
850cb9a4: folds
Uncalled bet ($0.88) returned to 4603f18d
*** SHOWDOWN ***
4603f18d collected $0.54 from pot
*** SUMMARY ***
Total pot $0.56 | Rake $0.02 | Jackpot $0 | Bingo $0 | Fortune $0 | Tax $0
Seat 1: 850cb9a4 (button) folded before Flop
Seat 2: 4603f18d (small blind) collected ($0.54)
Seat 3: 3728bbdd (big blind) folded before Flop
Seat 4: 210c58ca folded before Flop (didn't bet)
Seat 5: Hero folded before Flop (didn't bet)
Seat 6: 6ae4e262 folded before Flop (didn't bet)


Poker Hand #RC2771838548: Hold'em No Limit ($0.05/$0.1) - 2024/08/04 11:18:13
Table 'RushAndCash20813808' 6-max Seat #1 is the button
Seat 1: 12ab45ce ($23.51 in chips)
Seat 2: b9a30f82 ($21.05 in chips)
Seat 3: Hero ($30.51 in chips)
Seat 4: 53447ed9 ($9.18 in chips)
Seat 5: 84203a4a ($10.24 in chips)
Seat 6: 24c4b23f ($23.12 in chips)
b9a30f82: posts small blind $0.05
Hero: posts big blind $0.1
*** HOLE CARDS ***
Dealt to 12ab45ce 
Dealt to b9a30f82 
Dealt to Hero [Qs 8c]
Dealt to 53447ed9 
Dealt to 84203a4a 
Dealt to 24c4b23f 
53447ed9: raises $0.15 to $0.25
84203a4a: folds
24c4b23f: folds
12ab45ce: folds
b9a30f82: folds
Hero: folds
Uncalled bet ($0.15) returned to 53447ed9
*** SHOWDOWN ***
53447ed9 collected $0.25 from pot
*** SUMMARY ***
Total pot $0.25 | Rake $0 | Jackpot $0 | Bingo $0 | Fortune $0 | Tax $0
Seat 1: 12ab45ce (button) folded before Flop (didn't bet)
Seat 2: b9a30f82 (small blind) folded before Flop
Seat 3: Hero (big blind) folded before Flop
Seat 4: 53447ed9 collected ($0.25)
Seat 5: 84203a4a folded before Flop (didn't bet)
Seat 6: 24c4b23f folded before Flop (didn't bet)


Poker Hand #RC2771838492: Hold'em No Limit ($0.05/$0.1) - 2024/08/04 11:18:05
Table 'RushAndCash20813752' 6-max Seat #1 is the button
Seat 1: fe3a0a16 ($4.86 in chips)
Seat 2: 3bf7d120 ($12.09 in chips)
Seat 3: 5eb797ca ($10.28 in chips)
Seat 4: Hero ($30.51 in chips)
Seat 5: 781f7ab ($13.25 in chips)
Seat 6: e6e8601a ($26.49 in chips)
3bf7d120: posts small blind $0.05
5eb797ca: posts big blind $0.1
*** HOLE CARDS ***
Dealt to fe3a0a16 
Dealt to 3bf7d120 
Dealt to 5eb797ca 
Dealt to Hero [5c 5d]
Dealt to 781f7ab 
Dealt to e6e8601a 
Hero: folds
781f7ab: folds
e6e8601a: folds
fe3a0a16: folds
3bf7d120: folds
Uncalled bet ($0.05) returned to 5eb797ca
*** SHOWDOWN ***
5eb797ca collected $0.1 from pot
*** SUMMARY ***
Total pot $0.1 | Rake $0 | Jackpot $0 | Bingo $0 | Fortune $0 | Tax $0
Seat 1: fe3a0a16 (button) folded before Flop (didn't bet)
Seat 2: 3bf7d120 (small blind) folded before Flop
Seat 3: 5eb797ca (big blind) collected ($0.1)
Seat 4: Hero folded before Flop (didn't bet)
Seat 5: 781f7ab folded before Flop (didn't bet)
Seat 6: e6e8601a folded before Flop (didn't bet)


Poker Hand #RC2771838438: Hold'em No Limit ($0.05/$0.1) - 2024/08/04 11:17:57
Table 'RushAndCash20813698' 6-max Seat #1 is the button
Seat 1: 5f75fdfd ($10 in chips)
Seat 2: 76f0f9be ($12.09 in chips)
Seat 3: 7c803d6d ($10 in chips)
Seat 4: Hero ($30.51 in chips)
Seat 5: a4587f40 ($9.51 in chips)
Seat 6: b172cd25 ($11.73 in chips)
76f0f9be: posts small blind $0.05
7c803d6d: posts big blind $0.1
*** HOLE CARDS ***
Dealt to 5f75fdfd 
Dealt to 76f0f9be 
Dealt to 7c803d6d 
Dealt to Hero [Qs 2c]
Dealt to a4587f40 
Dealt to b172cd25 
Hero: folds
a4587f40: raises $0.1 to $0.2
b172cd25: folds
5f75fdfd: folds
76f0f9be: folds
7c803d6d: folds
Uncalled bet ($0.1) returned to a4587f40
*** SHOWDOWN ***
a4587f40 collected $0.25 from pot
*** SUMMARY ***
Total pot $0.25 | Rake $0 | Jackpot $0 | Bingo $0 | Fortune $0 | Tax $0
Seat 1: 5f75fdfd (button) folded before Flop (didn't bet)
Seat 2: 76f0f9be (small blind) folded before Flop
Seat 3: 7c803d6d (big blind) folded before Flop
Seat 4: Hero folded before Flop (didn't bet)
Seat 5: a4587f40 collected ($0.25)
Seat 6: b172cd25 folded before Flop (didn't bet)


Poker Hand #RC2771838387: Hold'em No Limit ($0.05/$0.1) - 2024/08/04 11:17:50
Table 'RushAndCash20813647' 6-max Seat #1 is the button
Seat 1: Hero ($30.51 in chips)
Seat 2: 18acc471 ($10.41 in chips)
Seat 3: 24ada796 ($10 in chips)
Seat 4: 1b86c5de ($10.5 in chips)
Seat 5: a4567cc ($12.79 in chips)
Seat 6: 3968ffd4 ($10.5 in chips)
18acc471: posts small blind $0.05
24ada796: posts big blind $0.1
*** HOLE CARDS ***
Dealt to Hero [8h Js]
Dealt to 18acc471 
Dealt to 24ada796 
Dealt to 1b86c5de 
Dealt to a4567cc 
Dealt to 3968ffd4 
1b86c5de: folds
a4567cc: folds
3968ffd4: raises $0.12 to $0.22
Hero: folds
18acc471: folds
24ada796: folds
Uncalled bet ($0.12) returned to 3968ffd4
*** SHOWDOWN ***
3968ffd4 collected $0.25 from pot
*** SUMMARY ***
Total pot $0.25 | Rake $0 | Jackpot $0 | Bingo $0 | Fortune $0 | Tax $0
Seat 1: Hero (button) folded before Flop (didn't bet)
Seat 2: 18acc471 (small blind) folded before Flop
Seat 3: 24ada796 (big blind) folded before Flop
Seat 4: 1b86c5de folded before Flop (didn't bet)
Seat 5: a4567cc folded before Flop (didn't bet)
Seat 6: 3968ffd4 collected ($0.25)


Poker Hand #RC2771838367: Hold'em No Limit ($0.05/$0.1) - 2024/08/04 11:17:47
Table 'RushAndCash20813627' 6-max Seat #1 is the button
Seat 1: 18ddc90b ($23.29 in chips)
Seat 2: Hero ($30.56 in chips)
Seat 3: 4ddc6258 ($10.15 in chips)
Seat 4: 24ada796 ($10 in chips)
Seat 5: 44212311 ($18.79 in chips)
Seat 6: c369fe87 ($10 in chips)
Hero: posts small blind $0.05
4ddc6258: posts big blind $0.1
*** HOLE CARDS ***
Dealt to 18ddc90b 
Dealt to Hero [3c 8h]
Dealt to 4ddc6258 
Dealt to 24ada796 
Dealt to 44212311 
Dealt to c369fe87 
24ada796: folds
44212311: folds
c369fe87: raises $0.15 to $0.25
18ddc90b: folds
Hero: folds
4ddc6258: folds
Uncalled bet ($0.15) returned to c369fe87
*** SHOWDOWN ***
c369fe87 collected $0.25 from pot
*** SUMMARY ***
Total pot $0.25 | Rake $0 | Jackpot $0 | Bingo $0 | Fortune $0 | Tax $0
Seat 1: 18ddc90b (button) folded before Flop (didn't bet)
Seat 2: Hero (small blind) folded before Flop
Seat 3: 4ddc6258 (big blind) folded before Flop
Seat 4: 24ada796 folded before Flop (didn't bet)
Seat 5: 44212311 folded before Flop (didn't bet)
Seat 6: c369fe87 collected ($0.25)


Poker Hand #RC2771838331: Hold'em No Limit ($0.05/$0.1) - 2024/08/04 11:17:42
Table 'RushAndCash20813591' 6-max Seat #1 is the button
Seat 1: d0d2ca4c ($10.96 in chips)
Seat 2: 6f8fa43a ($10 in chips)
Seat 3: df679d06 ($10.37 in chips)
Seat 4: 40c83366 ($10.45 in chips)
Seat 5: Hero ($30.56 in chips)
Seat 6: f814105e ($17.4 in chips)
6f8fa43a: posts small blind $0.05
df679d06: posts big blind $0.1
*** HOLE CARDS ***
Dealt to d0d2ca4c 
Dealt to 6f8fa43a 
Dealt to df679d06 
Dealt to 40c83366 
Dealt to Hero [9s 2c]
Dealt to f814105e 
40c83366: folds
Hero: folds
f814105e: folds
d0d2ca4c: folds
6f8fa43a: raises $0.12 to $0.22
df679d06: folds
Uncalled bet ($0.12) returned to 6f8fa43a
*** SHOWDOWN ***
6f8fa43a collected $0.2 from pot
*** SUMMARY ***
Total pot $0.2 | Rake $0 | Jackpot $0 | Bingo $0 | Fortune $0 | Tax $0
Seat 1: d0d2ca4c (button) folded before Flop (didn't bet)
Seat 2: 6f8fa43a (small blind) collected ($0.2)
Seat 3: df679d06 (big blind) folded before Flop
Seat 4: 40c83366 folded before Flop (didn't bet)
Seat 5: Hero folded before Flop (didn't bet)
Seat 6: f814105e folded before Flop (didn't bet)


Poker Hand #RC2771838270: Hold'em No Limit ($0.05/$0.1) - 2024/08/04 11:17:33
Table 'RushAndCash20813530' 6-max Seat #1 is the button
Seat 1: 560b685c ($10 in chips)
Seat 2: Hero ($30.61 in chips)
Seat 3: 5a871710 ($18.4 in chips)
Seat 4: cdce02a3 ($9.61 in chips)
Seat 5: bdd79bd8 ($12.5 in chips)
Seat 6: 84bdbe67 ($13.02 in chips)
Hero: posts small blind $0.05
5a871710: posts big blind $0.1
*** HOLE CARDS ***
Dealt to 560b685c 
Dealt to Hero [2d Ad]
Dealt to 5a871710 
Dealt to cdce02a3 
Dealt to bdd79bd8 
Dealt to 84bdbe67 
cdce02a3: folds
bdd79bd8: raises $0.15 to $0.25
84bdbe67: folds
560b685c: folds
Hero: folds
5a871710: folds
Uncalled bet ($0.15) returned to bdd79bd8
*** SHOWDOWN ***
bdd79bd8 collected $0.25 from pot
*** SUMMARY ***
Total pot $0.25 | Rake $0 | Jackpot $0 | Bingo $0 | Fortune $0 | Tax $0
Seat 1: 560b685c (button) folded before Flop (didn't bet)
Seat 2: Hero (small blind) folded before Flop
Seat 3: 5a871710 (big blind) folded before Flop
Seat 4: cdce02a3 folded before Flop (didn't bet)
Seat 5: bdd79bd8 collected ($0.25)
Seat 6: 84bdbe67 folded before Flop (didn't bet)


Poker Hand #RC2771838233: Hold'em No Limit ($0.05/$0.1) - 2024/08/04 11:17:27
Table 'RushAndCash20813493' 6-max Seat #1 is the button
Seat 1: Hero ($30.61 in chips)
Seat 2: e2e4a8ce ($15.22 in chips)
Seat 3: a80d90a1 ($9.24 in chips)
Seat 4: e326c2f9 ($23.14 in chips)
Seat 5: 34e762d1 ($7.31 in chips)
Seat 6: d67d6462 ($2.85 in chips)
e2e4a8ce: posts small blind $0.05
a80d90a1: posts big blind $0.1
*** HOLE CARDS ***
Dealt to Hero [Qh 5s]
Dealt to e2e4a8ce 
Dealt to a80d90a1 
Dealt to e326c2f9 
Dealt to 34e762d1 
Dealt to d67d6462 
e326c2f9: folds
34e762d1: folds
d67d6462: folds
Hero: folds
e2e4a8ce: folds
Uncalled bet ($0.05) returned to a80d90a1
*** SHOWDOWN ***
a80d90a1 collected $0.1 from pot
*** SUMMARY ***
Total pot $0.1 | Rake $0 | Jackpot $0 | Bingo $0 | Fortune $0 | Tax $0
Seat 1: Hero (button) folded before Flop (didn't bet)
Seat 2: e2e4a8ce (small blind) folded before Flop
Seat 3: a80d90a1 (big blind) collected ($0.1)
Seat 4: e326c2f9 folded before Flop (didn't bet)
Seat 5: 34e762d1 folded before Flop (didn't bet)
Seat 6: d67d6462 folded before Flop (didn't bet)


Poker Hand #RC2771838170: Hold'em No Limit ($0.05/$0.1) - 2024/08/04 11:17:18
Table 'RushAndCash20813430' 6-max Seat #1 is the button
Seat 1: 281ff05a ($11.46 in chips)
Seat 2: 29b9f6a8 ($9.91 in chips)
Seat 3: bb81dd1e ($8.43 in chips)
Seat 4: 33261387 ($10.96 in chips)
Seat 5: Hero ($30.61 in chips)
Seat 6: 56512c19 ($17.46 in chips)
Cash Drop to Pot : total $1 
29b9f6a8: posts small blind $0.05
bb81dd1e: posts big blind $0.1
*** HOLE CARDS ***
Dealt to 281ff05a 
Dealt to 29b9f6a8 
Dealt to bb81dd1e 
Dealt to 33261387 
Dealt to Hero [9c 5h]
Dealt to 56512c19 
33261387: folds
Hero: folds
56512c19: folds
281ff05a: raises $0.2 to $0.3
29b9f6a8: raises $9.61 to $9.91 and is all-in
bb81dd1e: calls $8.33 and is all-in
281ff05a: folds
Uncalled bet ($1.48) returned to 29b9f6a8
29b9f6a8: shows [Ah Ac]
bb81dd1e: shows [Tc Ts]
*** FIRST FLOP *** [Th Ks Kh]
*** FIRST TURN *** [Th Ks Kh] [7d]
*** FIRST RIVER *** [Th Ks Kh 7d] [8d]
*** SECOND FLOP *** [6c 3h 5s]
*** SECOND TURN *** [6c 3h 5s] [Jh]
*** SECOND RIVER *** [6c 3h 5s Jh] [Ad]
*** FIRST SHOWDOWN ***
bb81dd1e collected $8.85 from pot
*** SECOND SHOWDOWN ***
29b9f6a8 collected $8.86 from pot
*** SUMMARY ***
Total pot $18.16 | Rake $0.3 | Jackpot $0.15 | Bingo $0 | Fortune $0 | Tax $0
Hand was run two times
FIRST Board [Th Ks Kh 7d 8d]
SECOND Board [6c 3h 5s Jh Ad]
Seat 1: 281ff05a (button) folded before Flop
Seat 2: 29b9f6a8 (small blind) showed [Ah Ac] and lost with Pair of Aces and Pair of Kings, and won ($8.86) with Three Aces
Seat 3: bb81dd1e (big blind) showed [Tc Ts] and won ($8.85) with Tens Full over Kings, and lost with Pair of Tens
Seat 4: 33261387 folded before Flop (didn't bet)
Seat 5: Hero folded before Flop (didn't bet)
Seat 6: 56512c19 folded before Flop (didn't bet)


Poker Hand #RC2771838145: Hold'em No Limit ($0.05/$0.1) - 2024/08/04 11:17:15
Table 'RushAndCash20813405' 6-max Seat #1 is the button
Seat 1: 56512c19 ($17.46 in chips)
Seat 2: ee0cbb47 ($10.48 in chips)
Seat 3: Hero ($30.71 in chips)
Seat 4: 4504f10b ($21.25 in chips)
Seat 5: 76f0f9be ($12.24 in chips)
Seat 6: 32b76c01 ($11.86 in chips)
ee0cbb47: posts small blind $0.05
Hero: posts big blind $0.1
*** HOLE CARDS ***
Dealt to 56512c19 
Dealt to ee0cbb47 
Dealt to Hero [2s Td]
Dealt to 4504f10b 
Dealt to 76f0f9be 
Dealt to 32b76c01 
4504f10b: raises $0.1 to $0.2
76f0f9be: folds
32b76c01: folds
56512c19: folds
ee0cbb47: folds
Hero: folds
Uncalled bet ($0.1) returned to 4504f10b
*** SHOWDOWN ***
4504f10b collected $0.25 from pot
*** SUMMARY ***
Total pot $0.25 | Rake $0 | Jackpot $0 | Bingo $0 | Fortune $0 | Tax $0
Seat 1: 56512c19 (button) folded before Flop (didn't bet)
Seat 2: ee0cbb47 (small blind) folded before Flop
Seat 3: Hero (big blind) folded before Flop
Seat 4: 4504f10b collected ($0.25)
Seat 5: 76f0f9be folded before Flop (didn't bet)
Seat 6: 32b76c01 folded before Flop (didn't bet)


Poker Hand #RC2771838119: Hold'em No Limit ($0.05/$0.1) - 2024/08/04 11:17:11
Table 'RushAndCash20813379' 6-max Seat #1 is the button
Seat 1: e2c2989d ($28.68 in chips)
Seat 2: cf0239e6 ($28.42 in chips)
Seat 3: 9b7a4cfc ($12.36 in chips)
Seat 4: Hero ($30.71 in chips)
Seat 5: 133a3a48 ($18.58 in chips)
Seat 6: d0b6a689 ($10.61 in chips)
cf0239e6: posts small blind $0.05
9b7a4cfc: posts big blind $0.1
*** HOLE CARDS ***
Dealt to e2c2989d 
Dealt to cf0239e6 
Dealt to 9b7a4cfc 
Dealt to Hero [7d Jc]
Dealt to 133a3a48 
Dealt to d0b6a689 
Hero: folds
133a3a48: raises $0.15 to $0.25
d0b6a689: folds
e2c2989d: folds
cf0239e6: folds
9b7a4cfc: calls $0.15
*** FLOP *** [5s 8d 2h]
9b7a4cfc: checks
133a3a48: bets $0.28
9b7a4cfc: calls $0.28
*** TURN *** [5s 8d 2h] [5c]
9b7a4cfc: checks
133a3a48: bets $0.56
9b7a4cfc: calls $0.56
*** RIVER *** [5s 8d 2h 5c] [Jd]
9b7a4cfc: checks
133a3a48: bets $1.12
9b7a4cfc: raises $3.36 to $4.48
133a3a48: calls $3.36
9b7a4cfc: shows [Ac As] (Pair of Aces and Pair of Fives)
133a3a48: shows [Kc Kd] (Pair of Kings and Pair of Fives)
*** SHOWDOWN ***
9b7a4cfc collected $10.74 from pot
*** SUMMARY ***
Total pot $11.19 | Rake $0.3 | Jackpot $0.15 | Bingo $0 | Fortune $0 | Tax $0
Board [5s 8d 2h 5c Jd]
Seat 1: e2c2989d (button) folded before Flop (didn't bet)
Seat 2: cf0239e6 (small blind) folded before Flop
Seat 3: 9b7a4cfc (big blind) showed [Ac As] and won ($10.74) with Pair of Aces and Pair of Fives
Seat 4: Hero folded before Flop (didn't bet)
Seat 5: 133a3a48 showed [Kc Kd] and lost with Pair of Kings and Pair of Fives
Seat 6: d0b6a689 folded before Flop (didn't bet)


Poker Hand #RC2771837954: Hold'em No Limit ($0.05/$0.1) - 2024/08/04 11:16:48
Table 'RushAndCash20813214' 6-max Seat #1 is the button
Seat 1: 6ef03265 ($22.57 in chips)
Seat 2: 3a38c27b ($21.45 in chips)
Seat 3: 45bf4575 ($10.19 in chips)
Seat 4: b334737c ($12.52 in chips)
Seat 5: Hero ($30.56 in chips)
Seat 6: 56512c19 ($17.61 in chips)
3a38c27b: posts small blind $0.05
45bf4575: posts big blind $0.1
*** HOLE CARDS ***
Dealt to 6ef03265 
Dealt to 3a38c27b 
Dealt to 45bf4575 
Dealt to b334737c 
Dealt to Hero [Th Qh]
Dealt to 56512c19 
b334737c: folds
Hero: raises $0.1 to $0.2
56512c19: folds
6ef03265: folds
3a38c27b: folds
45bf4575: folds
Uncalled bet ($0.1) returned to Hero
*** SHOWDOWN ***
Hero collected $0.25 from pot
*** SUMMARY ***
Total pot $0.25 | Rake $0 | Jackpot $0 | Bingo $0 | Fortune $0 | Tax $0
Seat 1: 6ef03265 (button) folded before Flop (didn't bet)
Seat 2: 3a38c27b (small blind) folded before Flop
Seat 3: 45bf4575 (big blind) folded before Flop
Seat 4: b334737c folded before Flop (didn't bet)
Seat 5: Hero collected ($0.25)
Seat 6: 56512c19 folded before Flop (didn't bet)


Poker Hand #RC2771837930: Hold'em No Limit ($0.05/$0.1) - 2024/08/04 11:16:45
Table 'RushAndCash20813190' 6-max Seat #1 is the button
Seat 1: df679d06 ($10 in chips)
Seat 2: 4e88776f ($12.49 in chips)
Seat 3: 86db787b ($5.37 in chips)
Seat 4: 5135b9f4 ($20.98 in chips)
Seat 5: Hero ($30.56 in chips)
Seat 6: f112d971 ($23.55 in chips)
4e88776f: posts small blind $0.05
86db787b: posts big blind $0.1
*** HOLE CARDS ***
Dealt to df679d06 
Dealt to 4e88776f 
Dealt to 86db787b 
Dealt to 5135b9f4 
Dealt to Hero [Js 9c]
Dealt to f112d971 
5135b9f4: folds
Hero: folds
f112d971: folds
df679d06: folds
4e88776f: raises $0.15 to $0.25
86db787b: calls $0.15
*** FLOP *** [3h Td 6c]
4e88776f: checks
86db787b: checks
*** TURN *** [3h Td 6c] [7c]
4e88776f: bets $0.17
86db787b: folds
Uncalled bet ($0.17) returned to 4e88776f
*** SHOWDOWN ***
4e88776f collected $0.48 from pot
*** SUMMARY ***
Total pot $0.5 | Rake $0.02 | Jackpot $0 | Bingo $0 | Fortune $0 | Tax $0
Board [3h Td 6c 7c]
Seat 1: df679d06 (button) folded before Flop (didn't bet)
Seat 2: 4e88776f (small blind) won ($0.48)
Seat 3: 86db787b (big blind) folded on the Turn
Seat 4: 5135b9f4 folded before Flop (didn't bet)
Seat 5: Hero folded before Flop (didn't bet)
Seat 6: f112d971 folded before Flop (didn't bet)


Poker Hand #RC2771837906: Hold'em No Limit ($0.05/$0.1) - 2024/08/04 11:16:42
Table 'RushAndCash20813166' 6-max Seat #1 is the button
Seat 1: ca92f7d8 ($6.39 in chips)
Seat 2: Hero ($30.61 in chips)
Seat 3: ef551d4b ($10 in chips)
Seat 4: f112d971 ($23.55 in chips)
Seat 5: 295e4e85 ($11.94 in chips)
Seat 6: 86db787b ($5.37 in chips)
Hero: posts small blind $0.05
ef551d4b: posts big blind $0.1
*** HOLE CARDS ***
Dealt to ca92f7d8 
Dealt to Hero [Kh 8s]
Dealt to ef551d4b 
Dealt to f112d971 
Dealt to 295e4e85 
Dealt to 86db787b 
f112d971: folds
295e4e85: folds
86db787b: folds
ca92f7d8: folds
Hero: folds
Uncalled bet ($0.05) returned to ef551d4b
*** SHOWDOWN ***
ef551d4b collected $0.1 from pot
*** SUMMARY ***
Total pot $0.1 | Rake $0 | Jackpot $0 | Bingo $0 | Fortune $0 | Tax $0
Seat 1: ca92f7d8 (button) folded before Flop (didn't bet)
Seat 2: Hero (small blind) folded before Flop
Seat 3: ef551d4b (big blind) collected ($0.1)
Seat 4: f112d971 folded before Flop (didn't bet)
Seat 5: 295e4e85 folded before Flop (didn't bet)
Seat 6: 86db787b folded before Flop (didn't bet)


Poker Hand #RC2771837184: Hold'em No Limit ($0.05/$0.1) - 2024/08/04 11:15:05
Table 'RushAndCash20812444' 6-max Seat #1 is the button
Seat 1: Hero ($32.49 in chips)
Seat 2: ff1689f8 ($11.45 in chips)
Seat 3: dc8e7459 ($30.36 in chips)
Seat 4: cb6c5b1 ($15.58 in chips)
Seat 5: 295e4e85 ($10.24 in chips)
Seat 6: e1a39450 ($15.27 in chips)
ff1689f8: posts small blind $0.05
dc8e7459: posts big blind $0.1
*** HOLE CARDS ***
Dealt to Hero [Js Jc]
Dealt to ff1689f8 
Dealt to dc8e7459 
Dealt to cb6c5b1 
Dealt to 295e4e85 
Dealt to e1a39450 
cb6c5b1: folds
295e4e85: raises $0.1 to $0.2
e1a39450: folds
Hero: raises $0.7 to $0.9
ff1689f8: folds
dc8e7459: folds
295e4e85: raises $0.98 to $1.88
Hero: calls $0.98
*** FLOP *** [Ks Qh 2c]
295e4e85: bets $1.3
Hero: folds
Uncalled bet ($1.3) returned to 295e4e85
*** SHOWDOWN ***
295e4e85 collected $3.58 from pot
*** SUMMARY ***
Total pot $3.91 | Rake $0.18 | Jackpot $0.15 | Bingo $0 | Fortune $0 | Tax $0
Board [Ks Qh 2c]
Seat 1: Hero (button) folded on the Flop
Seat 2: ff1689f8 (small blind) folded before Flop
Seat 3: dc8e7459 (big blind) folded before Flop
Seat 4: cb6c5b1 folded before Flop (didn't bet)
Seat 5: 295e4e85 won ($3.58)
Seat 6: e1a39450 folded before Flop (didn't bet)


Poker Hand #RC2771837157: Hold'em No Limit ($0.05/$0.1) - 2024/08/04 11:15:01
Table 'RushAndCash20812417' 6-max Seat #1 is the button
Seat 1: 402f8b4b ($10.78 in chips)
Seat 2: 5223f055 ($10.63 in chips)
Seat 3: Hero ($32.59 in chips)
Seat 4: 5ab06e64 ($17.99 in chips)
Seat 5: 3ee283e0 ($22.58 in chips)
Seat 6: fa599f7d ($10.32 in chips)
5223f055: posts small blind $0.05
Hero: posts big blind $0.1
*** HOLE CARDS ***
Dealt to 402f8b4b 
Dealt to 5223f055 
Dealt to Hero [8h 4s]
Dealt to 5ab06e64 
Dealt to 3ee283e0 
Dealt to fa599f7d 
5ab06e64: raises $0.1 to $0.2
3ee283e0: folds
fa599f7d: calls $0.2
402f8b4b: calls $0.2
5223f055: folds
Hero: folds
*** FLOP *** [2h Jh 4c]
5ab06e64: checks
fa599f7d: checks
402f8b4b: bets $0.4
5ab06e64: folds
fa599f7d: folds
Uncalled bet ($0.4) returned to 402f8b4b
*** SHOWDOWN ***
402f8b4b collected $0.72 from pot
*** SUMMARY ***
Total pot $0.75 | Rake $0.03 | Jackpot $0 | Bingo $0 | Fortune $0 | Tax $0
Board [2h Jh 4c]
Seat 1: 402f8b4b (button) won ($0.72)
Seat 2: 5223f055 (small blind) folded before Flop
Seat 3: Hero (big blind) folded before Flop
Seat 4: 5ab06e64 folded on the Flop
Seat 5: 3ee283e0 folded before Flop (didn't bet)
Seat 6: fa599f7d folded on the Flop


Poker Hand #RC2771836887: Hold'em No Limit ($0.05/$0.1) - 2024/08/04 11:14:22
Table 'RushAndCash20812147' 6-max Seat #1 is the button
Seat 1: 402f8b4b ($10.93 in chips)
Seat 2: a5934483 ($10.31 in chips)
Seat 3: 5223f055 ($10.26 in chips)
Seat 4: Hero ($32.94 in chips)
Seat 5: 24e6aaf4 ($14.03 in chips)
Seat 6: de2f722d ($10.55 in chips)
a5934483: posts small blind $0.05
5223f055: posts big blind $0.1
*** HOLE CARDS ***
Dealt to 402f8b4b 
Dealt to a5934483 
Dealt to 5223f055 
Dealt to Hero [Qc Ac]
Dealt to 24e6aaf4 
Dealt to de2f722d 
Hero: raises $0.1 to $0.2
24e6aaf4: folds
de2f722d: folds
402f8b4b: folds
a5934483: folds
5223f055: calls $0.1
*** FLOP *** [5d 9h 7h]
5223f055: checks
Hero: checks
*** TURN *** [5d 9h 7h] [Qh]
5223f055: checks
Hero: checks
*** RIVER *** [5d 9h 7h Qh] [6c]
5223f055: bets $0.15
Hero: calls $0.15
5223f055: shows [7d Qd] (Pair of Queens and Pair of Sevens)
Hero: shows [Qc Ac] (Pair of Queens)
*** SHOWDOWN ***
5223f055 collected $0.72 from pot
*** SUMMARY ***
Total pot $0.75 | Rake $0.03 | Jackpot $0 | Bingo $0 | Fortune $0 | Tax $0
Board [5d 9h 7h Qh 6c]
Seat 1: 402f8b4b (button) folded before Flop (didn't bet)
Seat 2: a5934483 (small blind) folded before Flop
Seat 3: 5223f055 (big blind) showed [7d Qd] and won ($0.72) with Pair of Queens and Pair of Sevens
Seat 4: Hero showed [Qc Ac] and lost with Pair of Queens
Seat 5: 24e6aaf4 folded before Flop (didn't bet)
Seat 6: de2f722d folded before Flop (didn't bet)


Poker Hand #RC2771836858: Hold'em No Limit ($0.05/$0.1) - 2024/08/04 11:14:18
Table 'RushAndCash20812118' 6-max Seat #1 is the button
Seat 1: 33261387 ($9.77 in chips)
Seat 2: Hero ($32.99 in chips)
Seat 3: 98fe9892 ($3.09 in chips)
Seat 4: 2abef62e ($10 in chips)
Seat 5: b8050970 ($11.8 in chips)
Seat 6: 5c1fc04a ($15.73 in chips)
Hero: posts small blind $0.05
98fe9892: posts big blind $0.1
*** HOLE CARDS ***
Dealt to 33261387 
Dealt to Hero [9h 8s]
Dealt to 98fe9892 
Dealt to 2abef62e 
Dealt to b8050970 
Dealt to 5c1fc04a 
2abef62e: folds
b8050970: folds
5c1fc04a: folds
33261387: folds
Hero: folds
Uncalled bet ($0.05) returned to 98fe9892
*** SHOWDOWN ***
98fe9892 collected $0.1 from pot
*** SUMMARY ***
Total pot $0.1 | Rake $0 | Jackpot $0 | Bingo $0 | Fortune $0 | Tax $0
Seat 1: 33261387 (button) folded before Flop (didn't bet)
Seat 2: Hero (small blind) folded before Flop
Seat 3: 98fe9892 (big blind) collected ($0.1)
Seat 4: 2abef62e folded before Flop (didn't bet)
Seat 5: b8050970 folded before Flop (didn't bet)
Seat 6: 5c1fc04a folded before Flop (didn't bet)


Poker Hand #RC2771836836: Hold'em No Limit ($0.05/$0.1) - 2024/08/04 11:14:15
Table 'RushAndCash20812096' 6-max Seat #1 is the button
Seat 1: ad428624 ($10 in chips)
Seat 2: 133a3a48 ($19.13 in chips)
Seat 3: 3ee283e0 ($22.68 in chips)
Seat 4: 98fe9892 ($3.09 in chips)
Seat 5: 10beee26 ($10.12 in chips)
Seat 6: Hero ($32.99 in chips)
133a3a48: posts small blind $0.05
3ee283e0: posts big blind $0.1
*** HOLE CARDS ***
Dealt to ad428624 
Dealt to 133a3a48 
Dealt to 3ee283e0 
Dealt to 98fe9892 
Dealt to 10beee26 
Dealt to Hero [7h 5d]
98fe9892: folds
10beee26: raises $0.15 to $0.25
Hero: folds
ad428624: folds
133a3a48: folds
3ee283e0: folds
Uncalled bet ($0.15) returned to 10beee26
*** SHOWDOWN ***
10beee26 collected $0.25 from pot
*** SUMMARY ***
Total pot $0.25 | Rake $0 | Jackpot $0 | Bingo $0 | Fortune $0 | Tax $0
Seat 1: ad428624 (button) folded before Flop (didn't bet)
Seat 2: 133a3a48 (small blind) folded before Flop
Seat 3: 3ee283e0 (big blind) folded before Flop
Seat 4: 98fe9892 folded before Flop (didn't bet)
Seat 5: 10beee26 collected ($0.25)
Seat 6: Hero folded before Flop (didn't bet)


Poker Hand #RC2771836780: Hold'em No Limit ($0.05/$0.1) - 2024/08/04 11:14:07
Table 'RushAndCash20812040' 6-max Seat #1 is the button
Seat 1: cbe2c8e0 ($10 in chips)
Seat 2: 368ebd2f ($10 in chips)
Seat 3: Hero ($32.94 in chips)
Seat 4: 56587ded ($17.38 in chips)
Seat 5: b870dfb ($5.07 in chips)
Seat 6: 251ae843 ($10.18 in chips)
368ebd2f: posts small blind $0.05
Hero: posts big blind $0.1
*** HOLE CARDS ***
Dealt to cbe2c8e0 
Dealt to 368ebd2f 
Dealt to Hero [4h 5c]
Dealt to 56587ded 
Dealt to b870dfb 
Dealt to 251ae843 
56587ded: folds
b870dfb: folds
251ae843: folds
cbe2c8e0: folds
368ebd2f: folds
Uncalled bet ($0.05) returned to Hero
*** SHOWDOWN ***
Hero collected $0.1 from pot
*** SUMMARY ***
Total pot $0.1 | Rake $0 | Jackpot $0 | Bingo $0 | Fortune $0 | Tax $0
Seat 1: cbe2c8e0 (button) folded before Flop (didn't bet)
Seat 2: 368ebd2f (small blind) folded before Flop
Seat 3: Hero (big blind) collected ($0.1)
Seat 4: 56587ded folded before Flop (didn't bet)
Seat 5: b870dfb folded before Flop (didn't bet)
Seat 6: 251ae843 folded before Flop (didn't bet)


Poker Hand #RC2771836737: Hold'em No Limit ($0.05/$0.1) - 2024/08/04 11:14:01
Table 'RushAndCash20811997' 6-max Seat #1 is the button
Seat 1: 43cf33e0 ($10.1 in chips)
Seat 2: 6dad76a6 ($10.96 in chips)
Seat 3: 5ab06e64 ($17.08 in chips)
Seat 4: 483620e3 ($15.2 in chips)
Seat 5: e550fc7a ($4.19 in chips)
Seat 6: Hero ($32.94 in chips)
6dad76a6: posts small blind $0.05
5ab06e64: posts big blind $0.1
*** HOLE CARDS ***
Dealt to 43cf33e0 
Dealt to 6dad76a6 
Dealt to 5ab06e64 
Dealt to 483620e3 
Dealt to e550fc7a 
Dealt to Hero [5d 8c]
483620e3: folds
e550fc7a: folds
Hero: folds
43cf33e0: folds
6dad76a6: folds
Uncalled bet ($0.05) returned to 5ab06e64
*** SHOWDOWN ***
5ab06e64 collected $0.1 from pot
*** SUMMARY ***
Total pot $0.1 | Rake $0 | Jackpot $0 | Bingo $0 | Fortune $0 | Tax $0
Seat 1: 43cf33e0 (button) folded before Flop (didn't bet)
Seat 2: 6dad76a6 (small blind) folded before Flop
Seat 3: 5ab06e64 (big blind) collected ($0.1)
Seat 4: 483620e3 folded before Flop (didn't bet)
Seat 5: e550fc7a folded before Flop (didn't bet)
Seat 6: Hero folded before Flop (didn't bet)


Poker Hand #RC2771836713: Hold'em No Limit ($0.05/$0.1) - 2024/08/04 11:13:58
Table 'RushAndCash20811973' 6-max Seat #1 is the button
Seat 1: 49bff733 ($17.84 in chips)
Seat 2: a7d5fada ($10.13 in chips)
Seat 3: 369ff408 ($10.55 in chips)
Seat 4: 49db9bf6 ($10.28 in chips)
Seat 5: 40ac5fa3 ($12.86 in chips)
Seat 6: Hero ($32.94 in chips)
a7d5fada: posts small blind $0.05
369ff408: posts big blind $0.1
*** HOLE CARDS ***
Dealt to 49bff733 
Dealt to a7d5fada 
Dealt to 369ff408 
Dealt to 49db9bf6 
Dealt to 40ac5fa3 
Dealt to Hero [Js 6s]
49db9bf6: folds
40ac5fa3: folds
Hero: folds
49bff733: raises $0.1 to $0.2
a7d5fada: calls $0.15
369ff408: folds
*** FLOP *** [6d 5c 6c]
a7d5fada: checks
49bff733: checks
*** TURN *** [6d 5c 6c] [Qc]
a7d5fada: checks
49bff733: bets $0.4
a7d5fada: folds
Uncalled bet ($0.4) returned to 49bff733
*** SHOWDOWN ***
49bff733 collected $0.48 from pot
*** SUMMARY ***
Total pot $0.5 | Rake $0.02 | Jackpot $0 | Bingo $0 | Fortune $0 | Tax $0
Board [6d 5c 6c Qc]
Seat 1: 49bff733 (button) won ($0.48)
Seat 2: a7d5fada (small blind) folded on the Turn
Seat 3: 369ff408 (big blind) folded before Flop
Seat 4: 49db9bf6 folded before Flop (didn't bet)
Seat 5: 40ac5fa3 folded before Flop (didn't bet)
Seat 6: Hero folded before Flop (didn't bet)


Poker Hand #RC2771836692: Hold'em No Limit ($0.05/$0.1) - 2024/08/04 11:13:55
Table 'RushAndCash20811952' 6-max Seat #1 is the button
Seat 1: cb6c5b1 ($17.33 in chips)
Seat 2: f9814740 ($20.99 in chips)
Seat 3: 49bff733 ($17.94 in chips)
Seat 4: 483620e3 ($15.2 in chips)
Seat 5: Hero ($32.94 in chips)
Seat 6: c5ef7918 ($10 in chips)
f9814740: posts small blind $0.05
49bff733: posts big blind $0.1
*** HOLE CARDS ***
Dealt to cb6c5b1 
Dealt to f9814740 
Dealt to 49bff733 
Dealt to 483620e3 
Dealt to Hero [5d Ks]
Dealt to c5ef7918 
483620e3: folds
Hero: folds
c5ef7918: raises $0.1 to $0.2
cb6c5b1: raises $0.55 to $0.75
f9814740: raises $1.1 to $1.85
49bff733: folds
c5ef7918: folds
cb6c5b1: calls $1.1
*** FLOP *** [Kh 6s 5h]
f9814740: bets $1.2
cb6c5b1: folds
Uncalled bet ($1.2) returned to f9814740
*** SHOWDOWN ***
f9814740 collected $3.66 from pot
*** SUMMARY ***
Total pot $4 | Rake $0.19 | Jackpot $0.15 | Bingo $0 | Fortune $0 | Tax $0
Board [Kh 6s 5h]
Seat 1: cb6c5b1 (button) folded on the Flop
Seat 2: f9814740 (small blind) won ($3.66)
Seat 3: 49bff733 (big blind) folded before Flop
Seat 4: 483620e3 folded before Flop (didn't bet)
Seat 5: Hero folded before Flop (didn't bet)
Seat 6: c5ef7918 folded before Flop


Poker Hand #RC2771836506: Hold'em No Limit ($0.05/$0.1) - 2024/08/04 11:13:30
Table 'RushAndCash20811766' 6-max Seat #1 is the button
Seat 1: f567d1a ($18.52 in chips)
Seat 2: 483620e3 ($16.2 in chips)
Seat 3: dea5f731 ($9.45 in chips)
Seat 4: 53e19a62 ($20.02 in chips)
Seat 5: Hero ($31.94 in chips)
Seat 6: 27c79a21 ($13.45 in chips)
483620e3: posts small blind $0.05
dea5f731: posts big blind $0.1
*** HOLE CARDS ***
Dealt to f567d1a 
Dealt to 483620e3 
Dealt to dea5f731 
Dealt to 53e19a62 
Dealt to Hero [Kc Ad]
Dealt to 27c79a21 
53e19a62: folds
Hero: raises $0.1 to $0.2
27c79a21: folds
f567d1a: folds
483620e3: raises $0.8 to $1
dea5f731: folds
Hero: raises $1.5 to $2.5
483620e3: folds
Uncalled bet ($1.5) returned to Hero
*** SHOWDOWN ***
Hero collected $2 from pot
*** SUMMARY ***
Total pot $2.1 | Rake $0.1 | Jackpot $0 | Bingo $0 | Fortune $0 | Tax $0
Seat 1: f567d1a (button) folded before Flop (didn't bet)
Seat 2: 483620e3 (small blind) folded before Flop
Seat 3: dea5f731 (big blind) folded before Flop
Seat 4: 53e19a62 folded before Flop (didn't bet)
Seat 5: Hero collected ($2)
Seat 6: 27c79a21 folded before Flop (didn't bet)


Poker Hand #RC2771836464: Hold'em No Limit ($0.05/$0.1) - 2024/08/04 11:13:25
Table 'RushAndCash20811724' 6-max Seat #1 is the button
Seat 1: Hero ($31.94 in chips)
Seat 2: a9a2c7a7 ($9.65 in chips)
Seat 3: 5a60af3d ($18.15 in chips)
Seat 4: 8a570737 ($8.86 in chips)
Seat 5: aac8fa10 ($10.43 in chips)
Seat 6: 1b682c07 ($10.26 in chips)
a9a2c7a7: posts small blind $0.05
5a60af3d: posts big blind $0.1
*** HOLE CARDS ***
Dealt to Hero [8d Qh]
Dealt to a9a2c7a7 
Dealt to 5a60af3d 
Dealt to 8a570737 
Dealt to aac8fa10 
Dealt to 1b682c07 
8a570737: folds
aac8fa10: folds
1b682c07: folds
Hero: folds
a9a2c7a7: folds
Uncalled bet ($0.05) returned to 5a60af3d
*** SHOWDOWN ***
5a60af3d collected $0.1 from pot
*** SUMMARY ***
Total pot $0.1 | Rake $0 | Jackpot $0 | Bingo $0 | Fortune $0 | Tax $0
Seat 1: Hero (button) folded before Flop (didn't bet)
Seat 2: a9a2c7a7 (small blind) folded before Flop
Seat 3: 5a60af3d (big blind) collected ($0.1)
Seat 4: 8a570737 folded before Flop (didn't bet)
Seat 5: aac8fa10 folded before Flop (didn't bet)
Seat 6: 1b682c07 folded before Flop (didn't bet)


Poker Hand #RC2771836426: Hold'em No Limit ($0.05/$0.1) - 2024/08/04 11:13:20
Table 'RushAndCash20811686' 6-max Seat #1 is the button
Seat 1: b3cb985 ($14.39 in chips)
Seat 2: Hero ($31.84 in chips)
Seat 3: 5eb797ca ($10 in chips)
Seat 4: 76577d8b ($24.59 in chips)
Seat 5: 24c4b23f ($22.73 in chips)
Seat 6: 1da3eeec ($10 in chips)
Hero: posts small blind $0.05
5eb797ca: posts big blind $0.1
*** HOLE CARDS ***
Dealt to b3cb985 
Dealt to Hero [Qh 8s]
Dealt to 5eb797ca 
Dealt to 76577d8b 
Dealt to 24c4b23f 
Dealt to 1da3eeec 
76577d8b: folds
24c4b23f: folds
1da3eeec: calls $0.1
b3cb985: folds
Hero: folds
5eb797ca: checks
*** FLOP *** [4c 5d 2s]
5eb797ca: checks
1da3eeec: bets $0.1
5eb797ca: folds
Uncalled bet ($0.1) returned to 1da3eeec
*** SHOWDOWN ***
1da3eeec collected $0.24 from pot
*** SUMMARY ***
Total pot $0.25 | Rake $0.01 | Jackpot $0 | Bingo $0 | Fortune $0 | Tax $0
Board [4c 5d 2s]
Seat 1: b3cb985 (button) folded before Flop (didn't bet)
Seat 2: Hero (small blind) folded before Flop
Seat 3: 5eb797ca (big blind) folded on the Flop
Seat 4: 76577d8b folded before Flop (didn't bet)
Seat 5: 24c4b23f folded before Flop (didn't bet)
Seat 6: 1da3eeec won ($0.24)


Poker Hand #RC2771836390: Hold'em No Limit ($0.05/$0.1) - 2024/08/04 11:13:15
Table 'RushAndCash20811650' 6-max Seat #1 is the button
Seat 1: 48bc157a ($10.2 in chips)
Seat 2: 27c79a21 ($13.5 in chips)
Seat 3: Hero ($31.94 in chips)
Seat 4: 2eb05e74 ($10.09 in chips)
Seat 5: 658a450b ($11.8 in chips)
Seat 6: fa599f7d ($11.36 in chips)
27c79a21: posts small blind $0.05
Hero: posts big blind $0.1
*** HOLE CARDS ***
Dealt to 48bc157a 
Dealt to 27c79a21 
Dealt to Hero [3c Qh]
Dealt to 2eb05e74 
Dealt to 658a450b 
Dealt to fa599f7d 
2eb05e74: folds
658a450b: folds
fa599f7d: folds
48bc157a: folds
27c79a21: folds
Uncalled bet ($0.05) returned to Hero
*** SHOWDOWN ***
Hero collected $0.1 from pot
*** SUMMARY ***
Total pot $0.1 | Rake $0 | Jackpot $0 | Bingo $0 | Fortune $0 | Tax $0
Seat 1: 48bc157a (button) folded before Flop (didn't bet)
Seat 2: 27c79a21 (small blind) folded before Flop
Seat 3: Hero (big blind) collected ($0.1)
Seat 4: 2eb05e74 folded before Flop (didn't bet)
Seat 5: 658a450b folded before Flop (didn't bet)
Seat 6: fa599f7d folded before Flop (didn't bet)


Poker Hand #RC2771836342: Hold'em No Limit ($0.05/$0.1) - 2024/08/04 11:13:08
Table 'RushAndCash20811602' 6-max Seat #1 is the button
Seat 1: Hero ($31.94 in chips)
Seat 2: bbe5b1db ($14.55 in chips)
Seat 3: b2f6194b ($13.48 in chips)
Seat 4: d0697e32 ($13.95 in chips)
Seat 5: 7586706 ($4 in chips)
Seat 6: 56a3f58b ($18.49 in chips)
bbe5b1db: posts small blind $0.05
b2f6194b: posts big blind $0.1
*** HOLE CARDS ***
Dealt to Hero [3c 4d]
Dealt to bbe5b1db 
Dealt to b2f6194b 
Dealt to d0697e32 
Dealt to 7586706 
Dealt to 56a3f58b 
d0697e32: folds
7586706: folds
56a3f58b: folds
Hero: folds
bbe5b1db: raises $0.2 to $0.3
b2f6194b: calls $0.2
*** FLOP *** [6d 8h Qd]
bbe5b1db: bets $0.3
b2f6194b: calls $0.3
*** TURN *** [6d 8h Qd] [5s]
bbe5b1db: bets $0.9
b2f6194b: folds
Uncalled bet ($0.9) returned to bbe5b1db
*** SHOWDOWN ***
bbe5b1db collected $1.14 from pot
*** SUMMARY ***
Total pot $1.2 | Rake $0.06 | Jackpot $0 | Bingo $0 | Fortune $0 | Tax $0
Board [6d 8h Qd 5s]
Seat 1: Hero (button) folded before Flop (didn't bet)
Seat 2: bbe5b1db (small blind) won ($1.14)
Seat 3: b2f6194b (big blind) folded on the Turn
Seat 4: d0697e32 folded before Flop (didn't bet)
Seat 5: 7586706 folded before Flop (didn't bet)
Seat 6: 56a3f58b folded before Flop (didn't bet)


Poker Hand #RC2771836318: Hold'em No Limit ($0.05/$0.1) - 2024/08/04 11:13:05
Table 'RushAndCash20811578' 6-max Seat #1 is the button
Seat 1: c7bec670 ($10 in chips)
Seat 2: 9e88a611 ($20.15 in chips)
Seat 3: 48bc157a ($10.3 in chips)
Seat 4: Hero ($31.94 in chips)
Seat 5: 24c4b23f ($22.78 in chips)
Seat 6: cad0ab4e ($21.77 in chips)
9e88a611: posts small blind $0.05
48bc157a: posts big blind $0.1
*** HOLE CARDS ***
Dealt to c7bec670 
Dealt to 9e88a611 
Dealt to 48bc157a 
Dealt to Hero [Kc 3h]
Dealt to 24c4b23f 
Dealt to cad0ab4e 
Hero: folds
24c4b23f: folds
cad0ab4e: folds
c7bec670: raises $0.15 to $0.25
9e88a611: folds
48bc157a: folds
Uncalled bet ($0.15) returned to c7bec670
*** SHOWDOWN ***
c7bec670 collected $0.25 from pot
*** SUMMARY ***
Total pot $0.25 | Rake $0 | Jackpot $0 | Bingo $0 | Fortune $0 | Tax $0
Seat 1: c7bec670 (button) collected ($0.25)
Seat 2: 9e88a611 (small blind) folded before Flop
Seat 3: 48bc157a (big blind) folded before Flop
Seat 4: Hero folded before Flop (didn't bet)
Seat 5: 24c4b23f folded before Flop (didn't bet)
Seat 6: cad0ab4e folded before Flop (didn't bet)


Poker Hand #RC2771836293: Hold'em No Limit ($0.05/$0.1) - 2024/08/04 11:13:01
Table 'RushAndCash20811553' 6-max Seat #1 is the button
Seat 1: 1245ac17 ($10.75 in chips)
Seat 2: 11f6010d ($10 in chips)
Seat 3: bbe5b1db ($14.65 in chips)
Seat 4: 6bec3151 ($10 in chips)
Seat 5: bcec1907 ($10.15 in chips)
Seat 6: Hero ($31.94 in chips)
11f6010d: posts small blind $0.05
bbe5b1db: posts big blind $0.1
*** HOLE CARDS ***
Dealt to 1245ac17 
Dealt to 11f6010d 
Dealt to bbe5b1db 
Dealt to 6bec3151 
Dealt to bcec1907 
Dealt to Hero [9d 4s]
6bec3151: raises $0.1 to $0.2
bcec1907: folds
Hero: folds
1245ac17: folds
11f6010d: folds
bbe5b1db: folds
Uncalled bet ($0.1) returned to 6bec3151
*** SHOWDOWN ***
6bec3151 collected $0.25 from pot
*** SUMMARY ***
Total pot $0.25 | Rake $0 | Jackpot $0 | Bingo $0 | Fortune $0 | Tax $0
Seat 1: 1245ac17 (button) folded before Flop (didn't bet)
Seat 2: 11f6010d (small blind) folded before Flop
Seat 3: bbe5b1db (big blind) folded before Flop
Seat 4: 6bec3151 collected ($0.25)
Seat 5: bcec1907 folded before Flop (didn't bet)
Seat 6: Hero folded before Flop (didn't bet)


Poker Hand #RC2771836161: Hold'em No Limit ($0.05/$0.1) - 2024/08/04 11:12:43
Table 'RushAndCash20811421' 6-max Seat #1 is the button
Seat 1: Hero ($31.94 in chips)
Seat 2: c7bec670 ($10.05 in chips)
Seat 3: d3616756 ($10.59 in chips)
Seat 4: 3968ffd4 ($10.64 in chips)
Seat 5: d867642e ($19.11 in chips)
Seat 6: 993cf2a5 ($13.6 in chips)
c7bec670: posts small blind $0.05
d3616756: posts big blind $0.1
*** HOLE CARDS ***
Dealt to Hero [Qs Ac]
Dealt to c7bec670 
Dealt to d3616756 
Dealt to 3968ffd4 
Dealt to d867642e 
Dealt to 993cf2a5 
3968ffd4: raises $0.1 to $0.2
d867642e: calls $0.2
993cf2a5: folds
Hero: folds
c7bec670: folds
d3616756: folds
*** FLOP *** [5s 2s Jd]
3968ffd4: checks
d867642e: bets $0.19
3968ffd4: calls $0.19
*** TURN *** [5s 2s Jd] [3c]
3968ffd4: checks
d867642e: checks
*** RIVER *** [5s 2s Jd 3c] [6s]
3968ffd4: bets $0.3
d867642e: raises $0.51 to $0.81
3968ffd4: folds
Uncalled bet ($0.51) returned to d867642e
*** SHOWDOWN ***
d867642e collected $1.46 from pot
*** SUMMARY ***
Total pot $1.53 | Rake $0.07 | Jackpot $0 | Bingo $0 | Fortune $0 | Tax $0
Board [5s 2s Jd 3c 6s]
Seat 1: Hero (button) folded before Flop (didn't bet)
Seat 2: c7bec670 (small blind) folded before Flop
Seat 3: d3616756 (big blind) folded before Flop
Seat 4: 3968ffd4 folded on the River
Seat 5: d867642e won ($1.46)
Seat 6: 993cf2a5 folded before Flop (didn't bet)


Poker Hand #RC2771836130: Hold'em No Limit ($0.05/$0.1) - 2024/08/04 11:12:39
Table 'RushAndCash20811390' 6-max Seat #1 is the button
Seat 1: 2edd6345 ($10 in chips)
Seat 2: 9d5456b4 ($22.01 in chips)
Seat 3: b3cb985 ($14.54 in chips)
Seat 4: df0aa037 ($12.57 in chips)
Seat 5: 57ad6eae ($10 in chips)
Seat 6: Hero ($31.94 in chips)
9d5456b4: posts small blind $0.05
b3cb985: posts big blind $0.1
*** HOLE CARDS ***
Dealt to 2edd6345 
Dealt to 9d5456b4 
Dealt to b3cb985 
Dealt to df0aa037 
Dealt to 57ad6eae 
Dealt to Hero [2h 6s]
df0aa037: folds
57ad6eae: raises $0.1 to $0.2
Hero: folds
2edd6345: raises $0.6 to $0.8
9d5456b4: folds
b3cb985: folds
57ad6eae: raises $1.32 to $2.12
2edd6345: folds
Uncalled bet ($1.32) returned to 57ad6eae
*** SHOWDOWN ***
57ad6eae collected $1.67 from pot
*** SUMMARY ***
Total pot $1.75 | Rake $0.08 | Jackpot $0 | Bingo $0 | Fortune $0 | Tax $0
Seat 1: 2edd6345 (button) folded before Flop
Seat 2: 9d5456b4 (small blind) folded before Flop
Seat 3: b3cb985 (big blind) folded before Flop
Seat 4: df0aa037 folded before Flop (didn't bet)
Seat 5: 57ad6eae collected ($1.67)
Seat 6: Hero folded before Flop (didn't bet)


Poker Hand #RC2771836069: Hold'em No Limit ($0.05/$0.1) - 2024/08/04 11:12:32
Table 'RushAndCash20811329' 6-max Seat #1 is the button
Seat 1: df0aa037 ($12.57 in chips)
Seat 2: Hero ($31.99 in chips)
Seat 3: 342fbb5b ($7.75 in chips)
Seat 4: 2c4405a7 ($22.67 in chips)
Seat 5: 566f0499 ($10.65 in chips)
Seat 6: d47986ad ($7.01 in chips)
Hero: posts small blind $0.05
342fbb5b: posts big blind $0.1
*** HOLE CARDS ***
Dealt to df0aa037 
Dealt to Hero [6h Qd]
Dealt to 342fbb5b 
Dealt to 2c4405a7 
Dealt to 566f0499 
Dealt to d47986ad 
2c4405a7: folds
566f0499: folds
d47986ad: raises $0.1 to $0.2
df0aa037: folds
Hero: folds
342fbb5b: calls $0.1
*** FLOP *** [Kh Js 7h]
342fbb5b: checks
d47986ad: bets $0.15
342fbb5b: calls $0.15
*** TURN *** [Kh Js 7h] [2d]
342fbb5b: checks
d47986ad: bets $0.25
342fbb5b: folds
Uncalled bet ($0.25) returned to d47986ad
*** SHOWDOWN ***
d47986ad collected $0.72 from pot
*** SUMMARY ***
Total pot $0.75 | Rake $0.03 | Jackpot $0 | Bingo $0 | Fortune $0 | Tax $0
Board [Kh Js 7h 2d]
Seat 1: df0aa037 (button) folded before Flop (didn't bet)
Seat 2: Hero (small blind) folded before Flop
Seat 3: 342fbb5b (big blind) folded on the Turn
Seat 4: 2c4405a7 folded before Flop (didn't bet)
Seat 5: 566f0499 folded before Flop (didn't bet)
Seat 6: d47986ad won ($0.72)


Poker Hand #RC2771836022: Hold'em No Limit ($0.05/$0.1) - 2024/08/04 11:12:26
Table 'RushAndCash20811282' 6-max Seat #1 is the button
Seat 1: 5ab06e64 ($16.95 in chips)
Seat 2: 47262397 ($11.42 in chips)
Seat 3: 3234b8e9 ($21 in chips)
Seat 4: Hero ($31.99 in chips)
Seat 5: 9b29594d ($11.47 in chips)
Seat 6: 3f29b823 ($16.52 in chips)
47262397: posts small blind $0.05
3234b8e9: posts big blind $0.1
*** HOLE CARDS ***
Dealt to 5ab06e64 
Dealt to 47262397 
Dealt to 3234b8e9 
Dealt to Hero [6d Jh]
Dealt to 9b29594d 
Dealt to 3f29b823 
Hero: folds
9b29594d: folds
3f29b823: folds
5ab06e64: raises $0.1 to $0.2
47262397: folds
3234b8e9: raises $0.8 to $1
5ab06e64: folds
Uncalled bet ($0.8) returned to 3234b8e9
*** SHOWDOWN ***
3234b8e9 collected $0.43 from pot
*** SUMMARY ***
Total pot $0.45 | Rake $0.02 | Jackpot $0 | Bingo $0 | Fortune $0 | Tax $0
Seat 1: 5ab06e64 (button) folded before Flop
Seat 2: 47262397 (small blind) folded before Flop
Seat 3: 3234b8e9 (big blind) collected ($0.43)
Seat 4: Hero folded before Flop (didn't bet)
Seat 5: 9b29594d folded before Flop (didn't bet)
Seat 6: 3f29b823 folded before Flop (didn't bet)


Poker Hand #RC2771835989: Hold'em No Limit ($0.05/$0.1) - 2024/08/04 11:12:22
Table 'RushAndCash20811249' 6-max Seat #1 is the button
Seat 1: a721eb8 ($32.62 in chips)
Seat 2: 22888ca4 ($11.01 in chips)
Seat 3: 32b76c01 ($10.56 in chips)
Seat 4: 5b166896 ($14.67 in chips)
Seat 5: Hero ($31.99 in chips)
Seat 6: 7586706 ($4 in chips)
22888ca4: posts small blind $0.05
32b76c01: posts big blind $0.1
*** HOLE CARDS ***
Dealt to a721eb8 
Dealt to 22888ca4 
Dealt to 32b76c01 
Dealt to 5b166896 
Dealt to Hero [4c 2c]
Dealt to 7586706 
5b166896: folds
Hero: folds
7586706: folds
a721eb8: folds
22888ca4: folds
Uncalled bet ($0.05) returned to 32b76c01
*** SHOWDOWN ***
32b76c01 collected $0.1 from pot
*** SUMMARY ***
Total pot $0.1 | Rake $0 | Jackpot $0 | Bingo $0 | Fortune $0 | Tax $0
Seat 1: a721eb8 (button) folded before Flop (didn't bet)
Seat 2: 22888ca4 (small blind) folded before Flop
Seat 3: 32b76c01 (big blind) collected ($0.1)
Seat 4: 5b166896 folded before Flop (didn't bet)
Seat 5: Hero folded before Flop (didn't bet)
Seat 6: 7586706 folded before Flop (didn't bet)


Poker Hand #RC2771835668: Hold'em No Limit ($0.05/$0.1) - 2024/08/04 11:11:38
Table 'RushAndCash20810928' 6-max Seat #1 is the button
Seat 1: 98bcc404 ($10 in chips)
Seat 2: 4f10591d ($10 in chips)
Seat 3: Hero ($31.76 in chips)
Seat 4: 1b682c07 ($10.56 in chips)
Seat 5: ad428624 ($10.1 in chips)
Seat 6: c11839aa ($10 in chips)
4f10591d: posts small blind $0.05
Hero: posts big blind $0.1
*** HOLE CARDS ***
Dealt to 98bcc404 
Dealt to 4f10591d 
Dealt to Hero [Tc Qh]
Dealt to 1b682c07 
Dealt to ad428624 
Dealt to c11839aa 
1b682c07: folds
ad428624: folds
c11839aa: raises $0.1 to $0.2
98bcc404: folds
4f10591d: folds
Hero: calls $0.1
*** FLOP *** [7d 4d 5h]
Hero: checks
c11839aa: checks
*** TURN *** [7d 4d 5h] [2c]
Hero: checks
c11839aa: checks
*** RIVER *** [7d 4d 5h 2c] [4s]
Hero: bets $0.3
c11839aa: folds
Uncalled bet ($0.3) returned to Hero
*** SHOWDOWN ***
Hero collected $0.43 from pot
*** SUMMARY ***
Total pot $0.45 | Rake $0.02 | Jackpot $0 | Bingo $0 | Fortune $0 | Tax $0
Board [7d 4d 5h 2c 4s]
Seat 1: 98bcc404 (button) folded before Flop (didn't bet)
Seat 2: 4f10591d (small blind) folded before Flop
Seat 3: Hero (big blind) won ($0.43)
Seat 4: 1b682c07 folded before Flop (didn't bet)
Seat 5: ad428624 folded before Flop (didn't bet)
Seat 6: c11839aa folded on the River


Poker Hand #RC2771835646: Hold'em No Limit ($0.05/$0.1) - 2024/08/04 11:11:34
Table 'RushAndCash20810906' 6-max Seat #1 is the button
Seat 1: b4be0f48 ($12.03 in chips)
Seat 2: 6ac0b2bf ($11.15 in chips)
Seat 3: 3fbb25ec ($10 in chips)
Seat 4: 4504f10b ($10.62 in chips)
Seat 5: 9dd5e2d2 ($10 in chips)
Seat 6: Hero ($31.76 in chips)
6ac0b2bf: posts small blind $0.05
3fbb25ec: posts big blind $0.1
*** HOLE CARDS ***
Dealt to b4be0f48 
Dealt to 6ac0b2bf 
Dealt to 3fbb25ec 
Dealt to 4504f10b 
Dealt to 9dd5e2d2 
Dealt to Hero [5h Kc]
4504f10b: folds
9dd5e2d2: folds
Hero: folds
b4be0f48: folds
6ac0b2bf: raises $0.15 to $0.25
3fbb25ec: calls $0.15
*** FLOP *** [6d 4s 4h]
6ac0b2bf: checks
3fbb25ec: bets $0.38
6ac0b2bf: folds
Uncalled bet ($0.38) returned to 3fbb25ec
*** SHOWDOWN ***
3fbb25ec collected $0.48 from pot
*** SUMMARY ***
Total pot $0.5 | Rake $0.02 | Jackpot $0 | Bingo $0 | Fortune $0 | Tax $0
Board [6d 4s 4h]
Seat 1: b4be0f48 (button) folded before Flop (didn't bet)
Seat 2: 6ac0b2bf (small blind) folded on the Flop
Seat 3: 3fbb25ec (big blind) won ($0.48)
Seat 4: 4504f10b folded before Flop (didn't bet)
Seat 5: 9dd5e2d2 folded before Flop (didn't bet)
Seat 6: Hero folded before Flop (didn't bet)


Poker Hand #RC2771835513: Hold'em No Limit ($0.05/$0.1) - 2024/08/04 11:11:16
Table 'RushAndCash20810773' 6-max Seat #1 is the button
Seat 1: 1504d1d ($11.17 in chips)
Seat 2: Hero ($31.66 in chips)
Seat 3: 8cf8a919 ($11.46 in chips)
Seat 4: ab48ccb1 ($10.17 in chips)
Seat 5: 47b375d ($10.47 in chips)
Seat 6: 95b08de9 ($12.03 in chips)
Hero: posts small blind $0.05
8cf8a919: posts big blind $0.1
*** HOLE CARDS ***
Dealt to 1504d1d 
Dealt to Hero [5s Ks]
Dealt to 8cf8a919 
Dealt to ab48ccb1 
Dealt to 47b375d 
Dealt to 95b08de9 
ab48ccb1: folds
47b375d: folds
95b08de9: folds
1504d1d: folds
Hero: raises $0.2 to $0.3
8cf8a919: folds
Uncalled bet ($0.2) returned to Hero
*** SHOWDOWN ***
Hero collected $0.2 from pot
*** SUMMARY ***
Total pot $0.2 | Rake $0 | Jackpot $0 | Bingo $0 | Fortune $0 | Tax $0
Seat 1: 1504d1d (button) folded before Flop (didn't bet)
Seat 2: Hero (small blind) collected ($0.2)
Seat 3: 8cf8a919 (big blind) folded before Flop
Seat 4: ab48ccb1 folded before Flop (didn't bet)
Seat 5: 47b375d folded before Flop (didn't bet)
Seat 6: 95b08de9 folded before Flop (didn't bet)


Poker Hand #RC2771835484: Hold'em No Limit ($0.05/$0.1) - 2024/08/04 11:11:12
Table 'RushAndCash20810744' 6-max Seat #1 is the button
Seat 1: Hero ($31.66 in chips)
Seat 2: dc4ffc27 ($12.81 in chips)
Seat 3: 84ced393 ($10.44 in chips)
Seat 4: e956062a ($4.05 in chips)
Seat 5: b9c76347 ($15.83 in chips)
Seat 6: c80b913a ($13.67 in chips)
dc4ffc27: posts small blind $0.05
84ced393: posts big blind $0.1
*** HOLE CARDS ***
Dealt to Hero [7h Js]
Dealt to dc4ffc27 
Dealt to 84ced393 
Dealt to e956062a 
Dealt to b9c76347 
Dealt to c80b913a 
e956062a: folds
b9c76347: folds
c80b913a: folds
Hero: folds
dc4ffc27: folds
Uncalled bet ($0.05) returned to 84ced393
*** SHOWDOWN ***
84ced393 collected $0.1 from pot
*** SUMMARY ***
Total pot $0.1 | Rake $0 | Jackpot $0 | Bingo $0 | Fortune $0 | Tax $0
Seat 1: Hero (button) folded before Flop (didn't bet)
Seat 2: dc4ffc27 (small blind) folded before Flop
Seat 3: 84ced393 (big blind) collected ($0.1)
Seat 4: e956062a folded before Flop (didn't bet)
Seat 5: b9c76347 folded before Flop (didn't bet)
Seat 6: c80b913a folded before Flop (didn't bet)


Poker Hand #RC2771835460: Hold'em No Limit ($0.05/$0.1) - 2024/08/04 11:11:09
Table 'RushAndCash20810720' 6-max Seat #1 is the button
Seat 1: 6fe61f4 ($25.19 in chips)
Seat 2: 18ddc90b ($19.47 in chips)
Seat 3: Hero ($31.76 in chips)
Seat 4: d3616756 ($10 in chips)
Seat 5: c7502fa9 ($10.43 in chips)
Seat 6: e326c2f9 ($23.28 in chips)
18ddc90b: posts small blind $0.05
Hero: posts big blind $0.1
*** HOLE CARDS ***
Dealt to 6fe61f4 
Dealt to 18ddc90b 
Dealt to Hero [3s 8d]
Dealt to d3616756 
Dealt to c7502fa9 
Dealt to e326c2f9 
d3616756: folds
c7502fa9: raises $0.1 to $0.2
e326c2f9: raises $0.55 to $0.75
6fe61f4: calls $0.75
18ddc90b: folds
Hero: folds
c7502fa9: folds
*** FLOP *** [9d Ts 2h]
e326c2f9: checks
6fe61f4: checks
*** TURN *** [9d Ts 2h] [3h]
e326c2f9: checks
6fe61f4: checks
*** RIVER *** [9d Ts 2h 3h] [2c]
e326c2f9: checks
6fe61f4: checks
e326c2f9: shows [Kh Ad] (Pair of Twos)
6fe61f4: shows [Kd As] (Pair of Twos)
*** SHOWDOWN ***
e326c2f9 collected $0.89 from pot
6fe61f4 collected $0.88 from pot
*** SUMMARY ***
Total pot $1.85 | Rake $0.08 | Jackpot $0 | Bingo $0 | Fortune $0 | Tax $0
Board [9d Ts 2h 3h 2c]
Seat 1: 6fe61f4 (button) showed [Kd As] and won ($0.88) with Pair of Twos
Seat 2: 18ddc90b (small blind) folded before Flop
Seat 3: Hero (big blind) folded before Flop
Seat 4: d3616756 folded before Flop (didn't bet)
Seat 5: c7502fa9 folded before Flop
Seat 6: e326c2f9 showed [Kh Ad] and won ($0.89) with Pair of Twos


Poker Hand #RC2771835426: Hold'em No Limit ($0.05/$0.1) - 2024/08/04 11:11:05
Table 'RushAndCash20810686' 6-max Seat #1 is the button
Seat 1: 2d348a1a ($10.95 in chips)
Seat 2: 57ad6eae ($10.6 in chips)
Seat 3: 9c963c83 ($21.07 in chips)
Seat 4: 4dcb368 ($12.08 in chips)
Seat 5: 3bf7d120 ($10 in chips)
Seat 6: Hero ($31.76 in chips)
57ad6eae: posts small blind $0.05
9c963c83: posts big blind $0.1
*** HOLE CARDS ***
Dealt to 2d348a1a 
Dealt to 57ad6eae 
Dealt to 9c963c83 
Dealt to 4dcb368 
Dealt to 3bf7d120 
Dealt to Hero [5c 8c]
4dcb368: raises $0.2 to $0.3
3bf7d120: folds
Hero: folds
2d348a1a: folds
57ad6eae: folds
9c963c83: calls $0.2
*** FLOP *** [4s 3c Js]
9c963c83: checks
4dcb368: checks
*** TURN *** [4s 3c Js] [3h]
9c963c83: bets $0.33
4dcb368: calls $0.33
*** RIVER *** [4s 3c Js 3h] [6d]
9c963c83: checks
4dcb368: checks
9c963c83: shows [Jh Kd] (Pair of Jacks and Pair of Treys)
4dcb368: shows [Ac 6h] (Pair of Sixes and Pair of Treys)
*** SHOWDOWN ***
9c963c83 collected $1.25 from pot
*** SUMMARY ***
Total pot $1.31 | Rake $0.06 | Jackpot $0 | Bingo $0 | Fortune $0 | Tax $0
Board [4s 3c Js 3h 6d]
Seat 1: 2d348a1a (button) folded before Flop (didn't bet)
Seat 2: 57ad6eae (small blind) folded before Flop
Seat 3: 9c963c83 (big blind) showed [Jh Kd] and won ($1.25) with Pair of Jacks and Pair of Treys
Seat 4: 4dcb368 showed [Ac 6h] and lost with Pair of Sixes and Pair of Treys
Seat 5: 3bf7d120 folded before Flop (didn't bet)
Seat 6: Hero folded before Flop (didn't bet)


Poker Hand #RC2771835386: Hold'em No Limit ($0.05/$0.1) - 2024/08/04 11:11:00
Table 'RushAndCash20810646' 6-max Seat #1 is the button
Seat 1: Hero ($31.76 in chips)
Seat 2: 29b9f6a8 ($10.04 in chips)
Seat 3: 5c1fc04a ($15.18 in chips)
Seat 4: f85d7db2 ($13.97 in chips)
Seat 5: 54e832be ($10.57 in chips)
Seat 6: d7bf0e55 ($12.77 in chips)
29b9f6a8: posts small blind $0.05
5c1fc04a: posts big blind $0.1
*** HOLE CARDS ***
Dealt to Hero [7h 6h]
Dealt to 29b9f6a8 
Dealt to 5c1fc04a 
Dealt to f85d7db2 
Dealt to 54e832be 
Dealt to d7bf0e55 
f85d7db2: folds
54e832be: folds
d7bf0e55: raises $0.1 to $0.2
Hero: folds
29b9f6a8: folds
5c1fc04a: folds
Uncalled bet ($0.1) returned to d7bf0e55
*** SHOWDOWN ***
d7bf0e55 collected $0.25 from pot
*** SUMMARY ***
Total pot $0.25 | Rake $0 | Jackpot $0 | Bingo $0 | Fortune $0 | Tax $0
Seat 1: Hero (button) folded before Flop (didn't bet)
Seat 2: 29b9f6a8 (small blind) folded before Flop
Seat 3: 5c1fc04a (big blind) folded before Flop
Seat 4: f85d7db2 folded before Flop (didn't bet)
Seat 5: 54e832be folded before Flop (didn't bet)
Seat 6: d7bf0e55 collected ($0.25)


Poker Hand #RC2771835274: Hold'em No Limit ($0.05/$0.1) - 2024/08/04 11:10:45
Table 'RushAndCash20810534' 6-max Seat #1 is the button
Seat 1: f9dd4b13 ($10 in chips)
Seat 2: db87dc85 ($12.4 in chips)
Seat 3: f6e29945 ($13 in chips)
Seat 4: a1a3c459 ($16.17 in chips)
Seat 5: Hero ($31.76 in chips)
Seat 6: cba97507 ($12.15 in chips)
db87dc85: posts small blind $0.05
f6e29945: posts big blind $0.1
*** HOLE CARDS ***
Dealt to f9dd4b13 
Dealt to db87dc85 
Dealt to f6e29945 
Dealt to a1a3c459 
Dealt to Hero [8h Kh]
Dealt to cba97507 
a1a3c459: folds
Hero: folds
cba97507: folds
f9dd4b13: raises $0.2 to $0.3
db87dc85: raises $0.53 to $0.83
f6e29945: folds
f9dd4b13: raises $1.3 to $2.13
db87dc85: folds
Uncalled bet ($1.3) returned to f9dd4b13
*** SHOWDOWN ***
f9dd4b13 collected $1.68 from pot
*** SUMMARY ***
Total pot $1.76 | Rake $0.08 | Jackpot $0 | Bingo $0 | Fortune $0 | Tax $0
Seat 1: f9dd4b13 (button) collected ($1.68)
Seat 2: db87dc85 (small blind) folded before Flop
Seat 3: f6e29945 (big blind) folded before Flop
Seat 4: a1a3c459 folded before Flop (didn't bet)
Seat 5: Hero folded before Flop (didn't bet)
Seat 6: cba97507 folded before Flop (didn't bet)


Poker Hand #RC2771834906: Hold'em No Limit ($0.05/$0.1) - 2024/08/04 11:09:55
Table 'RushAndCash20810166' 6-max Seat #1 is the button
Seat 1: 9827083f ($11.69 in chips)
Seat 2: 4603f18d ($11.85 in chips)
Seat 3: 344bd79e ($10.8 in chips)
Seat 4: 5d5e7e95 ($10.15 in chips)
Seat 5: Hero ($31.53 in chips)
Seat 6: 9aeb337a ($19.36 in chips)
4603f18d: posts small blind $0.05
344bd79e: posts big blind $0.1
*** HOLE CARDS ***
Dealt to 9827083f 
Dealt to 4603f18d 
Dealt to 344bd79e 
Dealt to 5d5e7e95 
Dealt to Hero [Ac Kc]
Dealt to 9aeb337a 
5d5e7e95: folds
Hero: raises $0.1 to $0.2
9aeb337a: folds
9827083f: folds
4603f18d: folds
344bd79e: calls $0.1
*** FLOP *** [2s Td Ks]
344bd79e: checks
Hero: bets $0.15
344bd79e: folds
Uncalled bet ($0.15) returned to Hero
*** SHOWDOWN ***
Hero collected $0.43 from pot
*** SUMMARY ***
Total pot $0.45 | Rake $0.02 | Jackpot $0 | Bingo $0 | Fortune $0 | Tax $0
Board [2s Td Ks]
Seat 1: 9827083f (button) folded before Flop (didn't bet)
Seat 2: 4603f18d (small blind) folded before Flop
Seat 3: 344bd79e (big blind) folded on the Flop
Seat 4: 5d5e7e95 folded before Flop (didn't bet)
Seat 5: Hero won ($0.43)
Seat 6: 9aeb337a folded before Flop (didn't bet)


Poker Hand #RC2771834882: Hold'em No Limit ($0.05/$0.1) - 2024/08/04 11:09:52
Table 'RushAndCash20810142' 6-max Seat #1 is the button
Seat 1: 7bedf974 ($10.57 in chips)
Seat 2: ec81b7e ($13.78 in chips)
Seat 3: Hero ($31.63 in chips)
Seat 4: bbe5b1db ($9.35 in chips)
Seat 5: 54e832be ($10 in chips)
Seat 6: 5db9c6b8 ($10.15 in chips)
ec81b7e: posts small blind $0.05
Hero: posts big blind $0.1
*** HOLE CARDS ***
Dealt to 7bedf974 
Dealt to ec81b7e 
Dealt to Hero [7s 2c]
Dealt to bbe5b1db 
Dealt to 54e832be 
Dealt to 5db9c6b8 
bbe5b1db: raises $0.2 to $0.3
54e832be: raises $0.57 to $0.87
5db9c6b8: folds
7bedf974: folds
ec81b7e: folds
Hero: folds
bbe5b1db: folds
Uncalled bet ($0.57) returned to 54e832be
*** SHOWDOWN ***
54e832be collected $0.72 from pot
*** SUMMARY ***
Total pot $0.75 | Rake $0.03 | Jackpot $0 | Bingo $0 | Fortune $0 | Tax $0
Seat 1: 7bedf974 (button) folded before Flop (didn't bet)
Seat 2: ec81b7e (small blind) folded before Flop
Seat 3: Hero (big blind) folded before Flop
Seat 4: bbe5b1db folded before Flop
Seat 5: 54e832be collected ($0.72)
Seat 6: 5db9c6b8 folded before Flop (didn't bet)


Poker Hand #RC2771834769: Hold'em No Limit ($0.05/$0.1) - 2024/08/04 11:09:36
Table 'RushAndCash20810029' 6-max Seat #1 is the button
Seat 1: daa20e9f ($10 in chips)
Seat 2: 29b9f6a8 ($9.82 in chips)
Seat 3: 27a3f6e4 ($10.68 in chips)
Seat 4: 483620e3 ($15.24 in chips)
Seat 5: c527a092 ($11.18 in chips)
Seat 6: Hero ($31.48 in chips)
29b9f6a8: posts small blind $0.05
27a3f6e4: posts big blind $0.1
*** HOLE CARDS ***
Dealt to daa20e9f 
Dealt to 29b9f6a8 
Dealt to 27a3f6e4 
Dealt to 483620e3 
Dealt to c527a092 
Dealt to Hero [As Jh]
483620e3: folds
c527a092: folds
Hero: raises $0.14 to $0.24
daa20e9f: folds
29b9f6a8: folds
27a3f6e4: folds
Uncalled bet ($0.14) returned to Hero
*** SHOWDOWN ***
Hero collected $0.25 from pot
*** SUMMARY ***
Total pot $0.25 | Rake $0 | Jackpot $0 | Bingo $0 | Fortune $0 | Tax $0
Seat 1: daa20e9f (button) folded before Flop (didn't bet)
Seat 2: 29b9f6a8 (small blind) folded before Flop
Seat 3: 27a3f6e4 (big blind) folded before Flop
Seat 4: 483620e3 folded before Flop (didn't bet)
Seat 5: c527a092 folded before Flop (didn't bet)
Seat 6: Hero collected ($0.25)


Poker Hand #RC2771794653: Hold'em No Limit ($0.05/$0.1) - 2024/08/04 11:09:21
Table 'RushAndCash20809913' 6-max Seat #1 is the button
Seat 1: Hero ($31.33 in chips)
Seat 2: 5f18c0cc ($19 in chips)
Seat 3: 9b7a4cfc ($12.21 in chips)
Seat 4: c21f392c ($10.71 in chips)
Seat 5: 8cf8a919 ($11.48 in chips)
Seat 6: 49bff733 ($16.67 in chips)
5f18c0cc: posts small blind $0.05
9b7a4cfc: posts big blind $0.1
*** HOLE CARDS ***
Dealt to Hero [Ad Qh]
Dealt to 5f18c0cc 
Dealt to 9b7a4cfc 
Dealt to c21f392c 
Dealt to 8cf8a919 
Dealt to 49bff733 
c21f392c: folds
8cf8a919: folds
49bff733: folds
Hero: raises $0.14 to $0.24
5f18c0cc: folds
9b7a4cfc: folds
Uncalled bet ($0.14) returned to Hero
*** SHOWDOWN ***
Hero collected $0.25 from pot
*** SUMMARY ***
Total pot $0.25 | Rake $0 | Jackpot $0 | Bingo $0 | Fortune $0 | Tax $0
Seat 1: Hero (button) collected ($0.25)
Seat 2: 5f18c0cc (small blind) folded before Flop
Seat 3: 9b7a4cfc (big blind) folded before Flop
Seat 4: c21f392c folded before Flop (didn't bet)
Seat 5: 8cf8a919 folded before Flop (didn't bet)
Seat 6: 49bff733 folded before Flop (didn't bet)


Poker Hand #RC2771794570: Hold'em No Limit ($0.05/$0.1) - 2024/08/04 11:09:10
Table 'RushAndCash20809830' 6-max Seat #1 is the button
Seat 1: 6fe61f4 ($25.54 in chips)
Seat 2: Hero ($31.38 in chips)
Seat 3: ea536622 ($28.74 in chips)
Seat 4: 2731d46 ($20.97 in chips)
Seat 5: 49ece282 ($10.85 in chips)
Seat 6: 342fbb5b ($7.17 in chips)
Hero: posts small blind $0.05
ea536622: posts big blind $0.1
*** HOLE CARDS ***
Dealt to 6fe61f4 
Dealt to Hero [5c Ah]
Dealt to ea536622 
Dealt to 2731d46 
Dealt to 49ece282 
Dealt to 342fbb5b 
2731d46: folds
49ece282: raises $0.1 to $0.2
342fbb5b: calls $0.2
6fe61f4: calls $0.2
Hero: folds
ea536622: folds
*** FLOP *** [Ad Ts Ac]
49ece282: checks
342fbb5b: checks
6fe61f4: checks
*** TURN *** [Ad Ts Ac] [7h]
49ece282: checks
342fbb5b: checks
6fe61f4: checks
*** RIVER *** [Ad Ts Ac 7h] [8c]
49ece282: bets $4
342fbb5b: folds
6fe61f4: folds
Uncalled bet ($4) returned to 49ece282
*** SHOWDOWN ***
49ece282 collected $0.72 from pot
*** SUMMARY ***
Total pot $0.75 | Rake $0.03 | Jackpot $0 | Bingo $0 | Fortune $0 | Tax $0
Board [Ad Ts Ac 7h 8c]
Seat 1: 6fe61f4 (button) folded on the River
Seat 2: Hero (small blind) folded before Flop
Seat 3: ea536622 (big blind) folded before Flop
Seat 4: 2731d46 folded before Flop (didn't bet)
Seat 5: 49ece282 won ($0.72)
Seat 6: 342fbb5b folded on the River


Poker Hand #RC2771794538: Hold'em No Limit ($0.05/$0.1) - 2024/08/04 11:09:06
Table 'RushAndCash20809798' 6-max Seat #1 is the button
Seat 1: 1b682c07 ($10.56 in chips)
Seat 2: c01bdbe3 ($23.36 in chips)
Seat 3: 541ec3b4 ($10 in chips)
Seat 4: Hero ($31.38 in chips)
Seat 5: 344bd79e ($10.25 in chips)
Seat 6: f07a4e1f ($10.35 in chips)
c01bdbe3: posts small blind $0.05
541ec3b4: posts big blind $0.1
*** HOLE CARDS ***
Dealt to 1b682c07 
Dealt to c01bdbe3 
Dealt to 541ec3b4 
Dealt to Hero [4h Tc]
Dealt to 344bd79e 
Dealt to f07a4e1f 
Hero: folds
344bd79e: folds
f07a4e1f: folds
1b682c07: folds
c01bdbe3: raises $0.12 to $0.22
541ec3b4: folds
Uncalled bet ($0.12) returned to c01bdbe3
*** SHOWDOWN ***
c01bdbe3 collected $0.2 from pot
*** SUMMARY ***
Total pot $0.2 | Rake $0 | Jackpot $0 | Bingo $0 | Fortune $0 | Tax $0
Seat 1: 1b682c07 (button) folded before Flop (didn't bet)
Seat 2: c01bdbe3 (small blind) collected ($0.2)
Seat 3: 541ec3b4 (big blind) folded before Flop
Seat 4: Hero folded before Flop (didn't bet)
Seat 5: 344bd79e folded before Flop (didn't bet)
Seat 6: f07a4e1f folded before Flop (didn't bet)


Poker Hand #RC2771794186: Hold'em No Limit ($0.05/$0.1) - 2024/08/04 11:08:19
Table 'RushAndCash20809446' 6-max Seat #1 is the button
Seat 1: c01bdbe3 ($22.87 in chips)
Seat 2: 428e8d3f ($8.75 in chips)
Seat 3: Hero ($31.87 in chips)
Seat 4: d0f4fa1f ($10.23 in chips)
Seat 5: c2f88101 ($10.5 in chips)
Seat 6: eab6be81 ($10 in chips)
428e8d3f: posts small blind $0.05
Hero: posts big blind $0.1
*** HOLE CARDS ***
Dealt to c01bdbe3 
Dealt to 428e8d3f 
Dealt to Hero [Kc 5c]
Dealt to d0f4fa1f 
Dealt to c2f88101 
Dealt to eab6be81 
d0f4fa1f: folds
c2f88101: folds
eab6be81: folds
c01bdbe3: raises $0.12 to $0.22
428e8d3f: folds
Hero: calls $0.12
*** FLOP *** [9c 5h 2c]
Hero: checks
c01bdbe3: bets $0.27
Hero: calls $0.27
*** TURN *** [9c 5h 2c] [Js]
Hero: checks
c01bdbe3: bets $1.29
Hero: folds
Uncalled bet ($1.29) returned to c01bdbe3
*** SHOWDOWN ***
c01bdbe3 collected $0.98 from pot
*** SUMMARY ***
Total pot $1.03 | Rake $0.05 | Jackpot $0 | Bingo $0 | Fortune $0 | Tax $0
Board [9c 5h 2c Js]
Seat 1: c01bdbe3 (button) won ($0.98)
Seat 2: 428e8d3f (small blind) folded before Flop
Seat 3: Hero (big blind) folded on the Turn
Seat 4: d0f4fa1f folded before Flop (didn't bet)
Seat 5: c2f88101 folded before Flop (didn't bet)
Seat 6: eab6be81 folded before Flop (didn't bet)


Poker Hand #RC2771794156: Hold'em No Limit ($0.05/$0.1) - 2024/08/04 11:08:14
Table 'RushAndCash20809416' 6-max Seat #1 is the button
Seat 1: 10beee26 ($5.21 in chips)
Seat 2: Hero ($31.92 in chips)
Seat 3: 1e742f33 ($10 in chips)
Seat 4: 9b7a4cfc ($12.26 in chips)
Seat 5: ba9c6f92 ($15.28 in chips)
Seat 6: f720f372 ($10.44 in chips)
Hero: posts small blind $0.05
1e742f33: posts big blind $0.1
*** HOLE CARDS ***
Dealt to 10beee26 
Dealt to Hero [8h 9s]
Dealt to 1e742f33 
Dealt to 9b7a4cfc 
Dealt to ba9c6f92 
Dealt to f720f372 
9b7a4cfc: folds
ba9c6f92: folds
f720f372: raises $0.15 to $0.25
10beee26: folds
Hero: folds
1e742f33: folds
Uncalled bet ($0.15) returned to f720f372
*** SHOWDOWN ***
f720f372 collected $0.25 from pot
*** SUMMARY ***
Total pot $0.25 | Rake $0 | Jackpot $0 | Bingo $0 | Fortune $0 | Tax $0
Seat 1: 10beee26 (button) folded before Flop (didn't bet)
Seat 2: Hero (small blind) folded before Flop
Seat 3: 1e742f33 (big blind) folded before Flop
Seat 4: 9b7a4cfc folded before Flop (didn't bet)
Seat 5: ba9c6f92 folded before Flop (didn't bet)
Seat 6: f720f372 collected ($0.25)


Poker Hand #RC2771794135: Hold'em No Limit ($0.05/$0.1) - 2024/08/04 11:08:11
Table 'RushAndCash20809395' 6-max Seat #1 is the button
Seat 1: 3203c19d ($10.57 in chips)
Seat 2: cc86ed88 ($11.99 in chips)
Seat 3: 30211301 ($13.79 in chips)
Seat 4: 251ae843 ($10.05 in chips)
Seat 5: ba9c6f92 ($15.28 in chips)
Seat 6: Hero ($31.92 in chips)
cc86ed88: posts small blind $0.05
30211301: posts big blind $0.1
*** HOLE CARDS ***
Dealt to 3203c19d 
Dealt to cc86ed88 
Dealt to 30211301 
Dealt to 251ae843 
Dealt to ba9c6f92 
Dealt to Hero [3s 3d]
251ae843: raises $0.1 to $0.2
ba9c6f92: folds
Hero: folds
3203c19d: calls $0.2
cc86ed88: folds
30211301: folds
*** FLOP *** [As 8h Jh]
251ae843: checks
3203c19d: checks
*** TURN *** [As 8h Jh] [Ad]
251ae843: bets $0.3
3203c19d: folds
Uncalled bet ($0.3) returned to 251ae843
*** SHOWDOWN ***
251ae843 collected $0.53 from pot
*** SUMMARY ***
Total pot $0.55 | Rake $0.02 | Jackpot $0 | Bingo $0 | Fortune $0 | Tax $0
Board [As 8h Jh Ad]
Seat 1: 3203c19d (button) folded on the Turn
Seat 2: cc86ed88 (small blind) folded before Flop
Seat 3: 30211301 (big blind) folded before Flop
Seat 4: 251ae843 won ($0.53)
Seat 5: ba9c6f92 folded before Flop (didn't bet)
Seat 6: Hero folded before Flop (didn't bet)


Poker Hand #RC2771794066: Hold'em No Limit ($0.05/$0.1) - 2024/08/04 11:08:02
Table 'RushAndCash20809326' 6-max Seat #1 is the button
Seat 1: eab6be81 ($10.05 in chips)
Seat 2: 874a07fd ($11.34 in chips)
Seat 3: a631a0be ($12.41 in chips)
Seat 4: d0ece2cc ($13.09 in chips)
Seat 5: ee0cbb47 ($20.91 in chips)
Seat 6: Hero ($31.92 in chips)
874a07fd: posts small blind $0.05
a631a0be: posts big blind $0.1
*** HOLE CARDS ***
Dealt to eab6be81 
Dealt to 874a07fd 
Dealt to a631a0be 
Dealt to d0ece2cc 
Dealt to ee0cbb47 
Dealt to Hero [5s 5c]
d0ece2cc: raises $0.1 to $0.2
ee0cbb47: folds
Hero: folds
eab6be81: folds
874a07fd: folds
a631a0be: calls $0.1
*** FLOP *** [8s As 9d]
a631a0be: checks
d0ece2cc: bets $0.15
a631a0be: calls $0.15
*** TURN *** [8s As 9d] [4c]
a631a0be: checks
d0ece2cc: bets $0.57
a631a0be: calls $0.57
*** RIVER *** [8s As 9d 4c] [2c]
a631a0be: checks
d0ece2cc: checks
a631a0be: shows [Tc Ac] (Pair of Aces)
d0ece2cc: shows [Ah Jc] (Pair of Aces)
*** SHOWDOWN ***
d0ece2cc collected $1.8 from pot
*** SUMMARY ***
Total pot $1.89 | Rake $0.09 | Jackpot $0 | Bingo $0 | Fortune $0 | Tax $0
Board [8s As 9d 4c 2c]
Seat 1: eab6be81 (button) folded before Flop (didn't bet)
Seat 2: 874a07fd (small blind) folded before Flop
Seat 3: a631a0be (big blind) showed [Tc Ac] and lost with Pair of Aces
Seat 4: d0ece2cc showed [Ah Jc] and won ($1.8) with Pair of Aces
Seat 5: ee0cbb47 folded before Flop (didn't bet)
Seat 6: Hero folded before Flop (didn't bet)


Poker Hand #RC2771794042: Hold'em No Limit ($0.05/$0.1) - 2024/08/04 11:07:59
Table 'RushAndCash20809302' 6-max Seat #1 is the button
Seat 1: b0571f3f ($10.53 in chips)
Seat 2: 5135b9f4 ($23.93 in chips)
Seat 3: ad7caea4 ($4.62 in chips)
Seat 4: Hero ($31.92 in chips)
Seat 5: abd3008a ($19.98 in chips)
Seat 6: 2eb05e74 ($10.16 in chips)
5135b9f4: posts small blind $0.05
ad7caea4: posts big blind $0.1
*** HOLE CARDS ***
Dealt to b0571f3f 
Dealt to 5135b9f4 
Dealt to ad7caea4 
Dealt to Hero [6h 9d]
Dealt to abd3008a 
Dealt to 2eb05e74 
Hero: folds
abd3008a: folds
2eb05e74: folds
b0571f3f: raises $0.14 to $0.24
5135b9f4: folds
ad7caea4: folds
Uncalled bet ($0.14) returned to b0571f3f
*** SHOWDOWN ***
b0571f3f collected $0.25 from pot
*** SUMMARY ***
Total pot $0.25 | Rake $0 | Jackpot $0 | Bingo $0 | Fortune $0 | Tax $0
Seat 1: b0571f3f (button) collected ($0.25)
Seat 2: 5135b9f4 (small blind) folded before Flop
Seat 3: ad7caea4 (big blind) folded before Flop
Seat 4: Hero folded before Flop (didn't bet)
Seat 5: abd3008a folded before Flop (didn't bet)
Seat 6: 2eb05e74 folded before Flop (didn't bet)


Poker Hand #RC2771794016: Hold'em No Limit ($0.05/$0.1) - 2024/08/04 11:07:55
Table 'RushAndCash20809276' 6-max Seat #1 is the button
Seat 1: 6e38ebef ($25.33 in chips)
Seat 2: e2b7bd7f ($18.05 in chips)
Seat 3: ce9a1794 ($12.1 in chips)
Seat 4: deaca6c5 ($10 in chips)
Seat 5: 57ad6eae ($10.83 in chips)
Seat 6: Hero ($31.92 in chips)
e2b7bd7f: posts small blind $0.05
ce9a1794: posts big blind $0.1
*** HOLE CARDS ***
Dealt to 6e38ebef 
Dealt to e2b7bd7f 
Dealt to ce9a1794 
Dealt to deaca6c5 
Dealt to 57ad6eae 
Dealt to Hero [5h As]
deaca6c5: raises $0.1 to $0.2
57ad6eae: folds
Hero: folds
6e38ebef: raises $0.4 to $0.6
e2b7bd7f: folds
ce9a1794: folds
deaca6c5: folds
Uncalled bet ($0.4) returned to 6e38ebef
*** SHOWDOWN ***
6e38ebef collected $0.53 from pot
*** SUMMARY ***
Total pot $0.55 | Rake $0.02 | Jackpot $0 | Bingo $0 | Fortune $0 | Tax $0
Seat 1: 6e38ebef (button) collected ($0.53)
Seat 2: e2b7bd7f (small blind) folded before Flop
Seat 3: ce9a1794 (big blind) folded before Flop
Seat 4: deaca6c5 folded before Flop
Seat 5: 57ad6eae folded before Flop (didn't bet)
Seat 6: Hero folded before Flop (didn't bet)


Poker Hand #RC2771793975: Hold'em No Limit ($0.05/$0.1) - 2024/08/04 11:07:50
Table 'RushAndCash20809235' 6-max Seat #1 is the button
Seat 1: 876c37ae ($13.58 in chips)
Seat 2: 62cea8a3 ($23.72 in chips)
Seat 3: 50fe8237 ($12.65 in chips)
Seat 4: 43de7ac7 ($29.66 in chips)
Seat 5: Hero ($31.92 in chips)
Seat 6: c40d6b6a ($15.51 in chips)
62cea8a3: posts small blind $0.05
50fe8237: posts big blind $0.1
*** HOLE CARDS ***
Dealt to 876c37ae 
Dealt to 62cea8a3 
Dealt to 50fe8237 
Dealt to 43de7ac7 
Dealt to Hero [9h 4h]
Dealt to c40d6b6a 
43de7ac7: folds
Hero: folds
c40d6b6a: folds
876c37ae: folds
62cea8a3: raises $0.2 to $0.3
50fe8237: calls $0.2
*** FLOP *** [2c Kh 7s]
62cea8a3: bets $0.2
50fe8237: folds
Uncalled bet ($0.2) returned to 62cea8a3
*** SHOWDOWN ***
62cea8a3 collected $0.57 from pot
*** SUMMARY ***
Total pot $0.6 | Rake $0.03 | Jackpot $0 | Bingo $0 | Fortune $0 | Tax $0
Board [2c Kh 7s]
Seat 1: 876c37ae (button) folded before Flop (didn't bet)
Seat 2: 62cea8a3 (small blind) won ($0.57)
Seat 3: 50fe8237 (big blind) folded on the Flop
Seat 4: 43de7ac7 folded before Flop (didn't bet)
Seat 5: Hero folded before Flop (didn't bet)
Seat 6: c40d6b6a folded before Flop (didn't bet)


Poker Hand #RC2771793948: Hold'em No Limit ($0.05/$0.1) - 2024/08/04 11:07:46
Table 'RushAndCash20809208' 6-max Seat #1 is the button
Seat 1: b1d7299e ($10.57 in chips)
Seat 2: Hero ($31.97 in chips)
Seat 3: 482e88b5 ($13.66 in chips)
Seat 4: 24e6aaf4 ($10 in chips)
Seat 5: 7aec7bb3 ($10.92 in chips)
Seat 6: 62cea8a3 ($23.72 in chips)
Hero: posts small blind $0.05
482e88b5: posts big blind $0.1
*** HOLE CARDS ***
Dealt to b1d7299e 
Dealt to Hero [8c 7s]
Dealt to 482e88b5 
Dealt to 24e6aaf4 
Dealt to 7aec7bb3 
Dealt to 62cea8a3 
24e6aaf4: folds
7aec7bb3: folds
62cea8a3: folds
b1d7299e: raises $0.18 to $0.28
Hero: folds
482e88b5: folds
Uncalled bet ($0.18) returned to b1d7299e
*** SHOWDOWN ***
b1d7299e collected $0.25 from pot
*** SUMMARY ***
Total pot $0.25 | Rake $0 | Jackpot $0 | Bingo $0 | Fortune $0 | Tax $0
Seat 1: b1d7299e (button) collected ($0.25)
Seat 2: Hero (small blind) folded before Flop
Seat 3: 482e88b5 (big blind) folded before Flop
Seat 4: 24e6aaf4 folded before Flop (didn't bet)
Seat 5: 7aec7bb3 folded before Flop (didn't bet)
Seat 6: 62cea8a3 folded before Flop (didn't bet)


Poker Hand #RC2771793919: Hold'em No Limit ($0.05/$0.1) - 2024/08/04 11:07:42
Table 'RushAndCash20809179' 6-max Seat #1 is the button
Seat 1: Hero ($31.97 in chips)
Seat 2: efbbf492 ($8.09 in chips)
Seat 3: a7d5fada ($9.49 in chips)
Seat 4: 45bf4575 ($11.96 in chips)
Seat 5: 661fd842 ($13.14 in chips)
Seat 6: 8bd73196 ($10 in chips)
efbbf492: posts small blind $0.05
a7d5fada: posts big blind $0.1
*** HOLE CARDS ***
Dealt to Hero [3d 4c]
Dealt to efbbf492 
Dealt to a7d5fada 
Dealt to 45bf4575 
Dealt to 661fd842 
Dealt to 8bd73196 
45bf4575: raises $0.12 to $0.22
661fd842: folds
8bd73196: folds
Hero: folds
efbbf492: folds
a7d5fada: calls $0.12
*** FLOP *** [2d 6d 8h]
a7d5fada: checks
45bf4575: checks
*** TURN *** [2d 6d 8h] [Tc]
a7d5fada: checks
45bf4575: checks
*** RIVER *** [2d 6d 8h Tc] [8d]
a7d5fada: bets $0.19
45bf4575: folds
Uncalled bet ($0.19) returned to a7d5fada
*** SHOWDOWN ***
a7d5fada collected $0.47 from pot
*** SUMMARY ***
Total pot $0.49 | Rake $0.02 | Jackpot $0 | Bingo $0 | Fortune $0 | Tax $0
Board [2d 6d 8h Tc 8d]
Seat 1: Hero (button) folded before Flop (didn't bet)
Seat 2: efbbf492 (small blind) folded before Flop
Seat 3: a7d5fada (big blind) won ($0.47)
Seat 4: 45bf4575 folded on the River
Seat 5: 661fd842 folded before Flop (didn't bet)
Seat 6: 8bd73196 folded before Flop (didn't bet)


Poker Hand #RC2771793863: Hold'em No Limit ($0.05/$0.1) - 2024/08/04 11:07:34
Table 'RushAndCash20809123' 6-max Seat #1 is the button
Seat 1: c366e765 ($11.69 in chips)
Seat 2: ffd56108 ($18.37 in chips)
Seat 3: Hero ($32.07 in chips)
Seat 4: f9dd4b13 ($10.56 in chips)
Seat 5: b9c76347 ($16.57 in chips)
Seat 6: df0aa037 ($12.89 in chips)
ffd56108: posts small blind $0.05
Hero: posts big blind $0.1
*** HOLE CARDS ***
Dealt to c366e765 
Dealt to ffd56108 
Dealt to Hero [5h Qc]
Dealt to f9dd4b13 
Dealt to b9c76347 
Dealt to df0aa037 
f9dd4b13: folds
b9c76347: raises $0.15 to $0.25
df0aa037: folds
c366e765: raises $0.49 to $0.74
ffd56108: folds
Hero: folds
b9c76347: calls $0.49
*** FLOP *** [7h 2s 4s]
b9c76347: checks
c366e765: checks
*** TURN *** [7h 2s 4s] [4h]
b9c76347: bets $0.82
c366e765: folds
Uncalled bet ($0.82) returned to b9c76347
*** SHOWDOWN ***
b9c76347 collected $1.55 from pot
*** SUMMARY ***
Total pot $1.63 | Rake $0.08 | Jackpot $0 | Bingo $0 | Fortune $0 | Tax $0
Board [7h 2s 4s 4h]
Seat 1: c366e765 (button) folded on the Turn
Seat 2: ffd56108 (small blind) folded before Flop
Seat 3: Hero (big blind) folded before Flop
Seat 4: f9dd4b13 folded before Flop (didn't bet)
Seat 5: b9c76347 won ($1.55)
Seat 6: df0aa037 folded before Flop (didn't bet)


Poker Hand #RC2771793831: Hold'em No Limit ($0.05/$0.1) - 2024/08/04 11:07:30
Table 'RushAndCash20809091' 6-max Seat #1 is the button
Seat 1: Hero ($32.07 in chips)
Seat 2: e5ed0012 ($12.07 in chips)
Seat 3: 94459eaa ($17.01 in chips)
Seat 4: 34ac6fb3 ($11.26 in chips)
Seat 5: 7d9bc7f7 ($12.28 in chips)
Seat 6: eff9a804 ($9.57 in chips)
e5ed0012: posts small blind $0.05
94459eaa: posts big blind $0.1
*** HOLE CARDS ***
Dealt to Hero [Jh 4h]
Dealt to e5ed0012 
Dealt to 94459eaa 
Dealt to 34ac6fb3 
Dealt to 7d9bc7f7 
Dealt to eff9a804 
34ac6fb3: folds
7d9bc7f7: raises $0.12 to $0.22
eff9a804: folds
Hero: folds
e5ed0012: calls $0.17
94459eaa: calls $0.12
*** FLOP *** [7c 7s 9h]
e5ed0012: checks
94459eaa: checks
7d9bc7f7: checks
*** TURN *** [7c 7s 9h] [Qc]
e5ed0012: checks
94459eaa: checks
7d9bc7f7: bets $0.33
e5ed0012: folds
94459eaa: calls $0.33
*** RIVER *** [7c 7s 9h Qc] [3c]
94459eaa: checks
7d9bc7f7: bets $0.89
94459eaa: folds
Uncalled bet ($0.89) returned to 7d9bc7f7
*** SHOWDOWN ***
7d9bc7f7 collected $1.26 from pot
*** SUMMARY ***
Total pot $1.32 | Rake $0.06 | Jackpot $0 | Bingo $0 | Fortune $0 | Tax $0
Board [7c 7s 9h Qc 3c]
Seat 1: Hero (button) folded before Flop (didn't bet)
Seat 2: e5ed0012 (small blind) folded on the Turn
Seat 3: 94459eaa (big blind) folded on the River
Seat 4: 34ac6fb3 folded before Flop (didn't bet)
Seat 5: 7d9bc7f7 won ($1.26)
Seat 6: eff9a804 folded before Flop (didn't bet)


Poker Hand #RC2771793810: Hold'em No Limit ($0.05/$0.1) - 2024/08/04 11:07:26
Table 'RushAndCash20809070' 6-max Seat #1 is the button
Seat 1: a9ab9653 ($10 in chips)
Seat 2: Hero ($32.12 in chips)
Seat 3: 24e6aaf4 ($10.1 in chips)
Seat 4: e6e8601a ($29.15 in chips)
Seat 5: c1d9b1d4 ($9.76 in chips)
Seat 6: 8df92bde ($10 in chips)
Hero: posts small blind $0.05
24e6aaf4: posts big blind $0.1
*** HOLE CARDS ***
Dealt to a9ab9653 
Dealt to Hero [Ac 3s]
Dealt to 24e6aaf4 
Dealt to e6e8601a 
Dealt to c1d9b1d4 
Dealt to 8df92bde 
e6e8601a: folds
c1d9b1d4: folds
8df92bde: raises $0.15 to $0.25
a9ab9653: folds
Hero: folds
24e6aaf4: folds
Uncalled bet ($0.15) returned to 8df92bde
*** SHOWDOWN ***
8df92bde collected $0.25 from pot
*** SUMMARY ***
Total pot $0.25 | Rake $0 | Jackpot $0 | Bingo $0 | Fortune $0 | Tax $0
Seat 1: a9ab9653 (button) folded before Flop (didn't bet)
Seat 2: Hero (small blind) folded before Flop
Seat 3: 24e6aaf4 (big blind) folded before Flop
Seat 4: e6e8601a folded before Flop (didn't bet)
Seat 5: c1d9b1d4 folded before Flop (didn't bet)
Seat 6: 8df92bde collected ($0.25)


Poker Hand #RC2771793776: Hold'em No Limit ($0.05/$0.1) - 2024/08/04 11:07:22
Table 'RushAndCash20809036' 6-max Seat #1 is the button
Seat 1: 5a57d649 ($10.13 in chips)
Seat 2: 129c3cba ($11.28 in chips)
Seat 3: 6fe61f4 ($25.86 in chips)
Seat 4: 6ef03265 ($10 in chips)
Seat 5: 44e483f7 ($39.98 in chips)
Seat 6: Hero ($32.12 in chips)
129c3cba: posts small blind $0.05
6fe61f4: posts big blind $0.1
*** HOLE CARDS ***
Dealt to 5a57d649 
Dealt to 129c3cba 
Dealt to 6fe61f4 
Dealt to 6ef03265 
Dealt to 44e483f7 
Dealt to Hero [Td 5s]
6ef03265: folds
44e483f7: folds
Hero: folds
5a57d649: folds
129c3cba: raises $0.15 to $0.25
6fe61f4: calls $0.15
*** FLOP *** [Jd Ts 3d]
129c3cba: bets $0.2
6fe61f4: calls $0.2
*** TURN *** [Jd Ts 3d] [Qc]
129c3cba: checks
6fe61f4: checks
*** RIVER *** [Jd Ts 3d Qc] [As]
129c3cba: checks
6fe61f4: checks
129c3cba: shows [Qs 2s] (Pair of Queens)
6fe61f4: shows [8c Jc] (Pair of Jacks)
*** SHOWDOWN ***
129c3cba collected $0.86 from pot
*** SUMMARY ***
Total pot $0.9 | Rake $0.04 | Jackpot $0 | Bingo $0 | Fortune $0 | Tax $0
Board [Jd Ts 3d Qc As]
Seat 1: 5a57d649 (button) folded before Flop (didn't bet)
Seat 2: 129c3cba (small blind) showed [Qs 2s] and won ($0.86) with Pair of Queens
Seat 3: 6fe61f4 (big blind) showed [8c Jc] and lost with Pair of Jacks
Seat 4: 6ef03265 folded before Flop (didn't bet)
Seat 5: 44e483f7 folded before Flop (didn't bet)
Seat 6: Hero folded before Flop (didn't bet)


Poker Hand #RC2771793479: Hold'em No Limit ($0.05/$0.1) - 2024/08/04 11:06:43
Table 'RushAndCash20808739' 6-max Seat #1 is the button
Seat 1: d0697e32 ($12.42 in chips)
Seat 2: 8a8e979a ($14.58 in chips)
Seat 3: Hero ($33.32 in chips)
Seat 4: dd8d9610 ($11.15 in chips)
Seat 5: 49bff733 ($19.72 in chips)
Seat 6: 10beee26 ($5.51 in chips)
8a8e979a: posts small blind $0.05
Hero: posts big blind $0.1
*** HOLE CARDS ***
Dealt to d0697e32 
Dealt to 8a8e979a 
Dealt to Hero [Js Ad]
Dealt to dd8d9610 
Dealt to 49bff733 
Dealt to 10beee26 
dd8d9610: folds
49bff733: folds
10beee26: raises $0.15 to $0.25
d0697e32: folds
8a8e979a: calls $0.2
Hero: raises $0.95 to $1.2
10beee26: folds
8a8e979a: calls $0.95
*** FLOP *** [2s 4c Th]
8a8e979a: checks
Hero: checks
*** TURN *** [2s 4c Th] [8d]
8a8e979a: checks
Hero: checks
*** RIVER *** [2s 4c Th 8d] [Qc]
8a8e979a: bets $2.65
Hero: folds
Uncalled bet ($2.65) returned to 8a8e979a
*** SHOWDOWN ***
8a8e979a collected $2.52 from pot
*** SUMMARY ***
Total pot $2.65 | Rake $0.13 | Jackpot $0 | Bingo $0 | Fortune $0 | Tax $0
Board [2s 4c Th 8d Qc]
Seat 1: d0697e32 (button) folded before Flop (didn't bet)
Seat 2: 8a8e979a (small blind) won ($2.52)
Seat 3: Hero (big blind) folded on the River
Seat 4: dd8d9610 folded before Flop (didn't bet)
Seat 5: 49bff733 folded before Flop (didn't bet)
Seat 6: 10beee26 folded before Flop


Poker Hand #RC2771793456: Hold'em No Limit ($0.05/$0.1) - 2024/08/04 11:06:40
Table 'RushAndCash20808716' 6-max Seat #1 is the button
Seat 1: 27f9b2a1 ($13.69 in chips)
Seat 2: ef2038a9 ($14.27 in chips)
Seat 3: e280c40b ($10.66 in chips)
Seat 4: afb095e1 ($10 in chips)
Seat 5: 192e925e ($10.65 in chips)
Seat 6: Hero ($33.32 in chips)
ef2038a9: posts small blind $0.05
e280c40b: posts big blind $0.1
*** HOLE CARDS ***
Dealt to 27f9b2a1 
Dealt to ef2038a9 
Dealt to e280c40b 
Dealt to afb095e1 
Dealt to 192e925e 
Dealt to Hero [3d 6d]
afb095e1: folds
192e925e: folds
Hero: folds
27f9b2a1: raises $0.1 to $0.2
ef2038a9: folds
e280c40b: calls $0.1
*** FLOP *** [Ah Td Ac]
e280c40b: checks
27f9b2a1: checks
*** TURN *** [Ah Td Ac] [Kh]
e280c40b: bets $0.36
27f9b2a1: calls $0.36
*** RIVER *** [Ah Td Ac Kh] [8s]
e280c40b: bets $0.92
27f9b2a1: folds
Uncalled bet ($0.92) returned to e280c40b
*** SHOWDOWN ***
e280c40b collected $1.12 from pot
*** SUMMARY ***
Total pot $1.17 | Rake $0.05 | Jackpot $0 | Bingo $0 | Fortune $0 | Tax $0
Board [Ah Td Ac Kh 8s]
Seat 1: 27f9b2a1 (button) folded on the River
Seat 2: ef2038a9 (small blind) folded before Flop
Seat 3: e280c40b (big blind) won ($1.12)
Seat 4: afb095e1 folded before Flop (didn't bet)
Seat 5: 192e925e folded before Flop (didn't bet)
Seat 6: Hero folded before Flop (didn't bet)


Poker Hand #RC2771793413: Hold'em No Limit ($0.05/$0.1) - 2024/08/04 11:06:33
Table 'RushAndCash20808673' 6-max Seat #1 is the button
Seat 1: ec2e69db ($13.24 in chips)
Seat 2: c460565b ($12.98 in chips)
Seat 3: 92cc00d7 ($10 in chips)
Seat 4: e956062a ($3.61 in chips)
Seat 5: Hero ($33.32 in chips)
Seat 6: 482e88b5 ($14.21 in chips)
c460565b: posts small blind $0.05
92cc00d7: posts big blind $0.1
*** HOLE CARDS ***
Dealt to ec2e69db 
Dealt to c460565b 
Dealt to 92cc00d7 
Dealt to e956062a 
Dealt to Hero [5c 2s]
Dealt to 482e88b5 
e956062a: folds
Hero: folds
482e88b5: raises $0.15 to $0.25
ec2e69db: folds
c460565b: raises $0.75 to $1
92cc00d7: folds
482e88b5: folds
Uncalled bet ($0.75) returned to c460565b
*** SHOWDOWN ***
c460565b collected $0.57 from pot
*** SUMMARY ***
Total pot $0.6 | Rake $0.03 | Jackpot $0 | Bingo $0 | Fortune $0 | Tax $0
Seat 1: ec2e69db (button) folded before Flop (didn't bet)
Seat 2: c460565b (small blind) collected ($0.57)
Seat 3: 92cc00d7 (big blind) folded before Flop
Seat 4: e956062a folded before Flop (didn't bet)
Seat 5: Hero folded before Flop (didn't bet)
Seat 6: 482e88b5 folded before Flop


Poker Hand #RC2771793361: Hold'em No Limit ($0.05/$0.1) - 2024/08/04 11:06:27
Table 'RushAndCash20808621' 6-max Seat #1 is the button
Seat 1: d0d2ca4c ($10.82 in chips)
Seat 2: 541ec3b4 ($10.23 in chips)
Seat 3: c72c5bbf ($10.15 in chips)
Seat 4: 6e29a2c8 ($10.32 in chips)
Seat 5: Hero ($33.32 in chips)
Seat 6: 2c928ce8 ($10 in chips)
541ec3b4: posts small blind $0.05
c72c5bbf: posts big blind $0.1
*** HOLE CARDS ***
Dealt to d0d2ca4c 
Dealt to 541ec3b4 
Dealt to c72c5bbf 
Dealt to 6e29a2c8 
Dealt to Hero [Ac 6c]
Dealt to 2c928ce8 
6e29a2c8: raises $0.2 to $0.3
Hero: folds
2c928ce8: folds
d0d2ca4c: folds
541ec3b4: folds
c72c5bbf: folds
Uncalled bet ($0.2) returned to 6e29a2c8
*** SHOWDOWN ***
6e29a2c8 collected $0.25 from pot
*** SUMMARY ***
Total pot $0.25 | Rake $0 | Jackpot $0 | Bingo $0 | Fortune $0 | Tax $0
Seat 1: d0d2ca4c (button) folded before Flop (didn't bet)
Seat 2: 541ec3b4 (small blind) folded before Flop
Seat 3: c72c5bbf (big blind) folded before Flop
Seat 4: 6e29a2c8 collected ($0.25)
Seat 5: Hero folded before Flop (didn't bet)
Seat 6: 2c928ce8 folded before Flop (didn't bet)


Poker Hand #RC2771793333: Hold'em No Limit ($0.05/$0.1) - 2024/08/04 11:06:23
Table 'RushAndCash20808593' 6-max Seat #1 is the button
Seat 1: 7d9bc7f7 ($11.39 in chips)
Seat 2: 6dc91a63 ($23.24 in chips)
Seat 3: ce9a1794 ($12.4 in chips)
Seat 4: 5c1fc04a ($10.1 in chips)
Seat 5: 348e7778 ($32.45 in chips)
Seat 6: Hero ($33.32 in chips)
6dc91a63: posts small blind $0.05
ce9a1794: posts big blind $0.1
*** HOLE CARDS ***
Dealt to 7d9bc7f7 
Dealt to 6dc91a63 
Dealt to ce9a1794 
Dealt to 5c1fc04a 
Dealt to 348e7778 
Dealt to Hero [6s Ac]
5c1fc04a: folds
348e7778: folds
Hero: folds
7d9bc7f7: folds
6dc91a63: folds
Uncalled bet ($0.05) returned to ce9a1794
*** SHOWDOWN ***
ce9a1794 collected $0.1 from pot
*** SUMMARY ***
Total pot $0.1 | Rake $0 | Jackpot $0 | Bingo $0 | Fortune $0 | Tax $0
Seat 1: 7d9bc7f7 (button) folded before Flop (didn't bet)
Seat 2: 6dc91a63 (small blind) folded before Flop
Seat 3: ce9a1794 (big blind) collected ($0.1)
Seat 4: 5c1fc04a folded before Flop (didn't bet)
Seat 5: 348e7778 folded before Flop (didn't bet)
Seat 6: Hero folded before Flop (didn't bet)


Poker Hand #RC2771793300: Hold'em No Limit ($0.05/$0.1) - 2024/08/04 11:06:19
Table 'RushAndCash20808560' 6-max Seat #1 is the button
Seat 1: 2cf6e02d ($32.86 in chips)
Seat 2: a0b83ec3 ($11.1 in chips)
Seat 3: 2ca5f59c ($18.03 in chips)
Seat 4: Hero ($33.32 in chips)
Seat 5: 44165a65 ($16.92 in chips)
Seat 6: 34c80376 ($10.28 in chips)
a0b83ec3: posts small blind $0.05
2ca5f59c: posts big blind $0.1
*** HOLE CARDS ***
Dealt to 2cf6e02d 
Dealt to a0b83ec3 
Dealt to 2ca5f59c 
Dealt to Hero [8s 2c]
Dealt to 44165a65 
Dealt to 34c80376 
Hero: folds
44165a65: raises $0.2 to $0.3
34c80376: folds
2cf6e02d: folds
a0b83ec3: folds
2ca5f59c: folds
Uncalled bet ($0.2) returned to 44165a65
*** SHOWDOWN ***
44165a65 collected $0.25 from pot
*** SUMMARY ***
Total pot $0.25 | Rake $0 | Jackpot $0 | Bingo $0 | Fortune $0 | Tax $0
Seat 1: 2cf6e02d (button) folded before Flop (didn't bet)
Seat 2: a0b83ec3 (small blind) folded before Flop
Seat 3: 2ca5f59c (big blind) folded before Flop
Seat 4: Hero folded before Flop (didn't bet)
Seat 5: 44165a65 collected ($0.25)
Seat 6: 34c80376 folded before Flop (didn't bet)


Poker Hand #RC2771793261: Hold'em No Limit ($0.05/$0.1) - 2024/08/04 11:06:14
Table 'RushAndCash20808521' 6-max Seat #1 is the button
Seat 1: 3873054e ($9.88 in chips)
Seat 2: 1e5d0682 ($6 in chips)
Seat 3: 24f8fa31 ($19.54 in chips)
Seat 4: 2a3d22c6 ($10 in chips)
Seat 5: aac8fa10 ($10.23 in chips)
Seat 6: Hero ($33.32 in chips)
1e5d0682: posts small blind $0.05
24f8fa31: posts big blind $0.1
*** HOLE CARDS ***
Dealt to 3873054e 
Dealt to 1e5d0682 
Dealt to 24f8fa31 
Dealt to 2a3d22c6 
Dealt to aac8fa10 
Dealt to Hero [8s 3c]
2a3d22c6: folds
aac8fa10: raises $0.1 to $0.2
Hero: folds
3873054e: calls $0.2
1e5d0682: folds
24f8fa31: folds
*** FLOP *** [Qh 3s 8c]
aac8fa10: checks
3873054e: bets $0.3
aac8fa10: folds
Uncalled bet ($0.3) returned to 3873054e
*** SHOWDOWN ***
3873054e collected $0.53 from pot
*** SUMMARY ***
Total pot $0.55 | Rake $0.02 | Jackpot $0 | Bingo $0 | Fortune $0 | Tax $0
Board [Qh 3s 8c]
Seat 1: 3873054e (button) won ($0.53)
Seat 2: 1e5d0682 (small blind) folded before Flop
Seat 3: 24f8fa31 (big blind) folded before Flop
Seat 4: 2a3d22c6 folded before Flop (didn't bet)
Seat 5: aac8fa10 folded on the Flop
Seat 6: Hero folded before Flop (didn't bet)


Poker Hand #RC2771793181: Hold'em No Limit ($0.05/$0.1) - 2024/08/04 11:06:03
Table 'RushAndCash20808441' 6-max Seat #1 is the button
Seat 1: Hero ($33.32 in chips)
Seat 2: 27f9b2a1 ($13.94 in chips)
Seat 3: e956062a ($3.86 in chips)
Seat 4: 284ce5eb ($18.35 in chips)
Seat 5: b7b90fce ($11.11 in chips)
Seat 6: 9ff7304e ($10.15 in chips)
27f9b2a1: posts small blind $0.05
e956062a: posts big blind $0.1
*** HOLE CARDS ***
Dealt to Hero [5c 6d]
Dealt to 27f9b2a1 
Dealt to e956062a 
Dealt to 284ce5eb 
Dealt to b7b90fce 
Dealt to 9ff7304e 
284ce5eb: raises $0.15 to $0.25
b7b90fce: folds
9ff7304e: folds
Hero: folds
27f9b2a1: folds
e956062a: folds
Uncalled bet ($0.15) returned to 284ce5eb
*** SHOWDOWN ***
284ce5eb collected $0.25 from pot
*** SUMMARY ***
Total pot $0.25 | Rake $0 | Jackpot $0 | Bingo $0 | Fortune $0 | Tax $0
Seat 1: Hero (button) folded before Flop (didn't bet)
Seat 2: 27f9b2a1 (small blind) folded before Flop
Seat 3: e956062a (big blind) folded before Flop
Seat 4: 284ce5eb collected ($0.25)
Seat 5: b7b90fce folded before Flop (didn't bet)
Seat 6: 9ff7304e folded before Flop (didn't bet)


Poker Hand #RC2771793134: Hold'em No Limit ($0.05/$0.1) - 2024/08/04 11:05:57
Table 'RushAndCash20808394' 6-max Seat #1 is the button
Seat 1: 9db18e17 ($16.77 in chips)
Seat 2: Hero ($33.37 in chips)
Seat 3: 3f29b823 ($16.84 in chips)
Seat 4: c7d3fb41 ($10 in chips)
Seat 5: 2a3d22c6 ($10.1 in chips)
Seat 6: 350a6941 ($6.57 in chips)
Hero: posts small blind $0.05
3f29b823: posts big blind $0.1
*** HOLE CARDS ***
Dealt to 9db18e17 
Dealt to Hero [Ts 9h]
Dealt to 3f29b823 
Dealt to c7d3fb41 
Dealt to 2a3d22c6 
Dealt to 350a6941 
c7d3fb41: folds
2a3d22c6: folds
350a6941: raises $0.13 to $0.23
9db18e17: folds
Hero: folds
3f29b823: calls $0.13
*** FLOP *** [5d 9c 6s]
3f29b823: checks
350a6941: checks
*** TURN *** [5d 9c 6s] [Jd]
3f29b823: bets $0.34
350a6941: raises $0.6 to $0.94
3f29b823: folds
Uncalled bet ($0.6) returned to 350a6941
*** SHOWDOWN ***
350a6941 collected $1.13 from pot
*** SUMMARY ***
Total pot $1.19 | Rake $0.06 | Jackpot $0 | Bingo $0 | Fortune $0 | Tax $0
Board [5d 9c 6s Jd]
Seat 1: 9db18e17 (button) folded before Flop (didn't bet)
Seat 2: Hero (small blind) folded before Flop
Seat 3: 3f29b823 (big blind) folded on the Turn
Seat 4: c7d3fb41 folded before Flop (didn't bet)
Seat 5: 2a3d22c6 folded before Flop (didn't bet)
Seat 6: 350a6941 won ($1.13)


Poker Hand #RC2771792923: Hold'em No Limit ($0.05/$0.1) - 2024/08/04 11:05:30
Table 'RushAndCash20808183' 6-max Seat #1 is the button
Seat 1: b4679fe5 ($28.74 in chips)
Seat 2: 81a7f545 ($10.05 in chips)
Seat 3: Hero ($33.57 in chips)
Seat 4: b99d2702 ($10 in chips)
Seat 5: 9db18e17 ($16.54 in chips)
Seat 6: a1a3c459 ($19.35 in chips)
81a7f545: posts small blind $0.05
Hero: posts big blind $0.1
*** HOLE CARDS ***
Dealt to b4679fe5 
Dealt to 81a7f545 
Dealt to Hero [9s 6s]
Dealt to b99d2702 
Dealt to 9db18e17 
Dealt to a1a3c459 
b99d2702: folds
9db18e17: raises $0.1 to $0.2
a1a3c459: folds
b4679fe5: folds
81a7f545: folds
Hero: calls $0.1
*** FLOP *** [Jh 6h Kh]
Hero: checks
9db18e17: bets $0.23
Hero: folds
Uncalled bet ($0.23) returned to 9db18e17
*** SHOWDOWN ***
9db18e17 collected $0.43 from pot
*** SUMMARY ***
Total pot $0.45 | Rake $0.02 | Jackpot $0 | Bingo $0 | Fortune $0 | Tax $0
Board [Jh 6h Kh]
Seat 1: b4679fe5 (button) folded before Flop (didn't bet)
Seat 2: 81a7f545 (small blind) folded before Flop
Seat 3: Hero (big blind) folded on the Flop
Seat 4: b99d2702 folded before Flop (didn't bet)
Seat 5: 9db18e17 won ($0.43)
Seat 6: a1a3c459 folded before Flop (didn't bet)


Poker Hand #RC2771792898: Hold'em No Limit ($0.05/$0.1) - 2024/08/04 11:05:27
Table 'RushAndCash20808158' 6-max Seat #1 is the button
Seat 1: 47262397 ($22.35 in chips)
Seat 2: d47986ad ($8.47 in chips)
Seat 3: 12ab45ce ($16.56 in chips)
Seat 4: Hero ($33.57 in chips)
Seat 5: 9c963c83 ($23.15 in chips)
Seat 6: 5b433531 ($13.8 in chips)
d47986ad: posts small blind $0.05
12ab45ce: posts big blind $0.1
*** HOLE CARDS ***
Dealt to 47262397 
Dealt to d47986ad 
Dealt to 12ab45ce 
Dealt to Hero [3h Kc]
Dealt to 9c963c83 
Dealt to 5b433531 
Hero: folds
9c963c83: folds
5b433531: raises $0.1 to $0.2
47262397: folds
d47986ad: calls $0.15
12ab45ce: folds
*** FLOP *** [4d 8s 2c]
d47986ad: checks
5b433531: bets $0.17
d47986ad: calls $0.17
*** TURN *** [4d 8s 2c] [2d]
d47986ad: checks
5b433531: checks
*** RIVER *** [4d 8s 2c 2d] [Kd]
d47986ad: checks
5b433531: checks
d47986ad: shows [8d 7s] (Pair of Eights and Pair of Twos)
5b433531: shows [7c 7h] (Pair of Sevens and Pair of Twos)
*** SHOWDOWN ***
d47986ad collected $0.8 from pot
*** SUMMARY ***
Total pot $0.84 | Rake $0.04 | Jackpot $0 | Bingo $0 | Fortune $0 | Tax $0
Board [4d 8s 2c 2d Kd]
Seat 1: 47262397 (button) folded before Flop (didn't bet)
Seat 2: d47986ad (small blind) showed [8d 7s] and won ($0.8) with Pair of Eights and Pair of Twos
Seat 3: 12ab45ce (big blind) folded before Flop
Seat 4: Hero folded before Flop (didn't bet)
Seat 5: 9c963c83 folded before Flop (didn't bet)
Seat 6: 5b433531 showed [7c 7h] and lost with Pair of Sevens and Pair of Twos


Poker Hand #RC2771792870: Hold'em No Limit ($0.05/$0.1) - 2024/08/04 11:05:23
Table 'RushAndCash20808130' 6-max Seat #1 is the button
Seat 1: 94459eaa ($16.57 in chips)
Seat 2: 9c963c83 ($23.2 in chips)
Seat 3: a90e72e8 ($10 in chips)
Seat 4: e1a39450 ($16.27 in chips)
Seat 5: 45bf4575 ($12.06 in chips)
Seat 6: Hero ($33.57 in chips)
9c963c83: posts small blind $0.05
a90e72e8: posts big blind $0.1
*** HOLE CARDS ***
Dealt to 94459eaa 
Dealt to 9c963c83 
Dealt to a90e72e8 
Dealt to e1a39450 
Dealt to 45bf4575 
Dealt to Hero [5c 4h]
e1a39450: folds
45bf4575: raises $0.12 to $0.22
Hero: folds
94459eaa: folds
9c963c83: folds
a90e72e8: folds
Uncalled bet ($0.12) returned to 45bf4575
*** SHOWDOWN ***
45bf4575 collected $0.25 from pot
*** SUMMARY ***
Total pot $0.25 | Rake $0 | Jackpot $0 | Bingo $0 | Fortune $0 | Tax $0
Seat 1: 94459eaa (button) folded before Flop (didn't bet)
Seat 2: 9c963c83 (small blind) folded before Flop
Seat 3: a90e72e8 (big blind) folded before Flop
Seat 4: e1a39450 folded before Flop (didn't bet)
Seat 5: 45bf4575 collected ($0.25)
Seat 6: Hero folded before Flop (didn't bet)


Poker Hand #RC2771792843: Hold'em No Limit ($0.05/$0.1) - 2024/08/04 11:05:20
Table 'RushAndCash20808103' 6-max Seat #1 is the button
Seat 1: 3203c19d ($10.42 in chips)
Seat 2: e1a39450 ($16.32 in chips)
Seat 3: 3267ad58 ($10.03 in chips)
Seat 4: 81a7f545 ($10.15 in chips)
Seat 5: Hero ($33.57 in chips)
Seat 6: d110a07b ($10 in chips)
e1a39450: posts small blind $0.05
3267ad58: posts big blind $0.1
*** HOLE CARDS ***
Dealt to 3203c19d 
Dealt to e1a39450 
Dealt to 3267ad58 
Dealt to 81a7f545 
Dealt to Hero [9c Jh]
Dealt to d110a07b 
81a7f545: folds
Hero: folds
d110a07b: raises $0.1 to $0.2
3203c19d: folds
e1a39450: folds
3267ad58: calls $0.1
*** FLOP *** [7d Ks 7s]
3267ad58: checks
d110a07b: checks
*** TURN *** [7d Ks 7s] [Js]
3267ad58: checks
d110a07b: checks
*** RIVER *** [7d Ks 7s Js] [5d]
3267ad58: bets $0.36
d110a07b: folds
Uncalled bet ($0.36) returned to 3267ad58
*** SHOWDOWN ***
3267ad58 collected $0.43 from pot
*** SUMMARY ***
Total pot $0.45 | Rake $0.02 | Jackpot $0 | Bingo $0 | Fortune $0 | Tax $0
Board [7d Ks 7s Js 5d]
Seat 1: 3203c19d (button) folded before Flop (didn't bet)
Seat 2: e1a39450 (small blind) folded before Flop
Seat 3: 3267ad58 (big blind) won ($0.43)
Seat 4: 81a7f545 folded before Flop (didn't bet)
Seat 5: Hero folded before Flop (didn't bet)
Seat 6: d110a07b folded on the River


Poker Hand #RC2771792798: Hold'em No Limit ($0.05/$0.1) - 2024/08/04 11:05:14
Table 'RushAndCash20808058' 6-max Seat #1 is the button
Seat 1: 3a38c27b ($21.08 in chips)
Seat 2: Hero ($33.62 in chips)
Seat 3: 18ddc90b ($17.51 in chips)
Seat 4: 8f7c7d77 ($10.23 in chips)
Seat 5: 9d5456b4 ($12.1 in chips)
Seat 6: 49bff733 ($20.72 in chips)
Hero: posts small blind $0.05
18ddc90b: posts big blind $0.1
*** HOLE CARDS ***
Dealt to 3a38c27b 
Dealt to Hero [6h Ts]
Dealt to 18ddc90b 
Dealt to 8f7c7d77 
Dealt to 9d5456b4 
Dealt to 49bff733 
8f7c7d77: raises $0.1 to $0.2
9d5456b4: folds
49bff733: folds
3a38c27b: raises $0.42 to $0.62
Hero: folds
18ddc90b: folds
8f7c7d77: calls $0.42
*** FLOP *** [Ks 2h 4h]
8f7c7d77: checks
3a38c27b: checks
*** TURN *** [Ks 2h 4h] [Qs]
8f7c7d77: checks
3a38c27b: checks
*** RIVER *** [Ks 2h 4h Qs] [9h]
8f7c7d77: checks
3a38c27b: bets $0.46
8f7c7d77: folds
Uncalled bet ($0.46) returned to 3a38c27b
*** SHOWDOWN ***
3a38c27b collected $1.32 from pot
*** SUMMARY ***
Total pot $1.39 | Rake $0.07 | Jackpot $0 | Bingo $0 | Fortune $0 | Tax $0
Board [Ks 2h 4h Qs 9h]
Seat 1: 3a38c27b (button) won ($1.32)
Seat 2: Hero (small blind) folded before Flop
Seat 3: 18ddc90b (big blind) folded before Flop
Seat 4: 8f7c7d77 folded on the River
Seat 5: 9d5456b4 folded before Flop (didn't bet)
Seat 6: 49bff733 folded before Flop (didn't bet)


Poker Hand #RC2771792764: Hold'em No Limit ($0.05/$0.1) - 2024/08/04 11:05:09
Table 'RushAndCash20808024' 6-max Seat #1 is the button
Seat 1: 6f8fa43a ($10.63 in chips)
Seat 2: c5ef7918 ($10 in chips)
Seat 3: Hero ($33.72 in chips)
Seat 4: b70da252 ($32.49 in chips)
Seat 5: 281ff05a ($10.35 in chips)
Seat 6: 368ebd2f ($10.91 in chips)
c5ef7918: posts small blind $0.05
Hero: posts big blind $0.1
*** HOLE CARDS ***
Dealt to 6f8fa43a 
Dealt to c5ef7918 
Dealt to Hero [5d 9c]
Dealt to b70da252 
Dealt to 281ff05a 
Dealt to 368ebd2f 
b70da252: folds
281ff05a: folds
368ebd2f: folds
6f8fa43a: raises $0.12 to $0.22
c5ef7918: folds
Hero: folds
Uncalled bet ($0.12) returned to 6f8fa43a
*** SHOWDOWN ***
6f8fa43a collected $0.25 from pot
*** SUMMARY ***
Total pot $0.25 | Rake $0 | Jackpot $0 | Bingo $0 | Fortune $0 | Tax $0
Seat 1: 6f8fa43a (button) collected ($0.25)
Seat 2: c5ef7918 (small blind) folded before Flop
Seat 3: Hero (big blind) folded before Flop
Seat 4: b70da252 folded before Flop (didn't bet)
Seat 5: 281ff05a folded before Flop (didn't bet)
Seat 6: 368ebd2f folded before Flop (didn't bet)


Poker Hand #RC2771792699: Hold'em No Limit ($0.05/$0.1) - 2024/08/04 11:05:02
Table 'RushAndCash20807959' 6-max Seat #1 is the button
Seat 1: Hero ($33.72 in chips)
Seat 2: 53e19a62 ($10.28 in chips)
Seat 3: 348e7778 ($31.78 in chips)
Seat 4: 8bf101c5 ($13.72 in chips)
Seat 5: e47c7f94 ($12.07 in chips)
Seat 6: b275cda3 ($14.42 in chips)
53e19a62: posts small blind $0.05
348e7778: posts big blind $0.1
*** HOLE CARDS ***
Dealt to Hero [Qs 2h]
Dealt to 53e19a62 
Dealt to 348e7778 
Dealt to 8bf101c5 
Dealt to e47c7f94 
Dealt to b275cda3 
8bf101c5: folds
e47c7f94: folds
b275cda3: folds
Hero: folds
53e19a62: folds
Uncalled bet ($0.05) returned to 348e7778
*** SHOWDOWN ***
348e7778 collected $0.1 from pot
*** SUMMARY ***
Total pot $0.1 | Rake $0 | Jackpot $0 | Bingo $0 | Fortune $0 | Tax $0
Seat 1: Hero (button) folded before Flop (didn't bet)
Seat 2: 53e19a62 (small blind) folded before Flop
Seat 3: 348e7778 (big blind) collected ($0.1)
Seat 4: 8bf101c5 folded before Flop (didn't bet)
Seat 5: e47c7f94 folded before Flop (didn't bet)
Seat 6: b275cda3 folded before Flop (didn't bet)


Poker Hand #RC2771792350: Hold'em No Limit ($0.05/$0.1) - 2024/08/04 11:04:17
Table 'RushAndCash20807610' 6-max Seat #1 is the button
Seat 1: fa1bc3eb ($1.79 in chips)
Seat 2: Hero ($32.49 in chips)
Seat 3: 53e19a62 ($11.48 in chips)
Seat 4: 5b433531 ($13.22 in chips)
Seat 5: e79cc73f ($11.87 in chips)
Seat 6: 8bf101c5 ($13.4 in chips)
Hero: posts small blind $0.05
53e19a62: posts big blind $0.1
*** HOLE CARDS ***
Dealt to fa1bc3eb 
Dealt to Hero [4h 4c]
Dealt to 53e19a62 
Dealt to 5b433531 
Dealt to e79cc73f 
Dealt to 8bf101c5 
5b433531: folds
e79cc73f: folds
8bf101c5: folds
fa1bc3eb: folds
Hero: raises $0.2 to $0.3
53e19a62: raises $0.9 to $1.2
Hero: calls $0.9
*** FLOP *** [9d Ad 6h]
Hero: checks
53e19a62: checks
*** TURN *** [9d Ad 6h] [5h]
Hero: bets $1.59
53e19a62: folds
Uncalled bet ($1.59) returned to Hero
*** SHOWDOWN ***
Hero collected $2.28 from pot
*** SUMMARY ***
Total pot $2.4 | Rake $0.12 | Jackpot $0 | Bingo $0 | Fortune $0 | Tax $0
Board [9d Ad 6h 5h]
Seat 1: fa1bc3eb (button) folded before Flop (didn't bet)
Seat 2: Hero (small blind) won ($2.28)
Seat 3: 53e19a62 (big blind) folded on the Turn
Seat 4: 5b433531 folded before Flop (didn't bet)
Seat 5: e79cc73f folded before Flop (didn't bet)
Seat 6: 8bf101c5 folded before Flop (didn't bet)


Poker Hand #RC2771792326: Hold'em No Limit ($0.05/$0.1) - 2024/08/04 11:04:14
Table 'RushAndCash20807586' 6-max Seat #1 is the button
Seat 1: 659b0c2c ($10.35 in chips)
Seat 2: ab6efce2 ($10.05 in chips)
Seat 3: 2abef62e ($10.15 in chips)
Seat 4: e2c2989d ($20.99 in chips)
Seat 5: Hero ($32.49 in chips)
Seat 6: 2a030a46 ($13.92 in chips)
ab6efce2: posts small blind $0.05
2abef62e: posts big blind $0.1
*** HOLE CARDS ***
Dealt to 659b0c2c 
Dealt to ab6efce2 
Dealt to 2abef62e 
Dealt to e2c2989d 
Dealt to Hero [6s Th]
Dealt to 2a030a46 
e2c2989d: folds
Hero: folds
2a030a46: raises $0.2 to $0.3
659b0c2c: folds
ab6efce2: folds
2abef62e: folds
Uncalled bet ($0.2) returned to 2a030a46
*** SHOWDOWN ***
2a030a46 collected $0.25 from pot
*** SUMMARY ***
Total pot $0.25 | Rake $0 | Jackpot $0 | Bingo $0 | Fortune $0 | Tax $0
Seat 1: 659b0c2c (button) folded before Flop (didn't bet)
Seat 2: ab6efce2 (small blind) folded before Flop
Seat 3: 2abef62e (big blind) folded before Flop
Seat 4: e2c2989d folded before Flop (didn't bet)
Seat 5: Hero folded before Flop (didn't bet)
Seat 6: 2a030a46 collected ($0.25)


Poker Hand #RC2771792301: Hold'em No Limit ($0.05/$0.1) - 2024/08/04 11:04:10
Table 'RushAndCash20807561' 6-max Seat #1 is the button
Seat 1: 4603f18d ($10 in chips)
Seat 2: e60db8b9 ($10 in chips)
Seat 3: Hero ($32.59 in chips)
Seat 4: cec053d1 ($15.19 in chips)
Seat 5: 98fe9892 ($5.13 in chips)
Seat 6: 2bff48f1 ($10.15 in chips)
e60db8b9: posts small blind $0.05
Hero: posts big blind $0.1
*** HOLE CARDS ***
Dealt to 4603f18d 
Dealt to e60db8b9 
Dealt to Hero [9s Qc]
Dealt to cec053d1 
Dealt to 98fe9892 
Dealt to 2bff48f1 
cec053d1: folds
98fe9892: folds
2bff48f1: folds
4603f18d: folds
e60db8b9: folds
Uncalled bet ($0.05) returned to Hero
*** SHOWDOWN ***
Hero collected $0.1 from pot
*** SUMMARY ***
Total pot $0.1 | Rake $0 | Jackpot $0 | Bingo $0 | Fortune $0 | Tax $0
Seat 1: 4603f18d (button) folded before Flop (didn't bet)
Seat 2: e60db8b9 (small blind) folded before Flop
Seat 3: Hero (big blind) collected ($0.1)
Seat 4: cec053d1 folded before Flop (didn't bet)
Seat 5: 98fe9892 folded before Flop (didn't bet)
Seat 6: 2bff48f1 folded before Flop (didn't bet)


Poker Hand #RC2771792241: Hold'em No Limit ($0.05/$0.1) - 2024/08/04 11:04:02
Table 'RushAndCash20807501' 6-max Seat #1 is the button
Seat 1: 10beee26 ($9.35 in chips)
Seat 2: 659b0c2c ($10.4 in chips)
Seat 3: 5eedd38f ($12.16 in chips)
Seat 4: 2d6ece5f ($13.9 in chips)
Seat 5: 21a4c51d ($26.9 in chips)
Seat 6: Hero ($32.59 in chips)
659b0c2c: posts small blind $0.05
5eedd38f: posts big blind $0.1
*** HOLE CARDS ***
Dealt to 10beee26 
Dealt to 659b0c2c 
Dealt to 5eedd38f 
Dealt to 2d6ece5f 
Dealt to 21a4c51d 
Dealt to Hero [2h Qd]
2d6ece5f: folds
21a4c51d: raises $0.1 to $0.2
Hero: folds
10beee26: folds
659b0c2c: folds
5eedd38f: calls $0.1
*** FLOP *** [6s 8h Js]
5eedd38f: checks
21a4c51d: checks
*** TURN *** [6s 8h Js] [5c]
5eedd38f: bets $0.12
21a4c51d: folds
Uncalled bet ($0.12) returned to 5eedd38f
*** SHOWDOWN ***
5eedd38f collected $0.43 from pot
*** SUMMARY ***
Total pot $0.45 | Rake $0.02 | Jackpot $0 | Bingo $0 | Fortune $0 | Tax $0
Board [6s 8h Js 5c]
Seat 1: 10beee26 (button) folded before Flop (didn't bet)
Seat 2: 659b0c2c (small blind) folded before Flop
Seat 3: 5eedd38f (big blind) won ($0.43)
Seat 4: 2d6ece5f folded before Flop (didn't bet)
Seat 5: 21a4c51d folded on the Turn
Seat 6: Hero folded before Flop (didn't bet)


Poker Hand #RC2771792218: Hold'em No Limit ($0.05/$0.1) - 2024/08/04 11:03:58
Table 'RushAndCash20807478' 6-max Seat #1 is the button
Seat 1: 9aeb337a ($19.2 in chips)
Seat 2: f87b4de1 ($10.05 in chips)
Seat 3: c80b913a ($10 in chips)
Seat 4: 44c69b3c ($9.3 in chips)
Seat 5: e79cc73f ($12.12 in chips)
Seat 6: Hero ($32.59 in chips)
f87b4de1: posts small blind $0.05
c80b913a: posts big blind $0.1
*** HOLE CARDS ***
Dealt to 9aeb337a 
Dealt to f87b4de1 
Dealt to c80b913a 
Dealt to 44c69b3c 
Dealt to e79cc73f 
Dealt to Hero [Ad 2h]
44c69b3c: folds
e79cc73f: folds
Hero: folds
9aeb337a: folds
f87b4de1: folds
Uncalled bet ($0.05) returned to c80b913a
*** SHOWDOWN ***
c80b913a collected $0.1 from pot
*** SUMMARY ***
Total pot $0.1 | Rake $0 | Jackpot $0 | Bingo $0 | Fortune $0 | Tax $0
Seat 1: 9aeb337a (button) folded before Flop (didn't bet)
Seat 2: f87b4de1 (small blind) folded before Flop
Seat 3: c80b913a (big blind) collected ($0.1)
Seat 4: 44c69b3c folded before Flop (didn't bet)
Seat 5: e79cc73f folded before Flop (didn't bet)
Seat 6: Hero folded before Flop (didn't bet)


Poker Hand #RC2771792179: Hold'em No Limit ($0.05/$0.1) - 2024/08/04 11:03:53
Table 'RushAndCash20807439' 6-max Seat #1 is the button
Seat 1: Hero ($32.59 in chips)
Seat 2: bcae4591 ($14.73 in chips)
Seat 3: 876c37ae ($13.76 in chips)
Seat 4: bf3bd8d8 ($18.34 in chips)
Seat 5: a868f3c ($15.31 in chips)
Seat 6: b4679fe5 ($26.15 in chips)
bcae4591: posts small blind $0.05
876c37ae: posts big blind $0.1
*** HOLE CARDS ***
Dealt to Hero [2d Jd]
Dealt to bcae4591 
Dealt to 876c37ae 
Dealt to bf3bd8d8 
Dealt to a868f3c 
Dealt to b4679fe5 
bf3bd8d8: folds
a868f3c: folds
b4679fe5: raises $0.2 to $0.3
Hero: folds
bcae4591: folds
876c37ae: folds
Uncalled bet ($0.2) returned to b4679fe5
*** SHOWDOWN ***
b4679fe5 collected $0.25 from pot
*** SUMMARY ***
Total pot $0.25 | Rake $0 | Jackpot $0 | Bingo $0 | Fortune $0 | Tax $0
Seat 1: Hero (button) folded before Flop (didn't bet)
Seat 2: bcae4591 (small blind) folded before Flop
Seat 3: 876c37ae (big blind) folded before Flop
Seat 4: bf3bd8d8 folded before Flop (didn't bet)
Seat 5: a868f3c folded before Flop (didn't bet)
Seat 6: b4679fe5 collected ($0.25)


Poker Hand #RC2771792113: Hold'em No Limit ($0.05/$0.1) - 2024/08/04 11:03:45
Table 'RushAndCash20807373' 6-max Seat #1 is the button
Seat 1: 2db75ef2 ($9.85 in chips)
Seat 2: b51809ba ($10 in chips)
Seat 3: 98bcc404 ($10 in chips)
Seat 4: 45e34926 ($10 in chips)
Seat 5: Hero ($32.59 in chips)
Seat 6: b489763c ($10 in chips)
b51809ba: posts small blind $0.05
98bcc404: posts big blind $0.1
*** HOLE CARDS ***
Dealt to 2db75ef2 
Dealt to b51809ba 
Dealt to 98bcc404 
Dealt to 45e34926 
Dealt to Hero [2s 2c]
Dealt to b489763c 
45e34926: folds
Hero: folds
b489763c: folds
2db75ef2: raises $0.1 to $0.2
b51809ba: folds
98bcc404: folds
Uncalled bet ($0.1) returned to 2db75ef2
*** SHOWDOWN ***
2db75ef2 collected $0.25 from pot
*** SUMMARY ***
Total pot $0.25 | Rake $0 | Jackpot $0 | Bingo $0 | Fortune $0 | Tax $0
Seat 1: 2db75ef2 (button) collected ($0.25)
Seat 2: b51809ba (small blind) folded before Flop
Seat 3: 98bcc404 (big blind) folded before Flop
Seat 4: 45e34926 folded before Flop (didn't bet)
Seat 5: Hero folded before Flop (didn't bet)
Seat 6: b489763c folded before Flop (didn't bet)


Poker Hand #RC2771792075: Hold'em No Limit ($0.05/$0.1) - 2024/08/04 11:03:40
Table 'RushAndCash20807335' 6-max Seat #1 is the button
Seat 1: 3968ffd4 ($10.25 in chips)
Seat 2: 24d88274 ($11.52 in chips)
Seat 3: Hero ($32.69 in chips)
Seat 4: 3104c11b ($11.31 in chips)
Seat 5: 2f6a2c90 ($10.21 in chips)
Seat 6: 194afe9b ($11.57 in chips)
24d88274: posts small blind $0.05
Hero: posts big blind $0.1
*** HOLE CARDS ***
Dealt to 3968ffd4 
Dealt to 24d88274 
Dealt to Hero [4s Jc]
Dealt to 3104c11b 
Dealt to 2f6a2c90 
Dealt to 194afe9b 
3104c11b: folds
2f6a2c90: raises $0.15 to $0.25
194afe9b: folds
3968ffd4: folds
24d88274: folds
Hero: folds
Uncalled bet ($0.15) returned to 2f6a2c90
*** SHOWDOWN ***
2f6a2c90 collected $0.25 from pot
*** SUMMARY ***
Total pot $0.25 | Rake $0 | Jackpot $0 | Bingo $0 | Fortune $0 | Tax $0
Seat 1: 3968ffd4 (button) folded before Flop (didn't bet)
Seat 2: 24d88274 (small blind) folded before Flop
Seat 3: Hero (big blind) folded before Flop
Seat 4: 3104c11b folded before Flop (didn't bet)
Seat 5: 2f6a2c90 collected ($0.25)
Seat 6: 194afe9b folded before Flop (didn't bet)


Poker Hand #RC2771791956: Hold'em No Limit ($0.05/$0.1) - 2024/08/04 11:03:25
Table 'RushAndCash20807216' 6-max Seat #1 is the button
Seat 1: Hero ($32.54 in chips)
Seat 2: 5b433531 ($13.22 in chips)
Seat 3: b70da252 ($26.43 in chips)
Seat 4: 2b9b2434 ($10.05 in chips)
Seat 5: a8ea288c ($10.42 in chips)
Seat 6: 8223212b ($10 in chips)
5b433531: posts small blind $0.05
b70da252: posts big blind $0.1
*** HOLE CARDS ***
Dealt to Hero [Ad Js]
Dealt to 5b433531 
Dealt to b70da252 
Dealt to 2b9b2434 
Dealt to a8ea288c 
Dealt to 8223212b 
2b9b2434: folds
a8ea288c: folds
8223212b: folds
Hero: raises $0.14 to $0.24
5b433531: folds
b70da252: folds
Uncalled bet ($0.14) returned to Hero
*** SHOWDOWN ***
Hero collected $0.25 from pot
*** SUMMARY ***
Total pot $0.25 | Rake $0 | Jackpot $0 | Bingo $0 | Fortune $0 | Tax $0
Seat 1: Hero (button) collected ($0.25)
Seat 2: 5b433531 (small blind) folded before Flop
Seat 3: b70da252 (big blind) folded before Flop
Seat 4: 2b9b2434 folded before Flop (didn't bet)
Seat 5: a8ea288c folded before Flop (didn't bet)
Seat 6: 8223212b folded before Flop (didn't bet)


Poker Hand #RC2771791737: Hold'em No Limit ($0.05/$0.1) - 2024/08/04 11:02:53
Table 'RushAndCash20806997' 6-max Seat #1 is the button
Seat 1: 99589e60 ($10.4 in chips)
Seat 2: Hero ($31.45 in chips)
Seat 3: ec81b7e ($10 in chips)
Seat 4: 937b4f02 ($4.91 in chips)
Seat 5: b70da252 ($27.53 in chips)
Seat 6: 4fb5bda6 ($10.3 in chips)
Hero: posts small blind $0.05
ec81b7e: posts big blind $0.1
*** HOLE CARDS ***
Dealt to 99589e60 
Dealt to Hero [Ac Ks]
Dealt to ec81b7e 
Dealt to 937b4f02 
Dealt to b70da252 
Dealt to 4fb5bda6 
937b4f02: folds
b70da252: raises $0.1 to $0.2
4fb5bda6: folds
99589e60: folds
Hero: raises $0.9 to $1.1
ec81b7e: folds
b70da252: calls $0.9
*** FLOP *** [4d Jh Td]
Hero: bets $1.1
b70da252: folds
Uncalled bet ($1.1) returned to Hero
*** SHOWDOWN ***
Hero collected $2.19 from pot
*** SUMMARY ***
Total pot $2.3 | Rake $0.11 | Jackpot $0 | Bingo $0 | Fortune $0 | Tax $0
Board [4d Jh Td]
Seat 1: 99589e60 (button) folded before Flop (didn't bet)
Seat 2: Hero (small blind) won ($2.19)
Seat 3: ec81b7e (big blind) folded before Flop
Seat 4: 937b4f02 folded before Flop (didn't bet)
Seat 5: b70da252 folded on the Flop
Seat 6: 4fb5bda6 folded before Flop (didn't bet)


Poker Hand #RC2771791690: Hold'em No Limit ($0.05/$0.1) - 2024/08/04 11:02:47
Table 'RushAndCash20806950' 6-max Seat #1 is the button
Seat 1: 483620e3 ($18.19 in chips)
Seat 2: Hero ($31.5 in chips)
Seat 3: c40d6b6a ($14.66 in chips)
Seat 4: a92842bb ($12 in chips)
Seat 5: 83e14b1c ($10.43 in chips)
Seat 6: 7bedf974 ($10.85 in chips)
Hero: posts small blind $0.05
c40d6b6a: posts big blind $0.1
*** HOLE CARDS ***
Dealt to 483620e3 
Dealt to Hero [Ad 7h]
Dealt to c40d6b6a 
Dealt to a92842bb 
Dealt to 83e14b1c 
Dealt to 7bedf974 
a92842bb: folds
83e14b1c: raises $0.1 to $0.2
7bedf974: folds
483620e3: folds
Hero: folds
c40d6b6a: folds
Uncalled bet ($0.1) returned to 83e14b1c
*** SHOWDOWN ***
83e14b1c collected $0.25 from pot
*** SUMMARY ***
Total pot $0.25 | Rake $0 | Jackpot $0 | Bingo $0 | Fortune $0 | Tax $0
Seat 1: 483620e3 (button) folded before Flop (didn't bet)
Seat 2: Hero (small blind) folded before Flop
Seat 3: c40d6b6a (big blind) folded before Flop
Seat 4: a92842bb folded before Flop (didn't bet)
Seat 5: 83e14b1c collected ($0.25)
Seat 6: 7bedf974 folded before Flop (didn't bet)


Poker Hand #RC2771791660: Hold'em No Limit ($0.05/$0.1) - 2024/08/04 11:02:43
Table 'RushAndCash20806920' 6-max Seat #1 is the button
Seat 1: 133a3a48 ($10.29 in chips)
Seat 2: 8b956d00 ($11.36 in chips)
Seat 3: 24c4b23f ($22.88 in chips)
Seat 4: 558fbc32 ($15.83 in chips)
Seat 5: Hero ($31.5 in chips)
Seat 6: 5135b9f4 ($23.41 in chips)
8b956d00: posts small blind $0.05
24c4b23f: posts big blind $0.1
*** HOLE CARDS ***
Dealt to 133a3a48 
Dealt to 8b956d00 
Dealt to 24c4b23f 
Dealt to 558fbc32 
Dealt to Hero [Kc 9d]
Dealt to 5135b9f4 
558fbc32: folds
Hero: folds
5135b9f4: folds
133a3a48: folds
8b956d00: folds
Uncalled bet ($0.05) returned to 24c4b23f
*** SHOWDOWN ***
24c4b23f collected $0.1 from pot
*** SUMMARY ***
Total pot $0.1 | Rake $0 | Jackpot $0 | Bingo $0 | Fortune $0 | Tax $0
Seat 1: 133a3a48 (button) folded before Flop (didn't bet)
Seat 2: 8b956d00 (small blind) folded before Flop
Seat 3: 24c4b23f (big blind) collected ($0.1)
Seat 4: 558fbc32 folded before Flop (didn't bet)
Seat 5: Hero folded before Flop (didn't bet)
Seat 6: 5135b9f4 folded before Flop (didn't bet)


Poker Hand #RC2771791637: Hold'em No Limit ($0.05/$0.1) - 2024/08/04 11:02:39
Table 'RushAndCash20806897' 6-max Seat #1 is the button
Seat 1: 84bdbe67 ($18.29 in chips)
Seat 2: f18f5d5c ($9.6 in chips)
Seat 3: 76355958 ($10.19 in chips)
Seat 4: Hero ($31.5 in chips)
Seat 5: 33261387 ($4.15 in chips)
Seat 6: a80d90a1 ($10.04 in chips)
f18f5d5c: posts small blind $0.05
76355958: posts big blind $0.1
*** HOLE CARDS ***
Dealt to 84bdbe67 
Dealt to f18f5d5c 
Dealt to 76355958 
Dealt to Hero [6c 5s]
Dealt to 33261387 
Dealt to a80d90a1 
Hero: folds
33261387: folds
a80d90a1: calls $0.1
84bdbe67: folds
f18f5d5c: raises $0.3 to $0.4
76355958: folds
a80d90a1: calls $0.3
*** FLOP *** [9d 8h Jh]
f18f5d5c: checks
a80d90a1: bets $0.68
f18f5d5c: calls $0.68
*** TURN *** [9d 8h Jh] [4c]
f18f5d5c: checks
a80d90a1: checks
*** RIVER *** [9d 8h Jh 4c] [3s]
f18f5d5c: checks
a80d90a1: checks
f18f5d5c: shows [Qh Qs] (Pair of Queens)
a80d90a1: shows [Qc Js] (Pair of Jacks)
*** SHOWDOWN ***
f18f5d5c collected $2.15 from pot
*** SUMMARY ***
Total pot $2.26 | Rake $0.11 | Jackpot $0 | Bingo $0 | Fortune $0 | Tax $0
Board [9d 8h Jh 4c 3s]
Seat 1: 84bdbe67 (button) folded before Flop (didn't bet)
Seat 2: f18f5d5c (small blind) showed [Qh Qs] and won ($2.15) with Pair of Queens
Seat 3: 76355958 (big blind) folded before Flop
Seat 4: Hero folded before Flop (didn't bet)
Seat 5: 33261387 folded before Flop (didn't bet)
Seat 6: a80d90a1 showed [Qc Js] and lost with Pair of Jacks


Poker Hand #RC2771791502: Hold'em No Limit ($0.05/$0.1) - 2024/08/04 11:02:22
Table 'RushAndCash20806762' 6-max Seat #1 is the button
Seat 1: Hero ($31.35 in chips)
Seat 2: 9148d4b9 ($10.7 in chips)
Seat 3: b211a166 ($10 in chips)
Seat 4: b12ec176 ($6.8 in chips)
Seat 5: 3842342c ($13.77 in chips)
Seat 6: 5c2ef128 ($32.01 in chips)
9148d4b9: posts small blind $0.05
b211a166: posts big blind $0.1
*** HOLE CARDS ***
Dealt to Hero [Jc 9h]
Dealt to 9148d4b9 
Dealt to b211a166 
Dealt to b12ec176 
Dealt to 3842342c 
Dealt to 5c2ef128 
b12ec176: folds
3842342c: folds
5c2ef128: folds
Hero: raises $0.14 to $0.24
9148d4b9: folds
b211a166: folds
Uncalled bet ($0.14) returned to Hero
*** SHOWDOWN ***
Hero collected $0.25 from pot
*** SUMMARY ***
Total pot $0.25 | Rake $0 | Jackpot $0 | Bingo $0 | Fortune $0 | Tax $0
Seat 1: Hero (button) collected ($0.25)
Seat 2: 9148d4b9 (small blind) folded before Flop
Seat 3: b211a166 (big blind) folded before Flop
Seat 4: b12ec176 folded before Flop (didn't bet)
Seat 5: 3842342c folded before Flop (didn't bet)
Seat 6: 5c2ef128 folded before Flop (didn't bet)


Poker Hand #RC2771791475: Hold'em No Limit ($0.05/$0.1) - 2024/08/04 11:02:19
Table 'RushAndCash20806735' 6-max Seat #1 is the button
Seat 1: 993cf2a5 ($9.85 in chips)
Seat 2: 17d32a3f ($10.57 in chips)
Seat 3: Hero ($31.45 in chips)
Seat 4: e6e8601a ($28.4 in chips)
Seat 5: cba97507 ($10 in chips)
Seat 6: 5db9c6b8 ($10 in chips)
17d32a3f: posts small blind $0.05
Hero: posts big blind $0.1
*** HOLE CARDS ***
Dealt to 993cf2a5 
Dealt to 17d32a3f 
Dealt to Hero [2s Kh]
Dealt to e6e8601a 
Dealt to cba97507 
Dealt to 5db9c6b8 
e6e8601a: folds
cba97507: folds
5db9c6b8: folds
993cf2a5: folds
17d32a3f: raises $0.1 to $0.2
Hero: folds
Uncalled bet ($0.1) returned to 17d32a3f
*** SHOWDOWN ***
17d32a3f collected $0.2 from pot
*** SUMMARY ***
Total pot $0.2 | Rake $0 | Jackpot $0 | Bingo $0 | Fortune $0 | Tax $0
Seat 1: 993cf2a5 (button) folded before Flop (didn't bet)
Seat 2: 17d32a3f (small blind) collected ($0.2)
Seat 3: Hero (big blind) folded before Flop
Seat 4: e6e8601a folded before Flop (didn't bet)
Seat 5: cba97507 folded before Flop (didn't bet)
Seat 6: 5db9c6b8 folded before Flop (didn't bet)


Poker Hand #RC2771791449: Hold'em No Limit ($0.05/$0.1) - 2024/08/04 11:02:16
Table 'RushAndCash20806709' 6-max Seat #1 is the button
Seat 1: 2b7c9c19 ($10.56 in chips)
Seat 2: 11db0024 ($14.25 in chips)
Seat 3: f3ad8fc0 ($10.9 in chips)
Seat 4: Hero ($31.45 in chips)
Seat 5: 5e3d12d6 ($12.16 in chips)
Seat 6: 59b76ee2 ($10.42 in chips)
11db0024: posts small blind $0.05
f3ad8fc0: posts big blind $0.1
*** HOLE CARDS ***
Dealt to 2b7c9c19 
Dealt to 11db0024 
Dealt to f3ad8fc0 
Dealt to Hero [8s 4s]
Dealt to 5e3d12d6 
Dealt to 59b76ee2 
Hero: folds
5e3d12d6: raises $0.1 to $0.2
59b76ee2: folds
2b7c9c19: folds
11db0024: raises $0.95 to $1.15
f3ad8fc0: folds
5e3d12d6: folds
Uncalled bet ($0.95) returned to 11db0024
*** SHOWDOWN ***
11db0024 collected $0.48 from pot
*** SUMMARY ***
Total pot $0.5 | Rake $0.02 | Jackpot $0 | Bingo $0 | Fortune $0 | Tax $0
Seat 1: 2b7c9c19 (button) folded before Flop (didn't bet)
Seat 2: 11db0024 (small blind) collected ($0.48)
Seat 3: f3ad8fc0 (big blind) folded before Flop
Seat 4: Hero folded before Flop (didn't bet)
Seat 5: 5e3d12d6 folded before Flop
Seat 6: 59b76ee2 folded before Flop (didn't bet)


Poker Hand #RC2771791421: Hold'em No Limit ($0.05/$0.1) - 2024/08/04 11:02:12
Table 'RushAndCash20806681' 6-max Seat #1 is the button
Seat 1: 1e435647 ($10 in chips)
Seat 2: 13269ce ($13.54 in chips)
Seat 3: a1a3c459 ($18.54 in chips)
Seat 4: 5edaaafb ($10 in chips)
Seat 5: Hero ($31.45 in chips)
Seat 6: cba97507 ($10 in chips)
13269ce: posts small blind $0.05
a1a3c459: posts big blind $0.1
*** HOLE CARDS ***
Dealt to 1e435647 
Dealt to 13269ce 
Dealt to a1a3c459 
Dealt to 5edaaafb 
Dealt to Hero [6c 4h]
Dealt to cba97507 
5edaaafb: folds
Hero: folds
cba97507: folds
1e435647: folds
13269ce: raises $0.2 to $0.3
a1a3c459: calls $0.2
*** FLOP *** [5c 8d Jh]
13269ce: checks
a1a3c459: bets $0.3
13269ce: folds
Uncalled bet ($0.3) returned to a1a3c459
*** SHOWDOWN ***
a1a3c459 collected $0.57 from pot
*** SUMMARY ***
Total pot $0.6 | Rake $0.03 | Jackpot $0 | Bingo $0 | Fortune $0 | Tax $0
Board [5c 8d Jh]
Seat 1: 1e435647 (button) folded before Flop (didn't bet)
Seat 2: 13269ce (small blind) folded on the Flop
Seat 3: a1a3c459 (big blind) won ($0.57)
Seat 4: 5edaaafb folded before Flop (didn't bet)
Seat 5: Hero folded before Flop (didn't bet)
Seat 6: cba97507 folded before Flop (didn't bet)


Poker Hand #RC2771791392: Hold'em No Limit ($0.05/$0.1) - 2024/08/04 11:02:09
Table 'RushAndCash20806652' 6-max Seat #1 is the button
Seat 1: 5ad402a1 ($10.73 in chips)
Seat 2: 4f7435d8 ($10 in chips)
Seat 3: 53315b3b ($12.5 in chips)
Seat 4: Hero ($31.45 in chips)
Seat 5: 50fe8237 ($9.1 in chips)
Seat 6: e8f000d8 ($15.95 in chips)
4f7435d8: posts small blind $0.05
53315b3b: posts big blind $0.1
*** HOLE CARDS ***
Dealt to 5ad402a1 
Dealt to 4f7435d8 
Dealt to 53315b3b 
Dealt to Hero [4s Jd]
Dealt to 50fe8237 
Dealt to e8f000d8 
Hero: folds
50fe8237: raises $0.1 to $0.2
e8f000d8: folds
5ad402a1: calls $0.2
4f7435d8: folds
53315b3b: folds
*** FLOP *** [8d Ad 5c]
50fe8237: bets $0.19
5ad402a1: raises $0.41 to $0.6
50fe8237: calls $0.41
*** TURN *** [8d Ad 5c] [5d]
50fe8237: checks
5ad402a1: bets $1.25
50fe8237: calls $1.25
*** RIVER *** [8d Ad 5c 5d] [Th]
50fe8237: checks
5ad402a1: checks
50fe8237: shows [Ts As] (Pair of Aces and Pair of Tens)
5ad402a1: shows [7c 7h] (Pair of Sevens and Pair of Fives)
*** SHOWDOWN ***
50fe8237 collected $3.9 from pot
*** SUMMARY ***
Total pot $4.25 | Rake $0.2 | Jackpot $0.15 | Bingo $0 | Fortune $0 | Tax $0
Board [8d Ad 5c 5d Th]
Seat 1: 5ad402a1 (button) showed [7c 7h] and lost with Pair of Sevens and Pair of Fives
Seat 2: 4f7435d8 (small blind) folded before Flop
Seat 3: 53315b3b (big blind) folded before Flop
Seat 4: Hero folded before Flop (didn't bet)
Seat 5: 50fe8237 showed [Ts As] and won ($3.9) with Pair of Aces and Pair of Tens
Seat 6: e8f000d8 folded before Flop (didn't bet)


Poker Hand #RC2771791364: Hold'em No Limit ($0.05/$0.1) - 2024/08/04 11:02:06
Table 'RushAndCash20806624' 6-max Seat #1 is the button
Seat 1: fd5037a1 ($11.95 in chips)
Seat 2: c21f392c ($10.15 in chips)
Seat 3: 84aabf56 ($11.76 in chips)
Seat 4: c9efcb5e ($15.73 in chips)
Seat 5: 34c80376 ($10 in chips)
Seat 6: Hero ($31.45 in chips)
c21f392c: posts small blind $0.05
84aabf56: posts big blind $0.1
*** HOLE CARDS ***
Dealt to fd5037a1 
Dealt to c21f392c 
Dealt to 84aabf56 
Dealt to c9efcb5e 
Dealt to 34c80376 
Dealt to Hero [5s 4d]
c9efcb5e: folds
34c80376: folds
Hero: folds
fd5037a1: raises $0.14 to $0.24
c21f392c: raises $0.76 to $1
84aabf56: folds
fd5037a1: folds
Uncalled bet ($0.76) returned to c21f392c
*** SHOWDOWN ***
c21f392c collected $0.56 from pot
*** SUMMARY ***
Total pot $0.58 | Rake $0.02 | Jackpot $0 | Bingo $0 | Fortune $0 | Tax $0
Seat 1: fd5037a1 (button) folded before Flop
Seat 2: c21f392c (small blind) collected ($0.56)
Seat 3: 84aabf56 (big blind) folded before Flop
Seat 4: c9efcb5e folded before Flop (didn't bet)
Seat 5: 34c80376 folded before Flop (didn't bet)
Seat 6: Hero folded before Flop (didn't bet)


Poker Hand #RC2771791333: Hold'em No Limit ($0.05/$0.1) - 2024/08/04 11:02:02
Table 'RushAndCash20806593' 6-max Seat #1 is the button
Seat 1: befffaf9 ($15.16 in chips)
Seat 2: 8bf101c5 ($12.99 in chips)
Seat 3: 2a030a46 ($14.07 in chips)
Seat 4: 937b4f02 ($4.76 in chips)
Seat 5: eee2529e ($33.88 in chips)
Seat 6: Hero ($31.45 in chips)
8bf101c5: posts small blind $0.05
2a030a46: posts big blind $0.1
*** HOLE CARDS ***
Dealt to befffaf9 
Dealt to 8bf101c5 
Dealt to 2a030a46 
Dealt to 937b4f02 
Dealt to eee2529e 
Dealt to Hero [7h Td]
937b4f02: raises $0.1 to $0.2
eee2529e: folds
Hero: folds
befffaf9: folds
8bf101c5: folds
2a030a46: folds
Uncalled bet ($0.1) returned to 937b4f02
*** SHOWDOWN ***
937b4f02 collected $0.25 from pot
*** SUMMARY ***
Total pot $0.25 | Rake $0 | Jackpot $0 | Bingo $0 | Fortune $0 | Tax $0
Seat 1: befffaf9 (button) folded before Flop (didn't bet)
Seat 2: 8bf101c5 (small blind) folded before Flop
Seat 3: 2a030a46 (big blind) folded before Flop
Seat 4: 937b4f02 collected ($0.25)
Seat 5: eee2529e folded before Flop (didn't bet)
Seat 6: Hero folded before Flop (didn't bet)


Poker Hand #RC2771791306: Hold'em No Limit ($0.05/$0.1) - 2024/08/04 11:01:59
Table 'RushAndCash20806566' 6-max Seat #1 is the button
Seat 1: Hero ($31.45 in chips)
Seat 2: 6b66b44d ($14.85 in chips)
Seat 3: c3b93fde ($10 in chips)
Seat 4: f094a7c6 ($19.95 in chips)
Seat 5: ecc6c814 ($14.04 in chips)
Seat 6: 2d348a1a ($10.57 in chips)
6b66b44d: posts small blind $0.05
c3b93fde: posts big blind $0.1
*** HOLE CARDS ***
Dealt to Hero [4d 7c]
Dealt to 6b66b44d 
Dealt to c3b93fde 
Dealt to f094a7c6 
Dealt to ecc6c814 
Dealt to 2d348a1a 
f094a7c6: folds
ecc6c814: folds
2d348a1a: folds
Hero: folds
6b66b44d: folds
Uncalled bet ($0.05) returned to c3b93fde
*** SHOWDOWN ***
c3b93fde collected $0.1 from pot
*** SUMMARY ***
Total pot $0.1 | Rake $0 | Jackpot $0 | Bingo $0 | Fortune $0 | Tax $0
Seat 1: Hero (button) folded before Flop (didn't bet)
Seat 2: 6b66b44d (small blind) folded before Flop
Seat 3: c3b93fde (big blind) collected ($0.1)
Seat 4: f094a7c6 folded before Flop (didn't bet)
Seat 5: ecc6c814 folded before Flop (didn't bet)
Seat 6: 2d348a1a folded before Flop (didn't bet)


Poker Hand #RC2771791267: Hold'em No Limit ($0.05/$0.1) - 2024/08/04 11:01:54
Table 'RushAndCash20806527' 6-max Seat #1 is the button
Seat 1: bf68cd69 ($10.64 in chips)
Seat 2: 50a4c672 ($12.16 in chips)
Seat 3: Hero ($31.55 in chips)
Seat 4: 876c37ae ($14.11 in chips)
Seat 5: dfda616e ($17.98 in chips)
Seat 6: c80b913a ($10 in chips)
50a4c672: posts small blind $0.05
Hero: posts big blind $0.1
*** HOLE CARDS ***
Dealt to bf68cd69 
Dealt to 50a4c672 
Dealt to Hero [Qh 7d]
Dealt to 876c37ae 
Dealt to dfda616e 
Dealt to c80b913a 
876c37ae: raises $0.1 to $0.2
dfda616e: folds
c80b913a: folds
bf68cd69: folds
50a4c672: folds
Hero: folds
Uncalled bet ($0.1) returned to 876c37ae
*** SHOWDOWN ***
876c37ae collected $0.25 from pot
*** SUMMARY ***
Total pot $0.25 | Rake $0 | Jackpot $0 | Bingo $0 | Fortune $0 | Tax $0
Seat 1: bf68cd69 (button) folded before Flop (didn't bet)
Seat 2: 50a4c672 (small blind) folded before Flop
Seat 3: Hero (big blind) folded before Flop
Seat 4: 876c37ae collected ($0.25)
Seat 5: dfda616e folded before Flop (didn't bet)
Seat 6: c80b913a folded before Flop (didn't bet)


Poker Hand #RC2771791178: Hold'em No Limit ($0.05/$0.1) - 2024/08/04 11:01:43
Table 'RushAndCash20806438' 6-max Seat #1 is the button
Seat 1: 2d679fab ($20.84 in chips)
Seat 2: Hero ($31.6 in chips)
Seat 3: c527a092 ($15.52 in chips)
Seat 4: 29dd9a6d ($10.1 in chips)
Seat 5: ad7caea4 ($6.07 in chips)
Seat 6: fafe1b48 ($25.47 in chips)
Hero: posts small blind $0.05
c527a092: posts big blind $0.1
*** HOLE CARDS ***
Dealt to 2d679fab 
Dealt to Hero [9d Qd]
Dealt to c527a092 
Dealt to 29dd9a6d 
Dealt to ad7caea4 
Dealt to fafe1b48 
29dd9a6d: folds
ad7caea4: folds
fafe1b48: raises $0.15 to $0.25
2d679fab: folds
Hero: folds
c527a092: folds
Uncalled bet ($0.15) returned to fafe1b48
*** SHOWDOWN ***
fafe1b48 collected $0.25 from pot
*** SUMMARY ***
Total pot $0.25 | Rake $0 | Jackpot $0 | Bingo $0 | Fortune $0 | Tax $0
Seat 1: 2d679fab (button) folded before Flop (didn't bet)
Seat 2: Hero (small blind) folded before Flop
Seat 3: c527a092 (big blind) folded before Flop
Seat 4: 29dd9a6d folded before Flop (didn't bet)
Seat 5: ad7caea4 folded before Flop (didn't bet)
Seat 6: fafe1b48 collected ($0.25)


Poker Hand #RC2771791143: Hold'em No Limit ($0.05/$0.1) - 2024/08/04 11:01:38
Table 'RushAndCash20806403' 6-max Seat #1 is the button
Seat 1: eee2529e ($33.68 in chips)
Seat 2: e84bb4a6 ($21.17 in chips)
Seat 3: cd9b5f04 ($15.74 in chips)
Seat 4: 23f152ed ($16.36 in chips)
Seat 5: Hero ($31.6 in chips)
Seat 6: f4e67b8a ($10 in chips)
e84bb4a6: posts small blind $0.05
cd9b5f04: posts big blind $0.1
*** HOLE CARDS ***
Dealt to eee2529e 
Dealt to e84bb4a6 
Dealt to cd9b5f04 
Dealt to 23f152ed 
Dealt to Hero [5c 8h]
Dealt to f4e67b8a 
23f152ed: folds
Hero: folds
f4e67b8a: folds
eee2529e: raises $0.12 to $0.22
e84bb4a6: folds
cd9b5f04: folds
Uncalled bet ($0.12) returned to eee2529e
*** SHOWDOWN ***
eee2529e collected $0.25 from pot
*** SUMMARY ***
Total pot $0.25 | Rake $0 | Jackpot $0 | Bingo $0 | Fortune $0 | Tax $0
Seat 1: eee2529e (button) collected ($0.25)
Seat 2: e84bb4a6 (small blind) folded before Flop
Seat 3: cd9b5f04 (big blind) folded before Flop
Seat 4: 23f152ed folded before Flop (didn't bet)
Seat 5: Hero folded before Flop (didn't bet)
Seat 6: f4e67b8a folded before Flop (didn't bet)


Poker Hand #RC2771791096: Hold'em No Limit ($0.05/$0.1) - 2024/08/04 11:01:33
Table 'RushAndCash20806356' 6-max Seat #1 is the button
Seat 1: 934c3676 ($7.74 in chips)
Seat 2: 2d679fab ($20.89 in chips)
Seat 3: 8c3b41e9 ($14.12 in chips)
Seat 4: ccada4b7 ($29 in chips)
Seat 5: 53dfb2e2 ($16.41 in chips)
Seat 6: Hero ($31.6 in chips)
2d679fab: posts small blind $0.05
8c3b41e9: posts big blind $0.1
*** HOLE CARDS ***
Dealt to 934c3676 
Dealt to 2d679fab 
Dealt to 8c3b41e9 
Dealt to ccada4b7 
Dealt to 53dfb2e2 
Dealt to Hero [Qc 8d]
ccada4b7: folds
53dfb2e2: folds
Hero: folds
934c3676: folds
2d679fab: folds
Uncalled bet ($0.05) returned to 8c3b41e9
*** SHOWDOWN ***
8c3b41e9 collected $0.1 from pot
*** SUMMARY ***
Total pot $0.1 | Rake $0 | Jackpot $0 | Bingo $0 | Fortune $0 | Tax $0
Seat 1: 934c3676 (button) folded before Flop (didn't bet)
Seat 2: 2d679fab (small blind) folded before Flop
Seat 3: 8c3b41e9 (big blind) collected ($0.1)
Seat 4: ccada4b7 folded before Flop (didn't bet)
Seat 5: 53dfb2e2 folded before Flop (didn't bet)
Seat 6: Hero folded before Flop (didn't bet)


Poker Hand #RC2771791005: Hold'em No Limit ($0.05/$0.1) - 2024/08/04 11:01:21
Table 'RushAndCash20806265' 6-max Seat #1 is the button
Seat 1: dec8ca00 ($8.6 in chips)
Seat 2: d880dc03 ($10.16 in chips)
Seat 3: Hero ($31.7 in chips)
Seat 4: d0f4fa1f ($10 in chips)
Seat 5: fe9e1fc ($14.7 in chips)
Seat 6: 40ac5fa3 ($10 in chips)
d880dc03: posts small blind $0.05
Hero: posts big blind $0.1
*** HOLE CARDS ***
Dealt to dec8ca00 
Dealt to d880dc03 
Dealt to Hero [7c Tc]
Dealt to d0f4fa1f 
Dealt to fe9e1fc 
Dealt to 40ac5fa3 
d0f4fa1f: folds
fe9e1fc: folds
40ac5fa3: folds
dec8ca00: folds
d880dc03: raises $0.1 to $0.2
Hero: folds
Uncalled bet ($0.1) returned to d880dc03
*** SHOWDOWN ***
d880dc03 collected $0.2 from pot
*** SUMMARY ***
Total pot $0.2 | Rake $0 | Jackpot $0 | Bingo $0 | Fortune $0 | Tax $0
Seat 1: dec8ca00 (button) folded before Flop (didn't bet)
Seat 2: d880dc03 (small blind) collected ($0.2)
Seat 3: Hero (big blind) folded before Flop
Seat 4: d0f4fa1f folded before Flop (didn't bet)
Seat 5: fe9e1fc folded before Flop (didn't bet)
Seat 6: 40ac5fa3 folded before Flop (didn't bet)


Poker Hand #RC2771790970: Hold'em No Limit ($0.05/$0.1) - 2024/08/04 11:01:17
Table 'RushAndCash20806230' 6-max Seat #1 is the button
Seat 1: fa3df3b8 ($9.9 in chips)
Seat 2: 6459661b ($10.05 in chips)
Seat 3: 9fb56cd8 ($10.46 in chips)
Seat 4: Hero ($31.7 in chips)
Seat 5: de9bdfb1 ($10.79 in chips)
Seat 6: be383a91 ($14.55 in chips)
6459661b: posts small blind $0.05
9fb56cd8: posts big blind $0.1
*** HOLE CARDS ***
Dealt to fa3df3b8 
Dealt to 6459661b 
Dealt to 9fb56cd8 
Dealt to Hero [Jc 6c]
Dealt to de9bdfb1 
Dealt to be383a91 
Hero: folds
de9bdfb1: folds
be383a91: folds
fa3df3b8: folds
6459661b: raises $0.15 to $0.25
9fb56cd8: folds
Uncalled bet ($0.15) returned to 6459661b
*** SHOWDOWN ***
6459661b collected $0.2 from pot
*** SUMMARY ***
Total pot $0.2 | Rake $0 | Jackpot $0 | Bingo $0 | Fortune $0 | Tax $0
Seat 1: fa3df3b8 (button) folded before Flop (didn't bet)
Seat 2: 6459661b (small blind) collected ($0.2)
Seat 3: 9fb56cd8 (big blind) folded before Flop
Seat 4: Hero folded before Flop (didn't bet)
Seat 5: de9bdfb1 folded before Flop (didn't bet)
Seat 6: be383a91 folded before Flop (didn't bet)


Poker Hand #RC2771790921: Hold'em No Limit ($0.05/$0.1) - 2024/08/04 11:01:10
Table 'RushAndCash20806181' 6-max Seat #1 is the button
Seat 1: Hero ($31.7 in chips)
Seat 2: 5438f3e7 ($12.62 in chips)
Seat 3: e8b25c4e ($11.26 in chips)
Seat 4: 45609dce ($10 in chips)
Seat 5: 3968ffd4 ($10 in chips)
Seat 6: 7d7a37cc ($10.1 in chips)
5438f3e7: posts small blind $0.05
e8b25c4e: posts big blind $0.1
*** HOLE CARDS ***
Dealt to Hero [Th 5h]
Dealt to 5438f3e7 
Dealt to e8b25c4e 
Dealt to 45609dce 
Dealt to 3968ffd4 
Dealt to 7d7a37cc 
45609dce: folds
3968ffd4: folds
7d7a37cc: folds
Hero: folds
5438f3e7: folds
Uncalled bet ($0.05) returned to e8b25c4e
*** SHOWDOWN ***
e8b25c4e collected $0.1 from pot
*** SUMMARY ***
Total pot $0.1 | Rake $0 | Jackpot $0 | Bingo $0 | Fortune $0 | Tax $0
Seat 1: Hero (button) folded before Flop (didn't bet)
Seat 2: 5438f3e7 (small blind) folded before Flop
Seat 3: e8b25c4e (big blind) collected ($0.1)
Seat 4: 45609dce folded before Flop (didn't bet)
Seat 5: 3968ffd4 folded before Flop (didn't bet)
Seat 6: 7d7a37cc folded before Flop (didn't bet)


Poker Hand #RC2771790829: Hold'em No Limit ($0.05/$0.1) - 2024/08/04 11:00:59
Table 'RushAndCash20806089' 6-max Seat #1 is the button
Seat 1: 45bf4575 ($12.14 in chips)
Seat 2: Hero ($31.75 in chips)
Seat 3: bcec1907 ($10.1 in chips)
Seat 4: 5793462e ($12.11 in chips)
Seat 5: 95e39858 ($10 in chips)
Seat 6: 55a4f50d ($20.83 in chips)
Cash Drop to Pot : total $1 
Hero: posts small blind $0.05
bcec1907: posts big blind $0.1
*** HOLE CARDS ***
Dealt to 45bf4575 
Dealt to Hero [3c Th]
Dealt to bcec1907 
Dealt to 5793462e 
Dealt to 95e39858 
Dealt to 55a4f50d 
5793462e: calls $0.1
95e39858: raises $0.9 to $1
55a4f50d: folds
45bf4575: folds
Hero: folds
bcec1907: folds
5793462e: calls $0.9
*** FLOP *** [3d 7c 4c]
5793462e: checks
95e39858: bets $1.05
5793462e: raises $10.06 to $11.11 and is all-in
95e39858: folds
Uncalled bet ($10.06) returned to 5793462e
*** SHOWDOWN ***
5793462e collected $4.85 from pot
*** SUMMARY ***
Total pot $5.25 | Rake $0.25 | Jackpot $0.15 | Bingo $0 | Fortune $0 | Tax $0
Board [3d 7c 4c]
Seat 1: 45bf4575 (button) folded before Flop (didn't bet)
Seat 2: Hero (small blind) folded before Flop
Seat 3: bcec1907 (big blind) folded before Flop
Seat 4: 5793462e won ($4.85)
Seat 5: 95e39858 folded on the Flop
Seat 6: 55a4f50d folded before Flop (didn't bet)


Poker Hand #RC2771790786: Hold'em No Limit ($0.05/$0.1) - 2024/08/04 11:00:54
Table 'RushAndCash20806046' 6-max Seat #1 is the button
Seat 1: Hero ($31.75 in chips)
Seat 2: 15c99835 ($10.54 in chips)
Seat 3: d50058e4 ($16.82 in chips)
Seat 4: 9e7706ef ($11.07 in chips)
Seat 5: 937b4f02 ($5.11 in chips)
Seat 6: 4445ff51 ($14.37 in chips)
15c99835: posts small blind $0.05
d50058e4: posts big blind $0.1
*** HOLE CARDS ***
Dealt to Hero [Th 7c]
Dealt to 15c99835 
Dealt to d50058e4 
Dealt to 9e7706ef 
Dealt to 937b4f02 
Dealt to 4445ff51 
9e7706ef: raises $0.1 to $0.2
937b4f02: folds
4445ff51: folds
Hero: folds
15c99835: folds
d50058e4: calls $0.1
*** FLOP *** [2d 7s 6s]
d50058e4: checks
9e7706ef: bets $0.34
d50058e4: calls $0.34
*** TURN *** [2d 7s 6s] [Ad]
d50058e4: checks
9e7706ef: bets $0.85
d50058e4: folds
Uncalled bet ($0.85) returned to 9e7706ef
*** SHOWDOWN ***
9e7706ef collected $1.08 from pot
*** SUMMARY ***
Total pot $1.13 | Rake $0.05 | Jackpot $0 | Bingo $0 | Fortune $0 | Tax $0
Board [2d 7s 6s Ad]
Seat 1: Hero (button) folded before Flop (didn't bet)
Seat 2: 15c99835 (small blind) folded before Flop
Seat 3: d50058e4 (big blind) folded on the Turn
Seat 4: 9e7706ef won ($1.08)
Seat 5: 937b4f02 folded before Flop (didn't bet)
Seat 6: 4445ff51 folded before Flop (didn't bet)


Poker Hand #RC2771790760: Hold'em No Limit ($0.05/$0.1) - 2024/08/04 11:00:50
Table 'RushAndCash20806020' 6-max Seat #1 is the button
Seat 1: 576ce6d0 ($10 in chips)
Seat 2: 9ff7304e ($10.49 in chips)
Seat 3: 55a4f50d ($20.98 in chips)
Seat 4: Hero ($31.75 in chips)
Seat 5: 586d1c06 ($25.05 in chips)
Seat 6: bf3bd8d8 ($19.01 in chips)
9ff7304e: posts small blind $0.05
55a4f50d: posts big blind $0.1
*** HOLE CARDS ***
Dealt to 576ce6d0 
Dealt to 9ff7304e 
Dealt to 55a4f50d 
Dealt to Hero [3d 2d]
Dealt to 586d1c06 
Dealt to bf3bd8d8 
Hero: folds
586d1c06: raises $0.15 to $0.25
bf3bd8d8: folds
576ce6d0: folds
9ff7304e: calls $0.2
55a4f50d: folds
*** FLOP *** [Jh Tc 3s]
9ff7304e: checks
586d1c06: bets $0.42
9ff7304e: calls $0.42
*** TURN *** [Jh Tc 3s] [6h]
9ff7304e: checks
586d1c06: bets $1.01
9ff7304e: folds
Uncalled bet ($1.01) returned to 586d1c06
*** SHOWDOWN ***
586d1c06 collected $1.37 from pot
*** SUMMARY ***
Total pot $1.44 | Rake $0.07 | Jackpot $0 | Bingo $0 | Fortune $0 | Tax $0
Board [Jh Tc 3s 6h]
Seat 1: 576ce6d0 (button) folded before Flop (didn't bet)
Seat 2: 9ff7304e (small blind) folded on the Turn
Seat 3: 55a4f50d (big blind) folded before Flop
Seat 4: Hero folded before Flop (didn't bet)
Seat 5: 586d1c06 won ($1.37)
Seat 6: bf3bd8d8 folded before Flop (didn't bet)


Poker Hand #RC2771790734: Hold'em No Limit ($0.05/$0.1) - 2024/08/04 11:00:47
Table 'RushAndCash20805994' 6-max Seat #1 is the button
Seat 1: 960320f3 ($10.77 in chips)
Seat 2: bbaa9421 ($12.16 in chips)
Seat 3: 9ff7304e ($10.59 in chips)
Seat 4: Hero ($31.75 in chips)
Seat 5: 32d300c4 ($10.64 in chips)
Seat 6: 6e4dce0d ($17.61 in chips)
bbaa9421: posts small blind $0.05
9ff7304e: posts big blind $0.1
*** HOLE CARDS ***
Dealt to 960320f3 
Dealt to bbaa9421 
Dealt to 9ff7304e 
Dealt to Hero [Qs 8h]
Dealt to 32d300c4 
Dealt to 6e4dce0d 
Hero: folds
32d300c4: folds
6e4dce0d: folds
960320f3: folds
bbaa9421: folds
Uncalled bet ($0.05) returned to 9ff7304e
*** SHOWDOWN ***
9ff7304e collected $0.1 from pot
*** SUMMARY ***
Total pot $0.1 | Rake $0 | Jackpot $0 | Bingo $0 | Fortune $0 | Tax $0
Seat 1: 960320f3 (button) folded before Flop (didn't bet)
Seat 2: bbaa9421 (small blind) folded before Flop
Seat 3: 9ff7304e (big blind) collected ($0.1)
Seat 4: Hero folded before Flop (didn't bet)
Seat 5: 32d300c4 folded before Flop (didn't bet)
Seat 6: 6e4dce0d folded before Flop (didn't bet)


Poker Hand #RC2771790699: Hold'em No Limit ($0.05/$0.1) - 2024/08/04 11:00:43
Table 'RushAndCash20805959' 6-max Seat #1 is the button
Seat 1: 3b93bde5 ($13.49 in chips)
Seat 2: f3efd356 ($13.37 in chips)
Seat 3: 7d531e7d ($12.46 in chips)
Seat 4: Hero ($31.75 in chips)
Seat 5: 26619cd3 ($9.75 in chips)
Seat 6: 44454fd4 ($10.43 in chips)
f3efd356: posts small blind $0.05
7d531e7d: posts big blind $0.1
*** HOLE CARDS ***
Dealt to 3b93bde5 
Dealt to f3efd356 
Dealt to 7d531e7d 
Dealt to Hero [3c Jd]
Dealt to 26619cd3 
Dealt to 44454fd4 
Hero: folds
26619cd3: folds
44454fd4: folds
3b93bde5: folds
f3efd356: raises $0.1 to $0.2
7d531e7d: calls $0.1
*** FLOP *** [4h Qh Td]
f3efd356: checks
7d531e7d: bets $0.2
f3efd356: folds
Uncalled bet ($0.2) returned to 7d531e7d
*** SHOWDOWN ***
7d531e7d collected $0.38 from pot
*** SUMMARY ***
Total pot $0.4 | Rake $0.02 | Jackpot $0 | Bingo $0 | Fortune $0 | Tax $0
Board [4h Qh Td]
Seat 1: 3b93bde5 (button) folded before Flop (didn't bet)
Seat 2: f3efd356 (small blind) folded on the Flop
Seat 3: 7d531e7d (big blind) won ($0.38)
Seat 4: Hero folded before Flop (didn't bet)
Seat 5: 26619cd3 folded before Flop (didn't bet)
Seat 6: 44454fd4 folded before Flop (didn't bet)


Poker Hand #RC2771790668: Hold'em No Limit ($0.05/$0.1) - 2024/08/04 11:00:39
Table 'RushAndCash20805928' 6-max Seat #1 is the button
Seat 1: afb095e1 ($10 in chips)
Seat 2: Hero ($31.8 in chips)
Seat 3: da45b6b2 ($4 in chips)
Seat 4: 483620e3 ($17.68 in chips)
Seat 5: c04e8644 ($13.64 in chips)
Seat 6: d900eaa2 ($12.84 in chips)
Hero: posts small blind $0.05
da45b6b2: posts big blind $0.1
*** HOLE CARDS ***
Dealt to afb095e1 
Dealt to Hero [2s 7d]
Dealt to da45b6b2 
Dealt to 483620e3 
Dealt to c04e8644 
Dealt to d900eaa2 
483620e3: folds
c04e8644: folds
d900eaa2: folds
afb095e1: raises $0.1 to $0.2
Hero: folds
da45b6b2: folds
Uncalled bet ($0.1) returned to afb095e1
*** SHOWDOWN ***
afb095e1 collected $0.25 from pot
*** SUMMARY ***
Total pot $0.25 | Rake $0 | Jackpot $0 | Bingo $0 | Fortune $0 | Tax $0
Seat 1: afb095e1 (button) collected ($0.25)
Seat 2: Hero (small blind) folded before Flop
Seat 3: da45b6b2 (big blind) folded before Flop
Seat 4: 483620e3 folded before Flop (didn't bet)
Seat 5: c04e8644 folded before Flop (didn't bet)
Seat 6: d900eaa2 folded before Flop (didn't bet)


Poker Hand #RC2771790644: Hold'em No Limit ($0.05/$0.1) - 2024/08/04 11:00:36
Table 'RushAndCash20805904' 6-max Seat #1 is the button
Seat 1: 9148d4b9 ($10 in chips)
Seat 2: 96417c65 ($5.14 in chips)
Seat 3: Hero ($31.9 in chips)
Seat 4: 73ffd323 ($7 in chips)
Seat 5: c1d9b1d4 ($9.31 in chips)
Seat 6: 1b0c40c2 ($10 in chips)
96417c65: posts small blind $0.05
Hero: posts big blind $0.1
*** HOLE CARDS ***
Dealt to 9148d4b9 
Dealt to 96417c65 
Dealt to Hero [7c 3s]
Dealt to 73ffd323 
Dealt to c1d9b1d4 
Dealt to 1b0c40c2 
73ffd323: folds
c1d9b1d4: calls $0.1
1b0c40c2: folds
9148d4b9: raises $0.3 to $0.4
96417c65: folds
Hero: folds
c1d9b1d4: calls $0.3
*** FLOP *** [2d 8s 4d]
c1d9b1d4: checks
9148d4b9: bets $0.33
c1d9b1d4: calls $0.33
*** TURN *** [2d 8s 4d] [4h]
c1d9b1d4: checks
9148d4b9: bets $0.96
c1d9b1d4: folds
Uncalled bet ($0.96) returned to 9148d4b9
*** SHOWDOWN ***
9148d4b9 collected $1.53 from pot
*** SUMMARY ***
Total pot $1.61 | Rake $0.08 | Jackpot $0 | Bingo $0 | Fortune $0 | Tax $0
Board [2d 8s 4d 4h]
Seat 1: 9148d4b9 (button) won ($1.53)
Seat 2: 96417c65 (small blind) folded before Flop
Seat 3: Hero (big blind) folded before Flop
Seat 4: 73ffd323 folded before Flop (didn't bet)
Seat 5: c1d9b1d4 folded on the Turn
Seat 6: 1b0c40c2 folded before Flop (didn't bet)


Poker Hand #RC2771790617: Hold'em No Limit ($0.05/$0.1) - 2024/08/04 11:00:32
Table 'RushAndCash20805877' 6-max Seat #1 is the button
Seat 1: b5a5f5d2 ($12.32 in chips)
Seat 2: fe9e1fc ($15.7 in chips)
Seat 3: 96417c65 ($5.24 in chips)
Seat 4: Hero ($31.9 in chips)
Seat 5: f9dd4b13 ($10.11 in chips)
Seat 6: ce619ff2 ($10 in chips)
fe9e1fc: posts small blind $0.05
96417c65: posts big blind $0.1
*** HOLE CARDS ***
Dealt to b5a5f5d2 
Dealt to fe9e1fc 
Dealt to 96417c65 
Dealt to Hero [6c 8s]
Dealt to f9dd4b13 
Dealt to ce619ff2 
Hero: folds
f9dd4b13: raises $0.2 to $0.3
ce619ff2: folds
b5a5f5d2: folds
fe9e1fc: folds
96417c65: folds
Uncalled bet ($0.2) returned to f9dd4b13
*** SHOWDOWN ***
f9dd4b13 collected $0.25 from pot
*** SUMMARY ***
Total pot $0.25 | Rake $0 | Jackpot $0 | Bingo $0 | Fortune $0 | Tax $0
Seat 1: b5a5f5d2 (button) folded before Flop (didn't bet)
Seat 2: fe9e1fc (small blind) folded before Flop
Seat 3: 96417c65 (big blind) folded before Flop
Seat 4: Hero folded before Flop (didn't bet)
Seat 5: f9dd4b13 collected ($0.25)
Seat 6: ce619ff2 folded before Flop (didn't bet)


Poker Hand #RC2771790595: Hold'em No Limit ($0.05/$0.1) - 2024/08/04 11:00:29
Table 'RushAndCash20805855' 6-max Seat #1 is the button
Seat 1: c15805b2 ($13.75 in chips)
Seat 2: Hero ($31.95 in chips)
Seat 3: ec81b7e ($10 in chips)
Seat 4: 5b166896 ($10.15 in chips)
Seat 5: 44165a65 ($16.49 in chips)
Seat 6: 55a4f50d ($20.98 in chips)
Hero: posts small blind $0.05
ec81b7e: posts big blind $0.1
*** HOLE CARDS ***
Dealt to c15805b2 
Dealt to Hero [3d 2h]
Dealt to ec81b7e 
Dealt to 5b166896 
Dealt to 44165a65 
Dealt to 55a4f50d 
5b166896: folds
44165a65: folds
55a4f50d: folds
c15805b2: folds
Hero: folds
Uncalled bet ($0.05) returned to ec81b7e
*** SHOWDOWN ***
ec81b7e collected $0.1 from pot
*** SUMMARY ***
Total pot $0.1 | Rake $0 | Jackpot $0 | Bingo $0 | Fortune $0 | Tax $0
Seat 1: c15805b2 (button) folded before Flop (didn't bet)
Seat 2: Hero (small blind) folded before Flop
Seat 3: ec81b7e (big blind) collected ($0.1)
Seat 4: 5b166896 folded before Flop (didn't bet)
Seat 5: 44165a65 folded before Flop (didn't bet)
Seat 6: 55a4f50d folded before Flop (didn't bet)


Poker Hand #RC2771790571: Hold'em No Limit ($0.05/$0.1) - 2024/08/04 11:00:26
Table 'RushAndCash20805831' 6-max Seat #1 is the button
Seat 1: Hero ($31.95 in chips)
Seat 2: 6f8fa43a ($10 in chips)
Seat 3: aac8fa10 ($10 in chips)
Seat 4: ec81b7e ($10 in chips)
Seat 5: c21f392c ($10 in chips)
Seat 6: f567d1a ($11.14 in chips)
6f8fa43a: posts small blind $0.05
aac8fa10: posts big blind $0.1
*** HOLE CARDS ***
Dealt to Hero [8h 4s]
Dealt to 6f8fa43a 
Dealt to aac8fa10 
Dealt to ec81b7e 
Dealt to c21f392c 
Dealt to f567d1a 
ec81b7e: folds
c21f392c: folds
f567d1a: folds
Hero: folds
6f8fa43a: raises $0.1 to $0.2
aac8fa10: raises $0.53 to $0.73
6f8fa43a: folds
Uncalled bet ($0.53) returned to aac8fa10
*** SHOWDOWN ***
aac8fa10 collected $0.38 from pot
*** SUMMARY ***
Total pot $0.4 | Rake $0.02 | Jackpot $0 | Bingo $0 | Fortune $0 | Tax $0
Seat 1: Hero (button) folded before Flop (didn't bet)
Seat 2: 6f8fa43a (small blind) folded before Flop
Seat 3: aac8fa10 (big blind) collected ($0.38)
Seat 4: ec81b7e folded before Flop (didn't bet)
Seat 5: c21f392c folded before Flop (didn't bet)
Seat 6: f567d1a folded before Flop (didn't bet)


Poker Hand #RC2771790470: Hold'em No Limit ($0.05/$0.1) - 2024/08/04 11:00:12
Table 'RushAndCash20805730' 6-max Seat #1 is the button
Seat 1: 8bf101c5 ($14.31 in chips)
Seat 2: a2076872 ($18.88 in chips)
Seat 3: Hero ($31.9 in chips)
Seat 4: 21a4c51d ($24.89 in chips)
Seat 5: 74813e93 ($19.1 in chips)
Seat 6: 92ab134e ($46.09 in chips)
a2076872: posts small blind $0.05
Hero: posts big blind $0.1
*** HOLE CARDS ***
Dealt to 8bf101c5 
Dealt to a2076872 
Dealt to Hero [Ah Ts]
Dealt to 21a4c51d 
Dealt to 74813e93 
Dealt to 92ab134e 
21a4c51d: folds
74813e93: folds
92ab134e: folds
8bf101c5: folds
a2076872: folds
Uncalled bet ($0.05) returned to Hero
*** SHOWDOWN ***
Hero collected $0.1 from pot
*** SUMMARY ***
Total pot $0.1 | Rake $0 | Jackpot $0 | Bingo $0 | Fortune $0 | Tax $0
Seat 1: 8bf101c5 (button) folded before Flop (didn't bet)
Seat 2: a2076872 (small blind) folded before Flop
Seat 3: Hero (big blind) collected ($0.1)
Seat 4: 21a4c51d folded before Flop (didn't bet)
Seat 5: 74813e93 folded before Flop (didn't bet)
Seat 6: 92ab134e folded before Flop (didn't bet)


Poker Hand #RC2771790318: Hold'em No Limit ($0.05/$0.1) - 2024/08/04 10:59:53
Table 'RushAndCash20805578' 6-max Seat #1 is the button
Seat 1: 44165a65 ($16.97 in chips)
Seat 2: 6e1edbbc ($21.98 in chips)
Seat 3: 81e5a9d3 ($9.56 in chips)
Seat 4: Hero ($32.1 in chips)
Seat 5: 45609dce ($10 in chips)
Seat 6: 369ff408 ($10.15 in chips)
6e1edbbc: posts small blind $0.05
81e5a9d3: posts big blind $0.1
*** HOLE CARDS ***
Dealt to 44165a65 
Dealt to 6e1edbbc 
Dealt to 81e5a9d3 
Dealt to Hero [Kh 9h]
Dealt to 45609dce 
Dealt to 369ff408 
Hero: raises $0.1 to $0.2
45609dce: folds
369ff408: raises $0.42 to $0.62
44165a65: folds
6e1edbbc: folds
81e5a9d3: folds
Hero: folds
Uncalled bet ($0.42) returned to 369ff408
*** SHOWDOWN ***
369ff408 collected $0.53 from pot
*** SUMMARY ***
Total pot $0.55 | Rake $0.02 | Jackpot $0 | Bingo $0 | Fortune $0 | Tax $0
Seat 1: 44165a65 (button) folded before Flop (didn't bet)
Seat 2: 6e1edbbc (small blind) folded before Flop
Seat 3: 81e5a9d3 (big blind) folded before Flop
Seat 4: Hero folded before Flop
Seat 5: 45609dce folded before Flop (didn't bet)
Seat 6: 369ff408 collected ($0.53)


Poker Hand #RC2771790294: Hold'em No Limit ($0.05/$0.1) - 2024/08/04 10:59:49
Table 'RushAndCash20805554' 6-max Seat #1 is the button
Seat 1: 129c3cba ($10 in chips)
Seat 2: c14435f9 ($29.15 in chips)
Seat 3: 9bc1f882 ($18.31 in chips)
Seat 4: Hero ($32.1 in chips)
Seat 5: b55a552c ($10.29 in chips)
Seat 6: 50a4c672 ($11.16 in chips)
c14435f9: posts small blind $0.05
9bc1f882: posts big blind $0.1
*** HOLE CARDS ***
Dealt to 129c3cba 
Dealt to c14435f9 
Dealt to 9bc1f882 
Dealt to Hero [2h Jh]
Dealt to b55a552c 
Dealt to 50a4c672 
Hero: folds
b55a552c: folds
50a4c672: raises $0.12 to $0.22
129c3cba: folds
c14435f9: folds
9bc1f882: calls $0.12
*** FLOP *** [Qc 3s 7d]
9bc1f882: checks
50a4c672: bets $0.27
9bc1f882: calls $0.27
*** TURN *** [Qc 3s 7d] [9c]
9bc1f882: checks
50a4c672: bets $0.68
9bc1f882: calls $0.68
*** RIVER *** [Qc 3s 7d 9c] [7s]
9bc1f882: checks
50a4c672: bets $1.85
9bc1f882: folds
Uncalled bet ($1.85) returned to 50a4c672
*** SHOWDOWN ***
50a4c672 collected $2.27 from pot
*** SUMMARY ***
Total pot $2.39 | Rake $0.12 | Jackpot $0 | Bingo $0 | Fortune $0 | Tax $0
Board [Qc 3s 7d 9c 7s]
Seat 1: 129c3cba (button) folded before Flop (didn't bet)
Seat 2: c14435f9 (small blind) folded before Flop
Seat 3: 9bc1f882 (big blind) folded on the River
Seat 4: Hero folded before Flop (didn't bet)
Seat 5: b55a552c folded before Flop (didn't bet)
Seat 6: 50a4c672 won ($2.27)


Poker Hand #RC2771790265: Hold'em No Limit ($0.05/$0.1) - 2024/08/04 10:59:46
Table 'RushAndCash20805525' 6-max Seat #1 is the button
Seat 1: ec2e69db ($13.79 in chips)
Seat 2: 5d5e7e95 ($11.3 in chips)
Seat 3: 49ece282 ($12.97 in chips)
Seat 4: 2b7c9c19 ($11.14 in chips)
Seat 5: Hero ($32.1 in chips)
Seat 6: 12f8507f ($20.59 in chips)
5d5e7e95: posts small blind $0.05
49ece282: posts big blind $0.1
*** HOLE CARDS ***
Dealt to ec2e69db 
Dealt to 5d5e7e95 
Dealt to 49ece282 
Dealt to 2b7c9c19 
Dealt to Hero [6s 4s]
Dealt to 12f8507f 
2b7c9c19: raises $0.15 to $0.25
Hero: folds
12f8507f: folds
ec2e69db: folds
5d5e7e95: calls $0.2
49ece282: folds
*** FLOP *** [2s 4d Kd]
5d5e7e95: checks
2b7c9c19: bets $0.2
5d5e7e95: folds
Uncalled bet ($0.2) returned to 2b7c9c19
*** SHOWDOWN ***
2b7c9c19 collected $0.57 from pot
*** SUMMARY ***
Total pot $0.6 | Rake $0.03 | Jackpot $0 | Bingo $0 | Fortune $0 | Tax $0
Board [2s 4d Kd]
Seat 1: ec2e69db (button) folded before Flop (didn't bet)
Seat 2: 5d5e7e95 (small blind) folded on the Flop
Seat 3: 49ece282 (big blind) folded before Flop
Seat 4: 2b7c9c19 won ($0.57)
Seat 5: Hero folded before Flop (didn't bet)
Seat 6: 12f8507f folded before Flop (didn't bet)


Poker Hand #RC2771790236: Hold'em No Limit ($0.05/$0.1) - 2024/08/04 10:59:43
Table 'RushAndCash20805496' 6-max Seat #1 is the button
Seat 1: a721eb8 ($22.29 in chips)
Seat 2: 2474373b ($10.11 in chips)
Seat 3: 3104c11b ($10 in chips)
Seat 4: 3817698b ($11.61 in chips)
Seat 5: Hero ($32.1 in chips)
Seat 6: 24c4b23f ($33.03 in chips)
2474373b: posts small blind $0.05
3104c11b: posts big blind $0.1
*** HOLE CARDS ***
Dealt to a721eb8 
Dealt to 2474373b 
Dealt to 3104c11b 
Dealt to 3817698b 
Dealt to Hero [8h 3d]
Dealt to 24c4b23f 
3817698b: folds
Hero: folds
24c4b23f: folds
a721eb8: raises $0.15 to $0.25
2474373b: folds
3104c11b: calls $0.15
*** FLOP *** [8c Td 5c]
3104c11b: checks
a721eb8: checks
*** TURN *** [8c Td 5c] [4c]
3104c11b: bets $0.2
a721eb8: calls $0.2
*** RIVER *** [8c Td 5c 4c] [5s]
3104c11b: bets $0.32
a721eb8: folds
Uncalled bet ($0.32) returned to 3104c11b
*** SHOWDOWN ***
3104c11b collected $0.91 from pot
*** SUMMARY ***
Total pot $0.95 | Rake $0.04 | Jackpot $0 | Bingo $0 | Fortune $0 | Tax $0
Board [8c Td 5c 4c 5s]
Seat 1: a721eb8 (button) folded on the River
Seat 2: 2474373b (small blind) folded before Flop
Seat 3: 3104c11b (big blind) won ($0.91)
Seat 4: 3817698b folded before Flop (didn't bet)
Seat 5: Hero folded before Flop (didn't bet)
Seat 6: 24c4b23f folded before Flop (didn't bet)


Poker Hand #RC2771790208: Hold'em No Limit ($0.05/$0.1) - 2024/08/04 10:59:39
Table 'RushAndCash20805468' 6-max Seat #1 is the button
Seat 1: 3817698b ($11.61 in chips)
Seat 2: 2d10dac7 ($18.55 in chips)
Seat 3: Hero ($32.2 in chips)
Seat 4: 9aeb337a ($10 in chips)
Seat 5: b8561cc1 ($8.94 in chips)
Seat 6: ec81b7e ($10 in chips)
2d10dac7: posts small blind $0.05
Hero: posts big blind $0.1
*** HOLE CARDS ***
Dealt to 3817698b 
Dealt to 2d10dac7 
Dealt to Hero [Js 7h]
Dealt to 9aeb337a 
Dealt to b8561cc1 
Dealt to ec81b7e 
9aeb337a: folds
b8561cc1: folds
ec81b7e: raises $0.13 to $0.23
3817698b: folds
2d10dac7: folds
Hero: folds
Uncalled bet ($0.13) returned to ec81b7e
*** SHOWDOWN ***
ec81b7e collected $0.25 from pot
*** SUMMARY ***
Total pot $0.25 | Rake $0 | Jackpot $0 | Bingo $0 | Fortune $0 | Tax $0
Seat 1: 3817698b (button) folded before Flop (didn't bet)
Seat 2: 2d10dac7 (small blind) folded before Flop
Seat 3: Hero (big blind) folded before Flop
Seat 4: 9aeb337a folded before Flop (didn't bet)
Seat 5: b8561cc1 folded before Flop (didn't bet)
Seat 6: ec81b7e collected ($0.25)


Poker Hand #RC2771790172: Hold'em No Limit ($0.05/$0.1) - 2024/08/04 10:59:35
Table 'RushAndCash20805432' 6-max Seat #1 is the button
Seat 1: c2f88101 ($10 in chips)
Seat 2: 2a030a46 ($13.81 in chips)
Seat 3: 44454fd4 ($10.1 in chips)
Seat 4: 5f20a05a ($12.56 in chips)
Seat 5: Hero ($32.2 in chips)
Seat 6: 49bff733 ($13.81 in chips)
2a030a46: posts small blind $0.05
44454fd4: posts big blind $0.1
*** HOLE CARDS ***
Dealt to c2f88101 
Dealt to 2a030a46 
Dealt to 44454fd4 
Dealt to 5f20a05a 
Dealt to Hero [4d Qs]
Dealt to 49bff733 
5f20a05a: folds
Hero: folds
49bff733: folds
c2f88101: folds
2a030a46: folds
Uncalled bet ($0.05) returned to 44454fd4
*** SHOWDOWN ***
44454fd4 collected $0.1 from pot
*** SUMMARY ***
Total pot $0.1 | Rake $0 | Jackpot $0 | Bingo $0 | Fortune $0 | Tax $0
Seat 1: c2f88101 (button) folded before Flop (didn't bet)
Seat 2: 2a030a46 (small blind) folded before Flop
Seat 3: 44454fd4 (big blind) collected ($0.1)
Seat 4: 5f20a05a folded before Flop (didn't bet)
Seat 5: Hero folded before Flop (didn't bet)
Seat 6: 49bff733 folded before Flop (didn't bet)


Poker Hand #RC2771790137: Hold'em No Limit ($0.05/$0.1) - 2024/08/04 10:59:30
Table 'RushAndCash20805397' 6-max Seat #1 is the button
Seat 1: cbeb2991 ($14.31 in chips)
Seat 2: Hero ($32.25 in chips)
Seat 3: 44a2f7f9 ($11.32 in chips)
Seat 4: 95e39858 ($10.26 in chips)
Seat 5: 59b76ee2 ($10 in chips)
Seat 6: 9b29594d ($10.03 in chips)
Hero: posts small blind $0.05
44a2f7f9: posts big blind $0.1
*** HOLE CARDS ***
Dealt to cbeb2991 
Dealt to Hero [6h Qd]
Dealt to 44a2f7f9 
Dealt to 95e39858 
Dealt to 59b76ee2 
Dealt to 9b29594d 
95e39858: raises $0.1 to $0.2
59b76ee2: folds
9b29594d: folds
cbeb2991: folds
Hero: folds
44a2f7f9: folds
Uncalled bet ($0.1) returned to 95e39858
*** SHOWDOWN ***
95e39858 collected $0.25 from pot
*** SUMMARY ***
Total pot $0.25 | Rake $0 | Jackpot $0 | Bingo $0 | Fortune $0 | Tax $0
Seat 1: cbeb2991 (button) folded before Flop (didn't bet)
Seat 2: Hero (small blind) folded before Flop
Seat 3: 44a2f7f9 (big blind) folded before Flop
Seat 4: 95e39858 collected ($0.25)
Seat 5: 59b76ee2 folded before Flop (didn't bet)
Seat 6: 9b29594d folded before Flop (didn't bet)


Poker Hand #RC2771790105: Hold'em No Limit ($0.05/$0.1) - 2024/08/04 10:59:27
Table 'RushAndCash20805365' 6-max Seat #1 is the button
Seat 1: Hero ($32.25 in chips)
Seat 2: a673fc28 ($19.65 in chips)
Seat 3: a0b83ec3 ($10 in chips)
Seat 4: b6790577 ($14.13 in chips)
Seat 5: ce619ff2 ($26.49 in chips)
Seat 6: 45609dce ($10 in chips)
a673fc28: posts small blind $0.05
a0b83ec3: posts big blind $0.1
*** HOLE CARDS ***
Dealt to Hero [9h 6d]
Dealt to a673fc28 
Dealt to a0b83ec3 
Dealt to b6790577 
Dealt to ce619ff2 
Dealt to 45609dce 
b6790577: folds
ce619ff2: raises $0.14 to $0.24
45609dce: folds
Hero: folds
a673fc28: raises $0.87 to $1.11
a0b83ec3: folds
ce619ff2: raises $1.34 to $2.45
a673fc28: raises $17.2 to $19.65 and is all-in
ce619ff2: calls $17.2
a673fc28: shows [Ac As]
ce619ff2: shows [Kd Kc]
*** FLOP *** [5c Jd 6h]
*** TURN *** [5c Jd 6h] [Jc]
*** RIVER *** [5c Jd 6h Jc] [Th]
*** SHOWDOWN ***
a673fc28 collected $38.95 from pot
*** SUMMARY ***
Total pot $39.4 | Rake $0.3 | Jackpot $0.15 | Bingo $0 | Fortune $0 | Tax $0
Board [5c Jd 6h Jc Th]
Seat 1: Hero (button) folded before Flop (didn't bet)
Seat 2: a673fc28 (small blind) showed [Ac As] and won ($38.95) with Pair of Aces and Pair of Jacks
Seat 3: a0b83ec3 (big blind) folded before Flop
Seat 4: b6790577 folded before Flop (didn't bet)
Seat 5: ce619ff2 showed [Kd Kc] and lost with Pair of Kings and Pair of Jacks
Seat 6: 45609dce folded before Flop (didn't bet)


Poker Hand #RC2771790058: Hold'em No Limit ($0.05/$0.1) - 2024/08/04 10:59:21
Table 'RushAndCash20805318' 6-max Seat #1 is the button
Seat 1: 193a5ed ($12.55 in chips)
Seat 2: 44454fd4 ($10.15 in chips)
Seat 3: 19f702f3 ($12.74 in chips)
Seat 4: Hero ($32.25 in chips)
Seat 5: c04e8644 ($13.15 in chips)
Seat 6: 56444da6 ($10.78 in chips)
44454fd4: posts small blind $0.05
19f702f3: posts big blind $0.1
*** HOLE CARDS ***
Dealt to 193a5ed 
Dealt to 44454fd4 
Dealt to 19f702f3 
Dealt to Hero [3s As]
Dealt to c04e8644 
Dealt to 56444da6 
Hero: folds
c04e8644: folds
56444da6: folds
193a5ed: raises $0.15 to $0.25
44454fd4: folds
19f702f3: calls $0.15
*** FLOP *** [Th 7c 4d]
19f702f3: checks
193a5ed: bets $0.3
19f702f3: raises $0.7 to $1
193a5ed: calls $0.7
*** TURN *** [Th 7c 4d] [8s]
19f702f3: checks
193a5ed: checks
*** RIVER *** [Th 7c 4d 8s] [3h]
19f702f3: checks
193a5ed: bets $1.92
19f702f3: folds
Uncalled bet ($1.92) returned to 193a5ed
*** SHOWDOWN ***
193a5ed collected $2.43 from pot
*** SUMMARY ***
Total pot $2.55 | Rake $0.12 | Jackpot $0 | Bingo $0 | Fortune $0 | Tax $0
Board [Th 7c 4d 8s 3h]
Seat 1: 193a5ed (button) won ($2.43)
Seat 2: 44454fd4 (small blind) folded before Flop
Seat 3: 19f702f3 (big blind) folded on the River
Seat 4: Hero folded before Flop (didn't bet)
Seat 5: c04e8644 folded before Flop (didn't bet)
Seat 6: 56444da6 folded before Flop (didn't bet)


Poker Hand #RC2771790025: Hold'em No Limit ($0.05/$0.1) - 2024/08/04 10:59:17
Table 'RushAndCash20805285' 6-max Seat #1 is the button
Seat 1: a8ea288c ($9.25 in chips)
Seat 2: e669d47c ($11.07 in chips)
Seat 3: 71e81845 ($14.1 in chips)
Seat 4: b3744f64 ($24.3 in chips)
Seat 5: Hero ($32.25 in chips)
Seat 6: 50a4c672 ($11.31 in chips)
e669d47c: posts small blind $0.05
71e81845: posts big blind $0.1
*** HOLE CARDS ***
Dealt to a8ea288c 
Dealt to e669d47c 
Dealt to 71e81845 
Dealt to b3744f64 
Dealt to Hero [Js 6c]
Dealt to 50a4c672 
b3744f64: raises $0.15 to $0.25
Hero: folds
50a4c672: folds
a8ea288c: folds
e669d47c: folds
71e81845: folds
Uncalled bet ($0.15) returned to b3744f64
*** SHOWDOWN ***
b3744f64 collected $0.25 from pot
*** SUMMARY ***
Total pot $0.25 | Rake $0 | Jackpot $0 | Bingo $0 | Fortune $0 | Tax $0
Seat 1: a8ea288c (button) folded before Flop (didn't bet)
Seat 2: e669d47c (small blind) folded before Flop
Seat 3: 71e81845 (big blind) folded before Flop
Seat 4: b3744f64 collected ($0.25)
Seat 5: Hero folded before Flop (didn't bet)
Seat 6: 50a4c672 folded before Flop (didn't bet)


Poker Hand #RC2771789998: Hold'em No Limit ($0.05/$0.1) - 2024/08/04 10:59:14
Table 'RushAndCash20805258' 6-max Seat #1 is the button
Seat 1: c527a092 ($17.64 in chips)
Seat 2: a8ea288c ($9.3 in chips)
Seat 3: 5eedd38f ($12.94 in chips)
Seat 4: 50050a51 ($48.77 in chips)
Seat 5: 53ffcaa7 ($22.19 in chips)
Seat 6: Hero ($32.25 in chips)
a8ea288c: posts small blind $0.05
5eedd38f: posts big blind $0.1
*** HOLE CARDS ***
Dealt to c527a092 
Dealt to a8ea288c 
Dealt to 5eedd38f 
Dealt to 50050a51 
Dealt to 53ffcaa7 
Dealt to Hero [5h Qd]
50050a51: folds
53ffcaa7: raises $0.15 to $0.25
Hero: folds
c527a092: folds
a8ea288c: folds
5eedd38f: folds
Uncalled bet ($0.15) returned to 53ffcaa7
*** SHOWDOWN ***
53ffcaa7 collected $0.25 from pot
*** SUMMARY ***
Total pot $0.25 | Rake $0 | Jackpot $0 | Bingo $0 | Fortune $0 | Tax $0
Seat 1: c527a092 (button) folded before Flop (didn't bet)
Seat 2: a8ea288c (small blind) folded before Flop
Seat 3: 5eedd38f (big blind) folded before Flop
Seat 4: 50050a51 folded before Flop (didn't bet)
Seat 5: 53ffcaa7 collected ($0.25)
Seat 6: Hero folded before Flop (didn't bet)


Poker Hand #RC2771789958: Hold'em No Limit ($0.05/$0.1) - 2024/08/04 10:59:09
Table 'RushAndCash20805218' 6-max Seat #1 is the button
Seat 1: f0aa3fc3 ($13.13 in chips)
Seat 2: Hero ($32.3 in chips)
Seat 3: 576ce6d0 ($10.03 in chips)
Seat 4: 47f6e2ce ($10.51 in chips)
Seat 5: cc701c82 ($10.85 in chips)
Seat 6: 21a9bc71 ($9.85 in chips)
Hero: posts small blind $0.05
576ce6d0: posts big blind $0.1
*** HOLE CARDS ***
Dealt to f0aa3fc3 
Dealt to Hero [2c 7d]
Dealt to 576ce6d0 
Dealt to 47f6e2ce 
Dealt to cc701c82 
Dealt to 21a9bc71 
47f6e2ce: raises $0.13 to $0.23
cc701c82: folds
21a9bc71: folds
f0aa3fc3: folds
Hero: folds
576ce6d0: calls $0.13
*** FLOP *** [Jh 3h 7h]
576ce6d0: checks
47f6e2ce: bets $0.23
576ce6d0: folds
Uncalled bet ($0.23) returned to 47f6e2ce
*** SHOWDOWN ***
47f6e2ce collected $0.49 from pot
*** SUMMARY ***
Total pot $0.51 | Rake $0.02 | Jackpot $0 | Bingo $0 | Fortune $0 | Tax $0
Board [Jh 3h 7h]
Seat 1: f0aa3fc3 (button) folded before Flop (didn't bet)
Seat 2: Hero (small blind) folded before Flop
Seat 3: 576ce6d0 (big blind) folded on the Flop
Seat 4: 47f6e2ce won ($0.49)
Seat 5: cc701c82 folded before Flop (didn't bet)
Seat 6: 21a9bc71 folded before Flop (didn't bet)


Poker Hand #RC2771789934: Hold'em No Limit ($0.05/$0.1) - 2024/08/04 10:59:06
Table 'RushAndCash20805194' 6-max Seat #1 is the button
Seat 1: 16b6c43d ($10 in chips)
Seat 2: d8c28095 ($10.2 in chips)
Seat 3: Hero ($32.4 in chips)
Seat 4: 576ce6d0 ($10.03 in chips)
Seat 5: deb4b25 ($15.72 in chips)
Seat 6: 2a030a46 ($13.91 in chips)
d8c28095: posts small blind $0.05
Hero: posts big blind $0.1
*** HOLE CARDS ***
Dealt to 16b6c43d 
Dealt to d8c28095 
Dealt to Hero [9d 3s]
Dealt to 576ce6d0 
Dealt to deb4b25 
Dealt to 2a030a46 
576ce6d0: folds
deb4b25: folds
2a030a46: folds
16b6c43d: raises $0.15 to $0.25
d8c28095: raises $0.85 to $1.1
Hero: folds
16b6c43d: folds
Uncalled bet ($0.85) returned to d8c28095
*** SHOWDOWN ***
d8c28095 collected $0.57 from pot
*** SUMMARY ***
Total pot $0.6 | Rake $0.03 | Jackpot $0 | Bingo $0 | Fortune $0 | Tax $0
Seat 1: 16b6c43d (button) folded before Flop
Seat 2: d8c28095 (small blind) collected ($0.57)
Seat 3: Hero (big blind) folded before Flop
Seat 4: 576ce6d0 folded before Flop (didn't bet)
Seat 5: deb4b25 folded before Flop (didn't bet)
Seat 6: 2a030a46 folded before Flop (didn't bet)


Poker Hand #RC2771789908: Hold'em No Limit ($0.05/$0.1) - 2024/08/04 10:59:02
Table 'RushAndCash20805168' 6-max Seat #1 is the button
Seat 1: Hero ($32.4 in chips)
Seat 2: 844f67f5 ($20.31 in chips)
Seat 3: dd4caeeb ($10.25 in chips)
Seat 4: b966af64 ($27.85 in chips)
Seat 5: f4935e68 ($10.1 in chips)
Seat 6: e2c2989d ($10 in chips)
844f67f5: posts small blind $0.05
dd4caeeb: posts big blind $0.1
*** HOLE CARDS ***
Dealt to Hero [3s 2h]
Dealt to 844f67f5 
Dealt to dd4caeeb 
Dealt to b966af64 
Dealt to f4935e68 
Dealt to e2c2989d 
b966af64: folds
f4935e68: folds
e2c2989d: folds
Hero: folds
844f67f5: folds
Uncalled bet ($0.05) returned to dd4caeeb
*** SHOWDOWN ***
dd4caeeb collected $0.1 from pot
*** SUMMARY ***
Total pot $0.1 | Rake $0 | Jackpot $0 | Bingo $0 | Fortune $0 | Tax $0
Seat 1: Hero (button) folded before Flop (didn't bet)
Seat 2: 844f67f5 (small blind) folded before Flop
Seat 3: dd4caeeb (big blind) collected ($0.1)
Seat 4: b966af64 folded before Flop (didn't bet)
Seat 5: f4935e68 folded before Flop (didn't bet)
Seat 6: e2c2989d folded before Flop (didn't bet)


Poker Hand #RC2771789883: Hold'em No Limit ($0.05/$0.1) - 2024/08/04 10:58:59
Table 'RushAndCash20805143' 6-max Seat #1 is the button
Seat 1: 7aec7bb3 ($10 in chips)
Seat 2: 33427f42 ($10.91 in chips)
Seat 3: befffaf9 ($15.28 in chips)
Seat 4: Hero ($32.4 in chips)
Seat 5: 4f4a1d58 ($19.49 in chips)
Seat 6: c33594f ($6.3 in chips)
33427f42: posts small blind $0.05
befffaf9: posts big blind $0.1
*** HOLE CARDS ***
Dealt to 7aec7bb3 
Dealt to 33427f42 
Dealt to befffaf9 
Dealt to Hero [6d Qd]
Dealt to 4f4a1d58 
Dealt to c33594f 
Hero: folds
4f4a1d58: folds
c33594f: folds
7aec7bb3: folds
33427f42: raises $0.2 to $0.3
befffaf9: calls $0.2
*** FLOP *** [Kd 8s 2d]
33427f42: bets $0.3
befffaf9: folds
Uncalled bet ($0.3) returned to 33427f42
*** SHOWDOWN ***
33427f42 collected $0.57 from pot
*** SUMMARY ***
Total pot $0.6 | Rake $0.03 | Jackpot $0 | Bingo $0 | Fortune $0 | Tax $0
Board [Kd 8s 2d]
Seat 1: 7aec7bb3 (button) folded before Flop (didn't bet)
Seat 2: 33427f42 (small blind) won ($0.57)
Seat 3: befffaf9 (big blind) folded on the Flop
Seat 4: Hero folded before Flop (didn't bet)
Seat 5: 4f4a1d58 folded before Flop (didn't bet)
Seat 6: c33594f folded before Flop (didn't bet)


Poker Hand #RC2771789464: Hold'em No Limit ($0.05/$0.1) - 2024/08/04 10:58:06
Table 'RushAndCash20804724' 6-max Seat #1 is the button
Seat 1: da61e66f ($26.9 in chips)
Seat 2: 8e8677d6 ($10 in chips)
Seat 3: 33427f42 ($11.39 in chips)
Seat 4: 97c14ac4 ($9.42 in chips)
Seat 5: Hero ($31.92 in chips)
Seat 6: 32b875e3 ($12.28 in chips)
8e8677d6: posts small blind $0.05
33427f42: posts big blind $0.1
*** HOLE CARDS ***
Dealt to da61e66f 
Dealt to 8e8677d6 
Dealt to 33427f42 
Dealt to 97c14ac4 
Dealt to Hero [Ks Qc]
Dealt to 32b875e3 
97c14ac4: folds
Hero: raises $0.1 to $0.2
32b875e3: folds
da61e66f: folds
8e8677d6: folds
33427f42: calls $0.1
*** FLOP *** [2h 2s Tc]
33427f42: checks
Hero: checks
*** TURN *** [2h 2s Tc] [9d]
33427f42: bets $0.28
Hero: calls $0.28
*** RIVER *** [2h 2s Tc 9d] [6s]
33427f42: checks
Hero: bets $0.8
33427f42: folds
Uncalled bet ($0.8) returned to Hero
*** SHOWDOWN ***
Hero collected $0.96 from pot
*** SUMMARY ***
Total pot $1.01 | Rake $0.05 | Jackpot $0 | Bingo $0 | Fortune $0 | Tax $0
Board [2h 2s Tc 9d 6s]
Seat 1: da61e66f (button) folded before Flop (didn't bet)
Seat 2: 8e8677d6 (small blind) folded before Flop
Seat 3: 33427f42 (big blind) folded on the River
Seat 4: 97c14ac4 folded before Flop (didn't bet)
Seat 5: Hero won ($0.96)
Seat 6: 32b875e3 folded before Flop (didn't bet)


Poker Hand #RC2771789437: Hold'em No Limit ($0.05/$0.1) - 2024/08/04 10:58:03
Table 'RushAndCash20804697' 6-max Seat #1 is the button
Seat 1: ab598596 ($15.56 in chips)
Seat 2: b51809ba ($10.15 in chips)
Seat 3: c9efcb5e ($13.9 in chips)
Seat 4: 74d22b22 ($10.18 in chips)
Seat 5: Hero ($31.92 in chips)
Seat 6: da61e66f ($26.9 in chips)
b51809ba: posts small blind $0.05
c9efcb5e: posts big blind $0.1
*** HOLE CARDS ***
Dealt to ab598596 
Dealt to b51809ba 
Dealt to c9efcb5e 
Dealt to 74d22b22 
Dealt to Hero [3c Ah]
Dealt to da61e66f 
74d22b22: folds
Hero: folds
da61e66f: folds
ab598596: raises $0.15 to $0.25
b51809ba: folds
c9efcb5e: folds
Uncalled bet ($0.15) returned to ab598596
*** SHOWDOWN ***
ab598596 collected $0.25 from pot
*** SUMMARY ***
Total pot $0.25 | Rake $0 | Jackpot $0 | Bingo $0 | Fortune $0 | Tax $0
Seat 1: ab598596 (button) collected ($0.25)
Seat 2: b51809ba (small blind) folded before Flop
Seat 3: c9efcb5e (big blind) folded before Flop
Seat 4: 74d22b22 folded before Flop (didn't bet)
Seat 5: Hero folded before Flop (didn't bet)
Seat 6: da61e66f folded before Flop (didn't bet)


Poker Hand #RC2771789382: Hold'em No Limit ($0.05/$0.1) - 2024/08/04 10:57:56
Table 'RushAndCash20804642' 6-max Seat #1 is the button
Seat 1: Hero ($31.92 in chips)
Seat 2: 3817698b ($11.11 in chips)
Seat 3: 17e4534b ($18.95 in chips)
Seat 4: f9dd4b13 ($10.23 in chips)
Seat 5: f567d1a ($10.62 in chips)
Seat 6: 47b375d ($11.97 in chips)
3817698b: posts small blind $0.05
17e4534b: posts big blind $0.1
*** HOLE CARDS ***
Dealt to Hero [9s Jd]
Dealt to 3817698b 
Dealt to 17e4534b 
Dealt to f9dd4b13 
Dealt to f567d1a 
Dealt to 47b375d 
f9dd4b13: raises $0.2 to $0.3
f567d1a: folds
47b375d: folds
Hero: folds
3817698b: folds
17e4534b: folds
Uncalled bet ($0.2) returned to f9dd4b13
*** SHOWDOWN ***
f9dd4b13 collected $0.25 from pot
*** SUMMARY ***
Total pot $0.25 | Rake $0 | Jackpot $0 | Bingo $0 | Fortune $0 | Tax $0
Seat 1: Hero (button) folded before Flop (didn't bet)
Seat 2: 3817698b (small blind) folded before Flop
Seat 3: 17e4534b (big blind) folded before Flop
Seat 4: f9dd4b13 collected ($0.25)
Seat 5: f567d1a folded before Flop (didn't bet)
Seat 6: 47b375d folded before Flop (didn't bet)


Poker Hand #RC2771789160: Hold'em No Limit ($0.05/$0.1) - 2024/08/04 10:57:28
Table 'RushAndCash20804420' 6-max Seat #1 is the button
Seat 1: 76577d8b ($27.57 in chips)
Seat 2: 53ffcaa7 ($22.34 in chips)
Seat 3: Hero ($31.65 in chips)
Seat 4: cc701c82 ($10.7 in chips)
Seat 5: 1919eb2a ($16.1 in chips)
Seat 6: dd4caeeb ($10.12 in chips)
53ffcaa7: posts small blind $0.05
Hero: posts big blind $0.1
*** HOLE CARDS ***
Dealt to 76577d8b 
Dealt to 53ffcaa7 
Dealt to Hero [9s Jh]
Dealt to cc701c82 
Dealt to 1919eb2a 
Dealt to dd4caeeb 
cc701c82: folds
1919eb2a: folds
dd4caeeb: folds
76577d8b: folds
53ffcaa7: raises $0.2 to $0.3
Hero: calls $0.2
*** FLOP *** [Qd 9c Jc]
53ffcaa7: checks
Hero: bets $0.4
53ffcaa7: folds
Uncalled bet ($0.4) returned to Hero
*** SHOWDOWN ***
Hero collected $0.57 from pot
*** SUMMARY ***
Total pot $0.6 | Rake $0.03 | Jackpot $0 | Bingo $0 | Fortune $0 | Tax $0
Board [Qd 9c Jc]
Seat 1: 76577d8b (button) folded before Flop (didn't bet)
Seat 2: 53ffcaa7 (small blind) folded on the Flop
Seat 3: Hero (big blind) won ($0.57)
Seat 4: cc701c82 folded before Flop (didn't bet)
Seat 5: 1919eb2a folded before Flop (didn't bet)
Seat 6: dd4caeeb folded before Flop (didn't bet)


Poker Hand #RC2771789135: Hold'em No Limit ($0.05/$0.1) - 2024/08/04 10:57:24
Table 'RushAndCash20804395' 6-max Seat #1 is the button
Seat 1: 7756ff4c ($2.3 in chips)
Seat 2: Hero ($31.7 in chips)
Seat 3: cbeb2991 ($10.1 in chips)
Seat 4: 9df3d281 ($10.35 in chips)
Seat 5: 97c14ac4 ($9.62 in chips)
Seat 6: c31ebbeb ($11.44 in chips)
Hero: posts small blind $0.05
cbeb2991: posts big blind $0.1
*** HOLE CARDS ***
Dealt to 7756ff4c 
Dealt to Hero [Ac 5h]
Dealt to cbeb2991 
Dealt to 9df3d281 
Dealt to 97c14ac4 
Dealt to c31ebbeb 
9df3d281: raises $0.1 to $0.2
97c14ac4: calls $0.2
c31ebbeb: folds
7756ff4c: folds
Hero: folds
cbeb2991: folds
*** FLOP *** [Kc 4s Js]
9df3d281: bets $0.19
97c14ac4: folds
Uncalled bet ($0.19) returned to 9df3d281
*** SHOWDOWN ***
9df3d281 collected $0.53 from pot
*** SUMMARY ***
Total pot $0.55 | Rake $0.02 | Jackpot $0 | Bingo $0 | Fortune $0 | Tax $0
Board [Kc 4s Js]
Seat 1: 7756ff4c (button) folded before Flop (didn't bet)
Seat 2: Hero (small blind) folded before Flop
Seat 3: cbeb2991 (big blind) folded before Flop
Seat 4: 9df3d281 won ($0.53)
Seat 5: 97c14ac4 folded on the Flop
Seat 6: c31ebbeb folded before Flop (didn't bet)


Poker Hand #RC2771789109: Hold'em No Limit ($0.05/$0.1) - 2024/08/04 10:57:20
Table 'RushAndCash20804369' 6-max Seat #1 is the button
Seat 1: 4445ff51 ($14.21 in chips)
Seat 2: 6ab5975d ($11.45 in chips)
Seat 3: c33594f ($6.31 in chips)
Seat 4: 8de35383 ($11.91 in chips)
Seat 5: Hero ($31.7 in chips)
Seat 6: 5a69fec9 ($12.59 in chips)
6ab5975d: posts small blind $0.05
c33594f: posts big blind $0.1
*** HOLE CARDS ***
Dealt to 4445ff51 
Dealt to 6ab5975d 
Dealt to c33594f 
Dealt to 8de35383 
Dealt to Hero [Jc 9s]
Dealt to 5a69fec9 
8de35383: folds
Hero: folds
5a69fec9: folds
4445ff51: folds
6ab5975d: raises $0.14 to $0.24
c33594f: raises $0.66 to $0.9
6ab5975d: folds
Uncalled bet ($0.66) returned to c33594f
*** SHOWDOWN ***
c33594f collected $0.46 from pot
*** SUMMARY ***
Total pot $0.48 | Rake $0.02 | Jackpot $0 | Bingo $0 | Fortune $0 | Tax $0
Seat 1: 4445ff51 (button) folded before Flop (didn't bet)
Seat 2: 6ab5975d (small blind) folded before Flop
Seat 3: c33594f (big blind) collected ($0.46)
Seat 4: 8de35383 folded before Flop (didn't bet)
Seat 5: Hero folded before Flop (didn't bet)
Seat 6: 5a69fec9 folded before Flop (didn't bet)


Poker Hand #RC2771789084: Hold'em No Limit ($0.05/$0.1) - 2024/08/04 10:57:17
Table 'RushAndCash20804344' 6-max Seat #1 is the button
Seat 1: 4198c49e ($20.21 in chips)
Seat 2: Hero ($31.75 in chips)
Seat 3: b749b6d2 ($21.6 in chips)
Seat 4: b98e0eab ($12.02 in chips)
Seat 5: 76355958 ($10.19 in chips)
Seat 6: 8e982713 ($10.5 in chips)
Hero: posts small blind $0.05
b749b6d2: posts big blind $0.1
*** HOLE CARDS ***
Dealt to 4198c49e 
Dealt to Hero [5s Kc]
Dealt to b749b6d2 
Dealt to b98e0eab 
Dealt to 76355958 
Dealt to 8e982713 
b98e0eab: raises $0.11 to $0.21
76355958: folds
8e982713: folds
4198c49e: folds
Hero: folds
b749b6d2: folds
Uncalled bet ($0.11) returned to b98e0eab
*** SHOWDOWN ***
b98e0eab collected $0.25 from pot
*** SUMMARY ***
Total pot $0.25 | Rake $0 | Jackpot $0 | Bingo $0 | Fortune $0 | Tax $0
Seat 1: 4198c49e (button) folded before Flop (didn't bet)
Seat 2: Hero (small blind) folded before Flop
Seat 3: b749b6d2 (big blind) folded before Flop
Seat 4: b98e0eab collected ($0.25)
Seat 5: 76355958 folded before Flop (didn't bet)
Seat 6: 8e982713 folded before Flop (didn't bet)


Poker Hand #RC2771789059: Hold'em No Limit ($0.05/$0.1) - 2024/08/04 10:57:14
Table 'RushAndCash20804319' 6-max Seat #1 is the button
Seat 1: b98e0eab ($12.02 in chips)
Seat 2: 84aabf56 ($10 in chips)
Seat 3: cba97507 ($10 in chips)
Seat 4: 1245ac17 ($10.15 in chips)
Seat 5: 13269ce ($13.66 in chips)
Seat 6: Hero ($31.75 in chips)
84aabf56: posts small blind $0.05
cba97507: posts big blind $0.1
*** HOLE CARDS ***
Dealt to b98e0eab 
Dealt to 84aabf56 
Dealt to cba97507 
Dealt to 1245ac17 
Dealt to 13269ce 
Dealt to Hero [5h 8c]
1245ac17: folds
13269ce: folds
Hero: folds
b98e0eab: folds
84aabf56: folds
Uncalled bet ($0.05) returned to cba97507
*** SHOWDOWN ***
cba97507 collected $0.1 from pot
*** SUMMARY ***
Total pot $0.1 | Rake $0 | Jackpot $0 | Bingo $0 | Fortune $0 | Tax $0
Seat 1: b98e0eab (button) folded before Flop (didn't bet)
Seat 2: 84aabf56 (small blind) folded before Flop
Seat 3: cba97507 (big blind) collected ($0.1)
Seat 4: 1245ac17 folded before Flop (didn't bet)
Seat 5: 13269ce folded before Flop (didn't bet)
Seat 6: Hero folded before Flop (didn't bet)


Poker Hand #RC2771789033: Hold'em No Limit ($0.05/$0.1) - 2024/08/04 10:57:10
Table 'RushAndCash20804293' 6-max Seat #1 is the button
Seat 1: bab54623 ($13.11 in chips)
Seat 2: cad0ab4e ($21.93 in chips)
Seat 3: Hero ($31.85 in chips)
Seat 4: fa0a8acc ($4.96 in chips)
Seat 5: cf4d1c1c ($29.81 in chips)
Seat 6: 32b875e3 ($12.8 in chips)
cad0ab4e: posts small blind $0.05
Hero: posts big blind $0.1
*** HOLE CARDS ***
Dealt to bab54623 
Dealt to cad0ab4e 
Dealt to Hero [Jd 3d]
Dealt to fa0a8acc 
Dealt to cf4d1c1c 
Dealt to 32b875e3 
fa0a8acc: folds
cf4d1c1c: folds
32b875e3: folds
bab54623: raises $0.15 to $0.25
cad0ab4e: raises $0.6 to $0.85
Hero: folds
bab54623: folds
Uncalled bet ($0.6) returned to cad0ab4e
*** SHOWDOWN ***
cad0ab4e collected $0.57 from pot
*** SUMMARY ***
Total pot $0.6 | Rake $0.03 | Jackpot $0 | Bingo $0 | Fortune $0 | Tax $0
Seat 1: bab54623 (button) folded before Flop
Seat 2: cad0ab4e (small blind) collected ($0.57)
Seat 3: Hero (big blind) folded before Flop
Seat 4: fa0a8acc folded before Flop (didn't bet)
Seat 5: cf4d1c1c folded before Flop (didn't bet)
Seat 6: 32b875e3 folded before Flop (didn't bet)


Poker Hand #RC2771789004: Hold'em No Limit ($0.05/$0.1) - 2024/08/04 10:57:06
Table 'RushAndCash20804264' 6-max Seat #1 is the button
Seat 1: ab598596 ($15.56 in chips)
Seat 2: cc86ed88 ($10.28 in chips)
Seat 3: 33427f42 ($11.21 in chips)
Seat 4: 139dbe7d ($11.92 in chips)
Seat 5: b98e0eab ($12.12 in chips)
Seat 6: Hero ($31.85 in chips)
cc86ed88: posts small blind $0.05
33427f42: posts big blind $0.1
*** HOLE CARDS ***
Dealt to ab598596 
Dealt to cc86ed88 
Dealt to 33427f42 
Dealt to 139dbe7d 
Dealt to b98e0eab 
Dealt to Hero [3c 5c]
139dbe7d: raises $0.15 to $0.25
b98e0eab: folds
Hero: folds
ab598596: folds
cc86ed88: folds
33427f42: folds
Uncalled bet ($0.15) returned to 139dbe7d
*** SHOWDOWN ***
139dbe7d collected $0.25 from pot
*** SUMMARY ***
Total pot $0.25 | Rake $0 | Jackpot $0 | Bingo $0 | Fortune $0 | Tax $0
Seat 1: ab598596 (button) folded before Flop (didn't bet)
Seat 2: cc86ed88 (small blind) folded before Flop
Seat 3: 33427f42 (big blind) folded before Flop
Seat 4: 139dbe7d collected ($0.25)
Seat 5: b98e0eab folded before Flop (didn't bet)
Seat 6: Hero folded before Flop (didn't bet)


Poker Hand #RC2771788980: Hold'em No Limit ($0.05/$0.1) - 2024/08/04 10:57:03
Table 'RushAndCash20804240' 6-max Seat #1 is the button
Seat 1: f134e922 ($12.17 in chips)
Seat 2: 2d6ece5f ($13.57 in chips)
Seat 3: 54e832be ($10.15 in chips)
Seat 4: bf68cd69 ($11.15 in chips)
Seat 5: Hero ($31.85 in chips)
Seat 6: e15705d4 ($15.91 in chips)
2d6ece5f: posts small blind $0.05
54e832be: posts big blind $0.1
*** HOLE CARDS ***
Dealt to f134e922 
Dealt to 2d6ece5f 
Dealt to 54e832be 
Dealt to bf68cd69 
Dealt to Hero [Kh 3d]
Dealt to e15705d4 
bf68cd69: folds
Hero: folds
e15705d4: raises $0.16 to $0.26
f134e922: folds
2d6ece5f: folds
54e832be: folds
Uncalled bet ($0.16) returned to e15705d4
*** SHOWDOWN ***
e15705d4 collected $0.25 from pot
*** SUMMARY ***
Total pot $0.25 | Rake $0 | Jackpot $0 | Bingo $0 | Fortune $0 | Tax $0
Seat 1: f134e922 (button) folded before Flop (didn't bet)
Seat 2: 2d6ece5f (small blind) folded before Flop
Seat 3: 54e832be (big blind) folded before Flop
Seat 4: bf68cd69 folded before Flop (didn't bet)
Seat 5: Hero folded before Flop (didn't bet)
Seat 6: e15705d4 collected ($0.25)


Poker Hand #RC2771788957: Hold'em No Limit ($0.05/$0.1) - 2024/08/04 10:57:00
Table 'RushAndCash20804217' 6-max Seat #1 is the button
Seat 1: Hero ($31.85 in chips)
Seat 2: 193a5ed ($12.7 in chips)
Seat 3: 9aeb337a ($10.89 in chips)
Seat 4: c5ef7918 ($11.87 in chips)
Seat 5: c9f8ca6f ($10.25 in chips)
Seat 6: 73ffd323 ($6.92 in chips)
193a5ed: posts small blind $0.05
9aeb337a: posts big blind $0.1
*** HOLE CARDS ***
Dealt to Hero [3s 8h]
Dealt to 193a5ed 
Dealt to 9aeb337a 
Dealt to c5ef7918 
Dealt to c9f8ca6f 
Dealt to 73ffd323 
c5ef7918: folds
c9f8ca6f: folds
73ffd323: folds
Hero: folds
193a5ed: raises $0.2 to $0.3
9aeb337a: raises $0.6 to $0.9
193a5ed: raises $1.35 to $2.25
9aeb337a: folds
Uncalled bet ($1.35) returned to 193a5ed
*** SHOWDOWN ***
193a5ed collected $1.71 from pot
*** SUMMARY ***
Total pot $1.8 | Rake $0.09 | Jackpot $0 | Bingo $0 | Fortune $0 | Tax $0
Seat 1: Hero (button) folded before Flop (didn't bet)
Seat 2: 193a5ed (small blind) collected ($1.71)
Seat 3: 9aeb337a (big blind) folded before Flop
Seat 4: c5ef7918 folded before Flop (didn't bet)
Seat 5: c9f8ca6f folded before Flop (didn't bet)
Seat 6: 73ffd323 folded before Flop (didn't bet)


Poker Hand #RC2771788927: Hold'em No Limit ($0.05/$0.1) - 2024/08/04 10:56:57
Table 'RushAndCash20804187' 6-max Seat #1 is the button
Seat 1: dec8ca00 ($9.99 in chips)
Seat 2: 558fbc32 ($10 in chips)
Seat 3: 133a3a48 ($8.93 in chips)
Seat 4: Hero ($31.85 in chips)
Seat 5: cef72aa5 ($10.55 in chips)
Seat 6: 31d40042 ($13.62 in chips)
558fbc32: posts small blind $0.05
133a3a48: posts big blind $0.1
*** HOLE CARDS ***
Dealt to dec8ca00 
Dealt to 558fbc32 
Dealt to 133a3a48 
Dealt to Hero [3c 6h]
Dealt to cef72aa5 
Dealt to 31d40042 
Hero: folds
cef72aa5: raises $0.15 to $0.25
31d40042: folds
dec8ca00: raises $0.65 to $0.9
558fbc32: folds
133a3a48: folds
cef72aa5: folds
Uncalled bet ($0.65) returned to dec8ca00
*** SHOWDOWN ***
dec8ca00 collected $0.62 from pot
*** SUMMARY ***
Total pot $0.65 | Rake $0.03 | Jackpot $0 | Bingo $0 | Fortune $0 | Tax $0
Seat 1: dec8ca00 (button) collected ($0.62)
Seat 2: 558fbc32 (small blind) folded before Flop
Seat 3: 133a3a48 (big blind) folded before Flop
Seat 4: Hero folded before Flop (didn't bet)
Seat 5: cef72aa5 folded before Flop
Seat 6: 31d40042 folded before Flop (didn't bet)


Poker Hand #RC2771788900: Hold'em No Limit ($0.05/$0.1) - 2024/08/04 10:56:53
Table 'RushAndCash20804160' 6-max Seat #1 is the button
Seat 1: 15321053 ($14.62 in chips)
Seat 2: b3cb985 ($12.68 in chips)
Seat 3: 7d531e7d ($12.01 in chips)
Seat 4: Hero ($31.85 in chips)
Seat 5: 5a75ce82 ($19.66 in chips)
Seat 6: bfd53101 ($10.3 in chips)
b3cb985: posts small blind $0.05
7d531e7d: posts big blind $0.1
*** HOLE CARDS ***
Dealt to 15321053 
Dealt to b3cb985 
Dealt to 7d531e7d 
Dealt to Hero [Qc Ts]
Dealt to 5a75ce82 
Dealt to bfd53101 
Hero: folds
5a75ce82: folds
bfd53101: folds
15321053: folds
b3cb985: folds
Uncalled bet ($0.05) returned to 7d531e7d
*** SHOWDOWN ***
7d531e7d collected $0.1 from pot
*** SUMMARY ***
Total pot $0.1 | Rake $0 | Jackpot $0 | Bingo $0 | Fortune $0 | Tax $0
Seat 1: 15321053 (button) folded before Flop (didn't bet)
Seat 2: b3cb985 (small blind) folded before Flop
Seat 3: 7d531e7d (big blind) collected ($0.1)
Seat 4: Hero folded before Flop (didn't bet)
Seat 5: 5a75ce82 folded before Flop (didn't bet)
Seat 6: bfd53101 folded before Flop (didn't bet)


Poker Hand #RC2771788876: Hold'em No Limit ($0.05/$0.1) - 2024/08/04 10:56:49
Table 'RushAndCash20804136' 6-max Seat #1 is the button
Seat 1: 68b73d84 ($12.45 in chips)
Seat 2: Hero ($31.9 in chips)
Seat 3: 781f7ab ($10.15 in chips)
Seat 4: c0be3f58 ($10.15 in chips)
Seat 5: f3efd356 ($11.02 in chips)
Seat 6: e488ee10 ($35.57 in chips)
Hero: posts small blind $0.05
781f7ab: posts big blind $0.1
*** HOLE CARDS ***
Dealt to 68b73d84 
Dealt to Hero [7h 3d]
Dealt to 781f7ab 
Dealt to c0be3f58 
Dealt to f3efd356 
Dealt to e488ee10 
c0be3f58: folds
f3efd356: folds
e488ee10: raises $0.1 to $0.2
68b73d84: folds
Hero: folds
781f7ab: calls $0.1
*** FLOP *** [Th 7s 9s]
781f7ab: checks
e488ee10: checks
*** TURN *** [Th 7s 9s] [Td]
781f7ab: checks
e488ee10: checks
*** RIVER *** [Th 7s 9s Td] [Qs]
781f7ab: checks
e488ee10: bets $0.34
781f7ab: folds
Uncalled bet ($0.34) returned to e488ee10
*** SHOWDOWN ***
e488ee10 collected $0.43 from pot
*** SUMMARY ***
Total pot $0.45 | Rake $0.02 | Jackpot $0 | Bingo $0 | Fortune $0 | Tax $0
Board [Th 7s 9s Td Qs]
Seat 1: 68b73d84 (button) folded before Flop (didn't bet)
Seat 2: Hero (small blind) folded before Flop
Seat 3: 781f7ab (big blind) folded on the River
Seat 4: c0be3f58 folded before Flop (didn't bet)
Seat 5: f3efd356 folded before Flop (didn't bet)
Seat 6: e488ee10 won ($0.43)


Poker Hand #RC2771788853: Hold'em No Limit ($0.05/$0.1) - 2024/08/04 10:56:46
Table 'RushAndCash20804113' 6-max Seat #1 is the button
Seat 1: Hero ($31.9 in chips)
Seat 2: bb772c14 ($3.33 in chips)
Seat 3: dec8ca00 ($9.99 in chips)
Seat 4: 351b2066 ($12.53 in chips)
Seat 5: 35bec4dd ($11.38 in chips)
Seat 6: 94459eaa ($9.88 in chips)
bb772c14: posts small blind $0.05
dec8ca00: posts big blind $0.1
*** HOLE CARDS ***
Dealt to Hero [7d Ks]
Dealt to bb772c14 
Dealt to dec8ca00 
Dealt to 351b2066 
Dealt to 35bec4dd 
Dealt to 94459eaa 
351b2066: folds
35bec4dd: folds
94459eaa: folds
Hero: folds
bb772c14: folds
Uncalled bet ($0.05) returned to dec8ca00
*** SHOWDOWN ***
dec8ca00 collected $0.1 from pot
*** SUMMARY ***
Total pot $0.1 | Rake $0 | Jackpot $0 | Bingo $0 | Fortune $0 | Tax $0
Seat 1: Hero (button) folded before Flop (didn't bet)
Seat 2: bb772c14 (small blind) folded before Flop
Seat 3: dec8ca00 (big blind) collected ($0.1)
Seat 4: 351b2066 folded before Flop (didn't bet)
Seat 5: 35bec4dd folded before Flop (didn't bet)
Seat 6: 94459eaa folded before Flop (didn't bet)


Poker Hand #RC2771788828: Hold'em No Limit ($0.05/$0.1) - 2024/08/04 10:56:43
Table 'RushAndCash20804088' 6-max Seat #1 is the button
Seat 1: 4f4a1d58 ($21.17 in chips)
Seat 2: b275cda3 ($10 in chips)
Seat 3: Hero ($32 in chips)
Seat 4: 44e483f7 ($28.91 in chips)
Seat 5: cbe2c8e0 ($10 in chips)
Seat 6: 16ce98b3 ($12.2 in chips)
b275cda3: posts small blind $0.05
Hero: posts big blind $0.1
*** HOLE CARDS ***
Dealt to 4f4a1d58 
Dealt to b275cda3 
Dealt to Hero [5h 8d]
Dealt to 44e483f7 
Dealt to cbe2c8e0 
Dealt to 16ce98b3 
44e483f7: folds
cbe2c8e0: folds
16ce98b3: folds
4f4a1d58: raises $0.15 to $0.25
b275cda3: folds
Hero: folds
Uncalled bet ($0.15) returned to 4f4a1d58
*** SHOWDOWN ***
4f4a1d58 collected $0.25 from pot
*** SUMMARY ***
Total pot $0.25 | Rake $0 | Jackpot $0 | Bingo $0 | Fortune $0 | Tax $0
Seat 1: 4f4a1d58 (button) collected ($0.25)
Seat 2: b275cda3 (small blind) folded before Flop
Seat 3: Hero (big blind) folded before Flop
Seat 4: 44e483f7 folded before Flop (didn't bet)
Seat 5: cbe2c8e0 folded before Flop (didn't bet)
Seat 6: 16ce98b3 folded before Flop (didn't bet)


Poker Hand #RC2771788804: Hold'em No Limit ($0.05/$0.1) - 2024/08/04 10:56:40
Table 'RushAndCash20804064' 6-max Seat #1 is the button
Seat 1: 294f07a2 ($14.54 in chips)
Seat 2: 27a3f6e4 ($10 in chips)
Seat 3: e2b7bd7f ($15.44 in chips)
Seat 4: 5135b9f4 ($10.15 in chips)
Seat 5: Hero ($32 in chips)
Seat 6: dec8ca00 ($9.99 in chips)
27a3f6e4: posts small blind $0.05
e2b7bd7f: posts big blind $0.1
*** HOLE CARDS ***
Dealt to 294f07a2 
Dealt to 27a3f6e4 
Dealt to e2b7bd7f 
Dealt to 5135b9f4 
Dealt to Hero [4d 8d]
Dealt to dec8ca00 
5135b9f4: folds
Hero: folds
dec8ca00: folds
294f07a2: folds
27a3f6e4: raises $0.12 to $0.22
e2b7bd7f: folds
Uncalled bet ($0.12) returned to 27a3f6e4
*** SHOWDOWN ***
27a3f6e4 collected $0.2 from pot
*** SUMMARY ***
Total pot $0.2 | Rake $0 | Jackpot $0 | Bingo $0 | Fortune $0 | Tax $0
Seat 1: 294f07a2 (button) folded before Flop (didn't bet)
Seat 2: 27a3f6e4 (small blind) collected ($0.2)
Seat 3: e2b7bd7f (big blind) folded before Flop
Seat 4: 5135b9f4 folded before Flop (didn't bet)
Seat 5: Hero folded before Flop (didn't bet)
Seat 6: dec8ca00 folded before Flop (didn't bet)


Poker Hand #RC2771788780: Hold'em No Limit ($0.05/$0.1) - 2024/08/04 10:56:36
Table 'RushAndCash20804040' 6-max Seat #1 is the button
Seat 1: Hero ($32 in chips)
Seat 2: f06b0738 ($10.37 in chips)
Seat 3: 57862791 ($39.25 in chips)
Seat 4: 210c58ca ($21.8 in chips)
Seat 5: 271e0a8c ($10.51 in chips)
Seat 6: 72d42e4 ($10.39 in chips)
f06b0738: posts small blind $0.05
57862791: posts big blind $0.1
*** HOLE CARDS ***
Dealt to Hero [3c Kc]
Dealt to f06b0738 
Dealt to 57862791 
Dealt to 210c58ca 
Dealt to 271e0a8c 
Dealt to 72d42e4 
210c58ca: folds
271e0a8c: folds
72d42e4: folds
Hero: folds
f06b0738: raises $0.2 to $0.3
57862791: folds
Uncalled bet ($0.2) returned to f06b0738
*** SHOWDOWN ***
f06b0738 collected $0.2 from pot
*** SUMMARY ***
Total pot $0.2 | Rake $0 | Jackpot $0 | Bingo $0 | Fortune $0 | Tax $0
Seat 1: Hero (button) folded before Flop (didn't bet)
Seat 2: f06b0738 (small blind) collected ($0.2)
Seat 3: 57862791 (big blind) folded before Flop
Seat 4: 210c58ca folded before Flop (didn't bet)
Seat 5: 271e0a8c folded before Flop (didn't bet)
Seat 6: 72d42e4 folded before Flop (didn't bet)


Poker Hand #RC2771788510: Hold'em No Limit ($0.05/$0.1) - 2024/08/04 10:55:58
Table 'RushAndCash20803770' 6-max Seat #1 is the button
Seat 1: 1b0c40c2 ($10 in chips)
Seat 2: e1a39450 ($22.51 in chips)
Seat 3: f06b0738 ($10 in chips)
Seat 4: Hero ($32.2 in chips)
Seat 5: 3267ad58 ($10 in chips)
Seat 6: e84dfcb0 ($13.75 in chips)
e1a39450: posts small blind $0.05
f06b0738: posts big blind $0.1
*** HOLE CARDS ***
Dealt to 1b0c40c2 
Dealt to e1a39450 
Dealt to f06b0738 
Dealt to Hero [9h 9d]
Dealt to 3267ad58 
Dealt to e84dfcb0 
Hero: raises $0.1 to $0.2
3267ad58: folds
e84dfcb0: folds
1b0c40c2: folds
e1a39450: calls $0.15
f06b0738: raises $1.2 to $1.4
Hero: folds
e1a39450: folds
Uncalled bet ($1.2) returned to f06b0738
*** SHOWDOWN ***
f06b0738 collected $0.57 from pot
*** SUMMARY ***
Total pot $0.6 | Rake $0.03 | Jackpot $0 | Bingo $0 | Fortune $0 | Tax $0
Seat 1: 1b0c40c2 (button) folded before Flop (didn't bet)
Seat 2: e1a39450 (small blind) folded before Flop
Seat 3: f06b0738 (big blind) collected ($0.57)
Seat 4: Hero folded before Flop
Seat 5: 3267ad58 folded before Flop (didn't bet)
Seat 6: e84dfcb0 folded before Flop (didn't bet)


Poker Hand #RC2771788485: Hold'em No Limit ($0.05/$0.1) - 2024/08/04 10:55:55
Table 'RushAndCash20803745' 6-max Seat #1 is the button
Seat 1: aaac96d5 ($10 in chips)
Seat 2: 3234b8e9 ($12.54 in chips)
Seat 3: f9dd4b13 ($10 in chips)
Seat 4: e1a39450 ($22.51 in chips)
Seat 5: b749b6d2 ($21.9 in chips)
Seat 6: Hero ($32.2 in chips)
3234b8e9: posts small blind $0.05
f9dd4b13: posts big blind $0.1
*** HOLE CARDS ***
Dealt to aaac96d5 
Dealt to 3234b8e9 
Dealt to f9dd4b13 
Dealt to e1a39450 
Dealt to b749b6d2 
Dealt to Hero [2h 4c]
e1a39450: folds
b749b6d2: folds
Hero: folds
aaac96d5: raises $0.15 to $0.25
3234b8e9: folds
f9dd4b13: calls $0.15
*** FLOP *** [9h 4d 8d]
f9dd4b13: checks
aaac96d5: checks
*** TURN *** [9h 4d 8d] [4h]
f9dd4b13: bets $0.29
aaac96d5: folds
Uncalled bet ($0.29) returned to f9dd4b13
*** SHOWDOWN ***
f9dd4b13 collected $0.53 from pot
*** SUMMARY ***
Total pot $0.55 | Rake $0.02 | Jackpot $0 | Bingo $0 | Fortune $0 | Tax $0
Board [9h 4d 8d 4h]
Seat 1: aaac96d5 (button) folded on the Turn
Seat 2: 3234b8e9 (small blind) folded before Flop
Seat 3: f9dd4b13 (big blind) won ($0.53)
Seat 4: e1a39450 folded before Flop (didn't bet)
Seat 5: b749b6d2 folded before Flop (didn't bet)
Seat 6: Hero folded before Flop (didn't bet)


Poker Hand #RC2771788311: Hold'em No Limit ($0.05/$0.1) - 2024/08/04 10:55:34
Table 'RushAndCash20803571' 6-max Seat #1 is the button
Seat 1: 7ca57262 ($14.19 in chips)
Seat 2: b9c76347 ($16.12 in chips)
Seat 3: Hero ($31.97 in chips)
Seat 4: 5c9c14a2 ($10 in chips)
Seat 5: ddaba643 ($9.21 in chips)
Seat 6: 9bc1f882 ($22.49 in chips)
b9c76347: posts small blind $0.05
Hero: posts big blind $0.1
*** HOLE CARDS ***
Dealt to 7ca57262 
Dealt to b9c76347 
Dealt to Hero [As Ad]
Dealt to 5c9c14a2 
Dealt to ddaba643 
Dealt to 9bc1f882 
5c9c14a2: raises $0.1 to $0.2
ddaba643: folds
9bc1f882: folds
7ca57262: folds
b9c76347: folds
Hero: raises $0.7 to $0.9
5c9c14a2: folds
Uncalled bet ($0.7) returned to Hero
*** SHOWDOWN ***
Hero collected $0.43 from pot
*** SUMMARY ***
Total pot $0.45 | Rake $0.02 | Jackpot $0 | Bingo $0 | Fortune $0 | Tax $0
Seat 1: 7ca57262 (button) folded before Flop (didn't bet)
Seat 2: b9c76347 (small blind) folded before Flop
Seat 3: Hero (big blind) collected ($0.43)
Seat 4: 5c9c14a2 folded before Flop
Seat 5: ddaba643 folded before Flop (didn't bet)
Seat 6: 9bc1f882 folded before Flop (didn't bet)


Poker Hand #RC2771788130: Hold'em No Limit ($0.05/$0.1) - 2024/08/04 10:55:11
Table 'RushAndCash20803390' 6-max Seat #1 is the button
Seat 1: 74813e93 ($19.39 in chips)
Seat 2: Hero ($32.27 in chips)
Seat 3: 8c9cc5dc ($5.51 in chips)
Seat 4: 844f67f5 ($21.25 in chips)
Seat 5: 342fbb5b ($4.73 in chips)
Seat 6: 51cfda ($3.91 in chips)
Hero: posts small blind $0.05
8c9cc5dc: posts big blind $0.1
*** HOLE CARDS ***
Dealt to 74813e93 
Dealt to Hero [9s 5s]
Dealt to 8c9cc5dc 
Dealt to 844f67f5 
Dealt to 342fbb5b 
Dealt to 51cfda 
844f67f5: folds
342fbb5b: folds
51cfda: folds
74813e93: folds
Hero: raises $0.2 to $0.3
8c9cc5dc: raises $5.21 to $5.51 and is all-in
Hero: folds
Uncalled bet ($5.21) returned to 8c9cc5dc
*** SHOWDOWN ***
8c9cc5dc collected $0.57 from pot
*** SUMMARY ***
Total pot $0.6 | Rake $0.03 | Jackpot $0 | Bingo $0 | Fortune $0 | Tax $0
Seat 1: 74813e93 (button) folded before Flop (didn't bet)
Seat 2: Hero (small blind) folded before Flop
Seat 3: 8c9cc5dc (big blind) collected ($0.57)
Seat 4: 844f67f5 folded before Flop (didn't bet)
Seat 5: 342fbb5b folded before Flop (didn't bet)
Seat 6: 51cfda folded before Flop (didn't bet)


Poker Hand #RC2771788099: Hold'em No Limit ($0.05/$0.1) - 2024/08/04 10:55:08
Table 'RushAndCash20803359' 6-max Seat #1 is the button
Seat 1: f64bef ($11.49 in chips)
Seat 2: c9f8ca6f ($10.15 in chips)
Seat 3: 75104115 ($8.89 in chips)
Seat 4: ce619ff2 ($27.05 in chips)
Seat 5: b7b90fce ($10 in chips)
Seat 6: Hero ($32.27 in chips)
c9f8ca6f: posts small blind $0.05
75104115: posts big blind $0.1
*** HOLE CARDS ***
Dealt to f64bef 
Dealt to c9f8ca6f 
Dealt to 75104115 
Dealt to ce619ff2 
Dealt to b7b90fce 
Dealt to Hero [7d As]
ce619ff2: folds
b7b90fce: folds
Hero: folds
f64bef: folds
c9f8ca6f: folds
Uncalled bet ($0.05) returned to 75104115
*** SHOWDOWN ***
75104115 collected $0.1 from pot
*** SUMMARY ***
Total pot $0.1 | Rake $0 | Jackpot $0 | Bingo $0 | Fortune $0 | Tax $0
Seat 1: f64bef (button) folded before Flop (didn't bet)
Seat 2: c9f8ca6f (small blind) folded before Flop
Seat 3: 75104115 (big blind) collected ($0.1)
Seat 4: ce619ff2 folded before Flop (didn't bet)
Seat 5: b7b90fce folded before Flop (didn't bet)
Seat 6: Hero folded before Flop (didn't bet)


Poker Hand #RC2771788070: Hold'em No Limit ($0.05/$0.1) - 2024/08/04 10:55:04
Table 'RushAndCash20803330' 6-max Seat #1 is the button
Seat 1: 56587ded ($15.08 in chips)
Seat 2: 7d531e7d ($11.68 in chips)
Seat 3: b8561cc1 ($11.15 in chips)
Seat 4: ea536622 ($24.52 in chips)
Seat 5: Hero ($32.27 in chips)
Seat 6: 4f10591d ($11.5 in chips)
7d531e7d: posts small blind $0.05
b8561cc1: posts big blind $0.1
*** HOLE CARDS ***
Dealt to 56587ded 
Dealt to 7d531e7d 
Dealt to b8561cc1 
Dealt to ea536622 
Dealt to Hero [Qs 8h]
Dealt to 4f10591d 
ea536622: folds
Hero: folds
4f10591d: raises $0.18 to $0.28
56587ded: folds
7d531e7d: folds
b8561cc1: folds
Uncalled bet ($0.18) returned to 4f10591d
*** SHOWDOWN ***
4f10591d collected $0.25 from pot
*** SUMMARY ***
Total pot $0.25 | Rake $0 | Jackpot $0 | Bingo $0 | Fortune $0 | Tax $0
Seat 1: 56587ded (button) folded before Flop (didn't bet)
Seat 2: 7d531e7d (small blind) folded before Flop
Seat 3: b8561cc1 (big blind) folded before Flop
Seat 4: ea536622 folded before Flop (didn't bet)
Seat 5: Hero folded before Flop (didn't bet)
Seat 6: 4f10591d collected ($0.25)


Poker Hand #RC2771788046: Hold'em No Limit ($0.05/$0.1) - 2024/08/04 10:55:01
Table 'RushAndCash20803306' 6-max Seat #1 is the button
Seat 1: c7d3fb41 ($10.23 in chips)
Seat 2: c0be3f58 ($10 in chips)
Seat 3: d56b2dc3 ($13.43 in chips)
Seat 4: Hero ($32.27 in chips)
Seat 5: 482e88b5 ($12.43 in chips)
Seat 6: cd4487bf ($10 in chips)
c0be3f58: posts small blind $0.05
d56b2dc3: posts big blind $0.1
*** HOLE CARDS ***
Dealt to c7d3fb41 
Dealt to c0be3f58 
Dealt to d56b2dc3 
Dealt to Hero [8h 7h]
Dealt to 482e88b5 
Dealt to cd4487bf 
Hero: folds
482e88b5: folds
cd4487bf: folds
c7d3fb41: folds
c0be3f58: raises $0.2 to $0.3
d56b2dc3: folds
Uncalled bet ($0.2) returned to c0be3f58
*** SHOWDOWN ***
c0be3f58 collected $0.2 from pot
*** SUMMARY ***
Total pot $0.2 | Rake $0 | Jackpot $0 | Bingo $0 | Fortune $0 | Tax $0
Seat 1: c7d3fb41 (button) folded before Flop (didn't bet)
Seat 2: c0be3f58 (small blind) collected ($0.2)
Seat 3: d56b2dc3 (big blind) folded before Flop
Seat 4: Hero folded before Flop (didn't bet)
Seat 5: 482e88b5 folded before Flop (didn't bet)
Seat 6: cd4487bf folded before Flop (didn't bet)


Poker Hand #RC2771788018: Hold'em No Limit ($0.05/$0.1) - 2024/08/04 10:54:58
Table 'RushAndCash20803278' 6-max Seat #1 is the button
Seat 1: Hero ($32.27 in chips)
Seat 2: 7910f353 ($10.72 in chips)
Seat 3: 3cef30db ($10.69 in chips)
Seat 4: 541ec3b4 ($11.34 in chips)
Seat 5: c366e765 ($11.43 in chips)
Seat 6: 1ad07a30 ($19 in chips)
7910f353: posts small blind $0.05
3cef30db: posts big blind $0.1
*** HOLE CARDS ***
Dealt to Hero [4h Ac]
Dealt to 7910f353 
Dealt to 3cef30db 
Dealt to 541ec3b4 
Dealt to c366e765 
Dealt to 1ad07a30 
541ec3b4: folds
c366e765: folds
1ad07a30: folds
Hero: folds
7910f353: folds
Uncalled bet ($0.05) returned to 3cef30db
*** SHOWDOWN ***
3cef30db collected $0.1 from pot
*** SUMMARY ***
Total pot $0.1 | Rake $0 | Jackpot $0 | Bingo $0 | Fortune $0 | Tax $0
Seat 1: Hero (button) folded before Flop (didn't bet)
Seat 2: 7910f353 (small blind) folded before Flop
Seat 3: 3cef30db (big blind) collected ($0.1)
Seat 4: 541ec3b4 folded before Flop (didn't bet)
Seat 5: c366e765 folded before Flop (didn't bet)
Seat 6: 1ad07a30 folded before Flop (didn't bet)


Poker Hand #RC2771787947: Hold'em No Limit ($0.05/$0.1) - 2024/08/04 10:54:50
Table 'RushAndCash20803207' 6-max Seat #1 is the button
Seat 1: 1b0c40c2 ($10 in chips)
Seat 2: 3968ffd4 ($10 in chips)
Seat 3: Hero ($32.22 in chips)
Seat 4: c2ab94b0 ($19.52 in chips)
Seat 5: 1ad07a30 ($19.1 in chips)
Seat 6: 6e0df215 ($14.81 in chips)
3968ffd4: posts small blind $0.05
Hero: posts big blind $0.1
*** HOLE CARDS ***
Dealt to 1b0c40c2 
Dealt to 3968ffd4 
Dealt to Hero [Kh 7h]
Dealt to c2ab94b0 
Dealt to 1ad07a30 
Dealt to 6e0df215 
c2ab94b0: folds
1ad07a30: folds
6e0df215: folds
1b0c40c2: folds
3968ffd4: folds
Uncalled bet ($0.05) returned to Hero
*** SHOWDOWN ***
Hero collected $0.1 from pot
*** SUMMARY ***
Total pot $0.1 | Rake $0 | Jackpot $0 | Bingo $0 | Fortune $0 | Tax $0
Seat 1: 1b0c40c2 (button) folded before Flop (didn't bet)
Seat 2: 3968ffd4 (small blind) folded before Flop
Seat 3: Hero (big blind) collected ($0.1)
Seat 4: c2ab94b0 folded before Flop (didn't bet)
Seat 5: 1ad07a30 folded before Flop (didn't bet)
Seat 6: 6e0df215 folded before Flop (didn't bet)


Poker Hand #RC2771787904: Hold'em No Limit ($0.05/$0.1) - 2024/08/04 10:54:45
Table 'RushAndCash20803164' 6-max Seat #1 is the button
Seat 1: ab8944cf ($10.15 in chips)
Seat 2: Hero ($32.27 in chips)
Seat 3: 56587ded ($15.03 in chips)
Seat 4: 74a70ec0 ($20.79 in chips)
Seat 5: 47f6e2ce ($10.17 in chips)
Seat 6: cb9dc53 ($9.79 in chips)
Hero: posts small blind $0.05
56587ded: posts big blind $0.1
*** HOLE CARDS ***
Dealt to ab8944cf 
Dealt to Hero [4s 9h]
Dealt to 56587ded 
Dealt to 74a70ec0 
Dealt to 47f6e2ce 
Dealt to cb9dc53 
74a70ec0: folds
47f6e2ce: folds
cb9dc53: folds
ab8944cf: folds
Hero: folds
Uncalled bet ($0.05) returned to 56587ded
*** SHOWDOWN ***
56587ded collected $0.1 from pot
*** SUMMARY ***
Total pot $0.1 | Rake $0 | Jackpot $0 | Bingo $0 | Fortune $0 | Tax $0
Seat 1: ab8944cf (button) folded before Flop (didn't bet)
Seat 2: Hero (small blind) folded before Flop
Seat 3: 56587ded (big blind) collected ($0.1)
Seat 4: 74a70ec0 folded before Flop (didn't bet)
Seat 5: 47f6e2ce folded before Flop (didn't bet)
Seat 6: cb9dc53 folded before Flop (didn't bet)


Poker Hand #RC2771787879: Hold'em No Limit ($0.05/$0.1) - 2024/08/04 10:54:41
Table 'RushAndCash20803139' 6-max Seat #1 is the button
Seat 1: 35bec4dd ($11.98 in chips)
Seat 2: 93285ab3 ($10 in chips)
Seat 3: 34c80376 ($10 in chips)
Seat 4: Hero ($32.27 in chips)
Seat 5: 9f56fc6d ($42.14 in chips)
Seat 6: 5d5e7e95 ($11.2 in chips)
93285ab3: posts small blind $0.05
34c80376: posts big blind $0.1
*** HOLE CARDS ***
Dealt to 35bec4dd 
Dealt to 93285ab3 
Dealt to 34c80376 
Dealt to Hero [2c 9h]
Dealt to 9f56fc6d 
Dealt to 5d5e7e95 
Hero: folds
9f56fc6d: raises $0.1 to $0.2
5d5e7e95: folds
35bec4dd: folds
93285ab3: folds
34c80376: folds
Uncalled bet ($0.1) returned to 9f56fc6d
*** SHOWDOWN ***
9f56fc6d collected $0.25 from pot
*** SUMMARY ***
Total pot $0.25 | Rake $0 | Jackpot $0 | Bingo $0 | Fortune $0 | Tax $0
Seat 1: 35bec4dd (button) folded before Flop (didn't bet)
Seat 2: 93285ab3 (small blind) folded before Flop
Seat 3: 34c80376 (big blind) folded before Flop
Seat 4: Hero folded before Flop (didn't bet)
Seat 5: 9f56fc6d collected ($0.25)
Seat 6: 5d5e7e95 folded before Flop (didn't bet)


Poker Hand #RC2771787704: Hold'em No Limit ($0.05/$0.1) - 2024/08/04 10:54:20
Table 'RushAndCash20802964' 6-max Seat #1 is the button
Seat 1: 65ff60e9 ($10 in chips)
Seat 2: 5d1e428d ($22.79 in chips)
Seat 3: 47262397 ($10 in chips)
Seat 4: Hero ($32.47 in chips)
Seat 5: ca5ec18 ($24.65 in chips)
Seat 6: 5f20a05a ($12.78 in chips)
5d1e428d: posts small blind $0.05
47262397: posts big blind $0.1
*** HOLE CARDS ***
Dealt to 65ff60e9 
Dealt to 5d1e428d 
Dealt to 47262397 
Dealt to Hero [Tc Ad]
Dealt to ca5ec18 
Dealt to 5f20a05a 
Hero: raises $0.1 to $0.2
ca5ec18: folds
5f20a05a: folds
65ff60e9: folds
5d1e428d: folds
47262397: calls $0.1
*** FLOP *** [6c 8h 5c]
47262397: bets $0.33
Hero: folds
Uncalled bet ($0.33) returned to 47262397
*** SHOWDOWN ***
47262397 collected $0.43 from pot
*** SUMMARY ***
Total pot $0.45 | Rake $0.02 | Jackpot $0 | Bingo $0 | Fortune $0 | Tax $0
Board [6c 8h 5c]
Seat 1: 65ff60e9 (button) folded before Flop (didn't bet)
Seat 2: 5d1e428d (small blind) folded before Flop
Seat 3: 47262397 (big blind) won ($0.43)
Seat 4: Hero folded on the Flop
Seat 5: ca5ec18 folded before Flop (didn't bet)
Seat 6: 5f20a05a folded before Flop (didn't bet)


Poker Hand #RC2771787639: Hold'em No Limit ($0.05/$0.1) - 2024/08/04 10:54:12
Table 'RushAndCash20802899' 6-max Seat #1 is the button
Seat 1: Hero ($32.47 in chips)
Seat 2: 3c01d902 ($12.16 in chips)
Seat 3: aaac96d5 ($10.1 in chips)
Seat 4: f99f1785 ($2.78 in chips)
Seat 5: b11bd88c ($15.3 in chips)
Seat 6: 4827d941 ($10.75 in chips)
3c01d902: posts small blind $0.05
aaac96d5: posts big blind $0.1
*** HOLE CARDS ***
Dealt to Hero [Qs 4h]
Dealt to 3c01d902 
Dealt to aaac96d5 
Dealt to f99f1785 
Dealt to b11bd88c 
Dealt to 4827d941 
f99f1785: folds
b11bd88c: folds
4827d941: folds
Hero: folds
3c01d902: folds
Uncalled bet ($0.05) returned to aaac96d5
*** SHOWDOWN ***
aaac96d5 collected $0.1 from pot
*** SUMMARY ***
Total pot $0.1 | Rake $0 | Jackpot $0 | Bingo $0 | Fortune $0 | Tax $0
Seat 1: Hero (button) folded before Flop (didn't bet)
Seat 2: 3c01d902 (small blind) folded before Flop
Seat 3: aaac96d5 (big blind) collected ($0.1)
Seat 4: f99f1785 folded before Flop (didn't bet)
Seat 5: b11bd88c folded before Flop (didn't bet)
Seat 6: 4827d941 folded before Flop (didn't bet)


Poker Hand #RC2771787583: Hold'em No Limit ($0.05/$0.1) - 2024/08/04 10:54:04
Table 'RushAndCash20802843' 6-max Seat #1 is the button
Seat 1: db04086d ($11.77 in chips)
Seat 2: 21a4c51d ($25.16 in chips)
Seat 3: 5db9c6b8 ($11.06 in chips)
Seat 4: aaac96d5 ($10.1 in chips)
Seat 5: Hero ($32.47 in chips)
Seat 6: 74cc7be7 ($14.41 in chips)
21a4c51d: posts small blind $0.05
5db9c6b8: posts big blind $0.1
*** HOLE CARDS ***
Dealt to db04086d 
Dealt to 21a4c51d 
Dealt to 5db9c6b8 
Dealt to aaac96d5 
Dealt to Hero [5d Ks]
Dealt to 74cc7be7 
aaac96d5: folds
Hero: folds
74cc7be7: folds
db04086d: raises $0.15 to $0.25
21a4c51d: folds
5db9c6b8: raises $0.7 to $0.95
db04086d: folds
Uncalled bet ($0.7) returned to 5db9c6b8
*** SHOWDOWN ***
5db9c6b8 collected $0.53 from pot
*** SUMMARY ***
Total pot $0.55 | Rake $0.02 | Jackpot $0 | Bingo $0 | Fortune $0 | Tax $0
Seat 1: db04086d (button) folded before Flop
Seat 2: 21a4c51d (small blind) folded before Flop
Seat 3: 5db9c6b8 (big blind) collected ($0.53)
Seat 4: aaac96d5 folded before Flop (didn't bet)
Seat 5: Hero folded before Flop (didn't bet)
Seat 6: 74cc7be7 folded before Flop (didn't bet)


Poker Hand #RC2771787553: Hold'em No Limit ($0.05/$0.1) - 2024/08/04 10:54:00
Table 'RushAndCash20802813' 6-max Seat #1 is the button
Seat 1: ef9dc4c1 ($13.04 in chips)
Seat 2: Hero ($32.52 in chips)
Seat 3: fafe1b48 ($24.08 in chips)
Seat 4: 294f07a2 ($12.07 in chips)
Seat 5: e8b25c4e ($10.19 in chips)
Seat 6: ab6efce2 ($10 in chips)
Hero: posts small blind $0.05
fafe1b48: posts big blind $0.1
*** HOLE CARDS ***
Dealt to ef9dc4c1 
Dealt to Hero [2d Qh]
Dealt to fafe1b48 
Dealt to 294f07a2 
Dealt to e8b25c4e 
Dealt to ab6efce2 
294f07a2: folds
e8b25c4e: raises $0.13 to $0.23
ab6efce2: folds
ef9dc4c1: folds
Hero: folds
fafe1b48: folds
Uncalled bet ($0.13) returned to e8b25c4e
*** SHOWDOWN ***
e8b25c4e collected $0.25 from pot
*** SUMMARY ***
Total pot $0.25 | Rake $0 | Jackpot $0 | Bingo $0 | Fortune $0 | Tax $0
Seat 1: ef9dc4c1 (button) folded before Flop (didn't bet)
Seat 2: Hero (small blind) folded before Flop
Seat 3: fafe1b48 (big blind) folded before Flop
Seat 4: 294f07a2 folded before Flop (didn't bet)
Seat 5: e8b25c4e collected ($0.25)
Seat 6: ab6efce2 folded before Flop (didn't bet)


Poker Hand #RC2771741142: Hold'em No Limit ($0.05/$0.1) - 2024/08/04 10:40:33
Table 'RushAndCash20796402' 6-max Seat #1 is the button
Seat 1: 8609d9ac ($10.05 in chips)
Seat 2: de9bdfb1 ($12.55 in chips)
Seat 3: Hero ($32.25 in chips)
Seat 4: 89e4aa2d ($11.07 in chips)
Seat 5: 2d6ece5f ($11.14 in chips)
Seat 6: 288d6d95 ($20.92 in chips)
de9bdfb1: posts small blind $0.05
Hero: posts big blind $0.1
*** HOLE CARDS ***
Dealt to 8609d9ac 
Dealt to de9bdfb1 
Dealt to Hero [Qs Qh]
Dealt to 89e4aa2d 
Dealt to 2d6ece5f 
Dealt to 288d6d95 
89e4aa2d: folds
2d6ece5f: folds
288d6d95: folds
8609d9ac: folds
de9bdfb1: raises $0.2 to $0.3
Hero: raises $0.6 to $0.9
de9bdfb1: folds
Uncalled bet ($0.6) returned to Hero
*** SHOWDOWN ***
Hero collected $0.57 from pot
*** SUMMARY ***
Total pot $0.6 | Rake $0.03 | Jackpot $0 | Bingo $0 | Fortune $0 | Tax $0
Seat 1: 8609d9ac (button) folded before Flop (didn't bet)
Seat 2: de9bdfb1 (small blind) folded before Flop
Seat 3: Hero (big blind) collected ($0.57)
Seat 4: 89e4aa2d folded before Flop (didn't bet)
Seat 5: 2d6ece5f folded before Flop (didn't bet)
Seat 6: 288d6d95 folded before Flop (didn't bet)


Poker Hand #RC2771741117: Hold'em No Limit ($0.05/$0.1) - 2024/08/04 10:40:30
Table 'RushAndCash20796377' 6-max Seat #1 is the button
Seat 1: e6e8601a ($23.12 in chips)
Seat 2: 6ef67a73 ($12.81 in chips)
Seat 3: 5774fe03 ($10 in chips)
Seat 4: Hero ($32.25 in chips)
Seat 5: 74a70ec0 ($21.52 in chips)
Seat 6: 9b9f945f ($24.11 in chips)
6ef67a73: posts small blind $0.05
5774fe03: posts big blind $0.1
*** HOLE CARDS ***
Dealt to e6e8601a 
Dealt to 6ef67a73 
Dealt to 5774fe03 
Dealt to Hero [4s 8c]
Dealt to 74a70ec0 
Dealt to 9b9f945f 
Hero: folds
74a70ec0: folds
9b9f945f: raises $0.1 to $0.2
e6e8601a: raises $0.42 to $0.62
6ef67a73: folds
5774fe03: folds
9b9f945f: folds
Uncalled bet ($0.42) returned to e6e8601a
*** SHOWDOWN ***
e6e8601a collected $0.53 from pot
*** SUMMARY ***
Total pot $0.55 | Rake $0.02 | Jackpot $0 | Bingo $0 | Fortune $0 | Tax $0
Seat 1: e6e8601a (button) collected ($0.53)
Seat 2: 6ef67a73 (small blind) folded before Flop
Seat 3: 5774fe03 (big blind) folded before Flop
Seat 4: Hero folded before Flop (didn't bet)
Seat 5: 74a70ec0 folded before Flop (didn't bet)
Seat 6: 9b9f945f folded before Flop


Poker Hand #RC2771741089: Hold'em No Limit ($0.05/$0.1) - 2024/08/04 10:40:27
Table 'RushAndCash20796349' 6-max Seat #1 is the button
Seat 1: Hero ($32.25 in chips)
Seat 2: 48fa6d9 ($11.23 in chips)
Seat 3: 44f1e248 ($10 in chips)
Seat 4: 34d94a51 ($10 in chips)
Seat 5: 8615e9e7 ($11.94 in chips)
Seat 6: 3aea63ac ($10.37 in chips)
48fa6d9: posts small blind $0.05
44f1e248: posts big blind $0.1
*** HOLE CARDS ***
Dealt to Hero [9d 5c]
Dealt to 48fa6d9 
Dealt to 44f1e248 
Dealt to 34d94a51 
Dealt to 8615e9e7 
Dealt to 3aea63ac 
34d94a51: raises $0.15 to $0.25
8615e9e7: folds
3aea63ac: raises $0.55 to $0.8
Hero: folds
48fa6d9: folds
44f1e248: folds
34d94a51: calls $0.55
*** FLOP *** [3d 4d 5d]
34d94a51: checks
3aea63ac: checks
*** TURN *** [3d 4d 5d] [3s]
34d94a51: bets $1
3aea63ac: calls $1
*** RIVER *** [3d 4d 5d 3s] [2d]
34d94a51: bets $1.9
3aea63ac: calls $1.9
34d94a51: shows [6c 6h] (Sixes-High Straight)
3aea63ac: shows [Qd Kd] (King High Flush)
*** SHOWDOWN ***
3aea63ac collected $7.1 from pot
*** SUMMARY ***
Total pot $7.55 | Rake $0.3 | Jackpot $0.15 | Bingo $0 | Fortune $0 | Tax $0
Board [3d 4d 5d 3s 2d]
Seat 1: Hero (button) folded before Flop (didn't bet)
Seat 2: 48fa6d9 (small blind) folded before Flop
Seat 3: 44f1e248 (big blind) folded before Flop
Seat 4: 34d94a51 showed [6c 6h] and lost with Sixes-High Straight
Seat 5: 8615e9e7 folded before Flop (didn't bet)
Seat 6: 3aea63ac showed [Qd Kd] and won ($7.1) with King High Flush


Poker Hand #RC2771741045: Hold'em No Limit ($0.05/$0.1) - 2024/08/04 10:40:21
Table 'RushAndCash20796305' 6-max Seat #1 is the button
Seat 1: 1ad07a30 ($11.02 in chips)
Seat 2: Hero ($32.3 in chips)
Seat 3: e4181351 ($12.11 in chips)
Seat 4: b32a23b9 ($14.49 in chips)
Seat 5: 89e4aa2d ($11.07 in chips)
Seat 6: 938fde86 ($16.94 in chips)
Hero: posts small blind $0.05
e4181351: posts big blind $0.1
*** HOLE CARDS ***
Dealt to 1ad07a30 
Dealt to Hero [4d 8d]
Dealt to e4181351 
Dealt to b32a23b9 
Dealt to 89e4aa2d 
Dealt to 938fde86 
b32a23b9: raises $0.12 to $0.22
89e4aa2d: folds
938fde86: folds
1ad07a30: folds
Hero: folds
e4181351: calls $0.12
*** FLOP *** [Jd 4c 8c]
e4181351: checks
b32a23b9: bets $0.3
e4181351: calls $0.3
*** TURN *** [Jd 4c 8c] [Jh]
e4181351: checks
b32a23b9: bets $0.6
e4181351: raises $1.4 to $2
b32a23b9: folds
Uncalled bet ($1.4) returned to e4181351
*** SHOWDOWN ***
e4181351 collected $2.18 from pot
*** SUMMARY ***
Total pot $2.29 | Rake $0.11 | Jackpot $0 | Bingo $0 | Fortune $0 | Tax $0
Board [Jd 4c 8c Jh]
Seat 1: 1ad07a30 (button) folded before Flop (didn't bet)
Seat 2: Hero (small blind) folded before Flop
Seat 3: e4181351 (big blind) won ($2.18)
Seat 4: b32a23b9 folded on the Turn
Seat 5: 89e4aa2d folded before Flop (didn't bet)
Seat 6: 938fde86 folded before Flop (didn't bet)


Poker Hand #RC2771741011: Hold'em No Limit ($0.05/$0.1) - 2024/08/04 10:40:17
Table 'RushAndCash20796271' 6-max Seat #1 is the button
Seat 1: aa183b49 ($19.96 in chips)
Seat 2: 8c2139b4 ($10.2 in chips)
Seat 3: 7cdc313e ($10.15 in chips)
Seat 4: baa0cd2 ($23.05 in chips)
Seat 5: Hero ($32.3 in chips)
Seat 6: b121d894 ($14.76 in chips)
8c2139b4: posts small blind $0.05
7cdc313e: posts big blind $0.1
*** HOLE CARDS ***
Dealt to aa183b49 
Dealt to 8c2139b4 
Dealt to 7cdc313e 
Dealt to baa0cd2 
Dealt to Hero [Qc 5d]
Dealt to b121d894 
baa0cd2: folds
Hero: folds
b121d894: folds
aa183b49: folds
8c2139b4: raises $0.15 to $0.25
7cdc313e: calls $0.15
*** FLOP *** [Jc Ah 7s]
8c2139b4: bets $0.3
7cdc313e: folds
Uncalled bet ($0.3) returned to 8c2139b4
*** SHOWDOWN ***
8c2139b4 collected $0.48 from pot
*** SUMMARY ***
Total pot $0.5 | Rake $0.02 | Jackpot $0 | Bingo $0 | Fortune $0 | Tax $0
Board [Jc Ah 7s]
Seat 1: aa183b49 (button) folded before Flop (didn't bet)
Seat 2: 8c2139b4 (small blind) won ($0.48)
Seat 3: 7cdc313e (big blind) folded on the Flop
Seat 4: baa0cd2 folded before Flop (didn't bet)
Seat 5: Hero folded before Flop (didn't bet)
Seat 6: b121d894 folded before Flop (didn't bet)


Poker Hand #RC2771740939: Hold'em No Limit ($0.05/$0.1) - 2024/08/04 10:40:08
Table 'RushAndCash20796199' 6-max Seat #1 is the button
Seat 1: 8d0dba5a ($10.1 in chips)
Seat 2: 12e5985 ($10.05 in chips)
Seat 3: a1b9bc04 ($5.84 in chips)
Seat 4: 938fde86 ($16.94 in chips)
Seat 5: Hero ($32.15 in chips)
Seat 6: c00a92c4 ($10 in chips)
12e5985: posts small blind $0.05
a1b9bc04: posts big blind $0.1
*** HOLE CARDS ***
Dealt to 8d0dba5a 
Dealt to 12e5985 
Dealt to a1b9bc04 
Dealt to 938fde86 
Dealt to Hero [3s 3d]
Dealt to c00a92c4 
938fde86: folds
Hero: folds
c00a92c4: folds
8d0dba5a: raises $0.1 to $0.2
12e5985: folds
a1b9bc04: calls $0.1
*** FLOP *** [7c Ts Ad]
a1b9bc04: checks
8d0dba5a: bets $0.15
a1b9bc04: calls $0.15
*** TURN *** [7c Ts Ad] [Qs]
a1b9bc04: checks
8d0dba5a: checks
*** RIVER *** [7c Ts Ad Qs] [4h]
a1b9bc04: checks
8d0dba5a: bets $0.75
a1b9bc04: folds
Uncalled bet ($0.75) returned to 8d0dba5a
*** SHOWDOWN ***
8d0dba5a collected $0.72 from pot
*** SUMMARY ***
Total pot $0.75 | Rake $0.03 | Jackpot $0 | Bingo $0 | Fortune $0 | Tax $0
Board [7c Ts Ad Qs 4h]
Seat 1: 8d0dba5a (button) won ($0.72)
Seat 2: 12e5985 (small blind) folded before Flop
Seat 3: a1b9bc04 (big blind) folded on the River
Seat 4: 938fde86 folded before Flop (didn't bet)
Seat 5: Hero folded before Flop (didn't bet)
Seat 6: c00a92c4 folded before Flop (didn't bet)


Poker Hand #RC2771740816: Hold'em No Limit ($0.05/$0.1) - 2024/08/04 10:39:53
Table 'RushAndCash20796076' 6-max Seat #1 is the button
Seat 1: 56a3f58b ($11.25 in chips)
Seat 2: 74cc7be7 ($8.31 in chips)
Seat 3: Hero ($32.25 in chips)
Seat 4: a70c6a77 ($10.27 in chips)
Seat 5: e47c7f94 ($11.73 in chips)
Seat 6: b14aadb3 ($11.52 in chips)
74cc7be7: posts small blind $0.05
Hero: posts big blind $0.1
*** HOLE CARDS ***
Dealt to 56a3f58b 
Dealt to 74cc7be7 
Dealt to Hero [2c 8h]
Dealt to a70c6a77 
Dealt to e47c7f94 
Dealt to b14aadb3 
a70c6a77: folds
e47c7f94: folds
b14aadb3: folds
56a3f58b: folds
74cc7be7: folds
Uncalled bet ($0.05) returned to Hero
*** SHOWDOWN ***
Hero collected $0.1 from pot
*** SUMMARY ***
Total pot $0.1 | Rake $0 | Jackpot $0 | Bingo $0 | Fortune $0 | Tax $0
Seat 1: 56a3f58b (button) folded before Flop (didn't bet)
Seat 2: 74cc7be7 (small blind) folded before Flop
Seat 3: Hero (big blind) collected ($0.1)
Seat 4: a70c6a77 folded before Flop (didn't bet)
Seat 5: e47c7f94 folded before Flop (didn't bet)
Seat 6: b14aadb3 folded before Flop (didn't bet)


Poker Hand #RC2771740787: Hold'em No Limit ($0.05/$0.1) - 2024/08/04 10:39:50
Table 'RushAndCash20796047' 6-max Seat #1 is the button
Seat 1: b46ece11 ($10.38 in chips)
Seat 2: 72d42e4 ($10 in chips)
Seat 3: 3eed9a02 ($13.35 in chips)
Seat 4: Hero ($32.25 in chips)
Seat 5: 8615e9e7 ($12.09 in chips)
Seat 6: a5c05132 ($10.15 in chips)
72d42e4: posts small blind $0.05
3eed9a02: posts big blind $0.1
*** HOLE CARDS ***
Dealt to b46ece11 
Dealt to 72d42e4 
Dealt to 3eed9a02 
Dealt to Hero [Qs 9c]
Dealt to 8615e9e7 
Dealt to a5c05132 
Hero: folds
8615e9e7: folds
a5c05132: folds
b46ece11: folds
72d42e4: folds
Uncalled bet ($0.05) returned to 3eed9a02
*** SHOWDOWN ***
3eed9a02 collected $0.1 from pot
*** SUMMARY ***
Total pot $0.1 | Rake $0 | Jackpot $0 | Bingo $0 | Fortune $0 | Tax $0
Seat 1: b46ece11 (button) folded before Flop (didn't bet)
Seat 2: 72d42e4 (small blind) folded before Flop
Seat 3: 3eed9a02 (big blind) collected ($0.1)
Seat 4: Hero folded before Flop (didn't bet)
Seat 5: 8615e9e7 folded before Flop (didn't bet)
Seat 6: a5c05132 folded before Flop (didn't bet)


Poker Hand #RC2771740756: Hold'em No Limit ($0.05/$0.1) - 2024/08/04 10:39:46
Table 'RushAndCash20796016' 6-max Seat #1 is the button
Seat 1: 8615e9e7 ($12.09 in chips)
Seat 2: 1ad07a30 ($11.02 in chips)
Seat 3: 80de2b0c ($10 in chips)
Seat 4: 3dc3b335 ($10.58 in chips)
Seat 5: 7aec7bb3 ($10 in chips)
Seat 6: Hero ($32.25 in chips)
1ad07a30: posts small blind $0.05
80de2b0c: posts big blind $0.1
*** HOLE CARDS ***
Dealt to 8615e9e7 
Dealt to 1ad07a30 
Dealt to 80de2b0c 
Dealt to 3dc3b335 
Dealt to 7aec7bb3 
Dealt to Hero [7d 9h]
3dc3b335: folds
7aec7bb3: folds
Hero: folds
8615e9e7: folds
1ad07a30: raises $0.2 to $0.3
80de2b0c: folds
Uncalled bet ($0.2) returned to 1ad07a30
*** SHOWDOWN ***
1ad07a30 collected $0.2 from pot
*** SUMMARY ***
Total pot $0.2 | Rake $0 | Jackpot $0 | Bingo $0 | Fortune $0 | Tax $0
Seat 1: 8615e9e7 (button) folded before Flop (didn't bet)
Seat 2: 1ad07a30 (small blind) collected ($0.2)
Seat 3: 80de2b0c (big blind) folded before Flop
Seat 4: 3dc3b335 folded before Flop (didn't bet)
Seat 5: 7aec7bb3 folded before Flop (didn't bet)
Seat 6: Hero folded before Flop (didn't bet)


Poker Hand #RC2771740724: Hold'em No Limit ($0.05/$0.1) - 2024/08/04 10:39:43
Table 'RushAndCash20795984' 6-max Seat #1 is the button
Seat 1: Hero ($32.25 in chips)
Seat 2: ce934660 ($9.34 in chips)
Seat 3: 8d0dba5a ($10.25 in chips)
Seat 4: c2ab94b0 ($10.49 in chips)
Seat 5: ab598596 ($11.52 in chips)
Seat 6: 7910f353 ($11.11 in chips)
ce934660: posts small blind $0.05
8d0dba5a: posts big blind $0.1
*** HOLE CARDS ***
Dealt to Hero [8h 7s]
Dealt to ce934660 
Dealt to 8d0dba5a 
Dealt to c2ab94b0 
Dealt to ab598596 
Dealt to 7910f353 
c2ab94b0: folds
ab598596: folds
7910f353: raises $0.1 to $0.2
Hero: folds
ce934660: raises $0.5 to $0.7
8d0dba5a: folds
7910f353: calls $0.5
*** FLOP *** [As 7d 9s]
ce934660: bets $0.75
7910f353: calls $0.75
*** TURN *** [As 7d 9s] [8s]
ce934660: checks
7910f353: bets $0.9
ce934660: raises $1.59 to $2.49
7910f353: calls $1.59
*** RIVER *** [As 7d 9s 8s] [6h]
ce934660: bets $5.4 and is all-in
7910f353: calls $5.4
ce934660: shows [Qs Ts] (Ace High Flush)
7910f353: shows [Th Jh] (Jacks-High Straight)
*** SHOWDOWN ***
ce934660 collected $18.33 from pot
*** SUMMARY ***
Total pot $18.78 | Rake $0.3 | Jackpot $0.15 | Bingo $0 | Fortune $0 | Tax $0
Board [As 7d 9s 8s 6h]
Seat 1: Hero (button) folded before Flop (didn't bet)
Seat 2: ce934660 (small blind) showed [Qs Ts] and won ($18.33) with Ace High Flush
Seat 3: 8d0dba5a (big blind) folded before Flop
Seat 4: c2ab94b0 folded before Flop (didn't bet)
Seat 5: ab598596 folded before Flop (didn't bet)
Seat 6: 7910f353 showed [Th Jh] and lost with Jacks-High Straight


Poker Hand #RC2771740700: Hold'em No Limit ($0.05/$0.1) - 2024/08/04 10:39:40
Table 'RushAndCash20795960' 6-max Seat #1 is the button
Seat 1: 351b2066 ($11.79 in chips)
Seat 2: b4ed1af9 ($23.11 in chips)
Seat 3: 26be4468 ($4.34 in chips)
Seat 4: e4181351 ($11.37 in chips)
Seat 5: Hero ($32.25 in chips)
Seat 6: 1babc4f7 ($4.34 in chips)
b4ed1af9: posts small blind $0.05
26be4468: posts big blind $0.1
*** HOLE CARDS ***
Dealt to 351b2066 
Dealt to b4ed1af9 
Dealt to 26be4468 
Dealt to e4181351 
Dealt to Hero [4s 8h]
Dealt to 1babc4f7 
e4181351: raises $0.14 to $0.24
Hero: folds
1babc4f7: calls $0.24
351b2066: folds
b4ed1af9: folds
26be4468: folds
*** FLOP *** [Qc 5c 2c]
e4181351: checks
1babc4f7: bets $0.48
e4181351: raises $10.65 to $11.13 and is all-in
1babc4f7: folds
Uncalled bet ($10.65) returned to e4181351
*** SHOWDOWN ***
e4181351 collected $1.51 from pot
*** SUMMARY ***
Total pot $1.59 | Rake $0.08 | Jackpot $0 | Bingo $0 | Fortune $0 | Tax $0
Board [Qc 5c 2c]
Seat 1: 351b2066 (button) folded before Flop (didn't bet)
Seat 2: b4ed1af9 (small blind) folded before Flop
Seat 3: 26be4468 (big blind) folded before Flop
Seat 4: e4181351 won ($1.51)
Seat 5: Hero folded before Flop (didn't bet)
Seat 6: 1babc4f7 folded on the Flop


Poker Hand #RC2771740659: Hold'em No Limit ($0.05/$0.1) - 2024/08/04 10:39:35
Table 'RushAndCash20795919' 6-max Seat #1 is the button
Seat 1: 405aaea9 ($11.54 in chips)
Seat 2: 5e483734 ($13.53 in chips)
Seat 3: 909bf7a9 ($10.3 in chips)
Seat 4: b380dee0 ($13.73 in chips)
Seat 5: Hero ($32.25 in chips)
Seat 6: 271e0a8c ($10.15 in chips)
5e483734: posts small blind $0.05
909bf7a9: posts big blind $0.1
*** HOLE CARDS ***
Dealt to 405aaea9 
Dealt to 5e483734 
Dealt to 909bf7a9 
Dealt to b380dee0 
Dealt to Hero [9c 8h]
Dealt to 271e0a8c 
b380dee0: folds
Hero: folds
271e0a8c: folds
405aaea9: folds
5e483734: folds
Uncalled bet ($0.05) returned to 909bf7a9
*** SHOWDOWN ***
909bf7a9 collected $0.1 from pot
*** SUMMARY ***
Total pot $0.1 | Rake $0 | Jackpot $0 | Bingo $0 | Fortune $0 | Tax $0
Seat 1: 405aaea9 (button) folded before Flop (didn't bet)
Seat 2: 5e483734 (small blind) folded before Flop
Seat 3: 909bf7a9 (big blind) collected ($0.1)
Seat 4: b380dee0 folded before Flop (didn't bet)
Seat 5: Hero folded before Flop (didn't bet)
Seat 6: 271e0a8c folded before Flop (didn't bet)


Poker Hand #RC2771740603: Hold'em No Limit ($0.05/$0.1) - 2024/08/04 10:39:28
Table 'RushAndCash20795863' 6-max Seat #1 is the button
Seat 1: 2d72fe14 ($21.82 in chips)
Seat 2: Hero ($32.3 in chips)
Seat 3: 8826c01a ($10 in chips)
Seat 4: bdd79bd8 ($11.18 in chips)
Seat 5: 32d300c4 ($11.4 in chips)
Seat 6: 92b92535 ($11.02 in chips)
Hero: posts small blind $0.05
8826c01a: posts big blind $0.1
*** HOLE CARDS ***
Dealt to 2d72fe14 
Dealt to Hero [Kd Jh]
Dealt to 8826c01a 
Dealt to bdd79bd8 
Dealt to 32d300c4 
Dealt to 92b92535 
bdd79bd8: raises $0.15 to $0.25
32d300c4: folds
92b92535: folds
2d72fe14: folds
Hero: folds
8826c01a: folds
Uncalled bet ($0.15) returned to bdd79bd8
*** SHOWDOWN ***
bdd79bd8 collected $0.25 from pot
*** SUMMARY ***
Total pot $0.25 | Rake $0 | Jackpot $0 | Bingo $0 | Fortune $0 | Tax $0
Seat 1: 2d72fe14 (button) folded before Flop (didn't bet)
Seat 2: Hero (small blind) folded before Flop
Seat 3: 8826c01a (big blind) folded before Flop
Seat 4: bdd79bd8 collected ($0.25)
Seat 5: 32d300c4 folded before Flop (didn't bet)
Seat 6: 92b92535 folded before Flop (didn't bet)


Poker Hand #RC2771740536: Hold'em No Limit ($0.05/$0.1) - 2024/08/04 10:39:19
Table 'RushAndCash20795796' 6-max Seat #1 is the button
Seat 1: 209d274c ($10 in chips)
Seat 2: 4d23c2a6 ($10.01 in chips)
Seat 3: Hero ($32.4 in chips)
Seat 4: c1920c33 ($10.36 in chips)
Seat 5: 50193a1a ($10.52 in chips)
Seat 6: 3842342c ($10.57 in chips)
4d23c2a6: posts small blind $0.05
Hero: posts big blind $0.1
*** HOLE CARDS ***
Dealt to 209d274c 
Dealt to 4d23c2a6 
Dealt to Hero [Ah 4s]
Dealt to c1920c33 
Dealt to 50193a1a 
Dealt to 3842342c 
c1920c33: folds
50193a1a: folds
3842342c: folds
209d274c: raises $0.13 to $0.23
4d23c2a6: folds
Hero: folds
Uncalled bet ($0.13) returned to 209d274c
*** SHOWDOWN ***
209d274c collected $0.25 from pot
*** SUMMARY ***
Total pot $0.25 | Rake $0 | Jackpot $0 | Bingo $0 | Fortune $0 | Tax $0
Seat 1: 209d274c (button) collected ($0.25)
Seat 2: 4d23c2a6 (small blind) folded before Flop
Seat 3: Hero (big blind) folded before Flop
Seat 4: c1920c33 folded before Flop (didn't bet)
Seat 5: 50193a1a folded before Flop (didn't bet)
Seat 6: 3842342c folded before Flop (didn't bet)


Poker Hand #RC2771740468: Hold'em No Limit ($0.05/$0.1) - 2024/08/04 10:39:11
Table 'RushAndCash20795728' 6-max Seat #1 is the button
Seat 1: 4ac483a3 ($10.67 in chips)
Seat 2: 6ae4e262 ($12.61 in chips)
Seat 3: 44e483f7 ($18.6 in chips)
Seat 4: 3968ffd4 ($10.15 in chips)
Seat 5: Hero ($32.4 in chips)
Seat 6: 4d23c2a6 ($10.01 in chips)
6ae4e262: posts small blind $0.05
44e483f7: posts big blind $0.1
*** HOLE CARDS ***
Dealt to 4ac483a3 
Dealt to 6ae4e262 
Dealt to 44e483f7 
Dealt to 3968ffd4 
Dealt to Hero [9c 7c]
Dealt to 4d23c2a6 
3968ffd4: folds
Hero: folds
4d23c2a6: folds
4ac483a3: raises $0.1 to $0.2
6ae4e262: folds
44e483f7: raises $0.75 to $0.95
4ac483a3: folds
Uncalled bet ($0.75) returned to 44e483f7
*** SHOWDOWN ***
44e483f7 collected $0.43 from pot
*** SUMMARY ***
Total pot $0.45 | Rake $0.02 | Jackpot $0 | Bingo $0 | Fortune $0 | Tax $0
Seat 1: 4ac483a3 (button) folded before Flop
Seat 2: 6ae4e262 (small blind) folded before Flop
Seat 3: 44e483f7 (big blind) collected ($0.43)
Seat 4: 3968ffd4 folded before Flop (didn't bet)
Seat 5: Hero folded before Flop (didn't bet)
Seat 6: 4d23c2a6 folded before Flop (didn't bet)


Poker Hand #RC2771740443: Hold'em No Limit ($0.05/$0.1) - 2024/08/04 10:39:07
Table 'RushAndCash20795703' 6-max Seat #1 is the button
Seat 1: 48fa6d9 ($11.18 in chips)
Seat 2: b02b6b29 ($9.75 in chips)
Seat 3: 8a607e43 ($11.08 in chips)
Seat 4: 15c99835 ($10 in chips)
Seat 5: Hero ($32.4 in chips)
Seat 6: 78f2e121 ($10.3 in chips)
b02b6b29: posts small blind $0.05
8a607e43: posts big blind $0.1
*** HOLE CARDS ***
Dealt to 48fa6d9 
Dealt to b02b6b29 
Dealt to 8a607e43 
Dealt to 15c99835 
Dealt to Hero [Jh 2d]
Dealt to 78f2e121 
15c99835: folds
Hero: folds
78f2e121: folds
48fa6d9: raises $0.1 to $0.2
b02b6b29: folds
8a607e43: folds
Uncalled bet ($0.1) returned to 48fa6d9
*** SHOWDOWN ***
48fa6d9 collected $0.25 from pot
*** SUMMARY ***
Total pot $0.25 | Rake $0 | Jackpot $0 | Bingo $0 | Fortune $0 | Tax $0
Seat 1: 48fa6d9 (button) collected ($0.25)
Seat 2: b02b6b29 (small blind) folded before Flop
Seat 3: 8a607e43 (big blind) folded before Flop
Seat 4: 15c99835 folded before Flop (didn't bet)
Seat 5: Hero folded before Flop (didn't bet)
Seat 6: 78f2e121 folded before Flop (didn't bet)


Poker Hand #RC2771740196: Hold'em No Limit ($0.05/$0.1) - 2024/08/04 10:38:36
Table 'RushAndCash20795456' 6-max Seat #1 is the button
Seat 1: 813c397e ($12.66 in chips)
Seat 2: Hero ($32.7 in chips)
Seat 3: 3842342c ($10.35 in chips)
Seat 4: 45b05c97 ($14.75 in chips)
Seat 5: 3eebd214 ($10.16 in chips)
Seat 6: c33594f ($9.72 in chips)
Hero: posts small blind $0.05
3842342c: posts big blind $0.1
*** HOLE CARDS ***
Dealt to 813c397e 
Dealt to Hero [4s 3s]
Dealt to 3842342c 
Dealt to 45b05c97 
Dealt to 3eebd214 
Dealt to c33594f 
45b05c97: folds
3eebd214: folds
c33594f: folds
813c397e: folds
Hero: raises $0.2 to $0.3
3842342c: raises $0.7 to $1
Hero: folds
Uncalled bet ($0.7) returned to 3842342c
*** SHOWDOWN ***
3842342c collected $0.57 from pot
*** SUMMARY ***
Total pot $0.6 | Rake $0.03 | Jackpot $0 | Bingo $0 | Fortune $0 | Tax $0
Seat 1: 813c397e (button) folded before Flop (didn't bet)
Seat 2: Hero (small blind) folded before Flop
Seat 3: 3842342c (big blind) collected ($0.57)
Seat 4: 45b05c97 folded before Flop (didn't bet)
Seat 5: 3eebd214 folded before Flop (didn't bet)
Seat 6: c33594f folded before Flop (didn't bet)


Poker Hand #RC2771740149: Hold'em No Limit ($0.05/$0.1) - 2024/08/04 10:38:31
Table 'RushAndCash20795409' 6-max Seat #1 is the button
Seat 1: acb79567 ($10.15 in chips)
Seat 2: 6551b528 ($17.77 in chips)
Seat 3: Hero ($32.8 in chips)
Seat 4: 2d72fe14 ($22.24 in chips)
Seat 5: ffad3d86 ($11.76 in chips)
Seat 6: ce8f762b ($30.79 in chips)
6551b528: posts small blind $0.05
Hero: posts big blind $0.1
*** HOLE CARDS ***
Dealt to acb79567 
Dealt to 6551b528 
Dealt to Hero [8h 2s]
Dealt to 2d72fe14 
Dealt to ffad3d86 
Dealt to ce8f762b 
2d72fe14: folds
ffad3d86: raises $0.2 to $0.3
ce8f762b: folds
acb79567: folds
6551b528: folds
Hero: folds
Uncalled bet ($0.2) returned to ffad3d86
*** SHOWDOWN ***
ffad3d86 collected $0.25 from pot
*** SUMMARY ***
Total pot $0.25 | Rake $0 | Jackpot $0 | Bingo $0 | Fortune $0 | Tax $0
Seat 1: acb79567 (button) folded before Flop (didn't bet)
Seat 2: 6551b528 (small blind) folded before Flop
Seat 3: Hero (big blind) folded before Flop
Seat 4: 2d72fe14 folded before Flop (didn't bet)
Seat 5: ffad3d86 collected ($0.25)
Seat 6: ce8f762b folded before Flop (didn't bet)


Poker Hand #RC2771740115: Hold'em No Limit ($0.05/$0.1) - 2024/08/04 10:38:27
Table 'RushAndCash20795375' 6-max Seat #1 is the button
Seat 1: Hero ($32.8 in chips)
Seat 2: 42b9f44b ($10 in chips)
Seat 3: b30a5bfc ($10 in chips)
Seat 4: 8980c6e8 ($10.05 in chips)
Seat 5: 67ccfb52 ($22.92 in chips)
Seat 6: f28a3d54 ($10.49 in chips)
42b9f44b: posts small blind $0.05
b30a5bfc: posts big blind $0.1
*** HOLE CARDS ***
Dealt to Hero [4s 5c]
Dealt to 42b9f44b 
Dealt to b30a5bfc 
Dealt to 8980c6e8 
Dealt to 67ccfb52 
Dealt to f28a3d54 
8980c6e8: folds
67ccfb52: folds
f28a3d54: raises $0.1 to $0.2
Hero: folds
42b9f44b: folds
b30a5bfc: folds
Uncalled bet ($0.1) returned to f28a3d54
*** SHOWDOWN ***
f28a3d54 collected $0.25 from pot
*** SUMMARY ***
Total pot $0.25 | Rake $0 | Jackpot $0 | Bingo $0 | Fortune $0 | Tax $0
Seat 1: Hero (button) folded before Flop (didn't bet)
Seat 2: 42b9f44b (small blind) folded before Flop
Seat 3: b30a5bfc (big blind) folded before Flop
Seat 4: 8980c6e8 folded before Flop (didn't bet)
Seat 5: 67ccfb52 folded before Flop (didn't bet)
Seat 6: f28a3d54 collected ($0.25)


Poker Hand #RC2771740053: Hold'em No Limit ($0.05/$0.1) - 2024/08/04 10:38:20
Table 'RushAndCash20795313' 6-max Seat #1 is the button
Seat 1: 937b4f02 ($9.07 in chips)
Seat 2: da933ffd ($11.28 in chips)
Seat 3: ccada4b7 ($32.66 in chips)
Seat 4: fb1c537 ($7.31 in chips)
Seat 5: Hero ($32.8 in chips)
Seat 6: f156cdf1 ($9.18 in chips)
da933ffd: posts small blind $0.05
ccada4b7: posts big blind $0.1
*** HOLE CARDS ***
Dealt to 937b4f02 
Dealt to da933ffd 
Dealt to ccada4b7 
Dealt to fb1c537 
Dealt to Hero [2s Js]
Dealt to f156cdf1 
fb1c537: raises $0.1 to $0.2
Hero: folds
f156cdf1: folds
937b4f02: folds
da933ffd: folds
ccada4b7: folds
Uncalled bet ($0.1) returned to fb1c537
*** SHOWDOWN ***
fb1c537 collected $0.25 from pot
*** SUMMARY ***
Total pot $0.25 | Rake $0 | Jackpot $0 | Bingo $0 | Fortune $0 | Tax $0
Seat 1: 937b4f02 (button) folded before Flop (didn't bet)
Seat 2: da933ffd (small blind) folded before Flop
Seat 3: ccada4b7 (big blind) folded before Flop
Seat 4: fb1c537 collected ($0.25)
Seat 5: Hero folded before Flop (didn't bet)
Seat 6: f156cdf1 folded before Flop (didn't bet)


Poker Hand #RC2771739391: Hold'em No Limit ($0.05/$0.1) - 2024/08/04 10:36:59
Table 'RushAndCash20794651' 6-max Seat #1 is the button
Seat 1: Hero ($32.8 in chips)
Seat 2: d50058e4 ($11.74 in chips)
Seat 3: 24c4b23f ($16.24 in chips)
Seat 4: c4922c3d ($67.63 in chips)
Seat 5: e023a2f1 ($14.35 in chips)
Seat 6: c089462c ($11.88 in chips)
d50058e4: posts small blind $0.05
24c4b23f: posts big blind $0.1
*** HOLE CARDS ***
Dealt to Hero [7c As]
Dealt to d50058e4 
Dealt to 24c4b23f 
Dealt to c4922c3d 
Dealt to e023a2f1 
Dealt to c089462c 
c4922c3d: folds
e023a2f1: folds
c089462c: folds
Hero: folds
d50058e4: folds
Uncalled bet ($0.05) returned to 24c4b23f
*** SHOWDOWN ***
24c4b23f collected $0.1 from pot
*** SUMMARY ***
Total pot $0.1 | Rake $0 | Jackpot $0 | Bingo $0 | Fortune $0 | Tax $0
Seat 1: Hero (button) folded before Flop (didn't bet)
Seat 2: d50058e4 (small blind) folded before Flop
Seat 3: 24c4b23f (big blind) collected ($0.1)
Seat 4: c4922c3d folded before Flop (didn't bet)
Seat 5: e023a2f1 folded before Flop (didn't bet)
Seat 6: c089462c folded before Flop (didn't bet)


Poker Hand #RC2771739260: Hold'em No Limit ($0.05/$0.1) - 2024/08/04 10:36:43
Table 'RushAndCash20794520' 6-max Seat #1 is the button
Seat 1: 49ece282 ($6.63 in chips)
Seat 2: 139dbe7d ($14.98 in chips)
Seat 3: 288d6d95 ($14.01 in chips)
Seat 4: Hero ($32.8 in chips)
Seat 5: f634100a ($25.07 in chips)
Seat 6: 2d688649 ($10 in chips)
139dbe7d: posts small blind $0.05
288d6d95: posts big blind $0.1
*** HOLE CARDS ***
Dealt to 49ece282 
Dealt to 139dbe7d 
Dealt to 288d6d95 
Dealt to Hero [Ks 8s]
Dealt to f634100a 
Dealt to 2d688649 
Hero: folds
f634100a: folds
2d688649: folds
49ece282: folds
139dbe7d: folds
Uncalled bet ($0.05) returned to 288d6d95
*** SHOWDOWN ***
288d6d95 collected $0.1 from pot
*** SUMMARY ***
Total pot $0.1 | Rake $0 | Jackpot $0 | Bingo $0 | Fortune $0 | Tax $0
Seat 1: 49ece282 (button) folded before Flop (didn't bet)
Seat 2: 139dbe7d (small blind) folded before Flop
Seat 3: 288d6d95 (big blind) collected ($0.1)
Seat 4: Hero folded before Flop (didn't bet)
Seat 5: f634100a folded before Flop (didn't bet)
Seat 6: 2d688649 folded before Flop (didn't bet)


Poker Hand #RC2771739156: Hold'em No Limit ($0.05/$0.1) - 2024/08/04 10:36:30
Table 'RushAndCash20794416' 6-max Seat #1 is the button
Seat 1: c14435f9 ($32.01 in chips)
Seat 2: Hero ($32.7 in chips)
Seat 3: a7e4cbb8 ($11.3 in chips)
Seat 4: 8a607e43 ($10.03 in chips)
Seat 5: 288d6d95 ($14.06 in chips)
Seat 6: 7723daae ($6.77 in chips)
Hero: posts small blind $0.05
a7e4cbb8: posts big blind $0.1
*** HOLE CARDS ***
Dealt to c14435f9 
Dealt to Hero [7c 6c]
Dealt to a7e4cbb8 
Dealt to 8a607e43 
Dealt to 288d6d95 
Dealt to 7723daae 
8a607e43: folds
288d6d95: folds
7723daae: folds
c14435f9: folds
Hero: raises $0.2 to $0.3
a7e4cbb8: folds
Uncalled bet ($0.2) returned to Hero
*** SHOWDOWN ***
Hero collected $0.2 from pot
*** SUMMARY ***
Total pot $0.2 | Rake $0 | Jackpot $0 | Bingo $0 | Fortune $0 | Tax $0
Seat 1: c14435f9 (button) folded before Flop (didn't bet)
Seat 2: Hero (small blind) collected ($0.2)
Seat 3: a7e4cbb8 (big blind) folded before Flop
Seat 4: 8a607e43 folded before Flop (didn't bet)
Seat 5: 288d6d95 folded before Flop (didn't bet)
Seat 6: 7723daae folded before Flop (didn't bet)


Poker Hand #RC2771738736: Hold'em No Limit ($0.05/$0.1) - 2024/08/04 10:35:38
Table 'RushAndCash20793996' 6-max Seat #1 is the button
Seat 1: c629f1e0 ($16.22 in chips)
Seat 2: 70364239 ($13.39 in chips)
Seat 3: Hero ($32.47 in chips)
Seat 4: 26be4468 ($4.86 in chips)
Seat 5: 8a607e43 ($10.23 in chips)
Seat 6: 9e7c3795 ($10.16 in chips)
70364239: posts small blind $0.05
Hero: posts big blind $0.1
*** HOLE CARDS ***
Dealt to c629f1e0 
Dealt to 70364239 
Dealt to Hero [Js Tc]
Dealt to 26be4468 
Dealt to 8a607e43 
Dealt to 9e7c3795 
26be4468: folds
8a607e43: raises $0.1 to $0.2
9e7c3795: folds
c629f1e0: folds
70364239: folds
Hero: calls $0.1
*** FLOP *** [Qh Kh 8c]
Hero: checks
8a607e43: checks
*** TURN *** [Qh Kh 8c] [7h]
Hero: bets $0.3
8a607e43: folds
Uncalled bet ($0.3) returned to Hero
*** SHOWDOWN ***
Hero collected $0.43 from pot
*** SUMMARY ***
Total pot $0.45 | Rake $0.02 | Jackpot $0 | Bingo $0 | Fortune $0 | Tax $0
Board [Qh Kh 8c 7h]
Seat 1: c629f1e0 (button) folded before Flop (didn't bet)
Seat 2: 70364239 (small blind) folded before Flop
Seat 3: Hero (big blind) won ($0.43)
Seat 4: 26be4468 folded before Flop (didn't bet)
Seat 5: 8a607e43 folded on the Turn
Seat 6: 9e7c3795 folded before Flop (didn't bet)


Poker Hand #RC2771737896: Hold'em No Limit ($0.05/$0.1) - 2024/08/04 10:33:49
Table 'RushAndCash20793156' 6-max Seat #1 is the button
Seat 1: d7887721 ($9.67 in chips)
Seat 2: 34d94a51 ($10 in chips)
Seat 3: 26be4468 ($17.56 in chips)
Seat 4: Hero ($20.17 in chips)
Seat 5: cb9dc53 ($10.7 in chips)
Seat 6: 909bf7a9 ($10.81 in chips)
34d94a51: posts small blind $0.05
26be4468: posts big blind $0.1
*** HOLE CARDS ***
Dealt to d7887721 
Dealt to 34d94a51 
Dealt to 26be4468 
Dealt to Hero [6d 6h]
Dealt to cb9dc53 
Dealt to 909bf7a9 
Hero: raises $0.1 to $0.2
cb9dc53: folds
909bf7a9: folds
d7887721: folds
34d94a51: folds
26be4468: calls $0.1
*** FLOP *** [6c 5h 4d]
26be4468: checks
Hero: bets $0.25
26be4468: raises $0.75 to $1
Hero: calls $0.75
*** TURN *** [6c 5h 4d] [Kh]
26be4468: bets $2.5
Hero: calls $2.5
*** RIVER *** [6c 5h 4d Kh] [Ah]
26be4468: bets $9
Hero: calls $9
26be4468: shows [9d 7c] (Ace-High)
Hero: shows [6d 6h] (Three Sixes)
*** SHOWDOWN ***
Hero collected $25 from pot
*** SUMMARY ***
Total pot $25.45 | Rake $0.3 | Jackpot $0.15 | Bingo $0 | Fortune $0 | Tax $0
Board [6c 5h 4d Kh Ah]
Seat 1: d7887721 (button) folded before Flop (didn't bet)
Seat 2: 34d94a51 (small blind) folded before Flop
Seat 3: 26be4468 (big blind) showed [9d 7c] and lost with Ace-High
Seat 4: Hero showed [6d 6h] and won ($25) with Three Sixes
Seat 5: cb9dc53 folded before Flop (didn't bet)
Seat 6: 909bf7a9 folded before Flop (didn't bet)


Poker Hand #RC2771737788: Hold'em No Limit ($0.05/$0.1) - 2024/08/04 10:33:34
Table 'RushAndCash20793048' 6-max Seat #1 is the button
Seat 1: 223338da ($10 in chips)
Seat 2: 9c449d54 ($11.8 in chips)
Seat 3: 28ab5dc6 ($11.23 in chips)
Seat 4: 209d274c ($10.3 in chips)
Seat 5: 50f19bd5 ($16.89 in chips)
Seat 6: Hero ($20.02 in chips)
9c449d54: posts small blind $0.05
28ab5dc6: posts big blind $0.1
*** HOLE CARDS ***
Dealt to 223338da 
Dealt to 9c449d54 
Dealt to 28ab5dc6 
Dealt to 209d274c 
Dealt to 50f19bd5 
Dealt to Hero [6h Kh]
209d274c: folds
50f19bd5: folds
Hero: raises $0.14 to $0.24
223338da: folds
9c449d54: folds
28ab5dc6: folds
Uncalled bet ($0.14) returned to Hero
*** SHOWDOWN ***
Hero collected $0.25 from pot
*** SUMMARY ***
Total pot $0.25 | Rake $0 | Jackpot $0 | Bingo $0 | Fortune $0 | Tax $0
Seat 1: 223338da (button) folded before Flop (didn't bet)
Seat 2: 9c449d54 (small blind) folded before Flop
Seat 3: 28ab5dc6 (big blind) folded before Flop
Seat 4: 209d274c folded before Flop (didn't bet)
Seat 5: 50f19bd5 folded before Flop (didn't bet)
Seat 6: Hero collected ($0.25)


Poker Hand #RC2771737665: Hold'em No Limit ($0.05/$0.1) - 2024/08/04 10:33:17
Table 'RushAndCash20792925' 6-max Seat #1 is the button
Seat 1: 610739b9 ($10 in chips)
Seat 2: da9577eb ($10.24 in chips)
Seat 3: 73ffd323 ($14.36 in chips)
Seat 4: Hero ($20.02 in chips)
Seat 5: 64482f3c ($10.7 in chips)
Seat 6: e8a31569 ($10 in chips)
da9577eb: posts small blind $0.05
73ffd323: posts big blind $0.1
*** HOLE CARDS ***
Dealt to 610739b9 
Dealt to da9577eb 
Dealt to 73ffd323 
Dealt to Hero [Jh 3d]
Dealt to 64482f3c 
Dealt to e8a31569 
Hero: folds
64482f3c: folds
e8a31569: folds
610739b9: folds
da9577eb: raises $0.2 to $0.3
73ffd323: folds
Uncalled bet ($0.2) returned to da9577eb
*** SHOWDOWN ***
da9577eb collected $0.2 from pot
*** SUMMARY ***
Total pot $0.2 | Rake $0 | Jackpot $0 | Bingo $0 | Fortune $0 | Tax $0
Seat 1: 610739b9 (button) folded before Flop (didn't bet)
Seat 2: da9577eb (small blind) collected ($0.2)
Seat 3: 73ffd323 (big blind) folded before Flop
Seat 4: Hero folded before Flop (didn't bet)
Seat 5: 64482f3c folded before Flop (didn't bet)
Seat 6: e8a31569 folded before Flop (didn't bet)


Poker Hand #RC2771737636: Hold'em No Limit ($0.05/$0.1) - 2024/08/04 10:33:13
Table 'RushAndCash20792896' 6-max Seat #1 is the button
Seat 1: bab54623 ($10.42 in chips)
Seat 2: c15805b2 ($11.42 in chips)
Seat 3: 54920ebe ($13.1 in chips)
Seat 4: Hero ($20.02 in chips)
Seat 5: 9e7c3795 ($10.37 in chips)
Seat 6: 5438f3e7 ($10 in chips)
c15805b2: posts small blind $0.05
54920ebe: posts big blind $0.1
*** HOLE CARDS ***
Dealt to bab54623 
Dealt to c15805b2 
Dealt to 54920ebe 
Dealt to Hero [Ks 6h]
Dealt to 9e7c3795 
Dealt to 5438f3e7 
Hero: folds
9e7c3795: raises $0.1 to $0.2
5438f3e7: folds
bab54623: folds
c15805b2: folds
54920ebe: calls $0.1
*** FLOP *** [3c Kc Ah]
54920ebe: checks
9e7c3795: checks
*** TURN *** [3c Kc Ah] [9s]
54920ebe: checks
9e7c3795: checks
*** RIVER *** [3c Kc Ah 9s] [4h]
54920ebe: checks
9e7c3795: bets $0.27
54920ebe: folds
Uncalled bet ($0.27) returned to 9e7c3795
*** SHOWDOWN ***
9e7c3795 collected $0.43 from pot
*** SUMMARY ***
Total pot $0.45 | Rake $0.02 | Jackpot $0 | Bingo $0 | Fortune $0 | Tax $0
Board [3c Kc Ah 9s 4h]
Seat 1: bab54623 (button) folded before Flop (didn't bet)
Seat 2: c15805b2 (small blind) folded before Flop
Seat 3: 54920ebe (big blind) folded on the River
Seat 4: Hero folded before Flop (didn't bet)
Seat 5: 9e7c3795 won ($0.43)
Seat 6: 5438f3e7 folded before Flop (didn't bet)


Poker Hand #RC2771737611: Hold'em No Limit ($0.05/$0.1) - 2024/08/04 10:33:10
Table 'RushAndCash20792871' 6-max Seat #1 is the button
Seat 1: Hero ($20.02 in chips)
Seat 2: 4a9968a ($10 in chips)
Seat 3: f3d083d ($10.47 in chips)
Seat 4: 8615e9e7 ($10.49 in chips)
Seat 5: b380dee0 ($12.7 in chips)
Seat 6: bade3304 ($19.23 in chips)
4a9968a: posts small blind $0.05
f3d083d: posts big blind $0.1
*** HOLE CARDS ***
Dealt to Hero [4d Ah]
Dealt to 4a9968a 
Dealt to f3d083d 
Dealt to 8615e9e7 
Dealt to b380dee0 
Dealt to bade3304 
8615e9e7: raises $0.1 to $0.2
b380dee0: folds
bade3304: folds
Hero: folds
4a9968a: folds
f3d083d: calls $0.1
*** FLOP *** [9s 2c 3d]
f3d083d: checks
8615e9e7: bets $0.23
f3d083d: folds
Uncalled bet ($0.23) returned to 8615e9e7
*** SHOWDOWN ***
8615e9e7 collected $0.43 from pot
*** SUMMARY ***
Total pot $0.45 | Rake $0.02 | Jackpot $0 | Bingo $0 | Fortune $0 | Tax $0
Board [9s 2c 3d]
Seat 1: Hero (button) folded before Flop (didn't bet)
Seat 2: 4a9968a (small blind) folded before Flop
Seat 3: f3d083d (big blind) folded on the Flop
Seat 4: 8615e9e7 won ($0.43)
Seat 5: b380dee0 folded before Flop (didn't bet)
Seat 6: bade3304 folded before Flop (didn't bet)


Poker Hand #RC2771737560: Hold'em No Limit ($0.05/$0.1) - 2024/08/04 10:33:03
Table 'RushAndCash20792820' 6-max Seat #1 is the button
Seat 1: 71aa44d3 ($9.47 in chips)
Seat 2: e0895fa8 ($26.99 in chips)
Seat 3: Hero ($20.12 in chips)
Seat 4: 9c449d54 ($11.75 in chips)
Seat 5: c7a9c741 ($5.23 in chips)
Seat 6: 5a60af3d ($10 in chips)
e0895fa8: posts small blind $0.05
Hero: posts big blind $0.1
*** HOLE CARDS ***
Dealt to 71aa44d3 
Dealt to e0895fa8 
Dealt to Hero [2s 4d]
Dealt to 9c449d54 
Dealt to c7a9c741 
Dealt to 5a60af3d 
9c449d54: folds
c7a9c741: folds
5a60af3d: folds
71aa44d3: raises $0.2 to $0.3
e0895fa8: folds
Hero: folds
Uncalled bet ($0.2) returned to 71aa44d3
*** SHOWDOWN ***
71aa44d3 collected $0.25 from pot
*** SUMMARY ***
Total pot $0.25 | Rake $0 | Jackpot $0 | Bingo $0 | Fortune $0 | Tax $0
Seat 1: 71aa44d3 (button) collected ($0.25)
Seat 2: e0895fa8 (small blind) folded before Flop
Seat 3: Hero (big blind) folded before Flop
Seat 4: 9c449d54 folded before Flop (didn't bet)
Seat 5: c7a9c741 folded before Flop (didn't bet)
Seat 6: 5a60af3d folded before Flop (didn't bet)


Poker Hand #RC2771737376: Hold'em No Limit ($0.05/$0.1) - 2024/08/04 10:32:38
Table 'RushAndCash20792636' 6-max Seat #1 is the button
Seat 1: e0895fa8 ($27.19 in chips)
Seat 2: Hero ($19.65 in chips)
Seat 3: 4ce1a891 ($15.08 in chips)
Seat 4: 64482f3c ($10.85 in chips)
Seat 5: b9f01a33 ($13.98 in chips)
Seat 6: c7a9c741 ($5.43 in chips)
Hero: posts small blind $0.05
4ce1a891: posts big blind $0.1
*** HOLE CARDS ***
Dealt to e0895fa8 
Dealt to Hero [Kc Jd]
Dealt to 4ce1a891 
Dealt to 64482f3c 
Dealt to b9f01a33 
Dealt to c7a9c741 
64482f3c: folds
b9f01a33: folds
c7a9c741: raises $0.1 to $0.2
e0895fa8: calls $0.2
Hero: raises $1 to $1.2
4ce1a891: folds
c7a9c741: folds
e0895fa8: folds
Uncalled bet ($1) returned to Hero
*** SHOWDOWN ***
Hero collected $0.67 from pot
*** SUMMARY ***
Total pot $0.7 | Rake $0.03 | Jackpot $0 | Bingo $0 | Fortune $0 | Tax $0
Seat 1: e0895fa8 (button) folded before Flop
Seat 2: Hero (small blind) collected ($0.67)
Seat 3: 4ce1a891 (big blind) folded before Flop
Seat 4: 64482f3c folded before Flop (didn't bet)
Seat 5: b9f01a33 folded before Flop (didn't bet)
Seat 6: c7a9c741 folded before Flop


Poker Hand #RC2771737346: Hold'em No Limit ($0.05/$0.1) - 2024/08/04 10:32:34
Table 'RushAndCash20792606' 6-max Seat #1 is the button
Seat 1: fcaa3d00 ($11.9 in chips)
Seat 2: 92d25012 ($12.4 in chips)
Seat 3: 209d274c ($10.3 in chips)
Seat 4: c0e2330b ($12.83 in chips)
Seat 5: baa0cd2 ($24.05 in chips)
Seat 6: Hero ($19.65 in chips)
92d25012: posts small blind $0.05
209d274c: posts big blind $0.1
*** HOLE CARDS ***
Dealt to fcaa3d00 
Dealt to 92d25012 
Dealt to 209d274c 
Dealt to c0e2330b 
Dealt to baa0cd2 
Dealt to Hero [2c 2h]
c0e2330b: folds
baa0cd2: folds
Hero: folds
fcaa3d00: folds
92d25012: folds
Uncalled bet ($0.05) returned to 209d274c
*** SHOWDOWN ***
209d274c collected $0.1 from pot
*** SUMMARY ***
Total pot $0.1 | Rake $0 | Jackpot $0 | Bingo $0 | Fortune $0 | Tax $0
Seat 1: fcaa3d00 (button) folded before Flop (didn't bet)
Seat 2: 92d25012 (small blind) folded before Flop
Seat 3: 209d274c (big blind) collected ($0.1)
Seat 4: c0e2330b folded before Flop (didn't bet)
Seat 5: baa0cd2 folded before Flop (didn't bet)
Seat 6: Hero folded before Flop (didn't bet)


Poker Hand #RC2771737317: Hold'em No Limit ($0.05/$0.1) - 2024/08/04 10:32:30
Table 'RushAndCash20792577' 6-max Seat #1 is the button
Seat 1: c9fec00 ($10.3 in chips)
Seat 2: 348e7778 ($22.21 in chips)
Seat 3: b16c9de0 ($12.1 in chips)
Seat 4: Hero ($19.65 in chips)
Seat 5: 612e1008 ($10.9 in chips)
Seat 6: 4ebca1c ($10.36 in chips)
348e7778: posts small blind $0.05
b16c9de0: posts big blind $0.1
*** HOLE CARDS ***
Dealt to c9fec00 
Dealt to 348e7778 
Dealt to b16c9de0 
Dealt to Hero [Jc 8c]
Dealt to 612e1008 
Dealt to 4ebca1c 
Hero: folds
612e1008: folds
4ebca1c: raises $0.12 to $0.22
c9fec00: raises $0.48 to $0.7
348e7778: raises $0.92 to $1.62
b16c9de0: folds
4ebca1c: raises $2.38 to $4
c9fec00: folds
348e7778: calls $2.38
*** FLOP *** [Qd 7d 5s]
348e7778: bets $18.21 and is all-in
4ebca1c: calls $6.36 and is all-in
Uncalled bet ($11.85) returned to 348e7778
348e7778: shows [Qh Qs] (Three Queens)
4ebca1c: shows [Kh Ks] (Pair of Kings)
*** TURN *** [Qd 7d 5s] [3c]
*** RIVER *** [Qd 7d 5s 3c] [8h]
c9fec00: shows [Kd Ad] (Ace-High)
*** SHOWDOWN ***
348e7778 collected $21.07 from pot
*** SUMMARY ***
Total pot $21.52 | Rake $0.3 | Jackpot $0.15 | Bingo $0 | Fortune $0 | Tax $0
Board [Qd 7d 5s 3c 8h]
Seat 1: c9fec00 (button) folded before Flop
Seat 2: 348e7778 (small blind) showed [Qh Qs] and won ($21.07) with Three Queens
Seat 3: b16c9de0 (big blind) folded before Flop
Seat 4: Hero folded before Flop (didn't bet)
Seat 5: 612e1008 folded before Flop (didn't bet)
Seat 6: 4ebca1c showed [Kh Ks] and lost with Pair of Kings


Poker Hand #RC2771737286: Hold'em No Limit ($0.05/$0.1) - 2024/08/04 10:32:26
Table 'RushAndCash20792546' 6-max Seat #1 is the button
Seat 1: 45bf4575 ($10.56 in chips)
Seat 2: 5f20a05a ($8.43 in chips)
Seat 3: 288d6d95 ($13.15 in chips)
Seat 4: Hero ($19.65 in chips)
Seat 5: 27f6ab43 ($21.2 in chips)
Seat 6: d0697e32 ($15.4 in chips)
5f20a05a: posts small blind $0.05
288d6d95: posts big blind $0.1
*** HOLE CARDS ***
Dealt to 45bf4575 
Dealt to 5f20a05a 
Dealt to 288d6d95 
Dealt to Hero [5h 8d]
Dealt to 27f6ab43 
Dealt to d0697e32 
Hero: folds
27f6ab43: folds
d0697e32: raises $0.12 to $0.22
45bf4575: folds
5f20a05a: folds
288d6d95: folds
Uncalled bet ($0.12) returned to d0697e32
*** SHOWDOWN ***
d0697e32 collected $0.25 from pot
*** SUMMARY ***
Total pot $0.25 | Rake $0 | Jackpot $0 | Bingo $0 | Fortune $0 | Tax $0
Seat 1: 45bf4575 (button) folded before Flop (didn't bet)
Seat 2: 5f20a05a (small blind) folded before Flop
Seat 3: 288d6d95 (big blind) folded before Flop
Seat 4: Hero folded before Flop (didn't bet)
Seat 5: 27f6ab43 folded before Flop (didn't bet)
Seat 6: d0697e32 collected ($0.25)


Poker Hand #RC2771737260: Hold'em No Limit ($0.05/$0.1) - 2024/08/04 10:32:22
Table 'RushAndCash20792520' 6-max Seat #1 is the button
Seat 1: Hero ($19.65 in chips)
Seat 2: 844f67f5 ($18.14 in chips)
Seat 3: 4e876e8d ($10.69 in chips)
Seat 4: 949a4611 ($16.47 in chips)
Seat 5: c15805b2 ($11.52 in chips)
Seat 6: b3951cab ($15.96 in chips)
844f67f5: posts small blind $0.05
4e876e8d: posts big blind $0.1
*** HOLE CARDS ***
Dealt to Hero [7s 2c]
Dealt to 844f67f5 
Dealt to 4e876e8d 
Dealt to 949a4611 
Dealt to c15805b2 
Dealt to b3951cab 
949a4611: raises $0.15 to $0.25
c15805b2: folds
b3951cab: folds
Hero: folds
844f67f5: folds
4e876e8d: folds
Uncalled bet ($0.15) returned to 949a4611
*** SHOWDOWN ***
949a4611 collected $0.25 from pot
*** SUMMARY ***
Total pot $0.25 | Rake $0 | Jackpot $0 | Bingo $0 | Fortune $0 | Tax $0
Seat 1: Hero (button) folded before Flop (didn't bet)
Seat 2: 844f67f5 (small blind) folded before Flop
Seat 3: 4e876e8d (big blind) folded before Flop
Seat 4: 949a4611 collected ($0.25)
Seat 5: c15805b2 folded before Flop (didn't bet)
Seat 6: b3951cab folded before Flop (didn't bet)


Poker Hand #RC2771737152: Hold'em No Limit ($0.05/$0.1) - 2024/08/04 10:32:06
Table 'RushAndCash20792412' 6-max Seat #1 is the button
Seat 1: d760d6ee ($27.85 in chips)
Seat 2: ca7a5617 ($7.63 in chips)
Seat 3: Hero ($19.75 in chips)
Seat 4: 421c10f0 ($10.03 in chips)
Seat 5: 7a5ab6a1 ($10 in chips)
Seat 6: bade3304 ($19.82 in chips)
ca7a5617: posts small blind $0.05
Hero: posts big blind $0.1
*** HOLE CARDS ***
Dealt to d760d6ee 
Dealt to ca7a5617 
Dealt to Hero [Qc Jh]
Dealt to 421c10f0 
Dealt to 7a5ab6a1 
Dealt to bade3304 
421c10f0: folds
7a5ab6a1: raises $0.1 to $0.2
bade3304: folds
d760d6ee: raises $0.7 to $0.9
ca7a5617: folds
Hero: folds
7a5ab6a1: raises $1.4 to $2.3
d760d6ee: folds
Uncalled bet ($1.4) returned to 7a5ab6a1
*** SHOWDOWN ***
7a5ab6a1 collected $1.86 from pot
*** SUMMARY ***
Total pot $1.95 | Rake $0.09 | Jackpot $0 | Bingo $0 | Fortune $0 | Tax $0
Seat 1: d760d6ee (button) folded before Flop
Seat 2: ca7a5617 (small blind) folded before Flop
Seat 3: Hero (big blind) folded before Flop
Seat 4: 421c10f0 folded before Flop (didn't bet)
Seat 5: 7a5ab6a1 collected ($1.86)
Seat 6: bade3304 folded before Flop (didn't bet)


Poker Hand #RC2771737059: Hold'em No Limit ($0.05/$0.1) - 2024/08/04 10:31:54
Table 'RushAndCash20792319' 6-max Seat #1 is the button
Seat 1: 6e7ab779 ($12.64 in chips)
Seat 2: Hero ($19.8 in chips)
Seat 3: fbc8e0fb ($3.58 in chips)
Seat 4: 992a613 ($10.77 in chips)
Seat 5: af7e047d ($15.43 in chips)
Seat 6: ad66d6f9 ($13.52 in chips)
Hero: posts small blind $0.05
fbc8e0fb: posts big blind $0.1
*** HOLE CARDS ***
Dealt to 6e7ab779 
Dealt to Hero [Ts 8h]
Dealt to fbc8e0fb 
Dealt to 992a613 
Dealt to af7e047d 
Dealt to ad66d6f9 
992a613: folds
af7e047d: raises $0.15 to $0.25
ad66d6f9: folds
6e7ab779: folds
Hero: folds
fbc8e0fb: folds
Uncalled bet ($0.15) returned to af7e047d
*** SHOWDOWN ***
af7e047d collected $0.25 from pot
*** SUMMARY ***
Total pot $0.25 | Rake $0 | Jackpot $0 | Bingo $0 | Fortune $0 | Tax $0
Seat 1: 6e7ab779 (button) folded before Flop (didn't bet)
Seat 2: Hero (small blind) folded before Flop
Seat 3: fbc8e0fb (big blind) folded before Flop
Seat 4: 992a613 folded before Flop (didn't bet)
Seat 5: af7e047d collected ($0.25)
Seat 6: ad66d6f9 folded before Flop (didn't bet)


Poker Hand #RC2771737023: Hold'em No Limit ($0.05/$0.1) - 2024/08/04 10:31:49
Table 'RushAndCash20792283' 6-max Seat #1 is the button
Seat 1: 68d51957 ($8.23 in chips)
Seat 2: 75cf99ae ($12.07 in chips)
Seat 3: 6ef67a73 ($14.22 in chips)
Seat 4: Hero ($19.8 in chips)
Seat 5: e4181351 ($10.21 in chips)
Seat 6: 33750636 ($11.76 in chips)
75cf99ae: posts small blind $0.05
6ef67a73: posts big blind $0.1
*** HOLE CARDS ***
Dealt to 68d51957 
Dealt to 75cf99ae 
Dealt to 6ef67a73 
Dealt to Hero [3h 9s]
Dealt to e4181351 
Dealt to 33750636 
Hero: folds
e4181351: folds
33750636: calls $0.1
68d51957: folds
75cf99ae: calls $0.05
6ef67a73: checks
*** FLOP *** [2d 6h 2h]
75cf99ae: checks
6ef67a73: checks
33750636: bets $0.15
75cf99ae: calls $0.15
6ef67a73: folds
*** TURN *** [2d 6h 2h] [3s]
75cf99ae: checks
33750636: bets $0.3
75cf99ae: calls $0.3
*** RIVER *** [2d 6h 2h 3s] [Jh]
75cf99ae: bets $0.9
33750636: folds
Uncalled bet ($0.9) returned to 75cf99ae
*** SHOWDOWN ***
75cf99ae collected $1.14 from pot
*** SUMMARY ***
Total pot $1.2 | Rake $0.06 | Jackpot $0 | Bingo $0 | Fortune $0 | Tax $0
Board [2d 6h 2h 3s Jh]
Seat 1: 68d51957 (button) folded before Flop (didn't bet)
Seat 2: 75cf99ae (small blind) won ($1.14)
Seat 3: 6ef67a73 (big blind) folded on the Flop
Seat 4: Hero folded before Flop (didn't bet)
Seat 5: e4181351 folded before Flop (didn't bet)
Seat 6: 33750636 folded on the River


Poker Hand #RC2771736974: Hold'em No Limit ($0.05/$0.1) - 2024/08/04 10:31:43
Table 'RushAndCash20792234' 6-max Seat #1 is the button
Seat 1: 67f6fb4a ($11.74 in chips)
Seat 2: 4ce1a891 ($15.08 in chips)
Seat 3: 486cd423 ($4.7 in chips)
Seat 4: 3392be1b ($13.03 in chips)
Seat 5: c99aeebc ($11.56 in chips)
Seat 6: Hero ($19.8 in chips)
4ce1a891: posts small blind $0.05
486cd423: posts big blind $0.1
*** HOLE CARDS ***
Dealt to 67f6fb4a 
Dealt to 4ce1a891 
Dealt to 486cd423 
Dealt to 3392be1b 
Dealt to c99aeebc 
Dealt to Hero [8d 2d]
3392be1b: folds
c99aeebc: folds
Hero: folds
67f6fb4a: folds
4ce1a891: raises $0.2 to $0.3
486cd423: folds
Uncalled bet ($0.2) returned to 4ce1a891
*** SHOWDOWN ***
4ce1a891 collected $0.2 from pot
*** SUMMARY ***
Total pot $0.2 | Rake $0 | Jackpot $0 | Bingo $0 | Fortune $0 | Tax $0
Seat 1: 67f6fb4a (button) folded before Flop (didn't bet)
Seat 2: 4ce1a891 (small blind) collected ($0.2)
Seat 3: 486cd423 (big blind) folded before Flop
Seat 4: 3392be1b folded before Flop (didn't bet)
Seat 5: c99aeebc folded before Flop (didn't bet)
Seat 6: Hero folded before Flop (didn't bet)


Poker Hand #RC2771736947: Hold'em No Limit ($0.05/$0.1) - 2024/08/04 10:31:40
Table 'RushAndCash20792207' 6-max Seat #1 is the button
Seat 1: 4018f23f ($13.89 in chips)
Seat 2: c42d132f ($15.54 in chips)
Seat 3: c9fec00 ($10 in chips)
Seat 4: 9a8f5fbf ($10.13 in chips)
Seat 5: 6486bea0 ($11.93 in chips)
Seat 6: Hero ($19.8 in chips)
c42d132f: posts small blind $0.05
c9fec00: posts big blind $0.1
*** HOLE CARDS ***
Dealt to 4018f23f 
Dealt to c42d132f 
Dealt to c9fec00 
Dealt to 9a8f5fbf 
Dealt to 6486bea0 
Dealt to Hero [6c 8s]
9a8f5fbf: folds
6486bea0: folds
Hero: folds
4018f23f: raises $0.15 to $0.25
c42d132f: folds
c9fec00: folds
Uncalled bet ($0.15) returned to 4018f23f
*** SHOWDOWN ***
4018f23f collected $0.25 from pot
*** SUMMARY ***
Total pot $0.25 | Rake $0 | Jackpot $0 | Bingo $0 | Fortune $0 | Tax $0
Seat 1: 4018f23f (button) collected ($0.25)
Seat 2: c42d132f (small blind) folded before Flop
Seat 3: c9fec00 (big blind) folded before Flop
Seat 4: 9a8f5fbf folded before Flop (didn't bet)
Seat 5: 6486bea0 folded before Flop (didn't bet)
Seat 6: Hero folded before Flop (didn't bet)


Poker Hand #RC2771736855: Hold'em No Limit ($0.05/$0.1) - 2024/08/04 10:31:27
Table 'RushAndCash20792115' 6-max Seat #1 is the button
Seat 1: b461d7f3 ($10.19 in chips)
Seat 2: c04e8644 ($12.66 in chips)
Seat 3: 11bdbcea ($46.46 in chips)
Seat 4: 90173aa3 ($14.7 in chips)
Seat 5: Hero ($19.8 in chips)
Seat 6: 21d38071 ($11.39 in chips)
c04e8644: posts small blind $0.05
11bdbcea: posts big blind $0.1
*** HOLE CARDS ***
Dealt to b461d7f3 
Dealt to c04e8644 
Dealt to 11bdbcea 
Dealt to 90173aa3 
Dealt to Hero [6d 9d]
Dealt to 21d38071 
90173aa3: folds
Hero: folds
21d38071: folds
b461d7f3: folds
c04e8644: folds
Uncalled bet ($0.05) returned to 11bdbcea
*** SHOWDOWN ***
11bdbcea collected $0.1 from pot
*** SUMMARY ***
Total pot $0.1 | Rake $0 | Jackpot $0 | Bingo $0 | Fortune $0 | Tax $0
Seat 1: b461d7f3 (button) folded before Flop (didn't bet)
Seat 2: c04e8644 (small blind) folded before Flop
Seat 3: 11bdbcea (big blind) collected ($0.1)
Seat 4: 90173aa3 folded before Flop (didn't bet)
Seat 5: Hero folded before Flop (didn't bet)
Seat 6: 21d38071 folded before Flop (didn't bet)


Poker Hand #RC2771736793: Hold'em No Limit ($0.05/$0.1) - 2024/08/04 10:31:18
Table 'RushAndCash20792053' 6-max Seat #1 is the button
Seat 1: Hero ($19.8 in chips)
Seat 2: 294f07a2 ($14.03 in chips)
Seat 3: b6aba4a0 ($11.16 in chips)
Seat 4: e5d56084 ($31.14 in chips)
Seat 5: 5c2ef128 ($10.76 in chips)
Seat 6: f64bef ($12.6 in chips)
294f07a2: posts small blind $0.05
b6aba4a0: posts big blind $0.1
*** HOLE CARDS ***
Dealt to Hero [4c Kd]
Dealt to 294f07a2 
Dealt to b6aba4a0 
Dealt to e5d56084 
Dealt to 5c2ef128 
Dealt to f64bef 
e5d56084: raises $0.12 to $0.22
5c2ef128: folds
f64bef: folds
Hero: folds
294f07a2: folds
b6aba4a0: folds
Uncalled bet ($0.12) returned to e5d56084
*** SHOWDOWN ***
e5d56084 collected $0.25 from pot
*** SUMMARY ***
Total pot $0.25 | Rake $0 | Jackpot $0 | Bingo $0 | Fortune $0 | Tax $0
Seat 1: Hero (button) folded before Flop (didn't bet)
Seat 2: 294f07a2 (small blind) folded before Flop
Seat 3: b6aba4a0 (big blind) folded before Flop
Seat 4: e5d56084 collected ($0.25)
Seat 5: 5c2ef128 folded before Flop (didn't bet)
Seat 6: f64bef folded before Flop (didn't bet)


Poker Hand #RC2771736490: Hold'em No Limit ($0.05/$0.1) - 2024/08/04 10:30:35
Table 'RushAndCash20791750' 6-max Seat #1 is the button
Seat 1: 294f07a2 ($12.94 in chips)
Seat 2: Hero ($20.9 in chips)
Seat 3: 4e698754 ($12.4 in chips)
Seat 4: b6aba4a0 ($11.43 in chips)
Seat 5: 56d4b0e7 ($22.59 in chips)
Seat 6: 2fc699df ($4.8 in chips)
Hero: posts small blind $0.05
4e698754: posts big blind $0.1
*** HOLE CARDS ***
Dealt to 294f07a2 
Dealt to Hero [Jh Ah]
Dealt to 4e698754 
Dealt to b6aba4a0 
Dealt to 56d4b0e7 
Dealt to 2fc699df 
b6aba4a0: folds
56d4b0e7: folds
2fc699df: folds
294f07a2: raises $0.15 to $0.25
Hero: raises $0.85 to $1.1
4e698754: folds
294f07a2: calls $0.85
*** FLOP *** [Ks 4s 2s]
Hero: checks
294f07a2: bets $1.25
Hero: folds
Uncalled bet ($1.25) returned to 294f07a2
*** SHOWDOWN ***
294f07a2 collected $2.19 from pot
*** SUMMARY ***
Total pot $2.3 | Rake $0.11 | Jackpot $0 | Bingo $0 | Fortune $0 | Tax $0
Board [Ks 4s 2s]
Seat 1: 294f07a2 (button) won ($2.19)
Seat 2: Hero (small blind) folded on the Flop
Seat 3: 4e698754 (big blind) folded before Flop
Seat 4: b6aba4a0 folded before Flop (didn't bet)
Seat 5: 56d4b0e7 folded before Flop (didn't bet)
Seat 6: 2fc699df folded before Flop (didn't bet)


Poker Hand #RC2771735791: Hold'em No Limit ($0.05/$0.1) - 2024/08/04 10:29:00
Table 'RushAndCash20791051' 6-max Seat #1 is the button
Seat 1: 5e6e0767 ($9.77 in chips)
Seat 2: f112d971 ($10 in chips)
Seat 3: Hero ($11.35 in chips)
Seat 4: f551345f ($11.34 in chips)
Seat 5: f9814740 ($23.42 in chips)
Seat 6: e2b7bd7f ($10.87 in chips)
f112d971: posts small blind $0.05
Hero: posts big blind $0.1
*** HOLE CARDS ***
Dealt to 5e6e0767 
Dealt to f112d971 
Dealt to Hero [4h 4s]
Dealt to f551345f 
Dealt to f9814740 
Dealt to e2b7bd7f 
f551345f: folds
f9814740: folds
e2b7bd7f: folds
5e6e0767: folds
f112d971: raises $0.18 to $0.28
Hero: calls $0.18
*** FLOP *** [4c 8h Kd]
f112d971: checks
Hero: checks
*** TURN *** [4c 8h Kd] [8c]
f112d971: checks
Hero: bets $0.3
f112d971: raises $0.9 to $1.2
Hero: calls $0.9
*** RIVER *** [4c 8h Kd 8c] [Js]
f112d971: bets $1.8
Hero: raises $8.07 to $9.87 and is all-in
f112d971: calls $6.72 and is all-in
Uncalled bet ($1.35) returned to Hero
Hero: shows [4h 4s] (Fours Full over Eights)
f112d971: shows [8d 5d] (Three Eights)
*** SHOWDOWN ***
Hero collected $19.55 from pot
*** SUMMARY ***
Total pot $20 | Rake $0.3 | Jackpot $0.15 | Bingo $0 | Fortune $0 | Tax $0
Board [4c 8h Kd 8c Js]
Seat 1: 5e6e0767 (button) folded before Flop (didn't bet)
Seat 2: f112d971 (small blind) showed [8d 5d] and lost with Three Eights
Seat 3: Hero (big blind) showed [4h 4s] and won ($19.55) with Fours Full over Eights
Seat 4: f551345f folded before Flop (didn't bet)
Seat 5: f9814740 folded before Flop (didn't bet)
Seat 6: e2b7bd7f folded before Flop (didn't bet)


Poker Hand #RC2771735657: Hold'em No Limit ($0.05/$0.1) - 2024/08/04 10:28:43
Table 'RushAndCash20790917' 6-max Seat #1 is the button
Seat 1: e65ead08 ($8.06 in chips)
Seat 2: ffad3d86 ($13.06 in chips)
Seat 3: 50050a51 ($35.26 in chips)
Seat 4: 4368b7d5 ($10 in chips)
Seat 5: 8e896e34 ($10 in chips)
Seat 6: Hero ($11.2 in chips)
ffad3d86: posts small blind $0.05
50050a51: posts big blind $0.1
*** HOLE CARDS ***
Dealt to e65ead08 
Dealt to ffad3d86 
Dealt to 50050a51 
Dealt to 4368b7d5 
Dealt to 8e896e34 
Dealt to Hero [7d Ad]
4368b7d5: folds
8e896e34: folds
Hero: raises $0.14 to $0.24
e65ead08: folds
ffad3d86: folds
50050a51: folds
Uncalled bet ($0.14) returned to Hero
*** SHOWDOWN ***
Hero collected $0.25 from pot
*** SUMMARY ***
Total pot $0.25 | Rake $0 | Jackpot $0 | Bingo $0 | Fortune $0 | Tax $0
Seat 1: e65ead08 (button) folded before Flop (didn't bet)
Seat 2: ffad3d86 (small blind) folded before Flop
Seat 3: 50050a51 (big blind) folded before Flop
Seat 4: 4368b7d5 folded before Flop (didn't bet)
Seat 5: 8e896e34 folded before Flop (didn't bet)
Seat 6: Hero collected ($0.25)


Poker Hand #RC2771735627: Hold'em No Limit ($0.05/$0.1) - 2024/08/04 10:28:39
Table 'RushAndCash20790887' 6-max Seat #1 is the button
Seat 1: f98e5ea2 ($9.56 in chips)
Seat 2: c0e2330b ($6.53 in chips)
Seat 3: f8285850 ($12.89 in chips)
Seat 4: Hero ($11.2 in chips)
Seat 5: 56d4b0e7 ($22.86 in chips)
Seat 6: b70da252 ($14.31 in chips)
c0e2330b: posts small blind $0.05
f8285850: posts big blind $0.1
*** HOLE CARDS ***
Dealt to f98e5ea2 
Dealt to c0e2330b 
Dealt to f8285850 
Dealt to Hero [9c Jd]
Dealt to 56d4b0e7 
Dealt to b70da252 
Hero: folds
56d4b0e7: raises $0.15 to $0.25
b70da252: folds
f98e5ea2: calls $0.25
c0e2330b: folds
f8285850: calls $0.15
*** FLOP *** [9d 6s Ah]
f8285850: checks
56d4b0e7: checks
f98e5ea2: checks
*** TURN *** [9d 6s Ah] [4c]
f8285850: checks
56d4b0e7: checks
f98e5ea2: checks
*** RIVER *** [9d 6s Ah 4c] [2d]
f8285850: checks
56d4b0e7: checks
f98e5ea2: bets $0.6
f8285850: folds
56d4b0e7: folds
Uncalled bet ($0.6) returned to f98e5ea2
*** SHOWDOWN ***
f98e5ea2 collected $0.76 from pot
*** SUMMARY ***
Total pot $0.8 | Rake $0.04 | Jackpot $0 | Bingo $0 | Fortune $0 | Tax $0
Board [9d 6s Ah 4c 2d]
Seat 1: f98e5ea2 (button) won ($0.76)
Seat 2: c0e2330b (small blind) folded before Flop
Seat 3: f8285850 (big blind) folded on the River
Seat 4: Hero folded before Flop (didn't bet)
Seat 5: 56d4b0e7 folded on the River
Seat 6: b70da252 folded before Flop (didn't bet)


Poker Hand #RC2771735589: Hold'em No Limit ($0.05/$0.1) - 2024/08/04 10:28:34
Table 'RushAndCash20790849' 6-max Seat #1 is the button
Seat 1: Hero ($11.2 in chips)
Seat 2: bcfb1836 ($19.38 in chips)
Seat 3: bd397201 ($11.87 in chips)
Seat 4: e73af00 ($11.14 in chips)
Seat 5: 22008f7 ($16.87 in chips)
Seat 6: 14f07a64 ($13.16 in chips)
bcfb1836: posts small blind $0.05
bd397201: posts big blind $0.1
*** HOLE CARDS ***
Dealt to Hero [8d 9h]
Dealt to bcfb1836 
Dealt to bd397201 
Dealt to e73af00 
Dealt to 22008f7 
Dealt to 14f07a64 
e73af00: folds
22008f7: folds
14f07a64: raises $0.15 to $0.25
Hero: folds
bcfb1836: raises $0.87 to $1.12
bd397201: folds
14f07a64: calls $0.87
*** FLOP *** [2d Ad 3h]
bcfb1836: bets $0.78
14f07a64: folds
Uncalled bet ($0.78) returned to bcfb1836
*** SHOWDOWN ***
bcfb1836 collected $2.23 from pot
*** SUMMARY ***
Total pot $2.34 | Rake $0.11 | Jackpot $0 | Bingo $0 | Fortune $0 | Tax $0
Board [2d Ad 3h]
Seat 1: Hero (button) folded before Flop (didn't bet)
Seat 2: bcfb1836 (small blind) won ($2.23)
Seat 3: bd397201 (big blind) folded before Flop
Seat 4: e73af00 folded before Flop (didn't bet)
Seat 5: 22008f7 folded before Flop (didn't bet)
Seat 6: 14f07a64 folded on the Flop


Poker Hand #RC2771735351: Hold'em No Limit ($0.05/$0.1) - 2024/08/04 10:28:01
Table 'RushAndCash20790611' 6-max Seat #1 is the button
Seat 1: bcfb1836 ($19.6 in chips)
Seat 2: Hero ($10.69 in chips)
Seat 3: ff2ee96e ($11.32 in chips)
Seat 4: 7cd328dc ($10.4 in chips)
Seat 5: 74cc7be7 ($6.24 in chips)
Seat 6: b0e3b2a3 ($9.66 in chips)
Hero: posts small blind $0.05
ff2ee96e: posts big blind $0.1
*** HOLE CARDS ***
Dealt to bcfb1836 
Dealt to Hero [Jd Jc]
Dealt to ff2ee96e 
Dealt to 7cd328dc 
Dealt to 74cc7be7 
Dealt to b0e3b2a3 
7cd328dc: folds
74cc7be7: folds
b0e3b2a3: raises $0.12 to $0.22
bcfb1836: calls $0.22
Hero: raises $1.08 to $1.3
ff2ee96e: folds
b0e3b2a3: folds
bcfb1836: folds
Uncalled bet ($1.08) returned to Hero
*** SHOWDOWN ***
Hero collected $0.73 from pot
*** SUMMARY ***
Total pot $0.76 | Rake $0.03 | Jackpot $0 | Bingo $0 | Fortune $0 | Tax $0
Seat 1: bcfb1836 (button) folded before Flop
Seat 2: Hero (small blind) collected ($0.73)
Seat 3: ff2ee96e (big blind) folded before Flop
Seat 4: 7cd328dc folded before Flop (didn't bet)
Seat 5: 74cc7be7 folded before Flop (didn't bet)
Seat 6: b0e3b2a3 folded before Flop


Poker Hand #RC2771735216: Hold'em No Limit ($0.05/$0.1) - 2024/08/04 10:27:42
Table 'RushAndCash20790476' 6-max Seat #1 is the button
Seat 1: eb27c107 ($10 in chips)
Seat 2: 89e4aa2d ($11.98 in chips)
Seat 3: Hero ($10.41 in chips)
Seat 4: c37c9f38 ($13.78 in chips)
Seat 5: 47f6e2ce ($12.41 in chips)
Seat 6: a7e4cbb8 ($11.2 in chips)
89e4aa2d: posts small blind $0.05
Hero: posts big blind $0.1
*** HOLE CARDS ***
Dealt to eb27c107 
Dealt to 89e4aa2d 
Dealt to Hero [Ah Qc]
Dealt to c37c9f38 
Dealt to 47f6e2ce 
Dealt to a7e4cbb8 
c37c9f38: folds
47f6e2ce: folds
a7e4cbb8: folds
eb27c107: raises $0.15 to $0.25
89e4aa2d: folds
Hero: raises $0.85 to $1.1
eb27c107: folds
Uncalled bet ($0.85) returned to Hero
*** SHOWDOWN ***
Hero collected $0.53 from pot
*** SUMMARY ***
Total pot $0.55 | Rake $0.02 | Jackpot $0 | Bingo $0 | Fortune $0 | Tax $0
Seat 1: eb27c107 (button) folded before Flop
Seat 2: 89e4aa2d (small blind) folded before Flop
Seat 3: Hero (big blind) collected ($0.53)
Seat 4: c37c9f38 folded before Flop (didn't bet)
Seat 5: 47f6e2ce folded before Flop (didn't bet)
Seat 6: a7e4cbb8 folded before Flop (didn't bet)


Poker Hand #RC2771735189: Hold'em No Limit ($0.05/$0.1) - 2024/08/04 10:27:38
Table 'RushAndCash20790449' 6-max Seat #1 is the button
Seat 1: 2a6e3777 ($11.54 in chips)
Seat 2: c37c9f38 ($13.83 in chips)
Seat 3: 3302435a ($10.05 in chips)
Seat 4: Hero ($10.41 in chips)
Seat 5: 47f6e2ce ($12.41 in chips)
Seat 6: 197d87ef ($12.68 in chips)
c37c9f38: posts small blind $0.05
3302435a: posts big blind $0.1
*** HOLE CARDS ***
Dealt to 2a6e3777 
Dealt to c37c9f38 
Dealt to 3302435a 
Dealt to Hero [Th Kd]
Dealt to 47f6e2ce 
Dealt to 197d87ef 
Hero: folds
47f6e2ce: folds
197d87ef: folds
2a6e3777: folds
c37c9f38: folds
Uncalled bet ($0.05) returned to 3302435a
*** SHOWDOWN ***
3302435a collected $0.1 from pot
*** SUMMARY ***
Total pot $0.1 | Rake $0 | Jackpot $0 | Bingo $0 | Fortune $0 | Tax $0
Seat 1: 2a6e3777 (button) folded before Flop (didn't bet)
Seat 2: c37c9f38 (small blind) folded before Flop
Seat 3: 3302435a (big blind) collected ($0.1)
Seat 4: Hero folded before Flop (didn't bet)
Seat 5: 47f6e2ce folded before Flop (didn't bet)
Seat 6: 197d87ef folded before Flop (didn't bet)


Poker Hand #RC2771735166: Hold'em No Limit ($0.05/$0.1) - 2024/08/04 10:27:35
Table 'RushAndCash20790426' 6-max Seat #1 is the button
Seat 1: a16727d ($10.32 in chips)
Seat 2: 2d866f90 ($10.07 in chips)
Seat 3: 48c6297a ($16 in chips)
Seat 4: 3fc119ec ($18.93 in chips)
Seat 5: b461d7f3 ($10.04 in chips)
Seat 6: Hero ($10.41 in chips)
2d866f90: posts small blind $0.05
48c6297a: posts big blind $0.1
*** HOLE CARDS ***
Dealt to a16727d 
Dealt to 2d866f90 
Dealt to 48c6297a 
Dealt to 3fc119ec 
Dealt to b461d7f3 
Dealt to Hero [3c 9s]
3fc119ec: folds
b461d7f3: folds
Hero: folds
a16727d: raises $0.1 to $0.2
2d866f90: folds
48c6297a: raises $1 to $1.2
a16727d: folds
Uncalled bet ($1) returned to 48c6297a
*** SHOWDOWN ***
48c6297a collected $0.43 from pot
*** SUMMARY ***
Total pot $0.45 | Rake $0.02 | Jackpot $0 | Bingo $0 | Fortune $0 | Tax $0
Seat 1: a16727d (button) folded before Flop
Seat 2: 2d866f90 (small blind) folded before Flop
Seat 3: 48c6297a (big blind) collected ($0.43)
Seat 4: 3fc119ec folded before Flop (didn't bet)
Seat 5: b461d7f3 folded before Flop (didn't bet)
Seat 6: Hero folded before Flop (didn't bet)


Poker Hand #RC2771735135: Hold'em No Limit ($0.05/$0.1) - 2024/08/04 10:27:32
Table 'RushAndCash20790395' 6-max Seat #1 is the button
Seat 1: dd9cdf37 ($11.46 in chips)
Seat 2: e905139b ($9.27 in chips)
Seat 3: 834a0e1 ($10.72 in chips)
Seat 4: e9808f65 ($10 in chips)
Seat 5: Hero ($10.41 in chips)
Seat 6: 1ec0322a ($16.65 in chips)
e905139b: posts small blind $0.05
834a0e1: posts big blind $0.1
*** HOLE CARDS ***
Dealt to dd9cdf37 
Dealt to e905139b 
Dealt to 834a0e1 
Dealt to e9808f65 
Dealt to Hero [3c 6c]
Dealt to 1ec0322a 
e9808f65: folds
Hero: folds
1ec0322a: folds
dd9cdf37: raises $0.1 to $0.2
e905139b: raises $0.7 to $0.9
834a0e1: folds
dd9cdf37: folds
Uncalled bet ($0.7) returned to e905139b
*** SHOWDOWN ***
e905139b collected $0.48 from pot
*** SUMMARY ***
Total pot $0.5 | Rake $0.02 | Jackpot $0 | Bingo $0 | Fortune $0 | Tax $0
Seat 1: dd9cdf37 (button) folded before Flop
Seat 2: e905139b (small blind) collected ($0.48)
Seat 3: 834a0e1 (big blind) folded before Flop
Seat 4: e9808f65 folded before Flop (didn't bet)
Seat 5: Hero folded before Flop (didn't bet)
Seat 6: 1ec0322a folded before Flop (didn't bet)


Poker Hand #RC2771735107: Hold'em No Limit ($0.05/$0.1) - 2024/08/04 10:27:29
Table 'RushAndCash20790367' 6-max Seat #1 is the button
Seat 1: Hero ($10.41 in chips)
Seat 2: be383a91 ($12.76 in chips)
Seat 3: 9b9f945f ($23.36 in chips)
Seat 4: 1ad07a30 ($12.31 in chips)
Seat 5: 6e7ab779 ($12.28 in chips)
Seat 6: c61ce81a ($9.6 in chips)
be383a91: posts small blind $0.05
9b9f945f: posts big blind $0.1
*** HOLE CARDS ***
Dealt to Hero [3s Jh]
Dealt to be383a91 
Dealt to 9b9f945f 
Dealt to 1ad07a30 
Dealt to 6e7ab779 
Dealt to c61ce81a 
1ad07a30: folds
6e7ab779: folds
c61ce81a: raises $0.15 to $0.25
Hero: folds
be383a91: folds
9b9f945f: folds
Uncalled bet ($0.15) returned to c61ce81a
*** SHOWDOWN ***
c61ce81a collected $0.25 from pot
*** SUMMARY ***
Total pot $0.25 | Rake $0 | Jackpot $0 | Bingo $0 | Fortune $0 | Tax $0
Seat 1: Hero (button) folded before Flop (didn't bet)
Seat 2: be383a91 (small blind) folded before Flop
Seat 3: 9b9f945f (big blind) folded before Flop
Seat 4: 1ad07a30 folded before Flop (didn't bet)
Seat 5: 6e7ab779 folded before Flop (didn't bet)
Seat 6: c61ce81a collected ($0.25)


Poker Hand #RC2771735087: Hold'em No Limit ($0.05/$0.1) - 2024/08/04 10:27:26
Table 'RushAndCash20790347' 6-max Seat #1 is the button
Seat 1: efaabdb5 ($7.86 in chips)
Seat 2: Hero ($10.46 in chips)
Seat 3: 27948f90 ($10.38 in chips)
Seat 4: 78eed16a ($20.99 in chips)
Seat 5: 7f15a024 ($10 in chips)
Seat 6: b11bd88c ($22.61 in chips)
Hero: posts small blind $0.05
27948f90: posts big blind $0.1
*** HOLE CARDS ***
Dealt to efaabdb5 
Dealt to Hero [7h 5c]
Dealt to 27948f90 
Dealt to 78eed16a 
Dealt to 7f15a024 
Dealt to b11bd88c 
78eed16a: folds
7f15a024: raises $0.1 to $0.2
b11bd88c: folds
efaabdb5: calls $0.2
Hero: folds
27948f90: folds
*** FLOP *** [Qh 7d Ts]
7f15a024: bets $0.28
efaabdb5: calls $0.28
*** TURN *** [Qh 7d Ts] [5h]
7f15a024: bets $1.11
efaabdb5: folds
Uncalled bet ($1.11) returned to 7f15a024
*** SHOWDOWN ***
7f15a024 collected $1.06 from pot
*** SUMMARY ***
Total pot $1.11 | Rake $0.05 | Jackpot $0 | Bingo $0 | Fortune $0 | Tax $0
Board [Qh 7d Ts 5h]
Seat 1: efaabdb5 (button) folded on the Turn
Seat 2: Hero (small blind) folded before Flop
Seat 3: 27948f90 (big blind) folded before Flop
Seat 4: 78eed16a folded before Flop (didn't bet)
Seat 5: 7f15a024 won ($1.06)
Seat 6: b11bd88c folded before Flop (didn't bet)


Poker Hand #RC2771735038: Hold'em No Limit ($0.05/$0.1) - 2024/08/04 10:27:20
Table 'RushAndCash20790298' 6-max Seat #1 is the button
Seat 1: 14608725 ($10 in chips)
Seat 2: b121d894 ($10.33 in chips)
Seat 3: Hero ($10.56 in chips)
Seat 4: c4922c3d ($70.56 in chips)
Seat 5: 351b2066 ($10.52 in chips)
Seat 6: 7f903cda ($10.92 in chips)
b121d894: posts small blind $0.05
Hero: posts big blind $0.1
*** HOLE CARDS ***
Dealt to 14608725 
Dealt to b121d894 
Dealt to Hero [9c 4d]
Dealt to c4922c3d 
Dealt to 351b2066 
Dealt to 7f903cda 
c4922c3d: raises $0.12 to $0.22
351b2066: folds
7f903cda: folds
14608725: folds
b121d894: calls $0.17
Hero: folds
*** FLOP *** [Th 8c Jh]
b121d894: checks
c4922c3d: bets $0.27
b121d894: calls $0.27
*** TURN *** [Th 8c Jh] [5s]
b121d894: checks
c4922c3d: bets $0.81
b121d894: folds
Uncalled bet ($0.81) returned to c4922c3d
*** SHOWDOWN ***
c4922c3d collected $1.03 from pot
*** SUMMARY ***
Total pot $1.08 | Rake $0.05 | Jackpot $0 | Bingo $0 | Fortune $0 | Tax $0
Board [Th 8c Jh 5s]
Seat 1: 14608725 (button) folded before Flop (didn't bet)
Seat 2: b121d894 (small blind) folded on the Turn
Seat 3: Hero (big blind) folded before Flop
Seat 4: c4922c3d won ($1.03)
Seat 5: 351b2066 folded before Flop (didn't bet)
Seat 6: 7f903cda folded before Flop (didn't bet)


Poker Hand #RC2771735013: Hold'em No Limit ($0.05/$0.1) - 2024/08/04 10:27:17
Table 'RushAndCash20790273' 6-max Seat #1 is the button
Seat 1: e1581c36 ($17.03 in chips)
Seat 2: 44e483f7 ($14.23 in chips)
Seat 3: 74813e93 ($10 in chips)
Seat 4: d7ec1be4 ($9.54 in chips)
Seat 5: Hero ($10.56 in chips)
Seat 6: 348e7778 ($21.06 in chips)
44e483f7: posts small blind $0.05
74813e93: posts big blind $0.1
*** HOLE CARDS ***
Dealt to e1581c36 
Dealt to 44e483f7 
Dealt to 74813e93 
Dealt to d7ec1be4 
Dealt to Hero [4c 7c]
Dealt to 348e7778 
d7ec1be4: folds
Hero: folds
348e7778: folds
e1581c36: raises $0.1 to $0.2
44e483f7: folds
74813e93: calls $0.1
*** FLOP *** [6s Ac Kh]
74813e93: checks
e1581c36: bets $0.6
74813e93: folds
Uncalled bet ($0.6) returned to e1581c36
*** SHOWDOWN ***
e1581c36 collected $0.43 from pot
*** SUMMARY ***
Total pot $0.45 | Rake $0.02 | Jackpot $0 | Bingo $0 | Fortune $0 | Tax $0
Board [6s Ac Kh]
Seat 1: e1581c36 (button) won ($0.43)
Seat 2: 44e483f7 (small blind) folded before Flop
Seat 3: 74813e93 (big blind) folded on the Flop
Seat 4: d7ec1be4 folded before Flop (didn't bet)
Seat 5: Hero folded before Flop (didn't bet)
Seat 6: 348e7778 folded before Flop (didn't bet)


Poker Hand #RC2771734947: Hold'em No Limit ($0.05/$0.1) - 2024/08/04 10:27:10
Table 'RushAndCash20790207' 6-max Seat #1 is the button
Seat 1: 47b375d ($10.42 in chips)
Seat 2: 66ba8c7c ($19.46 in chips)
Seat 3: e82fd863 ($19.55 in chips)
Seat 4: bdd79bd8 ($10 in chips)
Seat 5: 3fc119ec ($18.78 in chips)
Seat 6: Hero ($10.56 in chips)
66ba8c7c: posts small blind $0.05
e82fd863: posts big blind $0.1
*** HOLE CARDS ***
Dealt to 47b375d 
Dealt to 66ba8c7c 
Dealt to e82fd863 
Dealt to bdd79bd8 
Dealt to 3fc119ec 
Dealt to Hero [Ah 2h]
bdd79bd8: folds
3fc119ec: raises $0.15 to $0.25
Hero: folds
47b375d: folds
66ba8c7c: folds
e82fd863: folds
Uncalled bet ($0.15) returned to 3fc119ec
*** SHOWDOWN ***
3fc119ec collected $0.25 from pot
*** SUMMARY ***
Total pot $0.25 | Rake $0 | Jackpot $0 | Bingo $0 | Fortune $0 | Tax $0
Seat 1: 47b375d (button) folded before Flop (didn't bet)
Seat 2: 66ba8c7c (small blind) folded before Flop
Seat 3: e82fd863 (big blind) folded before Flop
Seat 4: bdd79bd8 folded before Flop (didn't bet)
Seat 5: 3fc119ec collected ($0.25)
Seat 6: Hero folded before Flop (didn't bet)


Poker Hand #RC2771734912: Hold'em No Limit ($0.05/$0.1) - 2024/08/04 10:27:06
Table 'RushAndCash20790172' 6-max Seat #1 is the button
Seat 1: 76577d8b ($10.05 in chips)
Seat 2: 90735666 ($10.35 in chips)
Seat 3: aa4b9e7d ($25.68 in chips)
Seat 4: 3ba4c491 ($17.55 in chips)
Seat 5: 3bc0a854 ($10.15 in chips)
Seat 6: Hero ($10.56 in chips)
90735666: posts small blind $0.05
aa4b9e7d: posts big blind $0.1
*** HOLE CARDS ***
Dealt to 76577d8b 
Dealt to 90735666 
Dealt to aa4b9e7d 
Dealt to 3ba4c491 
Dealt to 3bc0a854 
Dealt to Hero [Qc 5s]
3ba4c491: folds
3bc0a854: folds
Hero: folds
76577d8b: folds
90735666: folds
Uncalled bet ($0.05) returned to aa4b9e7d
*** SHOWDOWN ***
aa4b9e7d collected $0.1 from pot
*** SUMMARY ***
Total pot $0.1 | Rake $0 | Jackpot $0 | Bingo $0 | Fortune $0 | Tax $0
Seat 1: 76577d8b (button) folded before Flop (didn't bet)
Seat 2: 90735666 (small blind) folded before Flop
Seat 3: aa4b9e7d (big blind) collected ($0.1)
Seat 4: 3ba4c491 folded before Flop (didn't bet)
Seat 5: 3bc0a854 folded before Flop (didn't bet)
Seat 6: Hero folded before Flop (didn't bet)


Poker Hand #RC2771734883: Hold'em No Limit ($0.05/$0.1) - 2024/08/04 10:27:02
Table 'RushAndCash20790143' 6-max Seat #1 is the button
Seat 1: Hero ($10.56 in chips)
Seat 2: 76577d8b ($10.1 in chips)
Seat 3: cbe2c8e0 ($11.93 in chips)
Seat 4: 6e38ebef ($14.54 in chips)
Seat 5: 294f07a2 ($12.83 in chips)
Seat 6: f10ee93a ($13.45 in chips)
76577d8b: posts small blind $0.05
cbe2c8e0: posts big blind $0.1
*** HOLE CARDS ***
Dealt to Hero [3d 2h]
Dealt to 76577d8b 
Dealt to cbe2c8e0 
Dealt to 6e38ebef 
Dealt to 294f07a2 
Dealt to f10ee93a 
6e38ebef: raises $0.15 to $0.25
294f07a2: calls $0.25
f10ee93a: folds
Hero: folds
76577d8b: folds
cbe2c8e0: folds
*** FLOP *** [9h 5h 7d]
6e38ebef: bets $0.33
294f07a2: folds
Uncalled bet ($0.33) returned to 6e38ebef
*** SHOWDOWN ***
6e38ebef collected $0.62 from pot
*** SUMMARY ***
Total pot $0.65 | Rake $0.03 | Jackpot $0 | Bingo $0 | Fortune $0 | Tax $0
Board [9h 5h 7d]
Seat 1: Hero (button) folded before Flop (didn't bet)
Seat 2: 76577d8b (small blind) folded before Flop
Seat 3: cbe2c8e0 (big blind) folded before Flop
Seat 4: 6e38ebef won ($0.62)
Seat 5: 294f07a2 folded on the Flop
Seat 6: f10ee93a folded before Flop (didn't bet)


Poker Hand #RC2771734855: Hold'em No Limit ($0.05/$0.1) - 2024/08/04 10:26:58
Table 'RushAndCash20790115' 6-max Seat #1 is the button
Seat 1: b16c9de0 ($10.02 in chips)
Seat 2: Hero ($10.61 in chips)
Seat 3: 1f9f6cb5 ($9.99 in chips)
Seat 4: 4e876e8d ($10 in chips)
Seat 5: af7e047d ($14.78 in chips)
Seat 6: 9410c30d ($16.82 in chips)
Hero: posts small blind $0.05
1f9f6cb5: posts big blind $0.1
*** HOLE CARDS ***
Dealt to b16c9de0 
Dealt to Hero [6d 7c]
Dealt to 1f9f6cb5 
Dealt to 4e876e8d 
Dealt to af7e047d 
Dealt to 9410c30d 
4e876e8d: folds
af7e047d: folds
9410c30d: folds
b16c9de0: raises $0.15 to $0.25
Hero: folds
1f9f6cb5: folds
Uncalled bet ($0.15) returned to b16c9de0
*** SHOWDOWN ***
b16c9de0 collected $0.25 from pot
*** SUMMARY ***
Total pot $0.25 | Rake $0 | Jackpot $0 | Bingo $0 | Fortune $0 | Tax $0
Seat 1: b16c9de0 (button) collected ($0.25)
Seat 2: Hero (small blind) folded before Flop
Seat 3: 1f9f6cb5 (big blind) folded before Flop
Seat 4: 4e876e8d folded before Flop (didn't bet)
Seat 5: af7e047d folded before Flop (didn't bet)
Seat 6: 9410c30d folded before Flop (didn't bet)


Poker Hand #RC2771734829: Hold'em No Limit ($0.05/$0.1) - 2024/08/04 10:26:54
Table 'RushAndCash20790089' 6-max Seat #1 is the button
Seat 1: fd959747 ($20.7 in chips)
Seat 2: 92bf6d23 ($11.37 in chips)
Seat 3: Hero ($10.71 in chips)
Seat 4: 45bf4575 ($11.31 in chips)
Seat 5: 845357be ($13.47 in chips)
Seat 6: 9b4d3588 ($10.15 in chips)
92bf6d23: posts small blind $0.05
Hero: posts big blind $0.1
*** HOLE CARDS ***
Dealt to fd959747 
Dealt to 92bf6d23 
Dealt to Hero [Jd 6h]
Dealt to 45bf4575 
Dealt to 845357be 
Dealt to 9b4d3588 
45bf4575: folds
845357be: folds
9b4d3588: folds
fd959747: folds
92bf6d23: raises $0.2 to $0.3
Hero: folds
Uncalled bet ($0.2) returned to 92bf6d23
*** SHOWDOWN ***
92bf6d23 collected $0.2 from pot
*** SUMMARY ***
Total pot $0.2 | Rake $0 | Jackpot $0 | Bingo $0 | Fortune $0 | Tax $0
Seat 1: fd959747 (button) folded before Flop (didn't bet)
Seat 2: 92bf6d23 (small blind) collected ($0.2)
Seat 3: Hero (big blind) folded before Flop
Seat 4: 45bf4575 folded before Flop (didn't bet)
Seat 5: 845357be folded before Flop (didn't bet)
Seat 6: 9b4d3588 folded before Flop (didn't bet)


Poker Hand #RC2771684409: Hold'em No Limit ($0.05/$0.1) - 2024/08/04 10:26:01
Table 'RushAndCash20789669' 6-max Seat #1 is the button
Seat 1: 612e1008 ($10 in chips)
Seat 2: 5eedd38f ($10.05 in chips)
Seat 3: 7a1ea221 ($20.15 in chips)
Seat 4: 66b6ae ($9.07 in chips)
Seat 5: Hero ($10.43 in chips)
Seat 6: 579c5fcc ($12.18 in chips)
5eedd38f: posts small blind $0.05
7a1ea221: posts big blind $0.1
*** HOLE CARDS ***
Dealt to 612e1008 
Dealt to 5eedd38f 
Dealt to 7a1ea221 
Dealt to 66b6ae 
Dealt to Hero [Th Qh]
Dealt to 579c5fcc 
66b6ae: folds
Hero: raises $0.1 to $0.2
579c5fcc: folds
612e1008: folds
5eedd38f: calls $0.15
7a1ea221: folds
*** FLOP *** [2d 5c 4s]
5eedd38f: checks
Hero: checks
*** TURN *** [2d 5c 4s] [7s]
5eedd38f: checks
Hero: checks
*** RIVER *** [2d 5c 4s 7s] [6h]
5eedd38f: checks
Hero: bets $0.33
5eedd38f: folds
Uncalled bet ($0.33) returned to Hero
*** SHOWDOWN ***
Hero collected $0.48 from pot
*** SUMMARY ***
Total pot $0.5 | Rake $0.02 | Jackpot $0 | Bingo $0 | Fortune $0 | Tax $0
Board [2d 5c 4s 7s 6h]
Seat 1: 612e1008 (button) folded before Flop (didn't bet)
Seat 2: 5eedd38f (small blind) folded on the River
Seat 3: 7a1ea221 (big blind) folded before Flop
Seat 4: 66b6ae folded before Flop (didn't bet)
Seat 5: Hero won ($0.48)
Seat 6: 579c5fcc folded before Flop (didn't bet)


Poker Hand #RC2771684296: Hold'em No Limit ($0.05/$0.1) - 2024/08/04 10:25:47
Table 'RushAndCash20789556' 6-max Seat #1 is the button
Seat 1: 2d72fe14 ($10.69 in chips)
Seat 2: 24f8fa31 ($22.62 in chips)
Seat 3: 4557e4ba ($10.15 in chips)
Seat 4: 1f9f6cb5 ($9.99 in chips)
Seat 5: Hero ($10.28 in chips)
Seat 6: 97f92a52 ($10 in chips)
24f8fa31: posts small blind $0.05
4557e4ba: posts big blind $0.1
*** HOLE CARDS ***
Dealt to 2d72fe14 
Dealt to 24f8fa31 
Dealt to 4557e4ba 
Dealt to 1f9f6cb5 
Dealt to Hero [Jc Ac]
Dealt to 97f92a52 
1f9f6cb5: folds
Hero: raises $0.1 to $0.2
97f92a52: folds
2d72fe14: folds
24f8fa31: folds
4557e4ba: folds
Uncalled bet ($0.1) returned to Hero
*** SHOWDOWN ***
Hero collected $0.25 from pot
*** SUMMARY ***
Total pot $0.25 | Rake $0 | Jackpot $0 | Bingo $0 | Fortune $0 | Tax $0
Seat 1: 2d72fe14 (button) folded before Flop (didn't bet)
Seat 2: 24f8fa31 (small blind) folded before Flop
Seat 3: 4557e4ba (big blind) folded before Flop
Seat 4: 1f9f6cb5 folded before Flop (didn't bet)
Seat 5: Hero collected ($0.25)
Seat 6: 97f92a52 folded before Flop (didn't bet)


Poker Hand #RC2771684262: Hold'em No Limit ($0.05/$0.1) - 2024/08/04 10:25:43
Table 'RushAndCash20789522' 6-max Seat #1 is the button
Seat 1: d9f61ba8 ($10 in chips)
Seat 2: b060664b ($10.5 in chips)
Seat 3: 4445ff51 ($18.57 in chips)
Seat 4: 23953e28 ($16.01 in chips)
Seat 5: 990dc3c7 ($10.26 in chips)
Seat 6: Hero ($10.28 in chips)
b060664b: posts small blind $0.05
4445ff51: posts big blind $0.1
*** HOLE CARDS ***
Dealt to d9f61ba8 
Dealt to b060664b 
Dealt to 4445ff51 
Dealt to 23953e28 
Dealt to 990dc3c7 
Dealt to Hero [2h 9d]
23953e28: folds
990dc3c7: folds
Hero: folds
d9f61ba8: raises $0.15 to $0.25
b060664b: folds
4445ff51: folds
Uncalled bet ($0.15) returned to d9f61ba8
*** SHOWDOWN ***
d9f61ba8 collected $0.25 from pot
*** SUMMARY ***
Total pot $0.25 | Rake $0 | Jackpot $0 | Bingo $0 | Fortune $0 | Tax $0
Seat 1: d9f61ba8 (button) collected ($0.25)
Seat 2: b060664b (small blind) folded before Flop
Seat 3: 4445ff51 (big blind) folded before Flop
Seat 4: 23953e28 folded before Flop (didn't bet)
Seat 5: 990dc3c7 folded before Flop (didn't bet)
Seat 6: Hero folded before Flop (didn't bet)


Poker Hand #RC2771684218: Hold'em No Limit ($0.05/$0.1) - 2024/08/04 10:25:37
Table 'RushAndCash20789478' 6-max Seat #1 is the button
Seat 1: Hero ($10.28 in chips)
Seat 2: 2a9c4d11 ($98.86 in chips)
Seat 3: 7ca57262 ($16.86 in chips)
Seat 4: 18ddc90b ($10.15 in chips)
Seat 5: 3a38c27b ($17.09 in chips)
Seat 6: 14608725 ($10.15 in chips)
2a9c4d11: posts small blind $0.05
7ca57262: posts big blind $0.1
*** HOLE CARDS ***
Dealt to Hero [As 2c]
Dealt to 2a9c4d11 
Dealt to 7ca57262 
Dealt to 18ddc90b 
Dealt to 3a38c27b 
Dealt to 14608725 
18ddc90b: folds
3a38c27b: raises $0.11 to $0.21
14608725: folds
Hero: folds
2a9c4d11: folds
7ca57262: folds
Uncalled bet ($0.11) returned to 3a38c27b
*** SHOWDOWN ***
3a38c27b collected $0.25 from pot
*** SUMMARY ***
Total pot $0.25 | Rake $0 | Jackpot $0 | Bingo $0 | Fortune $0 | Tax $0
Seat 1: Hero (button) folded before Flop (didn't bet)
Seat 2: 2a9c4d11 (small blind) folded before Flop
Seat 3: 7ca57262 (big blind) folded before Flop
Seat 4: 18ddc90b folded before Flop (didn't bet)
Seat 5: 3a38c27b collected ($0.25)
Seat 6: 14608725 folded before Flop (didn't bet)


Poker Hand #RC2771684141: Hold'em No Limit ($0.05/$0.1) - 2024/08/04 10:25:26
Table 'RushAndCash20789401' 6-max Seat #1 is the button
Seat 1: 34d94a51 ($10.27 in chips)
Seat 2: Hero ($10.33 in chips)
Seat 3: bdd79bd8 ($10.3 in chips)
Seat 4: 465ffdde ($19.96 in chips)
Seat 5: c99aeebc ($10.73 in chips)
Seat 6: ef3a40f4 ($14.27 in chips)
Hero: posts small blind $0.05
bdd79bd8: posts big blind $0.1
*** HOLE CARDS ***
Dealt to 34d94a51 
Dealt to Hero [As 7h]
Dealt to bdd79bd8 
Dealt to 465ffdde 
Dealt to c99aeebc 
Dealt to ef3a40f4 
465ffdde: folds
c99aeebc: folds
ef3a40f4: raises $0.15 to $0.25
34d94a51: folds
Hero: folds
bdd79bd8: folds
Uncalled bet ($0.15) returned to ef3a40f4
*** SHOWDOWN ***
ef3a40f4 collected $0.25 from pot
*** SUMMARY ***
Total pot $0.25 | Rake $0 | Jackpot $0 | Bingo $0 | Fortune $0 | Tax $0
Seat 1: 34d94a51 (button) folded before Flop (didn't bet)
Seat 2: Hero (small blind) folded before Flop
Seat 3: bdd79bd8 (big blind) folded before Flop
Seat 4: 465ffdde folded before Flop (didn't bet)
Seat 5: c99aeebc folded before Flop (didn't bet)
Seat 6: ef3a40f4 collected ($0.25)


Poker Hand #RC2771683799: Hold'em No Limit ($0.05/$0.1) - 2024/08/04 10:24:43
Table 'RushAndCash20789059' 6-max Seat #1 is the button
Seat 1: 2f4a54d5 ($12.31 in chips)
Seat 2: 34d94a51 ($10 in chips)
Seat 3: Hero ($10.63 in chips)
Seat 4: bcdb6073 ($10 in chips)
Seat 5: 27023ac7 ($30.51 in chips)
Seat 6: 992a613 ($11.26 in chips)
34d94a51: posts small blind $0.05
Hero: posts big blind $0.1
*** HOLE CARDS ***
Dealt to 2f4a54d5 
Dealt to 34d94a51 
Dealt to Hero [Js 7s]
Dealt to bcdb6073 
Dealt to 27023ac7 
Dealt to 992a613 
bcdb6073: folds
27023ac7: folds
992a613: folds
2f4a54d5: folds
34d94a51: raises $0.2 to $0.3
Hero: calls $0.2
*** FLOP *** [2s Ad 9h]
34d94a51: checks
Hero: checks
*** TURN *** [2s Ad 9h] [Kh]
34d94a51: checks
Hero: checks
*** RIVER *** [2s Ad 9h Kh] [3d]
34d94a51: bets $0.1
Hero: folds
Uncalled bet ($0.1) returned to 34d94a51
*** SHOWDOWN ***
34d94a51 collected $0.57 from pot
*** SUMMARY ***
Total pot $0.6 | Rake $0.03 | Jackpot $0 | Bingo $0 | Fortune $0 | Tax $0
Board [2s Ad 9h Kh 3d]
Seat 1: 2f4a54d5 (button) folded before Flop (didn't bet)
Seat 2: 34d94a51 (small blind) won ($0.57)
Seat 3: Hero (big blind) folded on the River
Seat 4: bcdb6073 folded before Flop (didn't bet)
Seat 5: 27023ac7 folded before Flop (didn't bet)
Seat 6: 992a613 folded before Flop (didn't bet)


Poker Hand #RC2771683696: Hold'em No Limit ($0.05/$0.1) - 2024/08/04 10:24:30
Table 'RushAndCash20788956' 6-max Seat #1 is the button
Seat 1: 140bf202 ($15.73 in chips)
Seat 2: 4e698754 ($14.32 in chips)
Seat 3: 857fd450 ($17.41 in chips)
Seat 4: ec4a051e ($10.15 in chips)
Seat 5: 27023ac7 ($30.56 in chips)
Seat 6: Hero ($10.48 in chips)
4e698754: posts small blind $0.05
857fd450: posts big blind $0.1
*** HOLE CARDS ***
Dealt to 140bf202 
Dealt to 4e698754 
Dealt to 857fd450 
Dealt to ec4a051e 
Dealt to 27023ac7 
Dealt to Hero [As 5s]
ec4a051e: folds
27023ac7: folds
Hero: raises $0.14 to $0.24
140bf202: folds
4e698754: folds
857fd450: folds
Uncalled bet ($0.14) returned to Hero
*** SHOWDOWN ***
Hero collected $0.25 from pot
*** SUMMARY ***
Total pot $0.25 | Rake $0 | Jackpot $0 | Bingo $0 | Fortune $0 | Tax $0
Seat 1: 140bf202 (button) folded before Flop (didn't bet)
Seat 2: 4e698754 (small blind) folded before Flop
Seat 3: 857fd450 (big blind) folded before Flop
Seat 4: ec4a051e folded before Flop (didn't bet)
Seat 5: 27023ac7 folded before Flop (didn't bet)
Seat 6: Hero collected ($0.25)


Poker Hand #RC2771683659: Hold'em No Limit ($0.05/$0.1) - 2024/08/04 10:24:26
Table 'RushAndCash20788919' 6-max Seat #1 is the button
Seat 1: da61e66f ($23.62 in chips)
Seat 2: 7142e51c ($10 in chips)
Seat 3: 1a4dc99 ($11.08 in chips)
Seat 4: Hero ($10.48 in chips)
Seat 5: f23cf046 ($10.18 in chips)
Seat 6: 365e7c76 ($9.92 in chips)
7142e51c: posts small blind $0.05
1a4dc99: posts big blind $0.1
*** HOLE CARDS ***
Dealt to da61e66f 
Dealt to 7142e51c 
Dealt to 1a4dc99 
Dealt to Hero [Ks Th]
Dealt to f23cf046 
Dealt to 365e7c76 
Hero: folds
f23cf046: folds
365e7c76: folds
da61e66f: folds
7142e51c: raises $0.2 to $0.3
1a4dc99: folds
Uncalled bet ($0.2) returned to 7142e51c
*** SHOWDOWN ***
7142e51c collected $0.2 from pot
*** SUMMARY ***
Total pot $0.2 | Rake $0 | Jackpot $0 | Bingo $0 | Fortune $0 | Tax $0
Seat 1: da61e66f (button) folded before Flop (didn't bet)
Seat 2: 7142e51c (small blind) collected ($0.2)
Seat 3: 1a4dc99 (big blind) folded before Flop
Seat 4: Hero folded before Flop (didn't bet)
Seat 5: f23cf046 folded before Flop (didn't bet)
Seat 6: 365e7c76 folded before Flop (didn't bet)


Poker Hand #RC2771683614: Hold'em No Limit ($0.05/$0.1) - 2024/08/04 10:24:20
Table 'RushAndCash20788874' 6-max Seat #1 is the button
Seat 1: 2a9c4d11 ($98.99 in chips)
Seat 2: b242b4d7 ($10 in chips)
Seat 3: a0eb2b72 ($6.05 in chips)
Seat 4: Hero ($10.48 in chips)
Seat 5: 92b63cd7 ($12.86 in chips)
Seat 6: 809c779a ($8.12 in chips)
b242b4d7: posts small blind $0.05
a0eb2b72: posts big blind $0.1
*** HOLE CARDS ***
Dealt to 2a9c4d11 
Dealt to b242b4d7 
Dealt to a0eb2b72 
Dealt to Hero [5h Jd]
Dealt to 92b63cd7 
Dealt to 809c779a 
Hero: folds
92b63cd7: folds
809c779a: calls $0.1
2a9c4d11: raises $0.27 to $0.37
b242b4d7: folds
a0eb2b72: calls $0.27
809c779a: calls $0.27
*** FLOP *** [Tc Qh 9h]
a0eb2b72: bets $0.58
809c779a: folds
2a9c4d11: calls $0.58
*** TURN *** [Tc Qh 9h] [7c]
a0eb2b72: checks
2a9c4d11: bets $1.16
a0eb2b72: calls $1.16
*** RIVER *** [Tc Qh 9h 7c] [6s]
a0eb2b72: checks
2a9c4d11: checks
a0eb2b72: shows [Ad Qs] (Pair of Queens)
2a9c4d11: shows [Qc Ah] (Pair of Queens)
*** SHOWDOWN ***
a0eb2b72 collected $2.14 from pot
2a9c4d11 collected $2.13 from pot
*** SUMMARY ***
Total pot $4.64 | Rake $0.22 | Jackpot $0.15 | Bingo $0 | Fortune $0 | Tax $0
Board [Tc Qh 9h 7c 6s]
Seat 1: 2a9c4d11 (button) showed [Qc Ah] and won ($2.13) with Pair of Queens
Seat 2: b242b4d7 (small blind) folded before Flop
Seat 3: a0eb2b72 (big blind) showed [Ad Qs] and won ($2.14) with Pair of Queens
Seat 4: Hero folded before Flop (didn't bet)
Seat 5: 92b63cd7 folded before Flop (didn't bet)
Seat 6: 809c779a folded on the Flop


Poker Hand #RC2771683580: Hold'em No Limit ($0.05/$0.1) - 2024/08/04 10:24:15
Table 'RushAndCash20788840' 6-max Seat #1 is the button
Seat 1: 98cfa9f0 ($11.21 in chips)
Seat 2: 90310af0 ($12.63 in chips)
Seat 3: ba74ce5d ($14.63 in chips)
Seat 4: Hero ($10.48 in chips)
Seat 5: 50f19bd5 ($12.25 in chips)
Seat 6: 365e7c76 ($9.92 in chips)
90310af0: posts small blind $0.05
ba74ce5d: posts big blind $0.1
*** HOLE CARDS ***
Dealt to 98cfa9f0 
Dealt to 90310af0 
Dealt to ba74ce5d 
Dealt to Hero [5c Kh]
Dealt to 50f19bd5 
Dealt to 365e7c76 
Hero: folds
50f19bd5: folds
365e7c76: folds
98cfa9f0: raises $0.15 to $0.25
90310af0: folds
ba74ce5d: raises $0.5 to $0.75
98cfa9f0: calls $0.5
*** FLOP *** [4h 5h 3s]
ba74ce5d: bets $0.78
98cfa9f0: folds
Uncalled bet ($0.78) returned to ba74ce5d
*** SHOWDOWN ***
ba74ce5d collected $1.48 from pot
*** SUMMARY ***
Total pot $1.55 | Rake $0.07 | Jackpot $0 | Bingo $0 | Fortune $0 | Tax $0
Board [4h 5h 3s]
Seat 1: 98cfa9f0 (button) folded on the Flop
Seat 2: 90310af0 (small blind) folded before Flop
Seat 3: ba74ce5d (big blind) won ($1.48)
Seat 4: Hero folded before Flop (didn't bet)
Seat 5: 50f19bd5 folded before Flop (didn't bet)
Seat 6: 365e7c76 folded before Flop (didn't bet)


Poker Hand #RC2771683535: Hold'em No Limit ($0.05/$0.1) - 2024/08/04 10:24:10
Table 'RushAndCash20788795' 6-max Seat #1 is the button
Seat 1: Hero ($10.48 in chips)
Seat 2: 8fff191a ($34.37 in chips)
Seat 3: cb9dc53 ($8.19 in chips)
Seat 4: 1ea45eef ($10 in chips)
Seat 5: 92ab134e ($43.41 in chips)
Seat 6: 170cf284 ($10.14 in chips)
8fff191a: posts small blind $0.05
cb9dc53: posts big blind $0.1
*** HOLE CARDS ***
Dealt to Hero [5c Jd]
Dealt to 8fff191a 
Dealt to cb9dc53 
Dealt to 1ea45eef 
Dealt to 92ab134e 
Dealt to 170cf284 
1ea45eef: folds
92ab134e: folds
170cf284: raises $0.12 to $0.22
Hero: folds
8fff191a: folds
cb9dc53: folds
Uncalled bet ($0.12) returned to 170cf284
*** SHOWDOWN ***
170cf284 collected $0.25 from pot
*** SUMMARY ***
Total pot $0.25 | Rake $0 | Jackpot $0 | Bingo $0 | Fortune $0 | Tax $0
Seat 1: Hero (button) folded before Flop (didn't bet)
Seat 2: 8fff191a (small blind) folded before Flop
Seat 3: cb9dc53 (big blind) folded before Flop
Seat 4: 1ea45eef folded before Flop (didn't bet)
Seat 5: 92ab134e folded before Flop (didn't bet)
Seat 6: 170cf284 collected ($0.25)


Poker Hand #RC2771683061: Hold'em No Limit ($0.05/$0.1) - 2024/08/04 10:23:08
Table 'RushAndCash20788321' 6-max Seat #1 is the button
Seat 1: 5d0272c6 ($13.37 in chips)
Seat 2: Hero ($10.53 in chips)
Seat 3: 56ec60f4 ($10 in chips)
Seat 4: befffaf9 ($10.58 in chips)
Seat 5: 8e05a33e ($25.72 in chips)
Seat 6: 56444da6 ($10.64 in chips)
Hero: posts small blind $0.05
56ec60f4: posts big blind $0.1
*** HOLE CARDS ***
Dealt to 5d0272c6 
Dealt to Hero [4h 3s]
Dealt to 56ec60f4 
Dealt to befffaf9 
Dealt to 8e05a33e 
Dealt to 56444da6 
befffaf9: folds
8e05a33e: folds
56444da6: folds
5d0272c6: raises $0.1 to $0.2
Hero: folds
56ec60f4: folds
Uncalled bet ($0.1) returned to 5d0272c6
*** SHOWDOWN ***
5d0272c6 collected $0.25 from pot
*** SUMMARY ***
Total pot $0.25 | Rake $0 | Jackpot $0 | Bingo $0 | Fortune $0 | Tax $0
Seat 1: 5d0272c6 (button) collected ($0.25)
Seat 2: Hero (small blind) folded before Flop
Seat 3: 56ec60f4 (big blind) folded before Flop
Seat 4: befffaf9 folded before Flop (didn't bet)
Seat 5: 8e05a33e folded before Flop (didn't bet)
Seat 6: 56444da6 folded before Flop (didn't bet)


Poker Hand #RC2771678760: Hold'em No Limit ($0.05/$0.1) - 2024/08/04 10:14:03
Table 'RushAndCash20784020' 6-max Seat #1 is the button
Seat 1: c5ad258e ($10.73 in chips)
Seat 2: a8519cf2 ($10 in chips)
Seat 3: Hero ($10 in chips)
Seat 4: a1a58c4f ($13.42 in chips)
Seat 5: b0e3b2a3 ($10 in chips)
Seat 6: c90c5beb ($14.31 in chips)
a8519cf2: posts small blind $0.05
Hero: posts big blind $0.1
*** HOLE CARDS ***
Dealt to c5ad258e 
Dealt to a8519cf2 
Dealt to Hero [4s 5s]
Dealt to a1a58c4f 
Dealt to b0e3b2a3 
Dealt to c90c5beb 
a1a58c4f: folds
b0e3b2a3: folds
c90c5beb: folds
c5ad258e: raises $0.15 to $0.25
a8519cf2: folds
Hero: calls $0.15
*** FLOP *** [3s 7d 7s]
Hero: checks
c5ad258e: bets $0.28
Hero: raises $0.62 to $0.9
c5ad258e: folds
Uncalled bet ($0.62) returned to Hero
*** SHOWDOWN ***
Hero collected $1.06 from pot
*** SUMMARY ***
Total pot $1.11 | Rake $0.05 | Jackpot $0 | Bingo $0 | Fortune $0 | Tax $0
Board [3s 7d 7s]
Seat 1: c5ad258e (button) folded on the Flop
Seat 2: a8519cf2 (small blind) folded before Flop
Seat 3: Hero (big blind) won ($1.06)
Seat 4: a1a58c4f folded before Flop (didn't bet)
Seat 5: b0e3b2a3 folded before Flop (didn't bet)
Seat 6: c90c5beb folded before Flop (didn't bet)


