Poker Hand #HD1724723300: Hold'em No Limit ($0.02/$0.05) - 2024/04/10 22:04:25
Table 'NLHBlue24' 6-max Seat #5 is the button
Seat 1: Hero ($6.52 in chips)
Seat 2: 30f25260 ($6.89 in chips)
Seat 3: 5eee53b7 ($8.64 in chips)
Seat 5: 3e29da52 ($5.43 in chips)
Seat 6: 837ac8c6 ($4.21 in chips)
837ac8c6: posts small blind $0.02
Hero: posts big blind $0.05
*** HOLE CARDS ***
Dealt to Hero [6c 9d]
Dealt to 30f25260 
Dealt to 5eee53b7 
Dealt to 3e29da52 
Dealt to 837ac8c6 
30f25260: folds
5eee53b7: folds
3e29da52: folds
837ac8c6: calls $0.03
Hero: checks
*** FLOP *** [5c Ad 9c]
837ac8c6: checks
Hero: checks
*** TURN *** [5c Ad 9c] [4s]
837ac8c6: checks
Hero: checks
*** RIVER *** [5c Ad 9c 4s] [6s]
837ac8c6: bets $0.05
Hero: raises $0.1 to $0.15
837ac8c6: calls $0.1
Hero: shows [6c 9d] (Pair of Nines and Pair of Sixes)
837ac8c6: shows [Td 6h] (Pair of Sixes)
*** SHOWDOWN ***
Hero collected $0.38 from pot
*** SUMMARY ***
Total pot $0.4 | Rake $0.02 | Jackpot $0 | Bingo $0 | Fortune $0 | Tax $0
Board [5c Ad 9c 4s 6s]
Seat 1: Hero (big blind) showed [6c 9d] and won ($0.38) with Pair of Nines and Pair of Sixes
Seat 2: 30f25260 folded before Flop (didn't bet)
Seat 3: 5eee53b7 folded before Flop (didn't bet)
Seat 5: 3e29da52 (button) folded before Flop (didn't bet)
Seat 6: 837ac8c6 (small blind) showed [Td 6h] and lost with Pair of Sixes


Poker Hand #HD1724723182: Hold'em No Limit ($0.02/$0.05) - 2024/04/10 22:03:12
Table 'NLHBlue24' 6-max Seat #3 is the button
Seat 1: Hero ($6.62 in chips)
Seat 2: 30f25260 ($6.68 in chips)
Seat 3: 5eee53b7 ($8.64 in chips)
Seat 5: 3e29da52 ($5.45 in chips)
Seat 6: 837ac8c6 ($4.31 in chips)
3e29da52: posts small blind $0.02
837ac8c6: posts big blind $0.05
*** HOLE CARDS ***
Dealt to Hero [9c Qc]
Dealt to 30f25260 
Dealt to 5eee53b7 
Dealt to 3e29da52 
Dealt to 837ac8c6 
Hero: raises $0.05 to $0.1
30f25260: calls $0.1
5eee53b7: folds
3e29da52: folds
837ac8c6: calls $0.05
*** FLOP *** [4c 3d 7d]
837ac8c6: checks
Hero: checks
30f25260: bets $0.11
837ac8c6: folds
Hero: folds
Uncalled bet ($0.11) returned to 30f25260
*** SHOWDOWN ***
30f25260 collected $0.31 from pot
*** SUMMARY ***
Total pot $0.32 | Rake $0.01 | Jackpot $0 | Bingo $0 | Fortune $0 | Tax $0
Board [4c 3d 7d]
Seat 1: Hero folded on the Flop
Seat 2: 30f25260 won ($0.31)
Seat 3: 5eee53b7 (button) folded before Flop (didn't bet)
Seat 5: 3e29da52 (small blind) folded before Flop
Seat 6: 837ac8c6 (big blind) folded on the Flop


Poker Hand #HD1724723111: Hold'em No Limit ($0.02/$0.05) - 2024/04/10 22:02:32
Table 'NLHBlue24' 6-max Seat #2 is the button
Seat 1: Hero ($6.77 in chips)
Seat 2: 30f25260 ($6.68 in chips)
Seat 3: 5eee53b7 ($8.66 in chips)
Seat 5: 3e29da52 ($5.5 in chips)
Seat 6: 837ac8c6 ($4.1 in chips)
5eee53b7: posts small blind $0.02
3e29da52: posts big blind $0.05
*** HOLE CARDS ***
Dealt to Hero [As Ks]
Dealt to 30f25260 
Dealt to 5eee53b7 
Dealt to 3e29da52 
Dealt to 837ac8c6 
837ac8c6: calls $0.05
Hero: raises $0.1 to $0.15
30f25260: folds
5eee53b7: folds
3e29da52: folds
837ac8c6: calls $0.1
*** FLOP *** [4d Jc 9h]
837ac8c6: bets $0.19
Hero: folds
Uncalled bet ($0.19) returned to 837ac8c6
*** SHOWDOWN ***
837ac8c6 collected $0.36 from pot
*** SUMMARY ***
Total pot $0.37 | Rake $0.01 | Jackpot $0 | Bingo $0 | Fortune $0 | Tax $0
Board [4d Jc 9h]
Seat 1: Hero folded on the Flop
Seat 2: 30f25260 (button) folded before Flop (didn't bet)
Seat 3: 5eee53b7 (small blind) folded before Flop
Seat 5: 3e29da52 (big blind) folded before Flop
Seat 6: 837ac8c6 won ($0.36)


Poker Hand #HD1724723055: Hold'em No Limit ($0.02/$0.05) - 2024/04/10 22:02:01
Table 'NLHBlue24' 6-max Seat #1 is the button
Seat 1: Hero ($6.77 in chips)
Seat 2: 30f25260 ($6.7 in chips)
Seat 3: 5eee53b7 ($8.52 in chips)
Seat 5: 3e29da52 ($5.63 in chips)
Seat 6: 837ac8c6 ($4.1 in chips)
30f25260: posts small blind $0.02
5eee53b7: posts big blind $0.05
*** HOLE CARDS ***
Dealt to Hero [Qs 7c]
Dealt to 30f25260 
Dealt to 5eee53b7 
Dealt to 3e29da52 
Dealt to 837ac8c6 
3e29da52: raises $0.08 to $0.13
837ac8c6: folds
Hero: folds
30f25260: folds
5eee53b7: calls $0.08
*** FLOP *** [Qh Td 9h]
5eee53b7: checks
3e29da52: checks
*** TURN *** [Qh Td 9h] [Ac]
5eee53b7: bets $0.21
3e29da52: folds
Uncalled bet ($0.21) returned to 5eee53b7
*** SHOWDOWN ***
5eee53b7 collected $0.27 from pot
*** SUMMARY ***
Total pot $0.28 | Rake $0.01 | Jackpot $0 | Bingo $0 | Fortune $0 | Tax $0
Board [Qh Td 9h Ac]
Seat 1: Hero (button) folded before Flop (didn't bet)
Seat 2: 30f25260 (small blind) folded before Flop
Seat 3: 5eee53b7 (big blind) won ($0.27)
Seat 5: 3e29da52 folded on the Turn
Seat 6: 837ac8c6 folded before Flop (didn't bet)


Poker Hand #HD1724722998: Hold'em No Limit ($0.02/$0.05) - 2024/04/10 22:01:26
Table 'NLHBlue24' 6-max Seat #6 is the button
Seat 1: Hero ($6.79 in chips)
Seat 2: 30f25260 ($6.44 in chips)
Seat 3: 5eee53b7 ($8.52 in chips)
Seat 5: 3e29da52 ($5.76 in chips)
Seat 6: 837ac8c6 ($4.23 in chips)
Hero: posts small blind $0.02
30f25260: posts big blind $0.05
*** HOLE CARDS ***
Dealt to Hero [8h 9c]
Dealt to 30f25260 
Dealt to 5eee53b7 
Dealt to 3e29da52 
Dealt to 837ac8c6 
5eee53b7: folds
3e29da52: raises $0.08 to $0.13
837ac8c6: calls $0.13
Hero: folds
30f25260: calls $0.08
*** FLOP *** [3s 6h 7c]
30f25260: bets $0.19
3e29da52: folds
837ac8c6: folds
Uncalled bet ($0.19) returned to 30f25260
*** SHOWDOWN ***
30f25260 collected $0.39 from pot
*** SUMMARY ***
Total pot $0.41 | Rake $0.02 | Jackpot $0 | Bingo $0 | Fortune $0 | Tax $0
Board [3s 6h 7c]
Seat 1: Hero (small blind) folded before Flop
Seat 2: 30f25260 (big blind) won ($0.39)
Seat 3: 5eee53b7 folded before Flop (didn't bet)
Seat 5: 3e29da52 folded on the Flop
Seat 6: 837ac8c6 (button) folded on the Flop


Poker Hand #HD1724722946: Hold'em No Limit ($0.02/$0.05) - 2024/04/10 22:01:00
Table 'NLHBlue24' 6-max Seat #5 is the button
Seat 1: Hero ($6.84 in chips)
Seat 2: 30f25260 ($6.44 in chips)
Seat 3: 5eee53b7 ($8.52 in chips)
Seat 5: 3e29da52 ($5.69 in chips)
Seat 6: 837ac8c6 ($4.25 in chips)
837ac8c6: posts small blind $0.02
Hero: posts big blind $0.05
*** HOLE CARDS ***
Dealt to Hero [Qh 7c]
Dealt to 30f25260 
Dealt to 5eee53b7 
Dealt to 3e29da52 
Dealt to 837ac8c6 
30f25260: folds
5eee53b7: folds
3e29da52: raises $0.08 to $0.13
837ac8c6: folds
Hero: folds
Uncalled bet ($0.08) returned to 3e29da52
*** SHOWDOWN ***
3e29da52 collected $0.12 from pot
*** SUMMARY ***
Total pot $0.12 | Rake $0 | Jackpot $0 | Bingo $0 | Fortune $0 | Tax $0
Seat 1: Hero (big blind) folded before Flop
Seat 2: 30f25260 folded before Flop (didn't bet)
Seat 3: 5eee53b7 folded before Flop (didn't bet)
Seat 5: 3e29da52 (button) collected ($0.12)
Seat 6: 837ac8c6 (small blind) folded before Flop


Poker Hand #HD1724722824: Hold'em No Limit ($0.02/$0.05) - 2024/04/10 21:59:51
Table 'NLHBlue24' 6-max Seat #3 is the button
Seat 1: Hero ($7.14 in chips)
Seat 2: 30f25260 ($6.44 in chips)
Seat 3: 5eee53b7 ($8.52 in chips)
Seat 5: 3e29da52 ($5.71 in chips)
Seat 6: 837ac8c6 ($3.96 in chips)
3e29da52: posts small blind $0.02
837ac8c6: posts big blind $0.05
*** HOLE CARDS ***
Dealt to Hero [Qs Qd]
Dealt to 30f25260 
Dealt to 5eee53b7 
Dealt to 3e29da52 
Dealt to 837ac8c6 
Hero: raises $0.05 to $0.1
30f25260: folds
5eee53b7: folds
3e29da52: folds
837ac8c6: raises $0.2 to $0.3
Hero: calls $0.2
*** FLOP *** [8h 6c As]
837ac8c6: checks
Hero: checks
*** TURN *** [8h 6c As] [Td]
837ac8c6: bets $0.31
Hero: folds
Uncalled bet ($0.31) returned to 837ac8c6
*** SHOWDOWN ***
837ac8c6 collected $0.59 from pot
*** SUMMARY ***
Total pot $0.62 | Rake $0.03 | Jackpot $0 | Bingo $0 | Fortune $0 | Tax $0
Board [8h 6c As Td]
Seat 1: Hero folded on the Turn
Seat 2: 30f25260 folded before Flop (didn't bet)
Seat 3: 5eee53b7 (button) folded before Flop (didn't bet)
Seat 5: 3e29da52 (small blind) folded before Flop
Seat 6: 837ac8c6 (big blind) won ($0.59)


Poker Hand #HD1724722749: Hold'em No Limit ($0.02/$0.05) - 2024/04/10 21:59:10
Table 'NLHBlue24' 6-max Seat #2 is the button
Seat 1: Hero ($7.27 in chips)
Seat 2: 30f25260 ($6.25 in chips)
Seat 3: 5eee53b7 ($8.54 in chips)
Seat 5: 3e29da52 ($5.76 in chips)
Seat 6: 837ac8c6 ($3.96 in chips)
5eee53b7: posts small blind $0.02
3e29da52: posts big blind $0.05
*** HOLE CARDS ***
Dealt to Hero [Jd Qc]
Dealt to 30f25260 
Dealt to 5eee53b7 
Dealt to 3e29da52 
Dealt to 837ac8c6 
837ac8c6: folds
Hero: raises $0.08 to $0.13
30f25260: raises $0.37 to $0.5
5eee53b7: folds
3e29da52: folds
Hero: folds
Uncalled bet ($0.37) returned to 30f25260
*** SHOWDOWN ***
30f25260 collected $0.32 from pot
*** SUMMARY ***
Total pot $0.33 | Rake $0.01 | Jackpot $0 | Bingo $0 | Fortune $0 | Tax $0
Seat 1: Hero folded before Flop
Seat 2: 30f25260 (button) collected ($0.32)
Seat 3: 5eee53b7 (small blind) folded before Flop
Seat 5: 3e29da52 (big blind) folded before Flop
Seat 6: 837ac8c6 folded before Flop (didn't bet)


Poker Hand #HD1724722556: Hold'em No Limit ($0.02/$0.05) - 2024/04/10 21:57:33
Table 'NLHBlue24' 6-max Seat #1 is the button
Seat 1: Hero ($7.27 in chips)
Seat 2: 30f25260 ($6.4 in chips)
Seat 3: 5eee53b7 ($5.37 in chips)
Seat 4: ae574fbd ($3.25 in chips)
Seat 5: 3e29da52 ($5.76 in chips)
Seat 6: 837ac8c6 ($4.11 in chips)
30f25260: posts small blind $0.02
5eee53b7: posts big blind $0.05
*** HOLE CARDS ***
Dealt to Hero [7d 4h]
Dealt to 30f25260 
Dealt to 5eee53b7 
Dealt to ae574fbd 
Dealt to 3e29da52 
Dealt to 837ac8c6 
ae574fbd: raises $0.1 to $0.15
3e29da52: folds
837ac8c6: calls $0.15
Hero: folds
30f25260: calls $0.13
5eee53b7: raises $0.67 to $0.82
ae574fbd: calls $0.67
837ac8c6: folds
30f25260: folds
*** FLOP *** [Jd Qh Ac]
5eee53b7: checks
ae574fbd: checks
*** TURN *** [Jd Qh Ac] [Kh]
5eee53b7: checks
ae574fbd: bets $0.65
5eee53b7: calls $0.65
*** RIVER *** [Jd Qh Ac Kh] [Ah]
5eee53b7: bets $2.43
ae574fbd: calls $1.78 and is all-in
Uncalled bet ($0.65) returned to 5eee53b7
5eee53b7: shows [Kd As] (Aces Full over Kings)
ae574fbd: shows [Qd Td] (Aces-High Straight)
*** SHOWDOWN ***
5eee53b7 collected $6.42 from pot
*** SUMMARY ***
Total pot $6.8 | Rake $0.33 | Jackpot $0.05 | Bingo $0 | Fortune $0 | Tax $0
Board [Jd Qh Ac Kh Ah]
Seat 1: Hero (button) folded before Flop (didn't bet)
Seat 2: 30f25260 (small blind) folded before Flop
Seat 3: 5eee53b7 (big blind) showed [Kd As] and won ($6.42) with Aces Full over Kings
Seat 4: ae574fbd showed [Qd Td] and lost with Aces-High Straight
Seat 5: 3e29da52 folded before Flop (didn't bet)
Seat 6: 837ac8c6 folded before Flop


Poker Hand #HD1724722530: Hold'em No Limit ($0.02/$0.05) - 2024/04/10 21:57:18
Table 'NLHBlue24' 6-max Seat #6 is the button
Seat 1: Hero ($7.29 in chips)
Seat 2: 30f25260 ($6.45 in chips)
Seat 3: 5eee53b7 ($5.37 in chips)
Seat 4: ae574fbd ($3.3 in chips)
Seat 5: 3e29da52 ($5.64 in chips)
Seat 6: 837ac8c6 ($4.11 in chips)
Hero: posts small blind $0.02
30f25260: posts big blind $0.05
ae574fbd: posts big blind $0.05
*** HOLE CARDS ***
Dealt to Hero [Js 5c]
Dealt to 30f25260 
Dealt to 5eee53b7 
Dealt to ae574fbd 
Dealt to 3e29da52 
Dealt to 837ac8c6 
5eee53b7: folds
ae574fbd: checks
3e29da52: raises $0.15 to $0.2
837ac8c6: folds
Hero: folds
30f25260: folds
ae574fbd: folds
Uncalled bet ($0.15) returned to 3e29da52
*** SHOWDOWN ***
3e29da52 collected $0.17 from pot
*** SUMMARY ***
Total pot $0.17 | Rake $0 | Jackpot $0 | Bingo $0 | Fortune $0 | Tax $0
Seat 1: Hero (small blind) folded before Flop
Seat 2: 30f25260 (big blind) folded before Flop
Seat 3: 5eee53b7 folded before Flop (didn't bet)
Seat 4: ae574fbd folded before Flop
Seat 5: 3e29da52 collected ($0.17)
Seat 6: 837ac8c6 (button) folded before Flop (didn't bet)


Poker Hand #HD1724722434: Hold'em No Limit ($0.02/$0.05) - 2024/04/10 21:56:36
Table 'NLHBlue24' 6-max Seat #5 is the button
Seat 1: Hero ($7.13 in chips)
Seat 2: 30f25260 ($6.45 in chips)
Seat 3: 5eee53b7 ($5.37 in chips)
Seat 5: 3e29da52 ($5.64 in chips)
Seat 6: 837ac8c6 ($4.28 in chips)
837ac8c6: posts small blind $0.02
Hero: posts big blind $0.05
*** HOLE CARDS ***
Dealt to Hero [Jc 4s]
Dealt to 30f25260 
Dealt to 5eee53b7 
Dealt to 3e29da52 
Dealt to 837ac8c6 
30f25260: folds
5eee53b7: folds
3e29da52: folds
837ac8c6: calls $0.03
Hero: checks
*** FLOP *** [8s 6s Jh]
837ac8c6: bets $0.05
Hero: calls $0.05
*** TURN *** [8s 6s Jh] [6d]
837ac8c6: bets $0.07
Hero: calls $0.07
*** RIVER *** [8s 6s Jh 6d] [Ah]
837ac8c6: checks
Hero: checks
837ac8c6: shows [9d Qd] (Pair of Sixes)
Hero: shows [Jc 4s] (Pair of Jacks and Pair of Sixes)
*** SHOWDOWN ***
Hero collected $0.33 from pot
*** SUMMARY ***
Total pot $0.34 | Rake $0.01 | Jackpot $0 | Bingo $0 | Fortune $0 | Tax $0
Board [8s 6s Jh 6d Ah]
Seat 1: Hero (big blind) showed [Jc 4s] and won ($0.33) with Pair of Jacks and Pair of Sixes
Seat 2: 30f25260 folded before Flop (didn't bet)
Seat 3: 5eee53b7 folded before Flop (didn't bet)
Seat 5: 3e29da52 (button) folded before Flop (didn't bet)
Seat 6: 837ac8c6 (small blind) showed [9d Qd] and lost with Pair of Sixes


Poker Hand #HD1724722404: Hold'em No Limit ($0.02/$0.05) - 2024/04/10 21:56:24
Table 'NLHBlue24' 6-max Seat #3 is the button
Seat 1: Hero ($7.13 in chips)
Seat 2: 30f25260 ($6.45 in chips)
Seat 3: 5eee53b7 ($5.37 in chips)
Seat 4: adb7f716 ($3.56 in chips)
Seat 5: 3e29da52 ($5.62 in chips)
Seat 6: 837ac8c6 ($4.28 in chips)
adb7f716: posts small blind $0.02
3e29da52: posts big blind $0.05
*** HOLE CARDS ***
Dealt to Hero [2h Qc]
Dealt to 30f25260 
Dealt to 5eee53b7 
Dealt to adb7f716 
Dealt to 3e29da52 
Dealt to 837ac8c6 
837ac8c6: folds
Hero: folds
30f25260: folds
5eee53b7: folds
adb7f716: folds
Uncalled bet ($0.03) returned to 3e29da52
*** SHOWDOWN ***
3e29da52 collected $0.04 from pot
*** SUMMARY ***
Total pot $0.04 | Rake $0 | Jackpot $0 | Bingo $0 | Fortune $0 | Tax $0
Seat 1: Hero folded before Flop (didn't bet)
Seat 2: 30f25260 folded before Flop (didn't bet)
Seat 3: 5eee53b7 (button) folded before Flop (didn't bet)
Seat 4: adb7f716 (small blind) folded before Flop
Seat 5: 3e29da52 (big blind) collected ($0.04)
Seat 6: 837ac8c6 folded before Flop (didn't bet)


Poker Hand #HD1724722323: Hold'em No Limit ($0.02/$0.05) - 2024/04/10 21:55:42
Table 'NLHBlue24' 6-max Seat #2 is the button
Seat 1: Hero ($7.13 in chips)
Seat 2: 30f25260 ($6.45 in chips)
Seat 3: 5eee53b7 ($5.39 in chips)
Seat 4: adb7f716 ($3.79 in chips)
Seat 5: 3e29da52 ($5.39 in chips)
Seat 6: 837ac8c6 ($4.28 in chips)
5eee53b7: posts small blind $0.02
adb7f716: posts big blind $0.05
*** HOLE CARDS ***
Dealt to Hero [6d Ad]
Dealt to 30f25260 
Dealt to 5eee53b7 
Dealt to adb7f716 
Dealt to 3e29da52 
Dealt to 837ac8c6 
3e29da52: raises $0.08 to $0.13
837ac8c6: folds
Hero: folds
30f25260: folds
5eee53b7: folds
adb7f716: calls $0.08
*** FLOP *** [Qd 5c 8d]
adb7f716: checks
3e29da52: bets $0.1
adb7f716: calls $0.1
*** TURN *** [Qd 5c 8d] [Jh]
adb7f716: checks
3e29da52: bets $0.29
adb7f716: folds
Uncalled bet ($0.29) returned to 3e29da52
*** SHOWDOWN ***
3e29da52 collected $0.46 from pot
*** SUMMARY ***
Total pot $0.48 | Rake $0.02 | Jackpot $0 | Bingo $0 | Fortune $0 | Tax $0
Board [Qd 5c 8d Jh]
Seat 1: Hero folded before Flop (didn't bet)
Seat 2: 30f25260 (button) folded before Flop (didn't bet)
Seat 3: 5eee53b7 (small blind) folded before Flop
Seat 4: adb7f716 (big blind) folded on the Turn
Seat 5: 3e29da52 won ($0.46)
Seat 6: 837ac8c6 folded before Flop (didn't bet)


Poker Hand #HD1724722198: Hold'em No Limit ($0.02/$0.05) - 2024/04/10 21:54:35
Table 'NLHBlue24' 6-max Seat #1 is the button
Seat 1: Hero ($6.77 in chips)
Seat 2: 30f25260 ($6.74 in chips)
Seat 3: 5eee53b7 ($5.44 in chips)
Seat 5: 3e29da52 ($5.39 in chips)
Seat 6: 837ac8c6 ($4.33 in chips)
30f25260: posts small blind $0.02
5eee53b7: posts big blind $0.05
*** HOLE CARDS ***
Dealt to Hero [Kc Qh]
Dealt to 30f25260 
Dealt to 5eee53b7 
Dealt to 3e29da52 
Dealt to 837ac8c6 
3e29da52: folds
837ac8c6: calls $0.05
Hero: raises $0.1 to $0.15
30f25260: calls $0.13
5eee53b7: folds
837ac8c6: folds
*** FLOP *** [Th 2c Ad]
30f25260: bets $0.14
Hero: calls $0.14
*** TURN *** [Th 2c Ad] [4s]
30f25260: checks
Hero: checks
*** RIVER *** [Th 2c Ad 4s] [Jd]
30f25260: checks
Hero: bets $0.5
30f25260: folds
Uncalled bet ($0.5) returned to Hero
*** SHOWDOWN ***
Hero collected $0.65 from pot
*** SUMMARY ***
Total pot $0.68 | Rake $0.03 | Jackpot $0 | Bingo $0 | Fortune $0 | Tax $0
Board [Th 2c Ad 4s Jd]
Seat 1: Hero (button) won ($0.65)
Seat 2: 30f25260 (small blind) folded on the River
Seat 3: 5eee53b7 (big blind) folded before Flop
Seat 5: 3e29da52 folded before Flop (didn't bet)
Seat 6: 837ac8c6 folded before Flop


Poker Hand #HD1724722139: Hold'em No Limit ($0.02/$0.05) - 2024/04/10 21:54:06
Table 'NLHBlue24' 6-max Seat #6 is the button
Seat 1: Hero ($6.79 in chips)
Seat 2: 30f25260 ($6.79 in chips)
Seat 3: 5eee53b7 ($5.44 in chips)
Seat 4: adb7f716 ($3.79 in chips)
Seat 5: 3e29da52 ($5.32 in chips)
Seat 6: 837ac8c6 ($4.33 in chips)
Hero: posts small blind $0.02
30f25260: posts big blind $0.05
*** HOLE CARDS ***
Dealt to Hero [Ac 7h]
Dealt to 30f25260 
Dealt to 5eee53b7 
Dealt to adb7f716 
Dealt to 3e29da52 
Dealt to 837ac8c6 
5eee53b7: folds
adb7f716: folds
3e29da52: raises $0.08 to $0.13
837ac8c6: folds
Hero: folds
30f25260: folds
Uncalled bet ($0.08) returned to 3e29da52
*** SHOWDOWN ***
3e29da52 collected $0.12 from pot
*** SUMMARY ***
Total pot $0.12 | Rake $0 | Jackpot $0 | Bingo $0 | Fortune $0 | Tax $0
Seat 1: Hero (small blind) folded before Flop
Seat 2: 30f25260 (big blind) folded before Flop
Seat 3: 5eee53b7 folded before Flop (didn't bet)
Seat 4: adb7f716 folded before Flop (didn't bet)
Seat 5: 3e29da52 collected ($0.12)
Seat 6: 837ac8c6 (button) folded before Flop (didn't bet)


Poker Hand #HD1724722038: Hold'em No Limit ($0.02/$0.05) - 2024/04/10 21:53:12
Table 'NLHBlue24' 6-max Seat #5 is the button
Seat 1: Hero ($6.84 in chips)
Seat 2: 30f25260 ($6.79 in chips)
Seat 3: 5eee53b7 ($5.44 in chips)
Seat 4: adb7f716 ($4.07 in chips)
Seat 5: 3e29da52 ($5 in chips)
Seat 6: 837ac8c6 ($4.35 in chips)
837ac8c6: posts small blind $0.02
Hero: posts big blind $0.05
*** HOLE CARDS ***
Dealt to Hero [8h 2h]
Dealt to 30f25260 
Dealt to 5eee53b7 
Dealt to adb7f716 
Dealt to 3e29da52 
Dealt to 837ac8c6 
30f25260: folds
5eee53b7: folds
adb7f716: raises $0.07 to $0.12
3e29da52: calls $0.12
837ac8c6: folds
Hero: folds
*** FLOP *** [Qh 7h Qd]
adb7f716: bets $0.16
3e29da52: calls $0.16
*** TURN *** [Qh 7h Qd] [7s]
adb7f716: checks
3e29da52: checks
*** RIVER *** [Qh 7h Qd 7s] [5s]
adb7f716: checks
3e29da52: bets $0.31
adb7f716: folds
Uncalled bet ($0.31) returned to 3e29da52
*** SHOWDOWN ***
3e29da52 collected $0.6 from pot
*** SUMMARY ***
Total pot $0.63 | Rake $0.03 | Jackpot $0 | Bingo $0 | Fortune $0 | Tax $0
Board [Qh 7h Qd 7s 5s]
Seat 1: Hero (big blind) folded before Flop
Seat 2: 30f25260 folded before Flop (didn't bet)
Seat 3: 5eee53b7 folded before Flop (didn't bet)
Seat 4: adb7f716 folded on the River
Seat 5: 3e29da52 (button) won ($0.6)
Seat 6: 837ac8c6 (small blind) folded before Flop


Poker Hand #HD1724721982: Hold'em No Limit ($0.02/$0.05) - 2024/04/10 21:52:42
Table 'NLHBlue24' 6-max Seat #4 is the button
Seat 1: Hero ($6.73 in chips)
Seat 2: 30f25260 ($6.79 in chips)
Seat 3: 5eee53b7 ($5.44 in chips)
Seat 4: adb7f716 ($4.07 in chips)
Seat 5: 3e29da52 ($5 in chips)
Seat 6: 837ac8c6 ($4.45 in chips)
3e29da52: posts small blind $0.02
837ac8c6: posts big blind $0.05
*** HOLE CARDS ***
Dealt to Hero [Qh Qd]
Dealt to 30f25260 
Dealt to 5eee53b7 
Dealt to adb7f716 
Dealt to 3e29da52 
Dealt to 837ac8c6 
Hero: raises $0.05 to $0.1
30f25260: folds
5eee53b7: folds
adb7f716: folds
3e29da52: folds
837ac8c6: calls $0.05
*** FLOP *** [Jd 2s 8h]
837ac8c6: checks
Hero: bets $0.1
837ac8c6: folds
Uncalled bet ($0.1) returned to Hero
*** SHOWDOWN ***
Hero collected $0.21 from pot
*** SUMMARY ***
Total pot $0.22 | Rake $0.01 | Jackpot $0 | Bingo $0 | Fortune $0 | Tax $0
Board [Jd 2s 8h]
Seat 1: Hero won ($0.21)
Seat 2: 30f25260 folded before Flop (didn't bet)
Seat 3: 5eee53b7 folded before Flop (didn't bet)
Seat 4: adb7f716 (button) folded before Flop (didn't bet)
Seat 5: 3e29da52 (small blind) folded before Flop
Seat 6: 837ac8c6 (big blind) folded on the Flop


Poker Hand #HD1724721918: Hold'em No Limit ($0.02/$0.05) - 2024/04/10 21:52:08
Table 'NLHBlue24' 6-max Seat #3 is the button
Seat 1: Hero ($6.73 in chips)
Seat 2: 30f25260 ($6.79 in chips)
Seat 3: 5eee53b7 ($5.44 in chips)
Seat 4: adb7f716 ($4.09 in chips)
Seat 5: 3e29da52 ($5 in chips)
Seat 6: 837ac8c6 ($4.11 in chips)
adb7f716: posts small blind $0.02
3e29da52: posts big blind $0.05
*** HOLE CARDS ***
Dealt to Hero [4d 6h]
Dealt to 30f25260 
Dealt to 5eee53b7 
Dealt to adb7f716 
Dealt to 3e29da52 
Dealt to 837ac8c6 
837ac8c6: calls $0.05
Hero: folds
30f25260: folds
5eee53b7: folds
adb7f716: folds
3e29da52: raises $0.1 to $0.15
837ac8c6: calls $0.1
*** FLOP *** [9s Ts 8h]
3e29da52: bets $0.2
837ac8c6: calls $0.2
*** TURN *** [9s Ts 8h] [6d]
3e29da52: checks
837ac8c6: checks
*** RIVER *** [9s Ts 8h 6d] [2d]
3e29da52: checks
837ac8c6: bets $0.36
3e29da52: folds
Uncalled bet ($0.36) returned to 837ac8c6
*** SHOWDOWN ***
837ac8c6 collected $0.69 from pot
*** SUMMARY ***
Total pot $0.72 | Rake $0.03 | Jackpot $0 | Bingo $0 | Fortune $0 | Tax $0
Board [9s Ts 8h 6d 2d]
Seat 1: Hero folded before Flop (didn't bet)
Seat 2: 30f25260 folded before Flop (didn't bet)
Seat 3: 5eee53b7 (button) folded before Flop (didn't bet)
Seat 4: adb7f716 (small blind) folded before Flop
Seat 5: 3e29da52 (big blind) folded on the River
Seat 6: 837ac8c6 won ($0.69)


Poker Hand #HD1724721815: Hold'em No Limit ($0.02/$0.05) - 2024/04/10 21:51:21
Table 'NLHBlue24' 6-max Seat #2 is the button
Seat 1: Hero ($6.73 in chips)
Seat 2: 30f25260 ($6.79 in chips)
Seat 3: 5eee53b7 ($5.46 in chips)
Seat 4: adb7f716 ($4.43 in chips)
Seat 5: 3e29da52 ($5 in chips)
Seat 6: 837ac8c6 ($3.78 in chips)
5eee53b7: posts small blind $0.02
adb7f716: posts big blind $0.05
*** HOLE CARDS ***
Dealt to Hero [5s 3h]
Dealt to 30f25260 
Dealt to 5eee53b7 
Dealt to adb7f716 
Dealt to 3e29da52 
Dealt to 837ac8c6 
3e29da52: folds
837ac8c6: calls $0.05
Hero: folds
30f25260: folds
5eee53b7: folds
adb7f716: checks
*** FLOP *** [9s 4h 5c]
adb7f716: checks
837ac8c6: checks
*** TURN *** [9s 4h 5c] [6h]
adb7f716: bets $0.09
837ac8c6: calls $0.09
*** RIVER *** [9s 4h 5c 6h] [2d]
adb7f716: checks
837ac8c6: bets $0.2
adb7f716: calls $0.2
837ac8c6: shows [9h 5h] (Pair of Nines and Pair of Fives)
adb7f716: shows [Td 5d] (Pair of Fives)
*** SHOWDOWN ***
837ac8c6 collected $0.67 from pot
*** SUMMARY ***
Total pot $0.7 | Rake $0.03 | Jackpot $0 | Bingo $0 | Fortune $0 | Tax $0
Board [9s 4h 5c 6h 2d]
Seat 1: Hero folded before Flop (didn't bet)
Seat 2: 30f25260 (button) folded before Flop (didn't bet)
Seat 3: 5eee53b7 (small blind) folded before Flop
Seat 4: adb7f716 (big blind) showed [Td 5d] and lost with Pair of Fives
Seat 5: 3e29da52 folded before Flop (didn't bet)
Seat 6: 837ac8c6 showed [9h 5h] and won ($0.67) with Pair of Nines and Pair of Fives


Poker Hand #HD1724721761: Hold'em No Limit ($0.02/$0.05) - 2024/04/10 21:50:48
Table 'NLHBlue24' 6-max Seat #1 is the button
Seat 1: Hero ($6.73 in chips)
Seat 2: 30f25260 ($6.81 in chips)
Seat 3: 5eee53b7 ($5.32 in chips)
Seat 4: adb7f716 ($4.43 in chips)
Seat 5: 3e29da52 ($5 in chips)
Seat 6: 837ac8c6 ($3.78 in chips)
30f25260: posts small blind $0.02
5eee53b7: posts big blind $0.05
*** HOLE CARDS ***
Dealt to Hero [5d 8h]
Dealt to 30f25260 
Dealt to 5eee53b7 
Dealt to adb7f716 
Dealt to 3e29da52 
Dealt to 837ac8c6 
adb7f716: folds
3e29da52: raises $0.08 to $0.13
837ac8c6: folds
Hero: folds
30f25260: folds
5eee53b7: raises $0.47 to $0.6
3e29da52: folds
Uncalled bet ($0.47) returned to 5eee53b7
*** SHOWDOWN ***
5eee53b7 collected $0.27 from pot
*** SUMMARY ***
Total pot $0.28 | Rake $0.01 | Jackpot $0 | Bingo $0 | Fortune $0 | Tax $0
Seat 1: Hero (button) folded before Flop (didn't bet)
Seat 2: 30f25260 (small blind) folded before Flop
Seat 3: 5eee53b7 (big blind) collected ($0.27)
Seat 4: adb7f716 folded before Flop (didn't bet)
Seat 5: 3e29da52 folded before Flop
Seat 6: 837ac8c6 folded before Flop (didn't bet)


Poker Hand #HD1724721625: Hold'em No Limit ($0.02/$0.05) - 2024/04/10 21:49:34
Table 'NLHBlue24' 6-max Seat #6 is the button
Seat 1: Hero ($5.02 in chips)
Seat 2: 30f25260 ($6.86 in chips)
Seat 3: 5eee53b7 ($5.32 in chips)
Seat 4: adb7f716 ($4.43 in chips)
Seat 5: 3e29da52 ($5 in chips)
Seat 6: 837ac8c6 ($3.78 in chips)
Hero: posts small blind $0.02
30f25260: posts big blind $0.05
*** HOLE CARDS ***
Dealt to Hero [Ac Kc]
Dealt to 30f25260 
Dealt to 5eee53b7 
Dealt to adb7f716 
Dealt to 3e29da52 
Dealt to 837ac8c6 
5eee53b7: folds
adb7f716: folds
3e29da52: raises $0.08 to $0.13
837ac8c6: folds
Hero: raises $0.32 to $0.45
30f25260: folds
3e29da52: calls $0.32
*** FLOP *** [Kh 5h 3h]
Hero: bets $0.25
3e29da52: calls $0.25
*** TURN *** [Kh 5h 3h] [Qd]
Hero: bets $0.5
3e29da52: calls $0.5
*** RIVER *** [Kh 5h 3h Qd] [8s]
Hero: bets $0.7
3e29da52: calls $0.7
Hero: shows [Ac Kc] (Pair of Kings)
3e29da52: shows [Js Ks] (Pair of Kings)
*** SHOWDOWN ***
Hero collected $3.61 from pot
*** SUMMARY ***
Total pot $3.85 | Rake $0.19 | Jackpot $0.05 | Bingo $0 | Fortune $0 | Tax $0
Board [Kh 5h 3h Qd 8s]
Seat 1: Hero (small blind) showed [Ac Kc] and won ($3.61) with Pair of Kings
Seat 2: 30f25260 (big blind) folded before Flop
Seat 3: 5eee53b7 folded before Flop (didn't bet)
Seat 4: adb7f716 folded before Flop (didn't bet)
Seat 5: 3e29da52 showed [Js Ks] and lost with Pair of Kings
Seat 6: 837ac8c6 (button) folded before Flop (didn't bet)


Poker Hand #HD1724721563: Hold'em No Limit ($0.02/$0.05) - 2024/04/10 21:49:00
Table 'NLHBlue24' 6-max Seat #5 is the button
Seat 1: Hero ($5.07 in chips)
Seat 2: 30f25260 ($6.86 in chips)
Seat 3: 5eee53b7 ($5.16 in chips)
Seat 4: adb7f716 ($3.43 in chips)
Seat 5: 3e29da52 ($5 in chips)
Seat 6: 837ac8c6 ($3.9 in chips)
837ac8c6: posts small blind $0.02
Hero: posts big blind $0.05
*** HOLE CARDS ***
Dealt to Hero [6s 9d]
Dealt to 30f25260 
Dealt to 5eee53b7 
Dealt to adb7f716 
Dealt to 3e29da52 
Dealt to 837ac8c6 
30f25260: folds
5eee53b7: raises $0.07 to $0.12
adb7f716: folds
3e29da52: folds
837ac8c6: calls $0.1
Hero: folds
*** FLOP *** [Ts 2h 8s]
837ac8c6: checks
5eee53b7: bets $0.22
837ac8c6: folds
Uncalled bet ($0.22) returned to 5eee53b7
*** SHOWDOWN ***
5eee53b7 collected $0.28 from pot
*** SUMMARY ***
Total pot $0.29 | Rake $0.01 | Jackpot $0 | Bingo $0 | Fortune $0 | Tax $0
Board [Ts 2h 8s]
Seat 1: Hero (big blind) folded before Flop
Seat 2: 30f25260 folded before Flop (didn't bet)
Seat 3: 5eee53b7 won ($0.28)
Seat 4: adb7f716 folded before Flop (didn't bet)
Seat 5: 3e29da52 (button) folded before Flop (didn't bet)
Seat 6: 837ac8c6 (small blind) folded on the Flop


Poker Hand #HD1724721438: Hold'em No Limit ($0.02/$0.05) - 2024/04/10 21:47:55
Table 'NLHBlue24' 6-max Seat #4 is the button
Seat 1: Hero ($5.07 in chips)
Seat 2: 30f25260 ($6.05 in chips)
Seat 3: 5eee53b7 ($5.16 in chips)
Seat 4: adb7f716 ($4.22 in chips)
Seat 5: 3e29da52 ($5 in chips)
Seat 6: 837ac8c6 ($4.03 in chips)
3e29da52: posts small blind $0.02
837ac8c6: posts big blind $0.05
*** HOLE CARDS ***
Dealt to Hero [2s 8d]
Dealt to 30f25260 
Dealt to 5eee53b7 
Dealt to adb7f716 
Dealt to 3e29da52 
Dealt to 837ac8c6 
Hero: folds
30f25260: raises $0.08 to $0.13
5eee53b7: folds
adb7f716: calls $0.13
3e29da52: folds
837ac8c6: calls $0.08
*** FLOP *** [Js 2h 6s]
837ac8c6: checks
30f25260: bets $0.14
adb7f716: calls $0.14
837ac8c6: folds
*** TURN *** [Js 2h 6s] [Th]
30f25260: bets $0.52
adb7f716: calls $0.52
*** RIVER *** [Js 2h 6s Th] [5d]
30f25260: bets $5.26 and is all-in
adb7f716: folds
Uncalled bet ($5.26) returned to 30f25260
*** SHOWDOWN ***
30f25260 collected $1.6 from pot
*** SUMMARY ***
Total pot $1.73 | Rake $0.08 | Jackpot $0.05 | Bingo $0 | Fortune $0 | Tax $0
Board [Js 2h 6s Th 5d]
Seat 1: Hero folded before Flop (didn't bet)
Seat 2: 30f25260 won ($1.6)
Seat 3: 5eee53b7 folded before Flop (didn't bet)
Seat 4: adb7f716 (button) folded on the River
Seat 5: 3e29da52 (small blind) folded before Flop
Seat 6: 837ac8c6 (big blind) folded on the Flop


Poker Hand #HD1724721309: Hold'em No Limit ($0.02/$0.05) - 2024/04/10 21:46:53
Table 'NLHBlue24' 6-max Seat #3 is the button
Seat 1: Hero ($5.07 in chips)
Seat 2: 30f25260 ($6.05 in chips)
Seat 3: 5eee53b7 ($5.36 in chips)
Seat 4: adb7f716 ($3.75 in chips)
Seat 5: 3e29da52 ($5 in chips)
Seat 6: 837ac8c6 ($3.31 in chips)
adb7f716: posts small blind $0.02
3e29da52: posts big blind $0.05
*** HOLE CARDS ***
Dealt to Hero [7d 8s]
Dealt to 30f25260 
Dealt to 5eee53b7 
Dealt to adb7f716 
Dealt to 3e29da52 
Dealt to 837ac8c6 
837ac8c6: calls $0.05
Hero: folds
30f25260: folds
5eee53b7: raises $0.15 to $0.2
adb7f716: calls $0.18
3e29da52: folds
837ac8c6: calls $0.15
*** FLOP *** [Kh 9d Qh]
adb7f716: checks
837ac8c6: bets $0.33
5eee53b7: folds
adb7f716: calls $0.33
*** TURN *** [Kh 9d Qh] [6h]
adb7f716: checks
837ac8c6: bets $2.78 and is all-in
adb7f716: folds
Uncalled bet ($2.78) returned to 837ac8c6
837ac8c6: shows [Ks 6d] (Pair of Kings and Pair of Sixes)
*** SHOWDOWN ***
837ac8c6 collected $1.25 from pot
*** SUMMARY ***
Total pot $1.31 | Rake $0.06 | Jackpot $0 | Bingo $0 | Fortune $0 | Tax $0
Board [Kh 9d Qh 6h]
Seat 1: Hero folded before Flop (didn't bet)
Seat 2: 30f25260 folded before Flop (didn't bet)
Seat 3: 5eee53b7 (button) folded on the Flop
Seat 4: adb7f716 (small blind) folded on the Turn
Seat 5: 3e29da52 (big blind) folded before Flop
Seat 6: 837ac8c6 showed [Ks 6d] and won ($1.25)


Poker Hand #HD1724721206: Hold'em No Limit ($0.02/$0.05) - 2024/04/10 21:45:56
Table 'NLHBlue24' 6-max Seat #2 is the button
Seat 1: Hero ($5.07 in chips)
Seat 2: 30f25260 ($6.23 in chips)
Seat 3: 5eee53b7 ($5.38 in chips)
Seat 4: adb7f716 ($4.35 in chips)
Seat 5: 3e29da52 ($5 in chips)
Seat 6: 837ac8c6 ($2.58 in chips)
5eee53b7: posts small blind $0.02
adb7f716: posts big blind $0.05
*** HOLE CARDS ***
Dealt to Hero [6c 2c]
Dealt to 30f25260 
Dealt to 5eee53b7 
Dealt to adb7f716 
Dealt to 3e29da52 
Dealt to 837ac8c6 
3e29da52: folds
837ac8c6: calls $0.05
Hero: folds
30f25260: raises $0.13 to $0.18
5eee53b7: folds
adb7f716: calls $0.13
837ac8c6: calls $0.13
*** FLOP *** [2h 6s 3s]
adb7f716: checks
837ac8c6: bets $0.42
30f25260: folds
adb7f716: calls $0.42
*** TURN *** [2h 6s 3s] [9c]
adb7f716: checks
837ac8c6: bets $1.98 and is all-in
adb7f716: folds
Uncalled bet ($1.98) returned to 837ac8c6
*** SHOWDOWN ***
837ac8c6 collected $1.33 from pot
*** SUMMARY ***
Total pot $1.4 | Rake $0.07 | Jackpot $0 | Bingo $0 | Fortune $0 | Tax $0
Board [2h 6s 3s 9c]
Seat 1: Hero folded before Flop (didn't bet)
Seat 2: 30f25260 (button) folded on the Flop
Seat 3: 5eee53b7 (small blind) folded before Flop
Seat 4: adb7f716 (big blind) folded on the Turn
Seat 5: 3e29da52 folded before Flop (didn't bet)
Seat 6: 837ac8c6 won ($1.33)


Poker Hand #HD1724721181: Hold'em No Limit ($0.02/$0.05) - 2024/04/10 21:45:38
Table 'NLHBlue24' 6-max Seat #1 is the button
Seat 1: Hero ($5 in chips)
Seat 2: 30f25260 ($6.25 in chips)
Seat 3: 5eee53b7 ($5.43 in chips)
Seat 4: adb7f716 ($4.35 in chips)
Seat 5: 3e29da52 ($5 in chips)
Seat 6: 837ac8c6 ($2.58 in chips)
30f25260: posts small blind $0.02
5eee53b7: posts big blind $0.05
*** HOLE CARDS ***
Dealt to Hero [Js 8s]
Dealt to 30f25260 
Dealt to 5eee53b7 
Dealt to adb7f716 
Dealt to 3e29da52 
Dealt to 837ac8c6 
adb7f716: folds
3e29da52: folds
837ac8c6: folds
Hero: raises $0.08 to $0.13
30f25260: folds
5eee53b7: folds
Uncalled bet ($0.08) returned to Hero
*** SHOWDOWN ***
Hero collected $0.12 from pot
*** SUMMARY ***
Total pot $0.12 | Rake $0 | Jackpot $0 | Bingo $0 | Fortune $0 | Tax $0
Seat 1: Hero (button) collected ($0.12)
Seat 2: 30f25260 (small blind) folded before Flop
Seat 3: 5eee53b7 (big blind) folded before Flop
Seat 4: adb7f716 folded before Flop (didn't bet)
Seat 5: 3e29da52 folded before Flop (didn't bet)
Seat 6: 837ac8c6 folded before Flop (didn't bet)


Poker Hand #HD1724721084: Hold'em No Limit ($0.02/$0.05) - 2024/04/10 21:44:52
Table 'NLHBlue24' 6-max Seat #6 is the button
Seat 1: Hero ($5 in chips)
Seat 2: 30f25260 ($6.3 in chips)
Seat 3: 5eee53b7 ($5 in chips)
Seat 4: adb7f716 ($4.35 in chips)
Seat 5: 3e29da52 ($5 in chips)
Seat 6: 837ac8c6 ($2.7 in chips)
Hero: posts small blind $0.02
30f25260: posts big blind $0.05
*** HOLE CARDS ***
Dealt to Hero [8c 9s]
Dealt to 30f25260 
Dealt to 5eee53b7 
Dealt to adb7f716 
Dealt to 3e29da52 
Dealt to 837ac8c6 
5eee53b7: raises $0.07 to $0.12
adb7f716: folds
3e29da52: calls $0.12
837ac8c6: calls $0.12
Hero: folds
30f25260: folds
*** FLOP *** [3s Jc 7c]
5eee53b7: checks
3e29da52: bets $0.15
837ac8c6: folds
5eee53b7: calls $0.15
*** TURN *** [3s Jc 7c] [Kc]
5eee53b7: checks
3e29da52: checks
*** RIVER *** [3s Jc 7c Kc] [5h]
5eee53b7: bets $0.55
3e29da52: folds
Uncalled bet ($0.55) returned to 5eee53b7
*** SHOWDOWN ***
5eee53b7 collected $0.7 from pot
*** SUMMARY ***
Total pot $0.73 | Rake $0.03 | Jackpot $0 | Bingo $0 | Fortune $0 | Tax $0
Board [3s Jc 7c Kc 5h]
Seat 1: Hero (small blind) folded before Flop
Seat 2: 30f25260 (big blind) folded before Flop
Seat 3: 5eee53b7 won ($0.7)
Seat 4: adb7f716 folded before Flop (didn't bet)
Seat 5: 3e29da52 folded on the River
Seat 6: 837ac8c6 (button) folded on the Flop


Poker Hand #HD1724720961: Hold'em No Limit ($0.02/$0.05) - 2024/04/10 21:43:53
Table 'NLHBlue24' 6-max Seat #5 is the button
Seat 1: Hero ($5 in chips)
Seat 2: 30f25260 ($6.3 in chips)
Seat 3: 5eee53b7 ($5 in chips)
Seat 4: adb7f716 ($4.35 in chips)
Seat 5: 3e29da52 ($5.49 in chips)
Seat 6: 837ac8c6 ($2.2 in chips)
837ac8c6: posts small blind $0.02
Hero: posts big blind $0.05
*** HOLE CARDS ***
Dealt to Hero [9s 7d]
Dealt to 30f25260 
Dealt to 5eee53b7 
Dealt to adb7f716 
Dealt to 3e29da52 
Dealt to 837ac8c6 
30f25260: folds
5eee53b7: folds
adb7f716: folds
3e29da52: raises $0.08 to $0.13
837ac8c6: calls $0.11
Hero: folds
*** FLOP *** [Qc Kd As]
837ac8c6: bets $0.16
3e29da52: calls $0.16
*** TURN *** [Qc Kd As] [5s]
837ac8c6: bets $0.21
3e29da52: calls $0.21
*** RIVER *** [Qc Kd As 5s] [7h]
837ac8c6: bets $0.35
3e29da52: folds
Uncalled bet ($0.35) returned to 837ac8c6
*** SHOWDOWN ***
837ac8c6 collected $1 from pot
*** SUMMARY ***
Total pot $1.05 | Rake $0.05 | Jackpot $0 | Bingo $0 | Fortune $0 | Tax $0
Board [Qc Kd As 5s 7h]
Seat 1: Hero (big blind) folded before Flop
Seat 2: 30f25260 folded before Flop (didn't bet)
Seat 3: 5eee53b7 folded before Flop (didn't bet)
Seat 4: adb7f716 folded before Flop (didn't bet)
Seat 5: 3e29da52 (button) folded on the River
Seat 6: 837ac8c6 (small blind) won ($1)


Poker Hand #HD1724720816: Hold'em No Limit ($0.02/$0.05) - 2024/04/10 21:42:39
Table 'NLHBlue24' 6-max Seat #4 is the button
Seat 1: Hero ($5 in chips)
Seat 2: 30f25260 ($5.68 in chips)
Seat 3: 5eee53b7 ($5 in chips)
Seat 4: adb7f716 ($4.67 in chips)
Seat 5: 3e29da52 ($5.51 in chips)
Seat 6: 837ac8c6 ($2.52 in chips)
3e29da52: posts small blind $0.02
837ac8c6: posts big blind $0.05
*** HOLE CARDS ***
Dealt to Hero [3c 8s]
Dealt to 30f25260 
Dealt to 5eee53b7 
Dealt to adb7f716 
Dealt to 3e29da52 
Dealt to 837ac8c6 
Hero: folds
30f25260: raises $0.08 to $0.13
5eee53b7: folds
adb7f716: calls $0.13
3e29da52: folds
837ac8c6: calls $0.08
*** FLOP *** [Jd 7h Qs]
837ac8c6: checks
30f25260: bets $0.19
adb7f716: calls $0.19
837ac8c6: calls $0.19
*** TURN *** [Jd 7h Qs] [Kc]
837ac8c6: checks
30f25260: bets $0.44
adb7f716: folds
837ac8c6: folds
Uncalled bet ($0.44) returned to 30f25260
*** SHOWDOWN ***
30f25260 collected $0.94 from pot
*** SUMMARY ***
Total pot $0.98 | Rake $0.04 | Jackpot $0 | Bingo $0 | Fortune $0 | Tax $0
Board [Jd 7h Qs Kc]
Seat 1: Hero folded before Flop (didn't bet)
Seat 2: 30f25260 won ($0.94)
Seat 3: 5eee53b7 folded before Flop (didn't bet)
Seat 4: adb7f716 (button) folded on the Turn
Seat 5: 3e29da52 (small blind) folded before Flop
Seat 6: 837ac8c6 (big blind) folded on the Turn


Poker Hand #HD1724720719: Hold'em No Limit ($0.02/$0.05) - 2024/04/10 21:41:44
Table 'NLHBlue24' 6-max Seat #3 is the button
Seat 1: Hero ($5 in chips)
Seat 2: 30f25260 ($5.68 in chips)
Seat 3: 5eee53b7 ($5 in chips)
Seat 4: adb7f716 ($4.45 in chips)
Seat 5: 3e29da52 ($5.56 in chips)
Seat 6: 837ac8c6 ($2.52 in chips)
adb7f716: posts small blind $0.02
3e29da52: posts big blind $0.05
*** HOLE CARDS ***
Dealt to Hero [Jd 6d]
Dealt to 30f25260 
Dealt to 5eee53b7 
Dealt to adb7f716 
Dealt to 3e29da52 
Dealt to 837ac8c6 
837ac8c6: folds
Hero: folds
30f25260: folds
5eee53b7: raises $0.05 to $0.1
adb7f716: calls $0.08
3e29da52: folds
*** FLOP *** [As 8h 2s]
adb7f716: checks
5eee53b7: bets $0.09
adb7f716: calls $0.09
*** TURN *** [As 8h 2s] [6s]
adb7f716: checks
5eee53b7: checks
*** RIVER *** [As 8h 2s 6s] [4s]
adb7f716: bets $0.22
5eee53b7: folds
Uncalled bet ($0.22) returned to adb7f716
*** SHOWDOWN ***
adb7f716 collected $0.41 from pot
*** SUMMARY ***
Total pot $0.43 | Rake $0.02 | Jackpot $0 | Bingo $0 | Fortune $0 | Tax $0
Board [As 8h 2s 6s 4s]
Seat 1: Hero folded before Flop (didn't bet)
Seat 2: 30f25260 folded before Flop (didn't bet)
Seat 3: 5eee53b7 (button) folded on the River
Seat 4: adb7f716 (small blind) won ($0.41)
Seat 5: 3e29da52 (big blind) folded before Flop
Seat 6: 837ac8c6 folded before Flop (didn't bet)


Poker Hand #HD1724720654: Hold'em No Limit ($0.02/$0.05) - 2024/04/10 21:41:12
Table 'NLHBlue24' 6-max Seat #2 is the button
Seat 1: Hero ($5 in chips)
Seat 2: 30f25260 ($5.37 in chips)
Seat 3: 5eee53b7 ($5 in chips)
Seat 4: adb7f716 ($4.5 in chips)
Seat 5: 3e29da52 ($5.69 in chips)
Seat 6: 837ac8c6 ($2.65 in chips)
5eee53b7: posts small blind $0.02
adb7f716: posts big blind $0.05
*** HOLE CARDS ***
Dealt to Hero [Qs 8h]
Dealt to 30f25260 
Dealt to 5eee53b7 
Dealt to adb7f716 
Dealt to 3e29da52 
Dealt to 837ac8c6 
3e29da52: raises $0.08 to $0.13
837ac8c6: calls $0.13
Hero: folds
30f25260: raises $0.4 to $0.53
5eee53b7: folds
adb7f716: folds
3e29da52: folds
837ac8c6: folds
Uncalled bet ($0.4) returned to 30f25260
*** SHOWDOWN ***
30f25260 collected $0.44 from pot
*** SUMMARY ***
Total pot $0.46 | Rake $0.02 | Jackpot $0 | Bingo $0 | Fortune $0 | Tax $0
Seat 1: Hero folded before Flop (didn't bet)
Seat 2: 30f25260 (button) collected ($0.44)
Seat 3: 5eee53b7 (small blind) folded before Flop
Seat 4: adb7f716 (big blind) folded before Flop
Seat 5: 3e29da52 folded before Flop
Seat 6: 837ac8c6 folded before Flop


Poker Hand #HD1724720599: Hold'em No Limit ($0.02/$0.05) - 2024/04/10 21:40:42
Table 'NLHBlue24' 6-max Seat #1 is the button
Seat 1: Hero ($5 in chips)
Seat 2: 30f25260 ($5.39 in chips)
Seat 3: 5eee53b7 ($5 in chips)
Seat 4: adb7f716 ($4.5 in chips)
Seat 5: 3e29da52 ($5.69 in chips)
Seat 6: 837ac8c6 ($2.43 in chips)
30f25260: posts small blind $0.02
5eee53b7: posts big blind $0.05
*** HOLE CARDS ***
Dealt to Hero [8s Ad]
Dealt to 30f25260 
Dealt to 5eee53b7 
Dealt to adb7f716 
Dealt to 3e29da52 
Dealt to 837ac8c6 
adb7f716: folds
3e29da52: folds
837ac8c6: calls $0.05
Hero: raises $0.12 to $0.17
30f25260: folds
5eee53b7: folds
837ac8c6: calls $0.12
*** FLOP *** [5c 9c Kc]
837ac8c6: bets $0.21
Hero: folds
Uncalled bet ($0.21) returned to 837ac8c6
*** SHOWDOWN ***
837ac8c6 collected $0.39 from pot
*** SUMMARY ***
Total pot $0.41 | Rake $0.02 | Jackpot $0 | Bingo $0 | Fortune $0 | Tax $0
Board [5c 9c Kc]
Seat 1: Hero (button) folded on the Flop
Seat 2: 30f25260 (small blind) folded before Flop
Seat 3: 5eee53b7 (big blind) folded before Flop
Seat 4: adb7f716 folded before Flop (didn't bet)
Seat 5: 3e29da52 folded before Flop (didn't bet)
Seat 6: 837ac8c6 won ($0.39)


Poker Hand #HD1724720450: Hold'em No Limit ($0.02/$0.05) - 2024/04/10 21:39:22
Table 'NLHBlue24' 6-max Seat #6 is the button
Seat 1: Hero ($5 in chips)
Seat 2: 30f25260 ($5.44 in chips)
Seat 3: 5eee53b7 ($5 in chips)
Seat 4: adb7f716 ($4.5 in chips)
Seat 5: 3e29da52 ($5.88 in chips)
Seat 6: 837ac8c6 ($2.43 in chips)
Hero: posts small blind $0.02
30f25260: posts big blind $0.05
*** HOLE CARDS ***
Dealt to Hero [Kh Kd]
Dealt to 30f25260 
Dealt to 5eee53b7 
Dealt to adb7f716 
Dealt to 3e29da52 
Dealt to 837ac8c6 
5eee53b7: raises $0.07 to $0.12
adb7f716: folds
3e29da52: raises $0.27 to $0.39
837ac8c6: folds
Hero: raises $0.61 to $1
30f25260: folds
5eee53b7: folds
3e29da52: raises $1 to $2
Hero: raises $3 to $5 and is all-in
3e29da52: calls $3
Hero: shows [Kh Kd]
3e29da52: shows [Ac Ad]
*** FIRST FLOP *** [3s 7d 2h]
*** FIRST TURN *** [3s 7d 2h] [Kc]
*** FIRST RIVER *** [3s 7d 2h Kc] [2s]
*** SECOND FLOP *** [Jd As 6s]
*** SECOND TURN *** [Jd As 6s] [Tc]
*** SECOND RIVER *** [Jd As 6s Tc] [2c]
*** FIRST SHOWDOWN ***
Hero collected $4.81 from pot
*** SECOND SHOWDOWN ***
3e29da52 collected $4.81 from pot
*** SUMMARY ***
Total pot $10.17 | Rake $0.5 | Jackpot $0.05 | Bingo $0 | Fortune $0 | Tax $0
Hand was run two times
FIRST Board [3s 7d 2h Kc 2s]
SECOND Board [Jd As 6s Tc 2c]
Seat 1: Hero (small blind) showed [Kh Kd] and won ($4.81) with Kings Full over Twos, and lost with Pair of Kings
Seat 2: 30f25260 (big blind) folded before Flop
Seat 3: 5eee53b7 folded before Flop
Seat 4: adb7f716 folded before Flop (didn't bet)
Seat 5: 3e29da52 showed [Ac Ad] and lost with Pair of Aces and Pair of Twos, and won ($4.81) with Three Aces
Seat 6: 837ac8c6 (button) folded before Flop (didn't bet)


Poker Hand #HD1724720318: Hold'em No Limit ($0.02/$0.05) - 2024/04/10 21:38:14
Table 'NLHBlue24' 6-max Seat #5 is the button
Seat 1: Hero ($5 in chips)
Seat 2: 30f25260 ($5.44 in chips)
Seat 3: 5eee53b7 ($5 in chips)
Seat 4: adb7f716 ($4.5 in chips)
Seat 5: 3e29da52 ($5 in chips)
Seat 6: 837ac8c6 ($2.61 in chips)
837ac8c6: posts small blind $0.02
Hero: posts big blind $0.05
*** HOLE CARDS ***
Dealt to Hero [Qc Td]
Dealt to 30f25260 
Dealt to 5eee53b7 
Dealt to adb7f716 
Dealt to 3e29da52 
Dealt to 837ac8c6 
30f25260: folds
5eee53b7: folds
adb7f716: folds
3e29da52: raises $0.08 to $0.13
837ac8c6: calls $0.11
Hero: calls $0.08
*** FLOP *** [4h Qh 4d]
837ac8c6: bets $0.05
Hero: raises $0.15 to $0.2
3e29da52: calls $0.2
837ac8c6: folds
*** TURN *** [4h Qh 4d] [Kc]
Hero: checks
3e29da52: bets $0.51
Hero: calls $0.51
*** RIVER *** [4h Qh 4d Kc] [9c]
Hero: checks
3e29da52: checks
Hero: shows [Qc Td] (Pair of Queens and Pair of Fours)
3e29da52: shows [Qs As] (Pair of Queens and Pair of Fours)
*** SHOWDOWN ***
3e29da52 collected $1.72 from pot
*** SUMMARY ***
Total pot $1.86 | Rake $0.09 | Jackpot $0.05 | Bingo $0 | Fortune $0 | Tax $0
Board [4h Qh 4d Kc 9c]
Seat 1: Hero (big blind) showed [Qc Td] and lost with Pair of Queens and Pair of Fours
Seat 2: 30f25260 folded before Flop (didn't bet)
Seat 3: 5eee53b7 folded before Flop (didn't bet)
Seat 4: adb7f716 folded before Flop (didn't bet)
Seat 5: 3e29da52 (button) showed [Qs As] and won ($1.72) with Pair of Queens and Pair of Fours
Seat 6: 837ac8c6 (small blind) folded on the Flop


Poker Hand #HD1724720237: Hold'em No Limit ($0.02/$0.05) - 2024/04/10 21:37:29
Table 'NLHBlue24' 6-max Seat #4 is the button
Seat 1: Hero ($5 in chips)
Seat 2: 30f25260 ($5.44 in chips)
Seat 3: 5eee53b7 ($5.09 in chips)
Seat 4: adb7f716 ($4.5 in chips)
Seat 5: 3e29da52 ($5 in chips)
Seat 6: 837ac8c6 ($2.48 in chips)
3e29da52: posts small blind $0.02
837ac8c6: posts big blind $0.05
*** HOLE CARDS ***
Dealt to Hero [2s Ac]
Dealt to 30f25260 
Dealt to 5eee53b7 
Dealt to adb7f716 
Dealt to 3e29da52 
Dealt to 837ac8c6 
Hero: folds
30f25260: folds
5eee53b7: raises $0.07 to $0.12
adb7f716: folds
3e29da52: folds
837ac8c6: calls $0.07
*** FLOP *** [9c 5h 2d]
837ac8c6: checks
5eee53b7: checks
*** TURN *** [9c 5h 2d] [3c]
837ac8c6: bets $0.13
5eee53b7: folds
Uncalled bet ($0.13) returned to 837ac8c6
837ac8c6: shows [3d 4c] (Pair of Treys)
*** SHOWDOWN ***
837ac8c6 collected $0.25 from pot
*** SUMMARY ***
Total pot $0.26 | Rake $0.01 | Jackpot $0 | Bingo $0 | Fortune $0 | Tax $0
Board [9c 5h 2d 3c]
Seat 1: Hero folded before Flop (didn't bet)
Seat 2: 30f25260 folded before Flop (didn't bet)
Seat 3: 5eee53b7 folded on the Turn
Seat 4: adb7f716 (button) folded before Flop (didn't bet)
Seat 5: 3e29da52 (small blind) folded before Flop
Seat 6: 837ac8c6 (big blind) showed [3d 4c] and won ($0.25)


Poker Hand #HD1724720161: Hold'em No Limit ($0.02/$0.05) - 2024/04/10 21:36:43
Table 'NLHBlue24' 6-max Seat #3 is the button
Seat 1: Hero ($5 in chips)
Seat 2: 30f25260 ($5.77 in chips)
Seat 3: 5eee53b7 ($5.09 in chips)
Seat 4: adb7f716 ($4.52 in chips)
Seat 5: 3e29da52 ($5 in chips)
Seat 6: 837ac8c6 ($2.11 in chips)
adb7f716: posts small blind $0.02
3e29da52: posts big blind $0.05
*** HOLE CARDS ***
Dealt to Hero [8s 4d]
Dealt to 30f25260 
Dealt to 5eee53b7 
Dealt to adb7f716 
Dealt to 3e29da52 
Dealt to 837ac8c6 
837ac8c6: calls $0.05
Hero: folds
30f25260: raises $0.13 to $0.18
5eee53b7: folds
adb7f716: folds
3e29da52: folds
837ac8c6: calls $0.13
*** FLOP *** [Jc 6d Kd]
837ac8c6: checks
30f25260: bets $0.15
837ac8c6: calls $0.15
*** TURN *** [Jc 6d Kd] [5s]
837ac8c6: checks
30f25260: checks
*** RIVER *** [Jc 6d Kd 5s] [8c]
837ac8c6: checks
30f25260: checks
837ac8c6: shows [Kc 3d] (Pair of Kings)
30f25260: shows [3c 3h] (Pair of Treys)
*** SHOWDOWN ***
837ac8c6 collected $0.7 from pot
*** SUMMARY ***
Total pot $0.73 | Rake $0.03 | Jackpot $0 | Bingo $0 | Fortune $0 | Tax $0
Board [Jc 6d Kd 5s 8c]
Seat 1: Hero folded before Flop (didn't bet)
Seat 2: 30f25260 showed [3c 3h] and lost with Pair of Treys
Seat 3: 5eee53b7 (button) folded before Flop (didn't bet)
Seat 4: adb7f716 (small blind) folded before Flop
Seat 5: 3e29da52 (big blind) folded before Flop
Seat 6: 837ac8c6 showed [Kc 3d] and won ($0.7) with Pair of Kings


Poker Hand #HD1724720064: Hold'em No Limit ($0.02/$0.05) - 2024/04/10 21:35:47
Table 'NLHBlue24' 6-max Seat #2 is the button
Seat 1: Hero ($5 in chips)
Seat 2: 30f25260 ($5.77 in chips)
Seat 3: 5eee53b7 ($5.11 in chips)
Seat 4: adb7f716 ($4.19 in chips)
Seat 5: 3e29da52 ($5 in chips)
Seat 6: 837ac8c6 ($2.11 in chips)
5eee53b7: posts small blind $0.02
adb7f716: posts big blind $0.05
*** HOLE CARDS ***
Dealt to Hero [5c 6d]
Dealt to 30f25260 
Dealt to 5eee53b7 
Dealt to adb7f716 
Dealt to 3e29da52 
Dealt to 837ac8c6 
3e29da52: raises $0.08 to $0.13
837ac8c6: folds
Hero: folds
30f25260: folds
5eee53b7: folds
adb7f716: raises $0.21 to $0.34
3e29da52: calls $0.21
*** FLOP *** [Ad 4c 8s]
adb7f716: bets $0.35
3e29da52: folds
Uncalled bet ($0.35) returned to adb7f716
*** SHOWDOWN ***
adb7f716 collected $0.67 from pot
*** SUMMARY ***
Total pot $0.7 | Rake $0.03 | Jackpot $0 | Bingo $0 | Fortune $0 | Tax $0
Board [Ad 4c 8s]
Seat 1: Hero folded before Flop (didn't bet)
Seat 2: 30f25260 (button) folded before Flop (didn't bet)
Seat 3: 5eee53b7 (small blind) folded before Flop
Seat 4: adb7f716 (big blind) won ($0.67)
Seat 5: 3e29da52 folded on the Flop
Seat 6: 837ac8c6 folded before Flop (didn't bet)


Poker Hand #HD1724719974: Hold'em No Limit ($0.02/$0.05) - 2024/04/10 21:35:02
Table 'NLHBlue24' 6-max Seat #1 is the button
Seat 1: Hero ($5 in chips)
Seat 2: 30f25260 ($5 in chips)
Seat 3: 5eee53b7 ($5.16 in chips)
Seat 4: adb7f716 ($5.04 in chips)
Seat 5: 3e29da52 ($5 in chips)
Seat 6: 837ac8c6 ($2.11 in chips)
30f25260: posts small blind $0.02
5eee53b7: posts big blind $0.05
*** HOLE CARDS ***
Dealt to Hero [Js Qc]
Dealt to 30f25260 
Dealt to 5eee53b7 
Dealt to adb7f716 
Dealt to 3e29da52 
Dealt to 837ac8c6 
adb7f716: raises $0.07 to $0.12
3e29da52: folds
837ac8c6: folds
Hero: folds
30f25260: raises $0.38 to $0.5
5eee53b7: folds
adb7f716: calls $0.38
*** FLOP *** [5h 3c 9d]
30f25260: bets $0.35
adb7f716: calls $0.35
*** TURN *** [5h 3c 9d] [8c]
30f25260: bets $0.58
adb7f716: folds
Uncalled bet ($0.58) returned to 30f25260
*** SHOWDOWN ***
30f25260 collected $1.62 from pot
*** SUMMARY ***
Total pot $1.75 | Rake $0.08 | Jackpot $0.05 | Bingo $0 | Fortune $0 | Tax $0
Board [5h 3c 9d 8c]
Seat 1: Hero (button) folded before Flop (didn't bet)
Seat 2: 30f25260 (small blind) won ($1.62)
Seat 3: 5eee53b7 (big blind) folded before Flop
Seat 4: adb7f716 folded on the Turn
Seat 5: 3e29da52 folded before Flop (didn't bet)
Seat 6: 837ac8c6 folded before Flop (didn't bet)


Poker Hand #HD1724719940: Hold'em No Limit ($0.02/$0.05) - 2024/04/10 21:34:41
Table 'NLHBlue24' 6-max Seat #6 is the button
Seat 1: Hero ($5 in chips)
Seat 2: 30f25260 ($5 in chips)
Seat 3: 5eee53b7 ($5.16 in chips)
Seat 4: adb7f716 ($4.97 in chips)
Seat 5: 3e29da52 ($5 in chips)
Seat 6: 837ac8c6 ($2.11 in chips)
Hero: posts small blind $0.02
30f25260: posts big blind $0.05
*** HOLE CARDS ***
Dealt to Hero [2s 5c]
Dealt to 30f25260 
Dealt to 5eee53b7 
Dealt to adb7f716 
Dealt to 3e29da52 
Dealt to 837ac8c6 
5eee53b7: folds
adb7f716: raises $0.07 to $0.12
3e29da52: folds
837ac8c6: folds
Hero: folds
30f25260: folds
Uncalled bet ($0.07) returned to adb7f716
*** SHOWDOWN ***
adb7f716 collected $0.12 from pot
*** SUMMARY ***
Total pot $0.12 | Rake $0 | Jackpot $0 | Bingo $0 | Fortune $0 | Tax $0
Seat 1: Hero (small blind) folded before Flop
Seat 2: 30f25260 (big blind) folded before Flop
Seat 3: 5eee53b7 folded before Flop (didn't bet)
Seat 4: adb7f716 collected ($0.12)
Seat 5: 3e29da52 folded before Flop (didn't bet)
Seat 6: 837ac8c6 (button) folded before Flop (didn't bet)


Poker Hand #HD1724719879: Hold'em No Limit ($0.02/$0.05) - 2024/04/10 21:34:10
Table 'NLHBlue24' 6-max Seat #5 is the button
Seat 1: Hero ($5 in chips)
Seat 2: 30f25260 ($5 in chips)
Seat 3: 5eee53b7 ($5 in chips)
Seat 4: adb7f716 ($4.69 in chips)
Seat 5: 3e29da52 ($5 in chips)
Seat 6: 837ac8c6 ($2.23 in chips)
837ac8c6: posts small blind $0.02
Hero: posts big blind $0.05
*** HOLE CARDS ***
Dealt to Hero [3s 7c]
Dealt to 30f25260 
Dealt to 5eee53b7 
Dealt to adb7f716 
Dealt to 3e29da52 
Dealt to 837ac8c6 
30f25260: folds
5eee53b7: raises $0.07 to $0.12
adb7f716: folds
3e29da52: folds
837ac8c6: calls $0.1
Hero: folds
*** FLOP *** [Ts 4c Kh]
837ac8c6: checks
5eee53b7: bets $0.22
837ac8c6: folds
Uncalled bet ($0.22) returned to 5eee53b7
*** SHOWDOWN ***
5eee53b7 collected $0.28 from pot
*** SUMMARY ***
Total pot $0.29 | Rake $0.01 | Jackpot $0 | Bingo $0 | Fortune $0 | Tax $0
Board [Ts 4c Kh]
Seat 1: Hero (big blind) folded before Flop
Seat 2: 30f25260 folded before Flop (didn't bet)
Seat 3: 5eee53b7 won ($0.28)
Seat 4: adb7f716 folded before Flop (didn't bet)
Seat 5: 3e29da52 (button) folded before Flop (didn't bet)
Seat 6: 837ac8c6 (small blind) folded on the Flop


Poker Hand #HD1724719834: Hold'em No Limit ($0.02/$0.05) - 2024/04/10 21:33:40
Table 'NLHBlue24' 6-max Seat #4 is the button
Seat 1: Hero ($5.52 in chips)
Seat 2: 30f25260 ($5.07 in chips)
Seat 3: 5eee53b7 ($5 in chips)
Seat 4: adb7f716 ($4.69 in chips)
Seat 5: 3e29da52 ($5 in chips)
Seat 6: 837ac8c6 ($1.62 in chips)
3e29da52: posts small blind $0.02
837ac8c6: posts big blind $0.05
*** HOLE CARDS ***
Dealt to Hero [Ah Js]
Dealt to 30f25260 
Dealt to 5eee53b7 
Dealt to adb7f716 
Dealt to 3e29da52 
Dealt to 837ac8c6 
Hero: raises $0.05 to $0.1
30f25260: calls $0.1
5eee53b7: folds
adb7f716: folds
3e29da52: folds
837ac8c6: raises $0.05 to $0.15
Hero: raises $0.4 to $0.55
30f25260: folds
837ac8c6: raises $0.4 to $0.95
Hero: folds
Uncalled bet ($0.4) returned to 837ac8c6
*** SHOWDOWN ***
837ac8c6 collected $1.16 from pot
*** SUMMARY ***
Total pot $1.22 | Rake $0.06 | Jackpot $0 | Bingo $0 | Fortune $0 | Tax $0
Seat 1: Hero folded before Flop
Seat 2: 30f25260 folded before Flop
Seat 3: 5eee53b7 folded before Flop (didn't bet)
Seat 4: adb7f716 (button) folded before Flop (didn't bet)
Seat 5: 3e29da52 (small blind) folded before Flop
Seat 6: 837ac8c6 (big blind) collected ($1.16)


Poker Hand #HD1724719788: Hold'em No Limit ($0.02/$0.05) - 2024/04/10 21:33:15
Table 'NLHBlue24' 6-max Seat #3 is the button
Seat 1: Hero ($5.52 in chips)
Seat 2: 30f25260 ($5 in chips)
Seat 3: 5eee53b7 ($5 in chips)
Seat 4: adb7f716 ($4.71 in chips)
Seat 5: 3e29da52 ($5 in chips)
Seat 6: 837ac8c6 ($1.62 in chips)
adb7f716: posts small blind $0.02
3e29da52: posts big blind $0.05
*** HOLE CARDS ***
Dealt to Hero [8s 2s]
Dealt to 30f25260 
Dealt to 5eee53b7 
Dealt to adb7f716 
Dealt to 3e29da52 
Dealt to 837ac8c6 
837ac8c6: folds
Hero: folds
30f25260: raises $0.08 to $0.13
5eee53b7: folds
adb7f716: folds
3e29da52: folds
Uncalled bet ($0.08) returned to 30f25260
*** SHOWDOWN ***
30f25260 collected $0.12 from pot
*** SUMMARY ***
Total pot $0.12 | Rake $0 | Jackpot $0 | Bingo $0 | Fortune $0 | Tax $0
Seat 1: Hero folded before Flop (didn't bet)
Seat 2: 30f25260 collected ($0.12)
Seat 3: 5eee53b7 (button) folded before Flop (didn't bet)
Seat 4: adb7f716 (small blind) folded before Flop
Seat 5: 3e29da52 (big blind) folded before Flop
Seat 6: 837ac8c6 folded before Flop (didn't bet)


Poker Hand #HD1724719724: Hold'em No Limit ($0.02/$0.05) - 2024/04/10 21:32:36
Table 'NLHBlue24' 6-max Seat #2 is the button
Seat 1: Hero ($5.52 in chips)
Seat 2: 30f25260 ($5 in chips)
Seat 3: 5eee53b7 ($5 in chips)
Seat 4: adb7f716 ($5 in chips)
Seat 6: 837ac8c6 ($1.34 in chips)
5eee53b7: posts small blind $0.02
adb7f716: posts big blind $0.05
*** HOLE CARDS ***
Dealt to Hero [Qc 8h]
Dealt to 30f25260 
Dealt to 5eee53b7 
Dealt to adb7f716 
Dealt to 837ac8c6 
837ac8c6: calls $0.05
Hero: folds
30f25260: folds
5eee53b7: folds
adb7f716: checks
*** FLOP *** [Ad 3d Ks]
adb7f716: checks
837ac8c6: checks
*** TURN *** [Ad 3d Ks] [Kc]
adb7f716: bets $0.09
837ac8c6: calls $0.09
*** RIVER *** [Ad 3d Ks Kc] [2c]
adb7f716: bets $0.15
837ac8c6: calls $0.15
adb7f716: shows [Ac 2d] (Pair of Aces and Pair of Kings)
837ac8c6: shows [Qs As] (Pair of Aces and Pair of Kings)
*** SHOWDOWN ***
837ac8c6 collected $0.57 from pot
*** SUMMARY ***
Total pot $0.6 | Rake $0.03 | Jackpot $0 | Bingo $0 | Fortune $0 | Tax $0
Board [Ad 3d Ks Kc 2c]
Seat 1: Hero folded before Flop (didn't bet)
Seat 2: 30f25260 (button) folded before Flop (didn't bet)
Seat 3: 5eee53b7 (small blind) folded before Flop
Seat 4: adb7f716 (big blind) showed [Ac 2d] and lost with Pair of Aces and Pair of Kings
Seat 6: 837ac8c6 showed [Qs As] and won ($0.57) with Pair of Aces and Pair of Kings


Poker Hand #HD1724719669: Hold'em No Limit ($0.02/$0.05) - 2024/04/10 21:32:05
Table 'NLHBlue24' 6-max Seat #1 is the button
Seat 1: Hero ($5.52 in chips)
Seat 2: 30f25260 ($5 in chips)
Seat 3: 5eee53b7 ($5 in chips)
Seat 6: 837ac8c6 ($1.27 in chips)
30f25260: posts small blind $0.02
5eee53b7: posts big blind $0.05
*** HOLE CARDS ***
Dealt to Hero [Tc 8c]
Dealt to 30f25260 
Dealt to 5eee53b7 
Dealt to 837ac8c6 
837ac8c6: calls $0.05
Hero: folds
30f25260: folds
5eee53b7: checks
*** FLOP *** [Th 5s 3d]
5eee53b7: checks
837ac8c6: checks
*** TURN *** [Th 5s 3d] [8d]
5eee53b7: checks
837ac8c6: bets $0.06
5eee53b7: folds
Uncalled bet ($0.06) returned to 837ac8c6
*** SHOWDOWN ***
837ac8c6 collected $0.12 from pot
*** SUMMARY ***
Total pot $0.12 | Rake $0 | Jackpot $0 | Bingo $0 | Fortune $0 | Tax $0
Board [Th 5s 3d 8d]
Seat 1: Hero (button) folded before Flop (didn't bet)
Seat 2: 30f25260 (small blind) folded before Flop
Seat 3: 5eee53b7 (big blind) folded on the Turn
Seat 6: 837ac8c6 won ($0.12)


Poker Hand #HD1724719618: Hold'em No Limit ($0.02/$0.05) - 2024/04/10 21:31:37
Table 'NLHBlue24' 6-max Seat #6 is the button
Seat 1: Hero ($5.38 in chips)
Seat 2: 30f25260 ($5 in chips)
Seat 6: 837ac8c6 ($1.27 in chips)
Hero: posts small blind $0.02
30f25260: posts big blind $0.05
*** HOLE CARDS ***
Dealt to Hero [2s Qs]
Dealt to 30f25260 
Dealt to 837ac8c6 
837ac8c6: folds
Hero: raises $0.1 to $0.15
30f25260: calls $0.1
*** FLOP *** [3c Js 9c]
Hero: bets $0.15
30f25260: folds
Uncalled bet ($0.15) returned to Hero
*** SHOWDOWN ***
Hero collected $0.29 from pot
*** SUMMARY ***
Total pot $0.3 | Rake $0.01 | Jackpot $0 | Bingo $0 | Fortune $0 | Tax $0
Board [3c Js 9c]
Seat 1: Hero (small blind) won ($0.29)
Seat 2: 30f25260 (big blind) folded on the Flop
Seat 6: 837ac8c6 (button) folded before Flop (didn't bet)


Poker Hand #HD1724719489: Hold'em No Limit ($0.02/$0.05) - 2024/04/10 21:30:28
Table 'NLHBlue24' 6-max Seat #4 is the button
Seat 1: Hero ($5.48 in chips)
Seat 2: 30f25260 ($5 in chips)
Seat 4: 41cfc3f2 ($7.38 in chips)
Seat 6: 837ac8c6 ($0.99 in chips)
837ac8c6: posts small blind $0.02
Hero: posts big blind $0.05
30f25260: posts big blind $0.05
*** HOLE CARDS ***
Dealt to Hero [7h 5s]
Dealt to 30f25260 
Dealt to 41cfc3f2 
Dealt to 837ac8c6 
30f25260: checks
41cfc3f2: calls $0.05
837ac8c6: calls $0.03
Hero: checks
*** FLOP *** [5d 9s 2c]
837ac8c6: checks
Hero: checks
30f25260: bets $0.05
41cfc3f2: calls $0.05
837ac8c6: calls $0.05
Hero: calls $0.05
*** TURN *** [5d 9s 2c] [Qd]
837ac8c6: checks
Hero: checks
30f25260: checks
41cfc3f2: checks
*** RIVER *** [5d 9s 2c Qd] [Jh]
837ac8c6: bets $0.2
Hero: folds
30f25260: folds
41cfc3f2: folds
Uncalled bet ($0.2) returned to 837ac8c6
*** SHOWDOWN ***
837ac8c6 collected $0.38 from pot
*** SUMMARY ***
Total pot $0.4 | Rake $0.02 | Jackpot $0 | Bingo $0 | Fortune $0 | Tax $0
Board [5d 9s 2c Qd Jh]
Seat 1: Hero (big blind) folded on the River
Seat 2: 30f25260 folded on the River
Seat 4: 41cfc3f2 (button) folded on the River
Seat 6: 837ac8c6 (small blind) won ($0.38)


Poker Hand #HD1724719391: Hold'em No Limit ($0.02/$0.05) - 2024/04/10 21:29:32
Table 'NLHBlue24' 6-max Seat #1 is the button
Seat 1: Hero ($5.48 in chips)
Seat 2: 3f098f87 ($6.83 in chips)
Seat 4: 41cfc3f2 ($7.61 in chips)
Seat 5: 461deea9 ($5.11 in chips)
Seat 6: 837ac8c6 ($0.76 in chips)
3f098f87: posts small blind $0.02
41cfc3f2: posts big blind $0.05
*** HOLE CARDS ***
Dealt to Hero [5c As]
Dealt to 3f098f87 
Dealt to 41cfc3f2 
Dealt to 461deea9 
Dealt to 837ac8c6 
461deea9: folds
837ac8c6: calls $0.05
Hero: folds
3f098f87: folds
41cfc3f2: checks
*** FLOP *** [6d 9c Kc]
41cfc3f2: checks
837ac8c6: bets $0.06
41cfc3f2: calls $0.06
*** TURN *** [6d 9c Kc] [8s]
41cfc3f2: checks
837ac8c6: bets $0.12
41cfc3f2: calls $0.12
*** RIVER *** [6d 9c Kc 8s] [2s]
41cfc3f2: checks
837ac8c6: checks
41cfc3f2: shows [Js Ts] (King-High)
837ac8c6: shows [Qc 9d] (Pair of Nines)
*** SHOWDOWN ***
837ac8c6 collected $0.46 from pot
*** SUMMARY ***
Total pot $0.48 | Rake $0.02 | Jackpot $0 | Bingo $0 | Fortune $0 | Tax $0
Board [6d 9c Kc 8s 2s]
Seat 1: Hero (button) folded before Flop (didn't bet)
Seat 2: 3f098f87 (small blind) folded before Flop
Seat 4: 41cfc3f2 (big blind) showed [Js Ts] and lost with King-High
Seat 5: 461deea9 folded before Flop (didn't bet)
Seat 6: 837ac8c6 showed [Qc 9d] and won ($0.46) with Pair of Nines


Poker Hand #HD1724719245: Hold'em No Limit ($0.02/$0.05) - 2024/04/10 21:28:10
Table 'NLHBlue24' 6-max Seat #6 is the button
Seat 1: Hero ($5.5 in chips)
Seat 2: 3f098f87 ($6.93 in chips)
Seat 3: dd54495c ($9.48 in chips)
Seat 4: 41cfc3f2 ($7.61 in chips)
Seat 5: 461deea9 ($5 in chips)
Seat 6: 837ac8c6 ($0.76 in chips)
Hero: posts small blind $0.02
3f098f87: posts big blind $0.05
*** HOLE CARDS ***
Dealt to Hero [Ks 5h]
Dealt to 3f098f87 
Dealt to dd54495c 
Dealt to 41cfc3f2 
Dealt to 461deea9 
Dealt to 837ac8c6 
dd54495c: folds
41cfc3f2: folds
461deea9: raises $0.05 to $0.1
837ac8c6: folds
Hero: folds
3f098f87: calls $0.05
*** FLOP *** [Ac 4h As]
3f098f87: checks
461deea9: bets $0.17
3f098f87: folds
Uncalled bet ($0.17) returned to 461deea9
*** SHOWDOWN ***
461deea9 collected $0.21 from pot
*** SUMMARY ***
Total pot $0.22 | Rake $0.01 | Jackpot $0 | Bingo $0 | Fortune $0 | Tax $0
Board [Ac 4h As]
Seat 1: Hero (small blind) folded before Flop
Seat 2: 3f098f87 (big blind) folded on the Flop
Seat 3: dd54495c folded before Flop (didn't bet)
Seat 4: 41cfc3f2 folded before Flop (didn't bet)
Seat 5: 461deea9 won ($0.21)
Seat 6: 837ac8c6 (button) folded before Flop (didn't bet)


Poker Hand #HD1724719146: Hold'em No Limit ($0.02/$0.05) - 2024/04/10 21:27:17
Table 'NLHBlue24' 6-max Seat #5 is the button
Seat 1: Hero ($5.55 in chips)
Seat 2: 3f098f87 ($6.52 in chips)
Seat 3: dd54495c ($9.48 in chips)
Seat 4: 41cfc3f2 ($7.61 in chips)
Seat 5: 461deea9 ($5 in chips)
Seat 6: 837ac8c6 ($1.16 in chips)
837ac8c6: posts small blind $0.02
Hero: posts big blind $0.05
*** HOLE CARDS ***
Dealt to Hero [4s Ac]
Dealt to 3f098f87 
Dealt to dd54495c 
Dealt to 41cfc3f2 
Dealt to 461deea9 
Dealt to 837ac8c6 
3f098f87: raises $0.05 to $0.1
dd54495c: folds
41cfc3f2: folds
461deea9: folds
837ac8c6: calls $0.08
Hero: folds
*** FLOP *** [8d Ah Kc]
837ac8c6: checks
3f098f87: checks
*** TURN *** [8d Ah Kc] [7s]
837ac8c6: bets $0.13
3f098f87: calls $0.13
*** RIVER *** [8d Ah Kc 7s] [4h]
837ac8c6: bets $0.17
3f098f87: calls $0.17
837ac8c6: shows [3c Kh] (Pair of Kings)
3f098f87: shows [6d Ad] (Pair of Aces)
*** SHOWDOWN ***
3f098f87 collected $0.81 from pot
*** SUMMARY ***
Total pot $0.85 | Rake $0.04 | Jackpot $0 | Bingo $0 | Fortune $0 | Tax $0
Board [8d Ah Kc 7s 4h]
Seat 1: Hero (big blind) folded before Flop
Seat 2: 3f098f87 showed [6d Ad] and won ($0.81) with Pair of Aces
Seat 3: dd54495c folded before Flop (didn't bet)
Seat 4: 41cfc3f2 folded before Flop (didn't bet)
Seat 5: 461deea9 (button) folded before Flop (didn't bet)
Seat 6: 837ac8c6 (small blind) showed [3c Kh] and lost with Pair of Kings


Poker Hand #HD1724719046: Hold'em No Limit ($0.02/$0.05) - 2024/04/10 21:26:21
Table 'NLHBlue24' 6-max Seat #4 is the button
Seat 1: Hero ($5.55 in chips)
Seat 2: 3f098f87 ($6.2 in chips)
Seat 3: dd54495c ($9.48 in chips)
Seat 4: 41cfc3f2 ($7.61 in chips)
Seat 5: 461deea9 ($5.02 in chips)
Seat 6: 837ac8c6 ($1.49 in chips)
461deea9: posts small blind $0.02
837ac8c6: posts big blind $0.05
*** HOLE CARDS ***
Dealt to Hero [Ks 4s]
Dealt to 3f098f87 
Dealt to dd54495c 
Dealt to 41cfc3f2 
Dealt to 461deea9 
Dealt to 837ac8c6 
Hero: folds
3f098f87: raises $0.05 to $0.1
dd54495c: folds
41cfc3f2: folds
461deea9: folds
837ac8c6: calls $0.05
*** FLOP *** [Ad Td 2d]
837ac8c6: checks
3f098f87: checks
*** TURN *** [Ad Td 2d] [7s]
837ac8c6: checks
3f098f87: bets $0.06
837ac8c6: calls $0.06
*** RIVER *** [Ad Td 2d 7s] [Qh]
837ac8c6: bets $0.17
3f098f87: calls $0.17
837ac8c6: shows [3c 8c] (Ace-High)
3f098f87: shows [Ts Ac] (Pair of Aces and Pair of Tens)
*** SHOWDOWN ***
3f098f87 collected $0.65 from pot
*** SUMMARY ***
Total pot $0.68 | Rake $0.03 | Jackpot $0 | Bingo $0 | Fortune $0 | Tax $0
Board [Ad Td 2d 7s Qh]
Seat 1: Hero folded before Flop (didn't bet)
Seat 2: 3f098f87 showed [Ts Ac] and won ($0.65) with Pair of Aces and Pair of Tens
Seat 3: dd54495c folded before Flop (didn't bet)
Seat 4: 41cfc3f2 (button) folded before Flop (didn't bet)
Seat 5: 461deea9 (small blind) folded before Flop
Seat 6: 837ac8c6 (big blind) showed [3c 8c] and lost with Ace-High


Poker Hand #HD1724718975: Hold'em No Limit ($0.02/$0.05) - 2024/04/10 21:25:42
Table 'NLHBlue24' 6-max Seat #3 is the button
Seat 1: Hero ($5.55 in chips)
Seat 2: 3f098f87 ($6.2 in chips)
Seat 3: dd54495c ($9.24 in chips)
Seat 4: 41cfc3f2 ($7.71 in chips)
Seat 5: 461deea9 ($5.07 in chips)
Seat 6: 837ac8c6 ($1.59 in chips)
41cfc3f2: posts small blind $0.02
461deea9: posts big blind $0.05
*** HOLE CARDS ***
Dealt to Hero [Qd 3d]
Dealt to 3f098f87 
Dealt to dd54495c 
Dealt to 41cfc3f2 
Dealt to 461deea9 
Dealt to 837ac8c6 
837ac8c6: raises $0.05 to $0.1
Hero: folds
3f098f87: folds
dd54495c: calls $0.1
41cfc3f2: calls $0.08
461deea9: folds
*** FLOP *** [4s 9d 5c]
41cfc3f2: checks
837ac8c6: checks
dd54495c: bets $0.18
41cfc3f2: folds
837ac8c6: folds
Uncalled bet ($0.18) returned to dd54495c
*** SHOWDOWN ***
dd54495c collected $0.34 from pot
*** SUMMARY ***
Total pot $0.35 | Rake $0.01 | Jackpot $0 | Bingo $0 | Fortune $0 | Tax $0
Board [4s 9d 5c]
Seat 1: Hero folded before Flop (didn't bet)
Seat 2: 3f098f87 folded before Flop (didn't bet)
Seat 3: dd54495c (button) won ($0.34)
Seat 4: 41cfc3f2 (small blind) folded on the Flop
Seat 5: 461deea9 (big blind) folded before Flop
Seat 6: 837ac8c6 folded on the Flop


Poker Hand #HD1724718871: Hold'em No Limit ($0.02/$0.05) - 2024/04/10 21:24:53
Table 'NLHBlue24' 6-max Seat #2 is the button
Seat 1: Hero ($5.55 in chips)
Seat 2: 3f098f87 ($6.2 in chips)
Seat 3: dd54495c ($9.26 in chips)
Seat 4: 41cfc3f2 ($7.81 in chips)
Seat 5: 461deea9 ($5.07 in chips)
Seat 6: 837ac8c6 ($1.48 in chips)
dd54495c: posts small blind $0.02
41cfc3f2: posts big blind $0.05
*** HOLE CARDS ***
Dealt to Hero [4h 5d]
Dealt to 3f098f87 
Dealt to dd54495c 
Dealt to 41cfc3f2 
Dealt to 461deea9 
Dealt to 837ac8c6 
461deea9: folds
837ac8c6: raises $0.05 to $0.1
Hero: folds
3f098f87: folds
dd54495c: folds
41cfc3f2: calls $0.05
*** FLOP *** [4s 7h 9s]
41cfc3f2: checks
837ac8c6: bets $0.11
41cfc3f2: folds
Uncalled bet ($0.11) returned to 837ac8c6
*** SHOWDOWN ***
837ac8c6 collected $0.21 from pot
*** SUMMARY ***
Total pot $0.22 | Rake $0.01 | Jackpot $0 | Bingo $0 | Fortune $0 | Tax $0
Board [4s 7h 9s]
Seat 1: Hero folded before Flop (didn't bet)
Seat 2: 3f098f87 (button) folded before Flop (didn't bet)
Seat 3: dd54495c (small blind) folded before Flop
Seat 4: 41cfc3f2 (big blind) folded on the Flop
Seat 5: 461deea9 folded before Flop (didn't bet)
Seat 6: 837ac8c6 won ($0.21)


Poker Hand #HD1724718835: Hold'em No Limit ($0.02/$0.05) - 2024/04/10 21:24:33
Table 'NLHBlue24' 6-max Seat #1 is the button
Seat 1: Hero ($5.55 in chips)
Seat 2: 3f098f87 ($6.22 in chips)
Seat 3: dd54495c ($9.31 in chips)
Seat 5: 461deea9 ($5 in chips)
Seat 6: 837ac8c6 ($1.48 in chips)
3f098f87: posts small blind $0.02
dd54495c: posts big blind $0.05
*** HOLE CARDS ***
Dealt to Hero [Ac 5h]
Dealt to 3f098f87 
Dealt to dd54495c 
Dealt to 461deea9 
Dealt to 837ac8c6 
461deea9: raises $0.05 to $0.1
837ac8c6: folds
Hero: folds
3f098f87: folds
dd54495c: folds
Uncalled bet ($0.05) returned to 461deea9
*** SHOWDOWN ***
461deea9 collected $0.12 from pot
*** SUMMARY ***
Total pot $0.12 | Rake $0 | Jackpot $0 | Bingo $0 | Fortune $0 | Tax $0
Seat 1: Hero (button) folded before Flop (didn't bet)
Seat 2: 3f098f87 (small blind) folded before Flop
Seat 3: dd54495c (big blind) folded before Flop
Seat 5: 461deea9 collected ($0.12)
Seat 6: 837ac8c6 folded before Flop (didn't bet)


Poker Hand #HD1724718750: Hold'em No Limit ($0.02/$0.05) - 2024/04/10 21:23:54
Table 'NLHBlue24' 6-max Seat #6 is the button
Seat 1: Hero ($5.57 in chips)
Seat 2: 3f098f87 ($6.27 in chips)
Seat 3: dd54495c ($9.13 in chips)
Seat 5: 461deea9 ($5 in chips)
Seat 6: 837ac8c6 ($1.6 in chips)
Hero: posts small blind $0.02
3f098f87: posts big blind $0.05
*** HOLE CARDS ***
Dealt to Hero [4s 8s]
Dealt to 3f098f87 
Dealt to dd54495c 
Dealt to 461deea9 
Dealt to 837ac8c6 
dd54495c: raises $0.07 to $0.12
461deea9: folds
837ac8c6: calls $0.12
Hero: folds
3f098f87: folds
*** FLOP *** [6h 6s Kh]
dd54495c: bets $0.16
837ac8c6: folds
Uncalled bet ($0.16) returned to dd54495c
*** SHOWDOWN ***
dd54495c collected $0.3 from pot
*** SUMMARY ***
Total pot $0.31 | Rake $0.01 | Jackpot $0 | Bingo $0 | Fortune $0 | Tax $0
Board [6h 6s Kh]
Seat 1: Hero (small blind) folded before Flop
Seat 2: 3f098f87 (big blind) folded before Flop
Seat 3: dd54495c won ($0.3)
Seat 5: 461deea9 folded before Flop (didn't bet)
Seat 6: 837ac8c6 (button) folded on the Flop


Poker Hand #HD1724718670: Hold'em No Limit ($0.02/$0.05) - 2024/04/10 21:23:15
Table 'NLHBlue24' 6-max Seat #5 is the button
Seat 1: Hero ($5.62 in chips)
Seat 2: 3f098f87 ($6.27 in chips)
Seat 3: dd54495c ($8.84 in chips)
Seat 5: 461deea9 ($5 in chips)
Seat 6: 837ac8c6 ($1.87 in chips)
837ac8c6: posts small blind $0.02
Hero: posts big blind $0.05
*** HOLE CARDS ***
Dealt to Hero [6c 5d]
Dealt to 3f098f87 
Dealt to dd54495c 
Dealt to 461deea9 
Dealt to 837ac8c6 
3f098f87: folds
dd54495c: raises $0.07 to $0.12
461deea9: folds
837ac8c6: calls $0.1
Hero: folds
*** FLOP *** [Qh 7h 2c]
837ac8c6: checks
dd54495c: checks
*** TURN *** [Qh 7h 2c] [9h]
837ac8c6: checks
dd54495c: checks
*** RIVER *** [Qh 7h 2c 9h] [Th]
837ac8c6: bets $0.15
dd54495c: calls $0.15
837ac8c6: shows [Qc 7d] (Pair of Queens and Pair of Sevens)
dd54495c: shows [4h 4c] (Queen High Flush)
*** SHOWDOWN ***
dd54495c collected $0.56 from pot
*** SUMMARY ***
Total pot $0.59 | Rake $0.03 | Jackpot $0 | Bingo $0 | Fortune $0 | Tax $0
Board [Qh 7h 2c 9h Th]
Seat 1: Hero (big blind) folded before Flop
Seat 2: 3f098f87 folded before Flop (didn't bet)
Seat 3: dd54495c showed [4h 4c] and won ($0.56) with Queen High Flush
Seat 5: 461deea9 (button) folded before Flop (didn't bet)
Seat 6: 837ac8c6 (small blind) showed [Qc 7d] and lost with Pair of Queens and Pair of Sevens


Poker Hand #HD1724718577: Hold'em No Limit ($0.02/$0.05) - 2024/04/10 21:22:30
Table 'NLHBlue24' 6-max Seat #3 is the button
Seat 1: Hero ($5.62 in chips)
Seat 2: 3f098f87 ($6.1 in chips)
Seat 3: dd54495c ($8.84 in chips)
Seat 5: 461deea9 ($5 in chips)
Seat 6: 837ac8c6 ($2.03 in chips)
461deea9: posts small blind $0.02
837ac8c6: posts big blind $0.05
*** HOLE CARDS ***
Dealt to Hero [2h 4s]
Dealt to 3f098f87 
Dealt to dd54495c 
Dealt to 461deea9 
Dealt to 837ac8c6 
Hero: folds
3f098f87: raises $0.05 to $0.1
dd54495c: folds
461deea9: folds
837ac8c6: calls $0.05
*** FLOP *** [2c 5s Kc]
837ac8c6: checks
3f098f87: bets $0.06
837ac8c6: calls $0.06
*** TURN *** [2c 5s Kc] [7d]
837ac8c6: checks
3f098f87: checks
*** RIVER *** [2c 5s Kc 7d] [Qc]
837ac8c6: checks
3f098f87: checks
837ac8c6: shows [Tc 3h] (King-High)
3f098f87: shows [Jd Ah] (Ace-High)
*** SHOWDOWN ***
3f098f87 collected $0.33 from pot
*** SUMMARY ***
Total pot $0.34 | Rake $0.01 | Jackpot $0 | Bingo $0 | Fortune $0 | Tax $0
Board [2c 5s Kc 7d Qc]
Seat 1: Hero folded before Flop (didn't bet)
Seat 2: 3f098f87 showed [Jd Ah] and won ($0.33) with Ace-High
Seat 3: dd54495c (button) folded before Flop (didn't bet)
Seat 5: 461deea9 (small blind) folded before Flop
Seat 6: 837ac8c6 (big blind) showed [Tc 3h] and lost with King-High


Poker Hand #HD1724718456: Hold'em No Limit ($0.02/$0.05) - 2024/04/10 21:21:26
Table 'NLHBlue24' 6-max Seat #2 is the button
Seat 1: Hero ($5.62 in chips)
Seat 2: 3f098f87 ($6.1 in chips)
Seat 3: dd54495c ($8.86 in chips)
Seat 5: 461deea9 ($5 in chips)
Seat 6: 837ac8c6 ($1.96 in chips)
dd54495c: posts small blind $0.02
461deea9: posts big blind $0.05
*** HOLE CARDS ***
Dealt to Hero [4h 3h]
Dealt to 3f098f87 
Dealt to dd54495c 
Dealt to 461deea9 
Dealt to 837ac8c6 
837ac8c6: calls $0.05
Hero: folds
3f098f87: folds
dd54495c: folds
461deea9: checks
*** FLOP *** [7c Jc Kc]
461deea9: checks
837ac8c6: checks
*** TURN *** [7c Jc Kc] [Ac]
461deea9: checks
837ac8c6: bets $0.09
461deea9: folds
Uncalled bet ($0.09) returned to 837ac8c6
*** SHOWDOWN ***
837ac8c6 collected $0.12 from pot
*** SUMMARY ***
Total pot $0.12 | Rake $0 | Jackpot $0 | Bingo $0 | Fortune $0 | Tax $0
Board [7c Jc Kc Ac]
Seat 1: Hero folded before Flop (didn't bet)
Seat 2: 3f098f87 (button) folded before Flop (didn't bet)
Seat 3: dd54495c (small blind) folded before Flop
Seat 5: 461deea9 (big blind) folded on the Turn
Seat 6: 837ac8c6 won ($0.12)


Poker Hand #HD1724718396: Hold'em No Limit ($0.02/$0.05) - 2024/04/10 21:20:56
Table 'NLHBlue24' 6-max Seat #1 is the button
Seat 1: Hero ($5.75 in chips)
Seat 2: 3f098f87 ($5.93 in chips)
Seat 3: dd54495c ($8.91 in chips)
Seat 4: 41cfc3f2 ($7.81 in chips)
Seat 6: 837ac8c6 ($1.96 in chips)
3f098f87: posts small blind $0.02
dd54495c: posts big blind $0.05
*** HOLE CARDS ***
Dealt to Hero [5d 9d]
Dealt to 3f098f87 
Dealt to dd54495c 
Dealt to 41cfc3f2 
Dealt to 837ac8c6 
41cfc3f2: folds
837ac8c6: folds
Hero: raises $0.08 to $0.13
3f098f87: raises $0.47 to $0.6
dd54495c: folds
Hero: folds
Uncalled bet ($0.47) returned to 3f098f87
*** SHOWDOWN ***
3f098f87 collected $0.3 from pot
*** SUMMARY ***
Total pot $0.31 | Rake $0.01 | Jackpot $0 | Bingo $0 | Fortune $0 | Tax $0
Seat 1: Hero (button) folded before Flop
Seat 2: 3f098f87 (small blind) collected ($0.3)
Seat 3: dd54495c (big blind) folded before Flop
Seat 4: 41cfc3f2 folded before Flop (didn't bet)
Seat 6: 837ac8c6 folded before Flop (didn't bet)


Poker Hand #HD1724718316: Hold'em No Limit ($0.02/$0.05) - 2024/04/10 21:20:14
Table 'NLHBlue24' 6-max Seat #6 is the button
Seat 1: Hero ($5.77 in chips)
Seat 2: 3f098f87 ($5.98 in chips)
Seat 3: dd54495c ($8.91 in chips)
Seat 4: 41cfc3f2 ($7.74 in chips)
Seat 6: 837ac8c6 ($1.96 in chips)
Hero: posts small blind $0.02
3f098f87: posts big blind $0.05
*** HOLE CARDS ***
Dealt to Hero [Kc 5h]
Dealt to 3f098f87 
Dealt to dd54495c 
Dealt to 41cfc3f2 
Dealt to 837ac8c6 
dd54495c: folds
41cfc3f2: raises $0.05 to $0.1
837ac8c6: folds
Hero: folds
3f098f87: folds
Uncalled bet ($0.05) returned to 41cfc3f2
*** SHOWDOWN ***
41cfc3f2 collected $0.12 from pot
*** SUMMARY ***
Total pot $0.12 | Rake $0 | Jackpot $0 | Bingo $0 | Fortune $0 | Tax $0
Seat 1: Hero (small blind) folded before Flop
Seat 2: 3f098f87 (big blind) folded before Flop
Seat 3: dd54495c folded before Flop (didn't bet)
Seat 4: 41cfc3f2 collected ($0.12)
Seat 6: 837ac8c6 (button) folded before Flop (didn't bet)


Poker Hand #HD1724718213: Hold'em No Limit ($0.02/$0.05) - 2024/04/10 21:19:18
Table 'NLHBlue24' 6-max Seat #4 is the button
Seat 1: Hero ($5.77 in chips)
Seat 2: 3f098f87 ($5.98 in chips)
Seat 3: dd54495c ($8.91 in chips)
Seat 4: 41cfc3f2 ($7.74 in chips)
Seat 5: ca94f02f ($2.23 in chips)
Seat 6: 837ac8c6 ($1.42 in chips)
ca94f02f: posts small blind $0.02
837ac8c6: posts big blind $0.05
*** HOLE CARDS ***
Dealt to Hero [6c 9s]
Dealt to 3f098f87 
Dealt to dd54495c 
Dealt to 41cfc3f2 
Dealt to ca94f02f 
Dealt to 837ac8c6 
Hero: folds
3f098f87: folds
dd54495c: folds
41cfc3f2: folds
ca94f02f: raises $0.1 to $0.15
837ac8c6: calls $0.1
*** FLOP *** [4h 9h 8d]
ca94f02f: bets $0.15
837ac8c6: calls $0.15
*** TURN *** [4h 9h 8d] [7c]
ca94f02f: checks
837ac8c6: bets $0.3
ca94f02f: calls $0.3
*** RIVER *** [4h 9h 8d 7c] [9d]
ca94f02f: checks
837ac8c6: checks
ca94f02f: shows [5s 4d] (Pair of Nines and Pair of Fours)
837ac8c6: shows [8s Tc] (Pair of Nines and Pair of Eights)
*** SHOWDOWN ***
837ac8c6 collected $1.14 from pot
*** SUMMARY ***
Total pot $1.2 | Rake $0.06 | Jackpot $0 | Bingo $0 | Fortune $0 | Tax $0
Board [4h 9h 8d 7c 9d]
Seat 1: Hero folded before Flop (didn't bet)
Seat 2: 3f098f87 folded before Flop (didn't bet)
Seat 3: dd54495c folded before Flop (didn't bet)
Seat 4: 41cfc3f2 (button) folded before Flop (didn't bet)
Seat 5: ca94f02f (small blind) showed [5s 4d] and lost with Pair of Nines and Pair of Fours
Seat 6: 837ac8c6 (big blind) showed [8s Tc] and won ($1.14) with Pair of Nines and Pair of Eights


Poker Hand #HD1724718039: Hold'em No Limit ($0.02/$0.05) - 2024/04/10 21:17:48
Table 'NLHBlue24' 6-max Seat #3 is the button
Seat 1: Hero ($5.77 in chips)
Seat 2: 3f098f87 ($5.98 in chips)
Seat 3: dd54495c ($8.96 in chips)
Seat 4: 41cfc3f2 ($7.79 in chips)
Seat 5: ca94f02f ($2.28 in chips)
Seat 6: 837ac8c6 ($1.28 in chips)
41cfc3f2: posts small blind $0.02
ca94f02f: posts big blind $0.05
*** HOLE CARDS ***
Dealt to Hero [8h 6d]
Dealt to 3f098f87 
Dealt to dd54495c 
Dealt to 41cfc3f2 
Dealt to ca94f02f 
Dealt to 837ac8c6 
837ac8c6: calls $0.05
Hero: folds
3f098f87: folds
dd54495c: calls $0.05
41cfc3f2: calls $0.03
ca94f02f: checks
*** FLOP *** [Th 7d Qh]
41cfc3f2: checks
ca94f02f: checks
837ac8c6: checks
dd54495c: checks
*** TURN *** [Th 7d Qh] [8c]
41cfc3f2: checks
ca94f02f: checks
837ac8c6: checks
dd54495c: checks
*** RIVER *** [Th 7d Qh 8c] [6s]
41cfc3f2: checks
ca94f02f: checks
837ac8c6: checks
dd54495c: checks
41cfc3f2: shows [Ac 2h] (Ace-High)
ca94f02f: shows [Kc 5h] (King-High)
837ac8c6: shows [6c Js] (Pair of Sixes)
dd54495c: shows [2d Ad] (Ace-High)
*** SHOWDOWN ***
837ac8c6 collected $0.19 from pot
*** SUMMARY ***
Total pot $0.2 | Rake $0.01 | Jackpot $0 | Bingo $0 | Fortune $0 | Tax $0
Board [Th 7d Qh 8c 6s]
Seat 1: Hero folded before Flop (didn't bet)
Seat 2: 3f098f87 folded before Flop (didn't bet)
Seat 3: dd54495c (button) showed [2d Ad] and lost with Ace-High
Seat 4: 41cfc3f2 (small blind) showed [Ac 2h] and lost with Ace-High
Seat 5: ca94f02f (big blind) showed [Kc 5h] and lost with King-High
Seat 6: 837ac8c6 showed [6c Js] and won ($0.19) with Pair of Sixes


Poker Hand #HD1724717992: Hold'em No Limit ($0.02/$0.05) - 2024/04/10 21:17:25
Table 'NLHBlue24' 6-max Seat #2 is the button
Seat 1: Hero ($5.7 in chips)
Seat 2: 3f098f87 ($5.98 in chips)
Seat 3: dd54495c ($8.98 in chips)
Seat 4: 41cfc3f2 ($7.84 in chips)
Seat 5: ca94f02f ($2.28 in chips)
Seat 6: 837ac8c6 ($1.28 in chips)
dd54495c: posts small blind $0.02
41cfc3f2: posts big blind $0.05
*** HOLE CARDS ***
Dealt to Hero [Qs Ts]
Dealt to 3f098f87 
Dealt to dd54495c 
Dealt to 41cfc3f2 
Dealt to ca94f02f 
Dealt to 837ac8c6 
ca94f02f: folds
837ac8c6: folds
Hero: raises $0.08 to $0.13
3f098f87: folds
dd54495c: folds
41cfc3f2: folds
Uncalled bet ($0.08) returned to Hero
*** SHOWDOWN ***
Hero collected $0.12 from pot
*** SUMMARY ***
Total pot $0.12 | Rake $0 | Jackpot $0 | Bingo $0 | Fortune $0 | Tax $0
Seat 1: Hero collected ($0.12)
Seat 2: 3f098f87 (button) folded before Flop (didn't bet)
Seat 3: dd54495c (small blind) folded before Flop
Seat 4: 41cfc3f2 (big blind) folded before Flop
Seat 5: ca94f02f folded before Flop (didn't bet)
Seat 6: 837ac8c6 folded before Flop (didn't bet)


Poker Hand #HD1724717963: Hold'em No Limit ($0.02/$0.05) - 2024/04/10 21:17:07
Table 'NLHBlue24' 6-max Seat #1 is the button
Seat 1: Hero ($5.7 in chips)
Seat 2: 3f098f87 ($6 in chips)
Seat 3: dd54495c ($9.03 in chips)
Seat 4: 41cfc3f2 ($7.77 in chips)
Seat 6: 837ac8c6 ($1.28 in chips)
3f098f87: posts small blind $0.02
dd54495c: posts big blind $0.05
*** HOLE CARDS ***
Dealt to Hero [3c 2h]
Dealt to 3f098f87 
Dealt to dd54495c 
Dealt to 41cfc3f2 
Dealt to 837ac8c6 
41cfc3f2: raises $0.05 to $0.1
837ac8c6: folds
Hero: folds
3f098f87: folds
dd54495c: folds
Uncalled bet ($0.05) returned to 41cfc3f2
*** SHOWDOWN ***
41cfc3f2 collected $0.12 from pot
*** SUMMARY ***
Total pot $0.12 | Rake $0 | Jackpot $0 | Bingo $0 | Fortune $0 | Tax $0
Seat 1: Hero (button) folded before Flop (didn't bet)
Seat 2: 3f098f87 (small blind) folded before Flop
Seat 3: dd54495c (big blind) folded before Flop
Seat 4: 41cfc3f2 collected ($0.12)
Seat 6: 837ac8c6 folded before Flop (didn't bet)


Poker Hand #HD1724717894: Hold'em No Limit ($0.02/$0.05) - 2024/04/10 21:16:32
Table 'NLHBlue24' 6-max Seat #6 is the button
Seat 1: Hero ($5.72 in chips)
Seat 2: 3f098f87 ($6.05 in chips)
Seat 3: dd54495c ($9.03 in chips)
Seat 4: 41cfc3f2 ($7.87 in chips)
Seat 6: 837ac8c6 ($1.12 in chips)
Hero: posts small blind $0.02
3f098f87: posts big blind $0.05
*** HOLE CARDS ***
Dealt to Hero [5h Qh]
Dealt to 3f098f87 
Dealt to dd54495c 
Dealt to 41cfc3f2 
Dealt to 837ac8c6 
dd54495c: folds
41cfc3f2: raises $0.05 to $0.1
837ac8c6: calls $0.1
Hero: folds
3f098f87: folds
*** FLOP *** [Td 9c 6h]
41cfc3f2: checks
837ac8c6: bets $0.14
41cfc3f2: folds
Uncalled bet ($0.14) returned to 837ac8c6
*** SHOWDOWN ***
837ac8c6 collected $0.26 from pot
*** SUMMARY ***
Total pot $0.27 | Rake $0.01 | Jackpot $0 | Bingo $0 | Fortune $0 | Tax $0
Board [Td 9c 6h]
Seat 1: Hero (small blind) folded before Flop
Seat 2: 3f098f87 (big blind) folded before Flop
Seat 3: dd54495c folded before Flop (didn't bet)
Seat 4: 41cfc3f2 folded on the Flop
Seat 6: 837ac8c6 (button) won ($0.26)


Poker Hand #HD1724717808: Hold'em No Limit ($0.02/$0.05) - 2024/04/10 21:15:51
Table 'NLHBlue24' 6-max Seat #5 is the button
Seat 1: Hero ($5.77 in chips)
Seat 2: 3f098f87 ($6.05 in chips)
Seat 3: dd54495c ($9.15 in chips)
Seat 4: 41cfc3f2 ($7.87 in chips)
Seat 5: ca94f02f ($2.28 in chips)
Seat 6: 837ac8c6 ($0.96 in chips)
837ac8c6: posts small blind $0.02
Hero: posts big blind $0.05
*** HOLE CARDS ***
Dealt to Hero [Ts 3d]
Dealt to 3f098f87 
Dealt to dd54495c 
Dealt to 41cfc3f2 
Dealt to ca94f02f 
Dealt to 837ac8c6 
3f098f87: folds
dd54495c: raises $0.07 to $0.12
41cfc3f2: folds
ca94f02f: folds
837ac8c6: calls $0.1
Hero: folds
*** FLOP *** [8s As Kc]
837ac8c6: bets $0.1
dd54495c: folds
Uncalled bet ($0.1) returned to 837ac8c6
*** SHOWDOWN ***
837ac8c6 collected $0.28 from pot
*** SUMMARY ***
Total pot $0.29 | Rake $0.01 | Jackpot $0 | Bingo $0 | Fortune $0 | Tax $0
Board [8s As Kc]
Seat 1: Hero (big blind) folded before Flop
Seat 2: 3f098f87 folded before Flop (didn't bet)
Seat 3: dd54495c folded on the Flop
Seat 4: 41cfc3f2 folded before Flop (didn't bet)
Seat 5: ca94f02f (button) folded before Flop (didn't bet)
Seat 6: 837ac8c6 (small blind) won ($0.28)


Poker Hand #HD1724717746: Hold'em No Limit ($0.02/$0.05) - 2024/04/10 21:15:17
Table 'NLHBlue24' 6-max Seat #4 is the button
Seat 1: Hero ($5.77 in chips)
Seat 2: 3f098f87 ($6.05 in chips)
Seat 3: dd54495c ($9.15 in chips)
Seat 4: 41cfc3f2 ($7.87 in chips)
Seat 5: ca94f02f ($2.23 in chips)
Seat 6: 837ac8c6 ($1.01 in chips)
ca94f02f: posts small blind $0.02
837ac8c6: posts big blind $0.05
*** HOLE CARDS ***
Dealt to Hero [Td 8s]
Dealt to 3f098f87 
Dealt to dd54495c 
Dealt to 41cfc3f2 
Dealt to ca94f02f 
Dealt to 837ac8c6 
Hero: folds
3f098f87: folds
dd54495c: folds
41cfc3f2: folds
ca94f02f: raises $0.05 to $0.1
837ac8c6: folds
Uncalled bet ($0.05) returned to ca94f02f
*** SHOWDOWN ***
ca94f02f collected $0.1 from pot
*** SUMMARY ***
Total pot $0.1 | Rake $0 | Jackpot $0 | Bingo $0 | Fortune $0 | Tax $0
Seat 1: Hero folded before Flop (didn't bet)
Seat 2: 3f098f87 folded before Flop (didn't bet)
Seat 3: dd54495c folded before Flop (didn't bet)
Seat 4: 41cfc3f2 (button) folded before Flop (didn't bet)
Seat 5: ca94f02f (small blind) collected ($0.1)
Seat 6: 837ac8c6 (big blind) folded before Flop


Poker Hand #HD1724717690: Hold'em No Limit ($0.02/$0.05) - 2024/04/10 21:14:46
Table 'NLHBlue24' 6-max Seat #3 is the button
Seat 1: Hero ($5.77 in chips)
Seat 2: 3f098f87 ($6.05 in chips)
Seat 3: dd54495c ($9.15 in chips)
Seat 4: 41cfc3f2 ($7.89 in chips)
Seat 5: ca94f02f ($2.16 in chips)
Seat 6: 837ac8c6 ($1.06 in chips)
41cfc3f2: posts small blind $0.02
ca94f02f: posts big blind $0.05
*** HOLE CARDS ***
Dealt to Hero [6c As]
Dealt to 3f098f87 
Dealt to dd54495c 
Dealt to 41cfc3f2 
Dealt to ca94f02f 
Dealt to 837ac8c6 
837ac8c6: calls $0.05
Hero: folds
3f098f87: folds
dd54495c: folds
41cfc3f2: folds
ca94f02f: checks
*** FLOP *** [7d 4c Kd]
ca94f02f: bets $0.09
837ac8c6: folds
Uncalled bet ($0.09) returned to ca94f02f
*** SHOWDOWN ***
ca94f02f collected $0.12 from pot
*** SUMMARY ***
Total pot $0.12 | Rake $0 | Jackpot $0 | Bingo $0 | Fortune $0 | Tax $0
Board [7d 4c Kd]
Seat 1: Hero folded before Flop (didn't bet)
Seat 2: 3f098f87 folded before Flop (didn't bet)
Seat 3: dd54495c (button) folded before Flop (didn't bet)
Seat 4: 41cfc3f2 (small blind) folded before Flop
Seat 5: ca94f02f (big blind) won ($0.12)
Seat 6: 837ac8c6 folded on the Flop


Poker Hand #HD1724717646: Hold'em No Limit ($0.02/$0.05) - 2024/04/10 21:14:24
Table 'NLHBlue24' 6-max Seat #2 is the button
Seat 1: Hero ($5.77 in chips)
Seat 2: 3f098f87 ($5.98 in chips)
Seat 3: dd54495c ($9.17 in chips)
Seat 4: 41cfc3f2 ($7.94 in chips)
Seat 5: ca94f02f ($2.16 in chips)
Seat 6: 837ac8c6 ($1.06 in chips)
dd54495c: posts small blind $0.02
41cfc3f2: posts big blind $0.05
*** HOLE CARDS ***
Dealt to Hero [3h Ts]
Dealt to 3f098f87 
Dealt to dd54495c 
Dealt to 41cfc3f2 
Dealt to ca94f02f 
Dealt to 837ac8c6 
ca94f02f: folds
837ac8c6: folds
Hero: folds
3f098f87: raises $0.1 to $0.15
dd54495c: folds
41cfc3f2: folds
Uncalled bet ($0.1) returned to 3f098f87
*** SHOWDOWN ***
3f098f87 collected $0.12 from pot
*** SUMMARY ***
Total pot $0.12 | Rake $0 | Jackpot $0 | Bingo $0 | Fortune $0 | Tax $0
Seat 1: Hero folded before Flop (didn't bet)
Seat 2: 3f098f87 (button) collected ($0.12)
Seat 3: dd54495c (small blind) folded before Flop
Seat 4: 41cfc3f2 (big blind) folded before Flop
Seat 5: ca94f02f folded before Flop (didn't bet)
Seat 6: 837ac8c6 folded before Flop (didn't bet)


Poker Hand #HD1724717567: Hold'em No Limit ($0.02/$0.05) - 2024/04/10 21:13:38
Table 'NLHBlue24' 6-max Seat #1 is the button
Seat 1: Hero ($5.77 in chips)
Seat 2: 3f098f87 ($6 in chips)
Seat 3: dd54495c ($8.96 in chips)
Seat 4: 41cfc3f2 ($7.94 in chips)
Seat 5: ca94f02f ($2.37 in chips)
Seat 6: 837ac8c6 ($1.06 in chips)
3f098f87: posts small blind $0.02
dd54495c: posts big blind $0.05
*** HOLE CARDS ***
Dealt to Hero [Kh 7d]
Dealt to 3f098f87 
Dealt to dd54495c 
Dealt to 41cfc3f2 
Dealt to ca94f02f 
Dealt to 837ac8c6 
41cfc3f2: folds
ca94f02f: raises $0.05 to $0.1
837ac8c6: folds
Hero: folds
3f098f87: folds
dd54495c: calls $0.05
*** FLOP *** [5h Ks Kd]
dd54495c: checks
ca94f02f: checks
*** TURN *** [5h Ks Kd] [Jd]
dd54495c: checks
ca94f02f: bets $0.11
dd54495c: calls $0.11
*** RIVER *** [5h Ks Kd Jd] [7h]
dd54495c: checks
ca94f02f: checks
dd54495c: shows [9d Js] (Pair of Kings and Pair of Jacks)
ca94f02f: shows [Qc Ts] (Pair of Kings)
*** SHOWDOWN ***
dd54495c collected $0.42 from pot
*** SUMMARY ***
Total pot $0.44 | Rake $0.02 | Jackpot $0 | Bingo $0 | Fortune $0 | Tax $0
Board [5h Ks Kd Jd 7h]
Seat 1: Hero (button) folded before Flop (didn't bet)
Seat 2: 3f098f87 (small blind) folded before Flop
Seat 3: dd54495c (big blind) showed [9d Js] and won ($0.42) with Pair of Kings and Pair of Jacks
Seat 4: 41cfc3f2 folded before Flop (didn't bet)
Seat 5: ca94f02f showed [Qc Ts] and lost with Pair of Kings
Seat 6: 837ac8c6 folded before Flop (didn't bet)


Poker Hand #HD1724717474: Hold'em No Limit ($0.02/$0.05) - 2024/04/10 21:12:44
Table 'NLHBlue24' 6-max Seat #6 is the button
Seat 1: Hero ($5.79 in chips)
Seat 2: 3f098f87 ($5.81 in chips)
Seat 3: dd54495c ($8.96 in chips)
Seat 4: 41cfc3f2 ($7.94 in chips)
Seat 5: ca94f02f ($2.37 in chips)
Seat 6: 837ac8c6 ($1.24 in chips)
Hero: posts small blind $0.02
3f098f87: posts big blind $0.05
*** HOLE CARDS ***
Dealt to Hero [4s Ad]
Dealt to 3f098f87 
Dealt to dd54495c 
Dealt to 41cfc3f2 
Dealt to ca94f02f 
Dealt to 837ac8c6 
dd54495c: folds
41cfc3f2: folds
ca94f02f: folds
837ac8c6: calls $0.05
Hero: folds
3f098f87: checks
*** FLOP *** [8h 4c Th]
3f098f87: checks
837ac8c6: bets $0.06
3f098f87: calls $0.06
*** TURN *** [8h 4c Th] [Ts]
3f098f87: checks
837ac8c6: checks
*** RIVER *** [8h 4c Th Ts] [5d]
3f098f87: bets $0.07
837ac8c6: calls $0.07
3f098f87: shows [8c Qh] (Pair of Tens and Pair of Eights)
837ac8c6: shows [Js 8d] (Pair of Tens and Pair of Eights)
*** SHOWDOWN ***
3f098f87 collected $0.37 from pot
*** SUMMARY ***
Total pot $0.38 | Rake $0.01 | Jackpot $0 | Bingo $0 | Fortune $0 | Tax $0
Board [8h 4c Th Ts 5d]
Seat 1: Hero (small blind) folded before Flop
Seat 2: 3f098f87 (big blind) showed [8c Qh] and won ($0.37) with Pair of Tens and Pair of Eights
Seat 3: dd54495c folded before Flop (didn't bet)
Seat 4: 41cfc3f2 folded before Flop (didn't bet)
Seat 5: ca94f02f folded before Flop (didn't bet)
Seat 6: 837ac8c6 (button) showed [Js 8d] and lost with Pair of Tens and Pair of Eights


Poker Hand #HD1724717378: Hold'em No Limit ($0.02/$0.05) - 2024/04/10 21:11:57
Table 'NLHBlue24' 6-max Seat #5 is the button
Seat 1: Hero ($5.84 in chips)
Seat 2: 3f098f87 ($5.81 in chips)
Seat 3: dd54495c ($8.96 in chips)
Seat 4: 41cfc3f2 ($7.94 in chips)
Seat 5: ca94f02f ($2.6 in chips)
Seat 6: 837ac8c6 ($0.98 in chips)
837ac8c6: posts small blind $0.02
Hero: posts big blind $0.05
*** HOLE CARDS ***
Dealt to Hero [Ts Ad]
Dealt to 3f098f87 
Dealt to dd54495c 
Dealt to 41cfc3f2 
Dealt to ca94f02f 
Dealt to 837ac8c6 
3f098f87: folds
dd54495c: folds
41cfc3f2: folds
ca94f02f: raises $0.05 to $0.1
837ac8c6: calls $0.08
Hero: folds
*** FLOP *** [6c 2h 7h]
837ac8c6: checks
ca94f02f: checks
*** TURN *** [6c 2h 7h] [9h]
837ac8c6: checks
ca94f02f: bets $0.13
837ac8c6: calls $0.13
*** RIVER *** [6c 2h 7h 9h] [Jh]
837ac8c6: bets $0.75 and is all-in
ca94f02f: folds
Uncalled bet ($0.75) returned to 837ac8c6
*** SHOWDOWN ***
837ac8c6 collected $0.49 from pot
*** SUMMARY ***
Total pot $0.51 | Rake $0.02 | Jackpot $0 | Bingo $0 | Fortune $0 | Tax $0
Board [6c 2h 7h 9h Jh]
Seat 1: Hero (big blind) folded before Flop
Seat 2: 3f098f87 folded before Flop (didn't bet)
Seat 3: dd54495c folded before Flop (didn't bet)
Seat 4: 41cfc3f2 folded before Flop (didn't bet)
Seat 5: ca94f02f (button) folded on the River
Seat 6: 837ac8c6 (small blind) won ($0.49)


Poker Hand #HD1724717306: Hold'em No Limit ($0.02/$0.05) - 2024/04/10 21:11:15
Table 'NLHBlue24' 6-max Seat #4 is the button
Seat 1: Hero ($5.84 in chips)
Seat 2: 3f098f87 ($5.7 in chips)
Seat 3: dd54495c ($8.96 in chips)
Seat 4: 41cfc3f2 ($7.94 in chips)
Seat 5: ca94f02f ($2.62 in chips)
Seat 6: 837ac8c6 ($1.08 in chips)
ca94f02f: posts small blind $0.02
837ac8c6: posts big blind $0.05
*** HOLE CARDS ***
Dealt to Hero [Js 6h]
Dealt to 3f098f87 
Dealt to dd54495c 
Dealt to 41cfc3f2 
Dealt to ca94f02f 
Dealt to 837ac8c6 
Hero: folds
3f098f87: raises $0.05 to $0.1
dd54495c: folds
41cfc3f2: folds
ca94f02f: folds
837ac8c6: calls $0.05
*** FLOP *** [Kd Kc 4h]
837ac8c6: checks
3f098f87: checks
*** TURN *** [Kd Kc 4h] [5c]
837ac8c6: checks
3f098f87: bets $0.06
837ac8c6: folds
Uncalled bet ($0.06) returned to 3f098f87
*** SHOWDOWN ***
3f098f87 collected $0.21 from pot
*** SUMMARY ***
Total pot $0.22 | Rake $0.01 | Jackpot $0 | Bingo $0 | Fortune $0 | Tax $0
Board [Kd Kc 4h 5c]
Seat 1: Hero folded before Flop (didn't bet)
Seat 2: 3f098f87 won ($0.21)
Seat 3: dd54495c folded before Flop (didn't bet)
Seat 4: 41cfc3f2 (button) folded before Flop (didn't bet)
Seat 5: ca94f02f (small blind) folded before Flop
Seat 6: 837ac8c6 (big blind) folded on the Turn


Poker Hand #HD1724717136: Hold'em No Limit ($0.02/$0.05) - 2024/04/10 21:09:38
Table 'NLHBlue24' 6-max Seat #3 is the button
Seat 1: Hero ($5.84 in chips)
Seat 2: 3f098f87 ($5.8 in chips)
Seat 3: dd54495c ($8.65 in chips)
Seat 4: 41cfc3f2 ($7.96 in chips)
Seat 5: ca94f02f ($2.83 in chips)
Seat 6: 837ac8c6 ($1.08 in chips)
41cfc3f2: posts small blind $0.02
ca94f02f: posts big blind $0.05
*** HOLE CARDS ***
Dealt to Hero [2d Td]
Dealt to 3f098f87 
Dealt to dd54495c 
Dealt to 41cfc3f2 
Dealt to ca94f02f 
Dealt to 837ac8c6 
837ac8c6: folds
Hero: folds
3f098f87: raises $0.05 to $0.1
dd54495c: calls $0.1
41cfc3f2: folds
ca94f02f: calls $0.05
*** FLOP *** [Th Qs Kd]
ca94f02f: checks
3f098f87: checks
dd54495c: checks
*** TURN *** [Th Qs Kd] [Jd]
ca94f02f: checks
3f098f87: checks
dd54495c: checks
*** RIVER *** [Th Qs Kd Jd] [7d]
ca94f02f: bets $0.11
3f098f87: folds
dd54495c: calls $0.11
ca94f02f: shows [7s 5h] (Pair of Sevens)
dd54495c: shows [9s 9d] (Kings-High Straight)
*** SHOWDOWN ***
dd54495c collected $0.52 from pot
*** SUMMARY ***
Total pot $0.54 | Rake $0.02 | Jackpot $0 | Bingo $0 | Fortune $0 | Tax $0
Board [Th Qs Kd Jd 7d]
Seat 1: Hero folded before Flop (didn't bet)
Seat 2: 3f098f87 folded on the River
Seat 3: dd54495c (button) showed [9s 9d] and won ($0.52) with Kings-High Straight
Seat 4: 41cfc3f2 (small blind) folded before Flop
Seat 5: ca94f02f (big blind) showed [7s 5h] and lost with Pair of Sevens
Seat 6: 837ac8c6 folded before Flop (didn't bet)


Poker Hand #HD1724717002: Hold'em No Limit ($0.02/$0.05) - 2024/04/10 21:08:26
Table 'NLHBlue24' 6-max Seat #2 is the button
Seat 1: Hero ($5.84 in chips)
Seat 2: 3f098f87 ($5.8 in chips)
Seat 3: dd54495c ($8.75 in chips)
Seat 4: 41cfc3f2 ($8.42 in chips)
Seat 5: ca94f02f ($2.93 in chips)
Seat 6: 837ac8c6 ($0.47 in chips)
dd54495c: posts small blind $0.02
41cfc3f2: posts big blind $0.05
*** HOLE CARDS ***
Dealt to Hero [7d Ad]
Dealt to 3f098f87 
Dealt to dd54495c 
Dealt to 41cfc3f2 
Dealt to ca94f02f 
Dealt to 837ac8c6 
ca94f02f: raises $0.05 to $0.1
837ac8c6: calls $0.1
Hero: folds
3f098f87: folds
dd54495c: calls $0.08
41cfc3f2: calls $0.05
*** FLOP *** [As 7c 4h]
dd54495c: checks
41cfc3f2: checks
ca94f02f: checks
837ac8c6: checks
*** TURN *** [As 7c 4h] [6s]
dd54495c: checks
41cfc3f2: bets $0.36
ca94f02f: folds
837ac8c6: calls $0.36
dd54495c: folds
*** RIVER *** [As 7c 4h 6s] [Qd]
41cfc3f2: checks
837ac8c6: bets $0.01 and is all-in
41cfc3f2: folds
Uncalled bet ($0.01) returned to 837ac8c6
*** SHOWDOWN ***
837ac8c6 collected $1.07 from pot
*** SUMMARY ***
Total pot $1.12 | Rake $0.05 | Jackpot $0 | Bingo $0 | Fortune $0 | Tax $0
Board [As 7c 4h 6s Qd]
Seat 1: Hero folded before Flop (didn't bet)
Seat 2: 3f098f87 (button) folded before Flop (didn't bet)
Seat 3: dd54495c (small blind) folded on the Turn
Seat 4: 41cfc3f2 (big blind) folded on the River
Seat 5: ca94f02f folded on the Turn
Seat 6: 837ac8c6 won ($1.07)


Poker Hand #HD1724716916: Hold'em No Limit ($0.02/$0.05) - 2024/04/10 21:07:38
Table 'NLHBlue24' 6-max Seat #1 is the button
Seat 1: Hero ($5.84 in chips)
Seat 2: 3f098f87 ($5.82 in chips)
Seat 3: dd54495c ($8.34 in chips)
Seat 4: 41cfc3f2 ($8.8 in chips)
Seat 5: ca94f02f ($2.93 in chips)
Seat 6: 837ac8c6 ($0.52 in chips)
3f098f87: posts small blind $0.02
dd54495c: posts big blind $0.05
*** HOLE CARDS ***
Dealt to Hero [7d 5h]
Dealt to 3f098f87 
Dealt to dd54495c 
Dealt to 41cfc3f2 
Dealt to ca94f02f 
Dealt to 837ac8c6 
41cfc3f2: calls $0.05
ca94f02f: folds
837ac8c6: calls $0.05
Hero: folds
3f098f87: folds
dd54495c: checks
*** FLOP *** [Jh Qs 4d]
dd54495c: checks
41cfc3f2: bets $0.12
837ac8c6: folds
dd54495c: calls $0.12
*** TURN *** [Jh Qs 4d] [Jd]
dd54495c: bets $0.21
41cfc3f2: calls $0.21
*** RIVER *** [Jh Qs 4d Jd] [3h]
dd54495c: bets $0.28
41cfc3f2: folds
Uncalled bet ($0.28) returned to dd54495c
ca94f02f: shows [Jc] (Three Jacks)
*** SHOWDOWN ***
dd54495c collected $0.79 from pot
*** SUMMARY ***
Total pot $0.83 | Rake $0.04 | Jackpot $0 | Bingo $0 | Fortune $0 | Tax $0
Board [Jh Qs 4d Jd 3h]
Seat 1: Hero (button) folded before Flop (didn't bet)
Seat 2: 3f098f87 (small blind) folded before Flop
Seat 3: dd54495c (big blind) won ($0.79)
Seat 4: 41cfc3f2 folded on the River
Seat 5: ca94f02f folded before Flop (didn't bet)
Seat 6: 837ac8c6 folded on the Flop


Poker Hand #HD1724716830: Hold'em No Limit ($0.02/$0.05) - 2024/04/10 21:06:52
Table 'NLHBlue24' 6-max Seat #6 is the button
Seat 1: Hero ($5.86 in chips)
Seat 2: 3f098f87 ($5.87 in chips)
Seat 3: dd54495c ($8.34 in chips)
Seat 4: 41cfc3f2 ($8.9 in chips)
Seat 5: ca94f02f ($2.06 in chips)
Seat 6: 837ac8c6 ($1.38 in chips)
Hero: posts small blind $0.02
3f098f87: posts big blind $0.05
*** HOLE CARDS ***
Dealt to Hero [Ks Td]
Dealt to 3f098f87 
Dealt to dd54495c 
Dealt to 41cfc3f2 
Dealt to ca94f02f 
Dealt to 837ac8c6 
dd54495c: folds
41cfc3f2: raises $0.05 to $0.1
ca94f02f: calls $0.1
837ac8c6: calls $0.1
Hero: folds
3f098f87: folds
*** FLOP *** [Jh 7h 7d]
41cfc3f2: checks
ca94f02f: checks
837ac8c6: checks
*** TURN *** [Jh 7h 7d] [Kd]
41cfc3f2: checks
ca94f02f: bets $0.19
837ac8c6: calls $0.19
41cfc3f2: folds
*** RIVER *** [Jh 7h 7d Kd] [5d]
ca94f02f: bets $0.57
837ac8c6: calls $0.57
ca94f02f: shows [9c 7c] (Three Sevens)
837ac8c6: shows [8c Kc] (Pair of Kings and Pair of Sevens)
*** SHOWDOWN ***
ca94f02f collected $1.73 from pot
*** SUMMARY ***
Total pot $1.89 | Rake $0.11 | Jackpot $0.05 | Bingo $0 | Fortune $0 | Tax $0
Board [Jh 7h 7d Kd 5d]
Seat 1: Hero (small blind) folded before Flop
Seat 2: 3f098f87 (big blind) folded before Flop
Seat 3: dd54495c folded before Flop (didn't bet)
Seat 4: 41cfc3f2 folded on the Turn
Seat 5: ca94f02f showed [9c 7c] and won ($1.73) with Three Sevens
Seat 6: 837ac8c6 (button) showed [8c Kc] and lost with Pair of Kings and Pair of Sevens


Poker Hand #HD1724716712: Hold'em No Limit ($0.02/$0.05) - 2024/04/10 21:05:49
Table 'NLHBlue24' 6-max Seat #5 is the button
Seat 1: Hero ($5.91 in chips)
Seat 2: 3f098f87 ($5.38 in chips)
Seat 3: dd54495c ($8.34 in chips)
Seat 4: 41cfc3f2 ($8.9 in chips)
Seat 5: ca94f02f ($2.44 in chips)
Seat 6: 837ac8c6 ($1.48 in chips)
837ac8c6: posts small blind $0.02
Hero: posts big blind $0.05
*** HOLE CARDS ***
Dealt to Hero [8s Qd]
Dealt to 3f098f87 
Dealt to dd54495c 
Dealt to 41cfc3f2 
Dealt to ca94f02f 
Dealt to 837ac8c6 
3f098f87: raises $0.05 to $0.1
dd54495c: folds
41cfc3f2: folds
ca94f02f: calls $0.1
837ac8c6: calls $0.08
Hero: folds
*** FLOP *** [8h 3s 8c]
837ac8c6: checks
3f098f87: checks
ca94f02f: bets $0.12
837ac8c6: folds
3f098f87: calls $0.12
*** TURN *** [8h 3s 8c] [7c]
3f098f87: checks
ca94f02f: checks
*** RIVER *** [8h 3s 8c 7c] [Qc]
3f098f87: bets $0.16
ca94f02f: calls $0.16
3f098f87: shows [9h 9s] (Pair of Nines and Pair of Eights)
ca94f02f: shows [4h Ad] (Pair of Eights)
*** SHOWDOWN ***
3f098f87 collected $0.87 from pot
*** SUMMARY ***
Total pot $0.91 | Rake $0.04 | Jackpot $0 | Bingo $0 | Fortune $0 | Tax $0
Board [8h 3s 8c 7c Qc]
Seat 1: Hero (big blind) folded before Flop
Seat 2: 3f098f87 showed [9h 9s] and won ($0.87) with Pair of Nines and Pair of Eights
Seat 3: dd54495c folded before Flop (didn't bet)
Seat 4: 41cfc3f2 folded before Flop (didn't bet)
Seat 5: ca94f02f (button) showed [4h Ad] and lost with Pair of Eights
Seat 6: 837ac8c6 (small blind) folded on the Flop


Poker Hand #HD1724716596: Hold'em No Limit ($0.02/$0.05) - 2024/04/10 21:04:55
Table 'NLHBlue24' 6-max Seat #4 is the button
Seat 1: Hero ($5.91 in chips)
Seat 2: 3f098f87 ($5 in chips)
Seat 3: dd54495c ($8.55 in chips)
Seat 4: 41cfc3f2 ($8.9 in chips)
Seat 5: ca94f02f ($2.54 in chips)
Seat 6: 837ac8c6 ($1.58 in chips)
ca94f02f: posts small blind $0.02
837ac8c6: posts big blind $0.05
*** HOLE CARDS ***
Dealt to Hero [Ts 2s]
Dealt to 3f098f87 
Dealt to dd54495c 
Dealt to 41cfc3f2 
Dealt to ca94f02f 
Dealt to 837ac8c6 
Hero: folds
3f098f87: raises $0.05 to $0.1
dd54495c: calls $0.1
41cfc3f2: folds
ca94f02f: calls $0.08
837ac8c6: calls $0.05
*** FLOP *** [9h Kd 3d]
ca94f02f: checks
837ac8c6: checks
3f098f87: bets $0.11
dd54495c: calls $0.11
ca94f02f: folds
837ac8c6: folds
*** TURN *** [9h Kd 3d] [Ad]
3f098f87: bets $0.33
dd54495c: folds
Uncalled bet ($0.33) returned to 3f098f87
*** SHOWDOWN ***
3f098f87 collected $0.59 from pot
*** SUMMARY ***
Total pot $0.62 | Rake $0.03 | Jackpot $0 | Bingo $0 | Fortune $0 | Tax $0
Board [9h Kd 3d Ad]
Seat 1: Hero folded before Flop (didn't bet)
Seat 2: 3f098f87 won ($0.59)
Seat 3: dd54495c folded on the Turn
Seat 4: 41cfc3f2 (button) folded before Flop (didn't bet)
Seat 5: ca94f02f (small blind) folded on the Flop
Seat 6: 837ac8c6 (big blind) folded on the Flop


Poker Hand #HD1724716546: Hold'em No Limit ($0.02/$0.05) - 2024/04/10 21:04:31
Table 'NLHBlue24' 6-max Seat #3 is the button
Seat 1: Hero ($5.84 in chips)
Seat 2: 3f098f87 ($5 in chips)
Seat 3: dd54495c ($8.55 in chips)
Seat 4: 41cfc3f2 ($8.92 in chips)
Seat 5: ca94f02f ($2.59 in chips)
Seat 6: 837ac8c6 ($1.58 in chips)
41cfc3f2: posts small blind $0.02
ca94f02f: posts big blind $0.05
*** HOLE CARDS ***
Dealt to Hero [Jh Jc]
Dealt to 3f098f87 
Dealt to dd54495c 
Dealt to 41cfc3f2 
Dealt to ca94f02f 
Dealt to 837ac8c6 
837ac8c6: folds
Hero: raises $0.08 to $0.13
3f098f87: folds
dd54495c: folds
41cfc3f2: folds
ca94f02f: folds
Uncalled bet ($0.08) returned to Hero
*** SHOWDOWN ***
Hero collected $0.12 from pot
*** SUMMARY ***
Total pot $0.12 | Rake $0 | Jackpot $0 | Bingo $0 | Fortune $0 | Tax $0
Seat 1: Hero collected ($0.12)
Seat 2: 3f098f87 folded before Flop (didn't bet)
Seat 3: dd54495c (button) folded before Flop (didn't bet)
Seat 4: 41cfc3f2 (small blind) folded before Flop
Seat 5: ca94f02f (big blind) folded before Flop
Seat 6: 837ac8c6 folded before Flop (didn't bet)


Poker Hand #HD1724716384: Hold'em No Limit ($0.02/$0.05) - 2024/04/10 21:03:04
Table 'NLHBlue24' 6-max Seat #2 is the button
Seat 1: Hero ($5.84 in chips)
Seat 2: 3f098f87 ($5 in chips)
Seat 3: dd54495c ($8.6 in chips)
Seat 4: 41cfc3f2 ($8.75 in chips)
Seat 5: ca94f02f ($2.59 in chips)
Seat 6: 837ac8c6 ($1.71 in chips)
dd54495c: posts small blind $0.02
41cfc3f2: posts big blind $0.05
*** HOLE CARDS ***
Dealt to Hero [2h Jd]
Dealt to 3f098f87 
Dealt to dd54495c 
Dealt to 41cfc3f2 
Dealt to ca94f02f 
Dealt to 837ac8c6 
ca94f02f: folds
837ac8c6: calls $0.05
Hero: folds
3f098f87: folds
dd54495c: calls $0.03
41cfc3f2: checks
*** FLOP *** [3s 7s Ks]
dd54495c: checks
41cfc3f2: checks
837ac8c6: bets $0.08
dd54495c: folds
41cfc3f2: calls $0.08
*** TURN *** [3s 7s Ks] [4d]
41cfc3f2: checks
837ac8c6: checks
*** RIVER *** [3s 7s Ks 4d] [Ac]
41cfc3f2: checks
837ac8c6: checks
41cfc3f2: shows [8s Kd] (Pair of Kings)
837ac8c6: shows [Qd Js] (Ace-High)
*** SHOWDOWN ***
41cfc3f2 collected $0.3 from pot
*** SUMMARY ***
Total pot $0.31 | Rake $0.01 | Jackpot $0 | Bingo $0 | Fortune $0 | Tax $0
Board [3s 7s Ks 4d Ac]
Seat 1: Hero folded before Flop (didn't bet)
Seat 2: 3f098f87 (button) folded before Flop (didn't bet)
Seat 3: dd54495c (small blind) folded on the Flop
Seat 4: 41cfc3f2 (big blind) showed [8s Kd] and won ($0.3) with Pair of Kings
Seat 5: ca94f02f folded before Flop (didn't bet)
Seat 6: 837ac8c6 showed [Qd Js] and lost with Ace-High


Poker Hand #HD1724716249: Hold'em No Limit ($0.02/$0.05) - 2024/04/10 21:02:01
Table 'NLHBlue24' 6-max Seat #1 is the button
Seat 1: Hero ($5.84 in chips)
Seat 2: 3f098f87 ($5 in chips)
Seat 3: dd54495c ($6.38 in chips)
Seat 4: 41cfc3f2 ($11.06 in chips)
Seat 5: ca94f02f ($2.76 in chips)
Seat 6: 837ac8c6 ($1.71 in chips)
3f098f87: posts small blind $0.02
dd54495c: posts big blind $0.05
*** HOLE CARDS ***
Dealt to Hero [Th 6d]
Dealt to 3f098f87 
Dealt to dd54495c 
Dealt to 41cfc3f2 
Dealt to ca94f02f 
Dealt to 837ac8c6 
41cfc3f2: calls $0.05
ca94f02f: calls $0.05
837ac8c6: folds
Hero: folds
3f098f87: folds
dd54495c: checks
*** FLOP *** [3c 7h 9d]
dd54495c: checks
41cfc3f2: bets $0.12
ca94f02f: calls $0.12
dd54495c: calls $0.12
*** TURN *** [3c 7h 9d] [Qh]
dd54495c: checks
41cfc3f2: bets $0.35
ca94f02f: folds
dd54495c: calls $0.35
*** RIVER *** [3c 7h 9d Qh] [8s]
dd54495c: bets $1.79
41cfc3f2: calls $1.79
dd54495c: shows [6c 5c] (Nines-High Straight)
41cfc3f2: shows [9s 9h] (Three Nines)
*** SHOWDOWN ***
dd54495c collected $4.53 from pot
*** SUMMARY ***
Total pot $4.81 | Rake $0.23 | Jackpot $0.05 | Bingo $0 | Fortune $0 | Tax $0
Board [3c 7h 9d Qh 8s]
Seat 1: Hero (button) folded before Flop (didn't bet)
Seat 2: 3f098f87 (small blind) folded before Flop
Seat 3: dd54495c (big blind) showed [6c 5c] and won ($4.53) with Nines-High Straight
Seat 4: 41cfc3f2 showed [9s 9h] and lost with Three Nines
Seat 5: ca94f02f folded on the Turn
Seat 6: 837ac8c6 folded before Flop (didn't bet)


Poker Hand #HD1724716104: Hold'em No Limit ($0.02/$0.05) - 2024/04/10 21:00:49
Table 'NLHBlue24' 6-max Seat #6 is the button
Seat 1: Hero ($5.86 in chips)
Seat 2: 3f098f87 ($5.22 in chips)
Seat 3: dd54495c ($6.5 in chips)
Seat 4: 41cfc3f2 ($11.06 in chips)
Seat 5: ca94f02f ($2.26 in chips)
Seat 6: 837ac8c6 ($1.83 in chips)
Hero: posts small blind $0.02
3f098f87: posts big blind $0.05
*** HOLE CARDS ***
Dealt to Hero [2s 7h]
Dealt to 3f098f87 
Dealt to dd54495c 
Dealt to 41cfc3f2 
Dealt to ca94f02f 
Dealt to 837ac8c6 
dd54495c: raises $0.07 to $0.12
41cfc3f2: folds
ca94f02f: calls $0.12
837ac8c6: calls $0.12
Hero: folds
3f098f87: calls $0.07
*** FLOP *** [8c 4s 2c]
3f098f87: checks
dd54495c: checks
ca94f02f: checks
837ac8c6: checks
*** TURN *** [8c 4s 2c] [2d]
3f098f87: checks
dd54495c: checks
ca94f02f: bets $0.17
837ac8c6: folds
3f098f87: calls $0.17
dd54495c: folds
*** RIVER *** [8c 4s 2c 2d] [8h]
3f098f87: checks
ca94f02f: bets $0.42
3f098f87: folds
Uncalled bet ($0.42) returned to ca94f02f
*** SHOWDOWN ***
ca94f02f collected $0.79 from pot
*** SUMMARY ***
Total pot $0.84 | Rake $0.05 | Jackpot $0 | Bingo $0 | Fortune $0 | Tax $0
Board [8c 4s 2c 2d 8h]
Seat 1: Hero (small blind) folded before Flop
Seat 2: 3f098f87 (big blind) folded on the River
Seat 3: dd54495c folded on the Turn
Seat 4: 41cfc3f2 folded before Flop (didn't bet)
Seat 5: ca94f02f won ($0.79)
Seat 6: 837ac8c6 (button) folded on the Turn


Poker Hand #HD1724716013: Hold'em No Limit ($0.02/$0.05) - 2024/04/10 21:00:09
Table 'NLHBlue24' 6-max Seat #5 is the button
Seat 1: Hero ($5.91 in chips)
Seat 2: 3f098f87 ($5.32 in chips)
Seat 3: dd54495c ($6.6 in chips)
Seat 4: 41cfc3f2 ($11.06 in chips)
Seat 5: ca94f02f ($2.26 in chips)
Seat 6: 837ac8c6 ($1.59 in chips)
837ac8c6: posts small blind $0.02
Hero: posts big blind $0.05
*** HOLE CARDS ***
Dealt to Hero [Ks 5c]
Dealt to 3f098f87 
Dealt to dd54495c 
Dealt to 41cfc3f2 
Dealt to ca94f02f 
Dealt to 837ac8c6 
3f098f87: raises $0.05 to $0.1
dd54495c: calls $0.1
41cfc3f2: folds
ca94f02f: folds
837ac8c6: calls $0.08
Hero: folds
*** FLOP *** [Jc 6h Ts]
837ac8c6: bets $0.18
3f098f87: folds
dd54495c: folds
Uncalled bet ($0.18) returned to 837ac8c6
*** SHOWDOWN ***
837ac8c6 collected $0.34 from pot
*** SUMMARY ***
Total pot $0.35 | Rake $0.01 | Jackpot $0 | Bingo $0 | Fortune $0 | Tax $0
Board [Jc 6h Ts]
Seat 1: Hero (big blind) folded before Flop
Seat 2: 3f098f87 folded on the Flop
Seat 3: dd54495c folded on the Flop
Seat 4: 41cfc3f2 folded before Flop (didn't bet)
Seat 5: ca94f02f (button) folded before Flop (didn't bet)
Seat 6: 837ac8c6 (small blind) won ($0.34)


Poker Hand #HD1724715933: Hold'em No Limit ($0.02/$0.05) - 2024/04/10 20:59:22
Table 'NLHBlue24' 6-max Seat #4 is the button
Seat 1: Hero ($5.91 in chips)
Seat 2: 3f098f87 ($5 in chips)
Seat 3: dd54495c ($6.6 in chips)
Seat 4: 41cfc3f2 ($11.06 in chips)
Seat 5: ca94f02f ($2.28 in chips)
Seat 6: 837ac8c6 ($1.92 in chips)
ca94f02f: posts small blind $0.02
837ac8c6: posts big blind $0.05
*** HOLE CARDS ***
Dealt to Hero [7d 9s]
Dealt to 3f098f87 
Dealt to dd54495c 
Dealt to 41cfc3f2 
Dealt to ca94f02f 
Dealt to 837ac8c6 
Hero: folds
3f098f87: raises $0.05 to $0.1
dd54495c: folds
41cfc3f2: folds
ca94f02f: folds
837ac8c6: calls $0.05
*** FLOP *** [4h 2d 5h]
837ac8c6: checks
3f098f87: checks
*** TURN *** [4h 2d 5h] [5c]
837ac8c6: checks
3f098f87: bets $0.06
837ac8c6: calls $0.06
*** RIVER *** [4h 2d 5h 5c] [2s]
837ac8c6: bets $0.17
3f098f87: calls $0.17
837ac8c6: shows [Qh 6h] (Pair of Fives and Pair of Twos)
3f098f87: shows [Kd Kc] (Pair of Kings and Pair of Fives)
*** SHOWDOWN ***
3f098f87 collected $0.65 from pot
*** SUMMARY ***
Total pot $0.68 | Rake $0.03 | Jackpot $0 | Bingo $0 | Fortune $0 | Tax $0
Board [4h 2d 5h 5c 2s]
Seat 1: Hero folded before Flop (didn't bet)
Seat 2: 3f098f87 showed [Kd Kc] and won ($0.65) with Pair of Kings and Pair of Fives
Seat 3: dd54495c folded before Flop (didn't bet)
Seat 4: 41cfc3f2 (button) folded before Flop (didn't bet)
Seat 5: ca94f02f (small blind) folded before Flop
Seat 6: 837ac8c6 (big blind) showed [Qh 6h] and lost with Pair of Fives and Pair of Twos


Poker Hand #HD1724715890: Hold'em No Limit ($0.02/$0.05) - 2024/04/10 20:59:02
Table 'NLHBlue24' 6-max Seat #3 is the button
Seat 1: Hero ($5.91 in chips)
Seat 2: 3f098f87 ($5 in chips)
Seat 3: dd54495c ($6.6 in chips)
Seat 4: 41cfc3f2 ($11.08 in chips)
Seat 5: ca94f02f ($2.26 in chips)
Seat 6: 837ac8c6 ($1.92 in chips)
41cfc3f2: posts small blind $0.02
ca94f02f: posts big blind $0.05
*** HOLE CARDS ***
Dealt to Hero [8d 3h]
Dealt to 3f098f87 
Dealt to dd54495c 
Dealt to 41cfc3f2 
Dealt to ca94f02f 
Dealt to 837ac8c6 
837ac8c6: folds
Hero: folds
3f098f87: folds
dd54495c: folds
41cfc3f2: folds
Uncalled bet ($0.03) returned to ca94f02f
*** SHOWDOWN ***
ca94f02f collected $0.04 from pot
*** SUMMARY ***
Total pot $0.04 | Rake $0 | Jackpot $0 | Bingo $0 | Fortune $0 | Tax $0
Seat 1: Hero folded before Flop (didn't bet)
Seat 2: 3f098f87 folded before Flop (didn't bet)
Seat 3: dd54495c (button) folded before Flop (didn't bet)
Seat 4: 41cfc3f2 (small blind) folded before Flop
Seat 5: ca94f02f (big blind) collected ($0.04)
Seat 6: 837ac8c6 folded before Flop (didn't bet)


Poker Hand #HD1724715786: Hold'em No Limit ($0.02/$0.05) - 2024/04/10 20:58:13
Table 'NLHBlue24' 6-max Seat #2 is the button
Seat 1: Hero ($5.69 in chips)
Seat 2: 3f098f87 ($5 in chips)
Seat 3: dd54495c ($6.62 in chips)
Seat 4: 41cfc3f2 ($11.13 in chips)
Seat 5: ca94f02f ($2.26 in chips)
Seat 6: 837ac8c6 ($2.09 in chips)
dd54495c: posts small blind $0.02
41cfc3f2: posts big blind $0.05
*** HOLE CARDS ***
Dealt to Hero [Jc Ks]
Dealt to 3f098f87 
Dealt to dd54495c 
Dealt to 41cfc3f2 
Dealt to ca94f02f 
Dealt to 837ac8c6 
ca94f02f: folds
837ac8c6: calls $0.05
Hero: raises $0.12 to $0.17
3f098f87: folds
dd54495c: folds
41cfc3f2: folds
837ac8c6: calls $0.12
*** FLOP *** [Jd As 8s]
837ac8c6: checks
Hero: checks
*** TURN *** [Jd As 8s] [3s]
837ac8c6: checks
Hero: bets $0.2
837ac8c6: folds
Uncalled bet ($0.2) returned to Hero
*** SHOWDOWN ***
Hero collected $0.39 from pot
*** SUMMARY ***
Total pot $0.41 | Rake $0.02 | Jackpot $0 | Bingo $0 | Fortune $0 | Tax $0
Board [Jd As 8s 3s]
Seat 1: Hero won ($0.39)
Seat 2: 3f098f87 (button) folded before Flop (didn't bet)
Seat 3: dd54495c (small blind) folded before Flop
Seat 4: 41cfc3f2 (big blind) folded before Flop
Seat 5: ca94f02f folded before Flop (didn't bet)
Seat 6: 837ac8c6 folded on the Turn


Poker Hand #HD1724715710: Hold'em No Limit ($0.02/$0.05) - 2024/04/10 20:57:30
Table 'NLHBlue24' 6-max Seat #1 is the button
Seat 1: Hero ($5.69 in chips)
Seat 2: 3f098f87 ($5 in chips)
Seat 3: dd54495c ($6.67 in chips)
Seat 4: 41cfc3f2 ($11.13 in chips)
Seat 5: ca94f02f ($2.58 in chips)
Seat 6: 837ac8c6 ($1.73 in chips)
3f098f87: posts small blind $0.02
dd54495c: posts big blind $0.05
*** HOLE CARDS ***
Dealt to Hero [8c 3c]
Dealt to 3f098f87 
Dealt to dd54495c 
Dealt to 41cfc3f2 
Dealt to ca94f02f 
Dealt to 837ac8c6 
41cfc3f2: folds
ca94f02f: calls $0.05
837ac8c6: calls $0.05
Hero: folds
3f098f87: folds
dd54495c: checks
*** FLOP *** [Kc 7d 4d]
dd54495c: checks
ca94f02f: checks
837ac8c6: bets $0.09
dd54495c: folds
ca94f02f: calls $0.09
*** TURN *** [Kc 7d 4d] [6s]
ca94f02f: bets $0.18
837ac8c6: calls $0.18
*** RIVER *** [Kc 7d 4d 6s] [8h]
ca94f02f: checks
837ac8c6: checks
ca94f02f: shows [Ac 6c] (Pair of Sixes)
837ac8c6: shows [Kh 3h] (Pair of Kings)
*** SHOWDOWN ***
837ac8c6 collected $0.68 from pot
*** SUMMARY ***
Total pot $0.71 | Rake $0.03 | Jackpot $0 | Bingo $0 | Fortune $0 | Tax $0
Board [Kc 7d 4d 6s 8h]
Seat 1: Hero (button) folded before Flop (didn't bet)
Seat 2: 3f098f87 (small blind) folded before Flop
Seat 3: dd54495c (big blind) folded on the Flop
Seat 4: 41cfc3f2 folded before Flop (didn't bet)
Seat 5: ca94f02f showed [Ac 6c] and lost with Pair of Sixes
Seat 6: 837ac8c6 showed [Kh 3h] and won ($0.68) with Pair of Kings


Poker Hand #HD1724625598: Hold'em No Limit ($0.02/$0.05) - 2024/04/10 20:56:38
Table 'NLHBlue24' 6-max Seat #6 is the button
Seat 1: Hero ($5.99 in chips)
Seat 2: 3f098f87 ($5 in chips)
Seat 3: dd54495c ($6.67 in chips)
Seat 4: 41cfc3f2 ($11.13 in chips)
Seat 5: ca94f02f ($2.26 in chips)
Seat 6: 837ac8c6 ($1.73 in chips)
Hero: posts small blind $0.02
3f098f87: posts big blind $0.05
*** HOLE CARDS ***
Dealt to Hero [8d 7d]
Dealt to 3f098f87 
Dealt to dd54495c 
Dealt to 41cfc3f2 
Dealt to ca94f02f 
Dealt to 837ac8c6 
dd54495c: folds
41cfc3f2: folds
ca94f02f: calls $0.05
837ac8c6: folds
Hero: raises $0.1 to $0.15
3f098f87: folds
ca94f02f: calls $0.1
*** FLOP *** [Ac Ks Th]
Hero: bets $0.15
ca94f02f: raises $0.22 to $0.37
Hero: folds
Uncalled bet ($0.22) returned to ca94f02f
*** SHOWDOWN ***
ca94f02f collected $0.62 from pot
*** SUMMARY ***
Total pot $0.65 | Rake $0.03 | Jackpot $0 | Bingo $0 | Fortune $0 | Tax $0
Board [Ac Ks Th]
Seat 1: Hero (small blind) folded on the Flop
Seat 2: 3f098f87 (big blind) folded before Flop
Seat 3: dd54495c folded before Flop (didn't bet)
Seat 4: 41cfc3f2 folded before Flop (didn't bet)
Seat 5: ca94f02f won ($0.62)
Seat 6: 837ac8c6 (button) folded before Flop (didn't bet)


Poker Hand #HD1724625535: Hold'em No Limit ($0.02/$0.05) - 2024/04/10 20:56:06
Table 'NLHBlue24' 6-max Seat #5 is the button
Seat 1: Hero ($6.04 in chips)
Seat 3: dd54495c ($6.79 in chips)
Seat 4: 41cfc3f2 ($11.13 in chips)
Seat 5: ca94f02f ($1.99 in chips)
Seat 6: 837ac8c6 ($1.85 in chips)
837ac8c6: posts small blind $0.02
Hero: posts big blind $0.05
*** HOLE CARDS ***
Dealt to Hero [Jh 2h]
Dealt to dd54495c 
Dealt to 41cfc3f2 
Dealt to ca94f02f 
Dealt to 837ac8c6 
dd54495c: raises $0.07 to $0.12
41cfc3f2: folds
ca94f02f: calls $0.12
837ac8c6: calls $0.1
Hero: folds
*** FLOP *** [7c 3c 2d]
837ac8c6: checks
dd54495c: checks
ca94f02f: bets $0.21
837ac8c6: folds
dd54495c: folds
Uncalled bet ($0.21) returned to ca94f02f
*** SHOWDOWN ***
ca94f02f collected $0.39 from pot
*** SUMMARY ***
Total pot $0.41 | Rake $0.02 | Jackpot $0 | Bingo $0 | Fortune $0 | Tax $0
Board [7c 3c 2d]
Seat 1: Hero (big blind) folded before Flop
Seat 3: dd54495c folded on the Flop
Seat 4: 41cfc3f2 folded before Flop (didn't bet)
Seat 5: ca94f02f (button) won ($0.39)
Seat 6: 837ac8c6 (small blind) folded on the Flop


Poker Hand #HD1724625481: Hold'em No Limit ($0.02/$0.05) - 2024/04/10 20:55:35
Table 'NLHBlue24' 6-max Seat #4 is the button
Seat 1: Hero ($6.04 in chips)
Seat 3: dd54495c ($6.79 in chips)
Seat 4: 41cfc3f2 ($10.94 in chips)
Seat 5: ca94f02f ($2.09 in chips)
Seat 6: 837ac8c6 ($1.95 in chips)
ca94f02f: posts small blind $0.02
837ac8c6: posts big blind $0.05
*** HOLE CARDS ***
Dealt to Hero [5s Jd]
Dealt to dd54495c 
Dealt to 41cfc3f2 
Dealt to ca94f02f 
Dealt to 837ac8c6 
Hero: folds
dd54495c: folds
41cfc3f2: raises $0.05 to $0.1
ca94f02f: calls $0.08
837ac8c6: calls $0.05
*** FLOP *** [2d Kc 7h]
ca94f02f: checks
837ac8c6: checks
41cfc3f2: bets $0.25
ca94f02f: folds
837ac8c6: folds
Uncalled bet ($0.25) returned to 41cfc3f2
*** SHOWDOWN ***
41cfc3f2 collected $0.29 from pot
*** SUMMARY ***
Total pot $0.3 | Rake $0.01 | Jackpot $0 | Bingo $0 | Fortune $0 | Tax $0
Board [2d Kc 7h]
Seat 1: Hero folded before Flop (didn't bet)
Seat 3: dd54495c folded before Flop (didn't bet)
Seat 4: 41cfc3f2 (button) won ($0.29)
Seat 5: ca94f02f (small blind) folded on the Flop
Seat 6: 837ac8c6 (big blind) folded on the Flop


Poker Hand #HD1724625357: Hold'em No Limit ($0.02/$0.05) - 2024/04/10 20:54:34
Table 'NLHBlue24' 6-max Seat #3 is the button
Seat 1: Hero ($6.7 in chips)
Seat 3: dd54495c ($6.08 in chips)
Seat 4: 41cfc3f2 ($10.96 in chips)
Seat 5: ca94f02f ($2.14 in chips)
Seat 6: 837ac8c6 ($2 in chips)
41cfc3f2: posts small blind $0.02
ca94f02f: posts big blind $0.05
*** HOLE CARDS ***
Dealt to Hero [Js Jh]
Dealt to dd54495c 
Dealt to 41cfc3f2 
Dealt to ca94f02f 
Dealt to 837ac8c6 
837ac8c6: calls $0.05
Hero: raises $0.06 to $0.11
dd54495c: raises $0.55 to $0.66
41cfc3f2: folds
ca94f02f: folds
837ac8c6: folds
Hero: calls $0.55
*** FLOP *** [9s 2h Ac]
Hero: checks
dd54495c: checks
*** TURN *** [9s 2h Ac] [Qs]
Hero: checks
dd54495c: checks
*** RIVER *** [9s 2h Ac Qs] [Tc]
Hero: checks
dd54495c: bets $0.72
Hero: folds
Uncalled bet ($0.72) returned to dd54495c
*** SHOWDOWN ***
dd54495c collected $1.37 from pot
*** SUMMARY ***
Total pot $1.44 | Rake $0.07 | Jackpot $0 | Bingo $0 | Fortune $0 | Tax $0
Board [9s 2h Ac Qs Tc]
Seat 1: Hero folded on the River
Seat 3: dd54495c (button) won ($1.37)
Seat 4: 41cfc3f2 (small blind) folded before Flop
Seat 5: ca94f02f (big blind) folded before Flop
Seat 6: 837ac8c6 folded before Flop


Poker Hand #HD1724625311: Hold'em No Limit ($0.02/$0.05) - 2024/04/10 20:54:12
Table 'NLHBlue24' 6-max Seat #1 is the button
Seat 1: Hero ($6.7 in chips)
Seat 3: dd54495c ($6.1 in chips)
Seat 4: 41cfc3f2 ($11.01 in chips)
Seat 5: ca94f02f ($2.14 in chips)
Seat 6: 837ac8c6 ($1.93 in chips)
dd54495c: posts small blind $0.02
41cfc3f2: posts big blind $0.05
*** HOLE CARDS ***
Dealt to Hero [4s Ac]
Dealt to dd54495c 
Dealt to 41cfc3f2 
Dealt to ca94f02f 
Dealt to 837ac8c6 
ca94f02f: folds
837ac8c6: calls $0.05
Hero: folds
dd54495c: folds
41cfc3f2: checks
*** FLOP *** [4c 5s Ad]
41cfc3f2: checks
837ac8c6: bets $0.06
41cfc3f2: folds
Uncalled bet ($0.06) returned to 837ac8c6
*** SHOWDOWN ***
837ac8c6 collected $0.12 from pot
*** SUMMARY ***
Total pot $0.12 | Rake $0 | Jackpot $0 | Bingo $0 | Fortune $0 | Tax $0
Board [4c 5s Ad]
Seat 1: Hero (button) folded before Flop (didn't bet)
Seat 3: dd54495c (small blind) folded before Flop
Seat 4: 41cfc3f2 (big blind) folded on the Flop
Seat 5: ca94f02f folded before Flop (didn't bet)
Seat 6: 837ac8c6 won ($0.12)


Poker Hand #HD1724625256: Hold'em No Limit ($0.02/$0.05) - 2024/04/10 20:53:43
Table 'NLHBlue24' 6-max Seat #6 is the button
Seat 1: Hero ($6.72 in chips)
Seat 3: dd54495c ($6.2 in chips)
Seat 4: 41cfc3f2 ($11.01 in chips)
Seat 5: ca94f02f ($1.94 in chips)
Seat 6: 837ac8c6 ($2.03 in chips)
Hero: posts small blind $0.02
dd54495c: posts big blind $0.05
*** HOLE CARDS ***
Dealt to Hero [Td 2h]
Dealt to dd54495c 
Dealt to 41cfc3f2 
Dealt to ca94f02f 
Dealt to 837ac8c6 
41cfc3f2: folds
ca94f02f: raises $0.05 to $0.1
837ac8c6: calls $0.1
Hero: folds
dd54495c: calls $0.05
*** FLOP *** [Kh 9h 6d]
dd54495c: checks
ca94f02f: bets $0.15
837ac8c6: folds
dd54495c: folds
Uncalled bet ($0.15) returned to ca94f02f
*** SHOWDOWN ***
ca94f02f collected $0.3 from pot
*** SUMMARY ***
Total pot $0.32 | Rake $0.02 | Jackpot $0 | Bingo $0 | Fortune $0 | Tax $0
Board [Kh 9h 6d]
Seat 1: Hero (small blind) folded before Flop
Seat 3: dd54495c (big blind) folded on the Flop
Seat 4: 41cfc3f2 folded before Flop (didn't bet)
Seat 5: ca94f02f won ($0.3)
Seat 6: 837ac8c6 (button) folded on the Flop


Poker Hand #HD1724625176: Hold'em No Limit ($0.02/$0.05) - 2024/04/10 20:53:02
Table 'NLHBlue24' 6-max Seat #5 is the button
Seat 1: Hero ($6.77 in chips)
Seat 2: d7816934 ($5.67 in chips)
Seat 3: dd54495c ($6.2 in chips)
Seat 4: 41cfc3f2 ($11.14 in chips)
Seat 5: ca94f02f ($1.94 in chips)
Seat 6: 837ac8c6 ($2.56 in chips)
837ac8c6: posts small blind $0.02
Hero: posts big blind $0.05
*** HOLE CARDS ***
Dealt to Hero [7c Ks]
Dealt to d7816934 
Dealt to dd54495c 
Dealt to 41cfc3f2 
Dealt to ca94f02f 
Dealt to 837ac8c6 
d7816934: raises $0.08 to $0.13
dd54495c: folds
41cfc3f2: calls $0.13
ca94f02f: folds
837ac8c6: calls $0.11
Hero: folds
*** FLOP *** [8h 8s Kh]
837ac8c6: bets $0.15
d7816934: calls $0.15
41cfc3f2: folds
*** TURN *** [8h 8s Kh] [6h]
837ac8c6: bets $0.25
d7816934: raises $0.62 to $0.87
837ac8c6: folds
Uncalled bet ($0.62) returned to d7816934
*** SHOWDOWN ***
d7816934 collected $1.18 from pot
*** SUMMARY ***
Total pot $1.24 | Rake $0.06 | Jackpot $0 | Bingo $0 | Fortune $0 | Tax $0
Board [8h 8s Kh 6h]
Seat 1: Hero (big blind) folded before Flop
Seat 2: d7816934 won ($1.18)
Seat 3: dd54495c folded before Flop (didn't bet)
Seat 4: 41cfc3f2 folded on the Flop
Seat 5: ca94f02f (button) folded before Flop (didn't bet)
Seat 6: 837ac8c6 (small blind) folded on the Turn


Poker Hand #HD1724625109: Hold'em No Limit ($0.02/$0.05) - 2024/04/10 20:52:25
Table 'NLHBlue24' 6-max Seat #4 is the button
Seat 1: Hero ($6.77 in chips)
Seat 2: d7816934 ($5.67 in chips)
Seat 3: dd54495c ($6.2 in chips)
Seat 4: 41cfc3f2 ($11.03 in chips)
Seat 5: ca94f02f ($1.96 in chips)
Seat 6: 837ac8c6 ($2.66 in chips)
ca94f02f: posts small blind $0.02
837ac8c6: posts big blind $0.05
*** HOLE CARDS ***
Dealt to Hero [5c 8h]
Dealt to d7816934 
Dealt to dd54495c 
Dealt to 41cfc3f2 
Dealt to ca94f02f 
Dealt to 837ac8c6 
Hero: folds
d7816934: folds
dd54495c: folds
41cfc3f2: raises $0.05 to $0.1
ca94f02f: folds
837ac8c6: calls $0.05
*** FLOP *** [7d 9s Ad]
837ac8c6: checks
41cfc3f2: bets $0.11
837ac8c6: folds
Uncalled bet ($0.11) returned to 41cfc3f2
*** SHOWDOWN ***
41cfc3f2 collected $0.21 from pot
*** SUMMARY ***
Total pot $0.22 | Rake $0.01 | Jackpot $0 | Bingo $0 | Fortune $0 | Tax $0
Board [7d 9s Ad]
Seat 1: Hero folded before Flop (didn't bet)
Seat 2: d7816934 folded before Flop (didn't bet)
Seat 3: dd54495c folded before Flop (didn't bet)
Seat 4: 41cfc3f2 (button) won ($0.21)
Seat 5: ca94f02f (small blind) folded before Flop
Seat 6: 837ac8c6 (big blind) folded on the Flop


Poker Hand #HD1724624974: Hold'em No Limit ($0.02/$0.05) - 2024/04/10 20:51:21
Table 'NLHBlue24' 6-max Seat #3 is the button
Seat 1: Hero ($6.77 in chips)
Seat 2: d7816934 ($5.67 in chips)
Seat 3: dd54495c ($6.2 in chips)
Seat 4: 41cfc3f2 ($11.41 in chips)
Seat 5: ca94f02f ($1.62 in chips)
Seat 6: 837ac8c6 ($2.66 in chips)
41cfc3f2: posts small blind $0.02
ca94f02f: posts big blind $0.05
*** HOLE CARDS ***
Dealt to Hero [2s 5s]
Dealt to d7816934 
Dealt to dd54495c 
Dealt to 41cfc3f2 
Dealt to ca94f02f 
Dealt to 837ac8c6 
837ac8c6: folds
Hero: folds
d7816934: folds
dd54495c: folds
41cfc3f2: raises $0.05 to $0.1
ca94f02f: calls $0.05
*** FLOP *** [7c 3c 7h]
41cfc3f2: bets $0.14
ca94f02f: raises $0.14 to $0.28
41cfc3f2: calls $0.14
*** TURN *** [7c 3c 7h] [4h]
41cfc3f2: checks
ca94f02f: bets $0.55
41cfc3f2: folds
Uncalled bet ($0.55) returned to ca94f02f
ca94f02f: shows [Td Ts] (Pair of Tens and Pair of Sevens)
*** SHOWDOWN ***
ca94f02f collected $0.72 from pot
*** SUMMARY ***
Total pot $0.76 | Rake $0.04 | Jackpot $0 | Bingo $0 | Fortune $0 | Tax $0
Board [7c 3c 7h 4h]
Seat 1: Hero folded before Flop (didn't bet)
Seat 2: d7816934 folded before Flop (didn't bet)
Seat 3: dd54495c (button) folded before Flop (didn't bet)
Seat 4: 41cfc3f2 (small blind) folded on the Turn
Seat 5: ca94f02f (big blind) showed [Td Ts] and won ($0.72)
Seat 6: 837ac8c6 folded before Flop (didn't bet)


Poker Hand #HD1724624885: Hold'em No Limit ($0.02/$0.05) - 2024/04/10 20:50:30
Table 'NLHBlue24' 6-max Seat #2 is the button
Seat 1: Hero ($6.77 in chips)
Seat 2: d7816934 ($5 in chips)
Seat 3: dd54495c ($6.22 in chips)
Seat 4: 41cfc3f2 ($11.46 in chips)
Seat 5: ca94f02f ($2.29 in chips)
Seat 6: 837ac8c6 ($2.66 in chips)
dd54495c: posts small blind $0.02
41cfc3f2: posts big blind $0.05
*** HOLE CARDS ***
Dealt to Hero [6h Ts]
Dealt to d7816934 
Dealt to dd54495c 
Dealt to 41cfc3f2 
Dealt to ca94f02f 
Dealt to 837ac8c6 
ca94f02f: raises $0.15 to $0.2
837ac8c6: folds
Hero: folds
d7816934: raises $0.47 to $0.67
dd54495c: folds
41cfc3f2: folds
ca94f02f: calls $0.47
*** FLOP *** [Tc 7d Ah]
ca94f02f: checks
d7816934: bets $0.47
ca94f02f: folds
Uncalled bet ($0.47) returned to d7816934
*** SHOWDOWN ***
d7816934 collected $1.34 from pot
*** SUMMARY ***
Total pot $1.41 | Rake $0.07 | Jackpot $0 | Bingo $0 | Fortune $0 | Tax $0
Board [Tc 7d Ah]
Seat 1: Hero folded before Flop (didn't bet)
Seat 2: d7816934 (button) won ($1.34)
Seat 3: dd54495c (small blind) folded before Flop
Seat 4: 41cfc3f2 (big blind) folded before Flop
Seat 5: ca94f02f folded on the Flop
Seat 6: 837ac8c6 folded before Flop (didn't bet)


Poker Hand #HD1724624706: Hold'em No Limit ($0.02/$0.05) - 2024/04/10 20:48:58
Table 'NLHBlue24' 6-max Seat #1 is the button
Seat 1: Hero ($6.77 in chips)
Seat 2: d7816934 ($5 in chips)
Seat 3: dd54495c ($5 in chips)
Seat 5: ca94f02f ($2.74 in chips)
Seat 6: 837ac8c6 ($3.11 in chips)
d7816934: posts small blind $0.02
dd54495c: posts big blind $0.05
*** HOLE CARDS ***
Dealt to Hero [Js 3c]
Dealt to d7816934 
Dealt to dd54495c 
Dealt to ca94f02f 
Dealt to 837ac8c6 
ca94f02f: calls $0.05
837ac8c6: calls $0.05
Hero: folds
d7816934: calls $0.03
dd54495c: checks
*** FLOP *** [Ad Td Ks]
d7816934: checks
dd54495c: bets $0.1
ca94f02f: calls $0.1
837ac8c6: calls $0.1
d7816934: calls $0.1
*** TURN *** [Ad Td Ks] [Qc]
d7816934: checks
dd54495c: bets $0.3
ca94f02f: calls $0.3
837ac8c6: calls $0.3
d7816934: calls $0.3
*** RIVER *** [Ad Td Ks Qc] [7c]
d7816934: checks
dd54495c: bets $1.35
ca94f02f: folds
837ac8c6: folds
d7816934: folds
Uncalled bet ($1.35) returned to dd54495c
ca94f02f: shows [Kd Qh] (Pair of Kings and Pair of Queens)
*** SHOWDOWN ***
dd54495c collected $1.67 from pot
*** SUMMARY ***
Total pot $1.8 | Rake $0.08 | Jackpot $0.05 | Bingo $0 | Fortune $0 | Tax $0
Board [Ad Td Ks Qc 7c]
Seat 1: Hero (button) folded before Flop (didn't bet)
Seat 2: d7816934 (small blind) folded on the River
Seat 3: dd54495c (big blind) won ($1.67)
Seat 5: ca94f02f folded on the River
Seat 6: 837ac8c6 folded on the River


Poker Hand #HD1724624654: Hold'em No Limit ($0.02/$0.05) - 2024/04/10 20:48:32
Table 'NLHBlue24' 6-max Seat #6 is the button
Seat 1: Hero ($6.79 in chips)
Seat 2: d7816934 ($5 in chips)
Seat 3: dd54495c ($5 in chips)
Seat 5: ca94f02f ($2.67 in chips)
Seat 6: 837ac8c6 ($3.11 in chips)
Hero: posts small blind $0.02
d7816934: posts big blind $0.05
*** HOLE CARDS ***
Dealt to Hero [5c 9c]
Dealt to d7816934 
Dealt to dd54495c 
Dealt to ca94f02f 
Dealt to 837ac8c6 
dd54495c: folds
ca94f02f: calls $0.05
837ac8c6: folds
Hero: folds
d7816934: checks
*** FLOP *** [Kc 8h 7h]
d7816934: checks
ca94f02f: bets $0.06
d7816934: folds
Uncalled bet ($0.06) returned to ca94f02f
*** SHOWDOWN ***
ca94f02f collected $0.12 from pot
*** SUMMARY ***
Total pot $0.12 | Rake $0 | Jackpot $0 | Bingo $0 | Fortune $0 | Tax $0
Board [Kc 8h 7h]
Seat 1: Hero (small blind) folded before Flop
Seat 2: d7816934 (big blind) folded on the Flop
Seat 3: dd54495c folded before Flop (didn't bet)
Seat 5: ca94f02f won ($0.12)
Seat 6: 837ac8c6 (button) folded before Flop (didn't bet)


Poker Hand #HD1724624619: Hold'em No Limit ($0.02/$0.05) - 2024/04/10 20:48:17
Table 'NLHBlue24' 6-max Seat #5 is the button
Seat 1: Hero ($6.84 in chips)
Seat 2: d7816934 ($5 in chips)
Seat 3: dd54495c ($5 in chips)
Seat 5: ca94f02f ($2.6 in chips)
Seat 6: 837ac8c6 ($3.13 in chips)
837ac8c6: posts small blind $0.02
Hero: posts big blind $0.05
*** HOLE CARDS ***
Dealt to Hero [6c Ad]
Dealt to d7816934 
Dealt to dd54495c 
Dealt to ca94f02f 
Dealt to 837ac8c6 
d7816934: folds
dd54495c: folds
ca94f02f: raises $0.05 to $0.1
837ac8c6: folds
Hero: folds
Uncalled bet ($0.05) returned to ca94f02f
*** SHOWDOWN ***
ca94f02f collected $0.12 from pot
*** SUMMARY ***
Total pot $0.12 | Rake $0 | Jackpot $0 | Bingo $0 | Fortune $0 | Tax $0
Seat 1: Hero (big blind) folded before Flop
Seat 2: d7816934 folded before Flop (didn't bet)
Seat 3: dd54495c folded before Flop (didn't bet)
Seat 5: ca94f02f (button) collected ($0.12)
Seat 6: 837ac8c6 (small blind) folded before Flop


Poker Hand #HD1724624488: Hold'em No Limit ($0.02/$0.05) - 2024/04/10 20:47:10
Table 'NLHBlue24' 6-max Seat #3 is the button
Seat 1: Hero ($6.84 in chips)
Seat 2: d7816934 ($5 in chips)
Seat 3: dd54495c ($5 in chips)
Seat 5: ca94f02f ($4.12 in chips)
Seat 6: 837ac8c6 ($1.52 in chips)
ca94f02f: posts small blind $0.02
837ac8c6: posts big blind $0.05
*** HOLE CARDS ***
Dealt to Hero [8h 6d]
Dealt to d7816934 
Dealt to dd54495c 
Dealt to ca94f02f 
Dealt to 837ac8c6 
Hero: folds
d7816934: folds
dd54495c: raises $0.07 to $0.12
ca94f02f: calls $0.1
837ac8c6: calls $0.07
*** FLOP *** [Ts 9c 9h]
ca94f02f: checks
837ac8c6: checks
dd54495c: bets $0.18
ca94f02f: raises $0.36 to $0.54
837ac8c6: calls $0.54
dd54495c: folds
*** TURN *** [Ts 9c 9h] [5s]
ca94f02f: checks
837ac8c6: bets $0.81
ca94f02f: raises $0.81 to $1.62
837ac8c6: calls $0.05 and is all-in
Uncalled bet ($0.76) returned to ca94f02f
ca94f02f: shows [Th Jd] (Pair of Tens and Pair of Nines)
837ac8c6: shows [Kh 9d] (Three Nines)
*** RIVER *** [Ts 9c 9h 5s] [5d]
*** SHOWDOWN ***
837ac8c6 collected $3.13 from pot
*** SUMMARY ***
Total pot $3.34 | Rake $0.16 | Jackpot $0.05 | Bingo $0 | Fortune $0 | Tax $0
Board [Ts 9c 9h 5s 5d]
Seat 1: Hero folded before Flop (didn't bet)
Seat 2: d7816934 folded before Flop (didn't bet)
Seat 3: dd54495c (button) folded on the Flop
Seat 5: ca94f02f (small blind) showed [Th Jd] and lost with Pair of Tens and Pair of Nines
Seat 6: 837ac8c6 (big blind) showed [Kh 9d] and won ($3.13) with Nines Full over Fives


Poker Hand #HD1724624454: Hold'em No Limit ($0.02/$0.05) - 2024/04/10 20:46:55
Table 'NLHBlue24' 6-max Seat #2 is the button
Seat 1: Hero ($6.84 in chips)
Seat 2: d7816934 ($5 in chips)
Seat 3: dd54495c ($5 in chips)
Seat 5: ca94f02f ($4.1 in chips)
Seat 6: 837ac8c6 ($1.52 in chips)
dd54495c: posts small blind $0.02
ca94f02f: posts big blind $0.05
*** HOLE CARDS ***
Dealt to Hero [Qc 2c]
Dealt to d7816934 
Dealt to dd54495c 
Dealt to ca94f02f 
Dealt to 837ac8c6 
837ac8c6: folds
Hero: folds
d7816934: folds
dd54495c: folds
Uncalled bet ($0.03) returned to ca94f02f
*** SHOWDOWN ***
ca94f02f collected $0.04 from pot
*** SUMMARY ***
Total pot $0.04 | Rake $0 | Jackpot $0 | Bingo $0 | Fortune $0 | Tax $0
Seat 1: Hero folded before Flop (didn't bet)
Seat 2: d7816934 (button) folded before Flop (didn't bet)
Seat 3: dd54495c (small blind) folded before Flop
Seat 5: ca94f02f (big blind) collected ($0.04)
Seat 6: 837ac8c6 folded before Flop (didn't bet)


Poker Hand #HD1724624417: Hold'em No Limit ($0.02/$0.05) - 2024/04/10 20:46:32
Table 'NLHBlue24' 6-max Seat #1 is the button
Seat 1: Hero ($6.84 in chips)
Seat 2: d7816934 ($5 in chips)
Seat 3: dd54495c ($5.05 in chips)
Seat 5: ca94f02f ($4.03 in chips)
Seat 6: 837ac8c6 ($1.52 in chips)
d7816934: posts small blind $0.02
dd54495c: posts big blind $0.05
*** HOLE CARDS ***
Dealt to Hero [9h 4d]
Dealt to d7816934 
Dealt to dd54495c 
Dealt to ca94f02f 
Dealt to 837ac8c6 
ca94f02f: raises $0.1 to $0.15
837ac8c6: folds
Hero: folds
d7816934: folds
dd54495c: folds
Uncalled bet ($0.1) returned to ca94f02f
*** SHOWDOWN ***
ca94f02f collected $0.12 from pot
*** SUMMARY ***
Total pot $0.12 | Rake $0 | Jackpot $0 | Bingo $0 | Fortune $0 | Tax $0
Seat 1: Hero (button) folded before Flop (didn't bet)
Seat 2: d7816934 (small blind) folded before Flop
Seat 3: dd54495c (big blind) folded before Flop
Seat 5: ca94f02f collected ($0.12)
Seat 6: 837ac8c6 folded before Flop (didn't bet)


Poker Hand #HD1724624326: Hold'em No Limit ($0.02/$0.05) - 2024/04/10 20:45:49
Table 'NLHBlue24' 6-max Seat #6 is the button
Seat 1: Hero ($6.58 in chips)
Seat 2: d7816934 ($5 in chips)
Seat 3: dd54495c ($5.16 in chips)
Seat 5: ca94f02f ($4.03 in chips)
Seat 6: 837ac8c6 ($1.63 in chips)
Hero: posts small blind $0.02
d7816934: posts big blind $0.05
*** HOLE CARDS ***
Dealt to Hero [Ad Kc]
Dealt to d7816934 
Dealt to dd54495c 
Dealt to ca94f02f 
Dealt to 837ac8c6 
dd54495c: raises $0.06 to $0.11
ca94f02f: folds
837ac8c6: calls $0.11
Hero: raises $0.39 to $0.5
d7816934: folds
dd54495c: folds
837ac8c6: folds
Uncalled bet ($0.39) returned to Hero
*** SHOWDOWN ***
Hero collected $0.37 from pot
*** SUMMARY ***
Total pot $0.38 | Rake $0.01 | Jackpot $0 | Bingo $0 | Fortune $0 | Tax $0
Seat 1: Hero (small blind) collected ($0.37)
Seat 2: d7816934 (big blind) folded before Flop
Seat 3: dd54495c folded before Flop
Seat 5: ca94f02f folded before Flop (didn't bet)
Seat 6: 837ac8c6 (button) folded before Flop


Poker Hand #HD1724624277: Hold'em No Limit ($0.02/$0.05) - 2024/04/10 20:45:27
Table 'NLHBlue24' 6-max Seat #5 is the button
Seat 1: Hero ($6.63 in chips)
Seat 3: dd54495c ($5.16 in chips)
Seat 5: ca94f02f ($3.96 in chips)
Seat 6: 837ac8c6 ($1.65 in chips)
837ac8c6: posts small blind $0.02
Hero: posts big blind $0.05
*** HOLE CARDS ***
Dealt to Hero [3h 5d]
Dealt to dd54495c 
Dealt to ca94f02f 
Dealt to 837ac8c6 
dd54495c: folds
ca94f02f: raises $0.05 to $0.1
837ac8c6: folds
Hero: folds
Uncalled bet ($0.05) returned to ca94f02f
*** SHOWDOWN ***
ca94f02f collected $0.12 from pot
*** SUMMARY ***
Total pot $0.12 | Rake $0 | Jackpot $0 | Bingo $0 | Fortune $0 | Tax $0
Seat 1: Hero (big blind) folded before Flop
Seat 3: dd54495c folded before Flop (didn't bet)
Seat 5: ca94f02f (button) collected ($0.12)
Seat 6: 837ac8c6 (small blind) folded before Flop


Poker Hand #HD1724624228: Hold'em No Limit ($0.02/$0.05) - 2024/04/10 20:45:02
Table 'NLHBlue24' 6-max Seat #3 is the button
Seat 1: Hero ($6.63 in chips)
Seat 3: dd54495c ($5 in chips)
Seat 5: ca94f02f ($3.98 in chips)
Seat 6: 837ac8c6 ($1.8 in chips)
ca94f02f: posts small blind $0.02
837ac8c6: posts big blind $0.05
*** HOLE CARDS ***
Dealt to Hero [Qc 7c]
Dealt to dd54495c 
Dealt to ca94f02f 
Dealt to 837ac8c6 
Hero: folds
dd54495c: raises $0.1 to $0.15
ca94f02f: folds
837ac8c6: calls $0.1
*** FLOP *** [4s 4c Tc]
837ac8c6: checks
dd54495c: bets $0.16
837ac8c6: folds
Uncalled bet ($0.16) returned to dd54495c
*** SHOWDOWN ***
dd54495c collected $0.31 from pot
*** SUMMARY ***
Total pot $0.32 | Rake $0.01 | Jackpot $0 | Bingo $0 | Fortune $0 | Tax $0
Board [4s 4c Tc]
Seat 1: Hero folded before Flop (didn't bet)
Seat 3: dd54495c (button) won ($0.31)
Seat 5: ca94f02f (small blind) folded before Flop
Seat 6: 837ac8c6 (big blind) folded on the Flop


Poker Hand #HD1724624123: Hold'em No Limit ($0.02/$0.05) - 2024/04/10 20:44:14
Table 'NLHBlue24' 6-max Seat #1 is the button
Seat 1: Hero ($6.63 in chips)
Seat 3: dd54495c ($5 in chips)
Seat 5: ca94f02f ($4.21 in chips)
Seat 6: 837ac8c6 ($1.57 in chips)
dd54495c: posts small blind $0.02
ca94f02f: posts big blind $0.05
*** HOLE CARDS ***
Dealt to Hero [5c Ad]
Dealt to dd54495c 
Dealt to ca94f02f 
Dealt to 837ac8c6 
837ac8c6: calls $0.05
Hero: folds
dd54495c: folds
ca94f02f: checks
*** FLOP *** [3h 5d 6c]
ca94f02f: bets $0.06
837ac8c6: calls $0.06
*** TURN *** [3h 5d 6c] [4h]
ca94f02f: bets $0.12
837ac8c6: calls $0.12
*** RIVER *** [3h 5d 6c 4h] [8c]
ca94f02f: checks
837ac8c6: bets $0.24
ca94f02f: folds
Uncalled bet ($0.24) returned to 837ac8c6
*** SHOWDOWN ***
837ac8c6 collected $0.46 from pot
*** SUMMARY ***
Total pot $0.48 | Rake $0.02 | Jackpot $0 | Bingo $0 | Fortune $0 | Tax $0
Board [3h 5d 6c 4h 8c]
Seat 1: Hero (button) folded before Flop (didn't bet)
Seat 3: dd54495c (small blind) folded before Flop
Seat 5: ca94f02f (big blind) folded on the River
Seat 6: 837ac8c6 won ($0.46)


Poker Hand #HD1724624060: Hold'em No Limit ($0.02/$0.05) - 2024/04/10 20:43:47
Table 'NLHBlue24' 6-max Seat #6 is the button
Seat 1: Hero ($6.53 in chips)
Seat 3: dd54495c ($5 in chips)
Seat 5: ca94f02f ($4.26 in chips)
Seat 6: 837ac8c6 ($1.57 in chips)
Hero: posts small blind $0.02
dd54495c: posts big blind $0.05
*** HOLE CARDS ***
Dealt to Hero [6d 6s]
Dealt to dd54495c 
Dealt to ca94f02f 
Dealt to 837ac8c6 
ca94f02f: calls $0.05
837ac8c6: folds
Hero: raises $0.1 to $0.15
dd54495c: folds
ca94f02f: folds
Uncalled bet ($0.1) returned to Hero
*** SHOWDOWN ***
Hero collected $0.15 from pot
*** SUMMARY ***
Total pot $0.15 | Rake $0 | Jackpot $0 | Bingo $0 | Fortune $0 | Tax $0
Seat 1: Hero (small blind) collected ($0.15)
Seat 3: dd54495c (big blind) folded before Flop
Seat 5: ca94f02f folded before Flop
Seat 6: 837ac8c6 (button) folded before Flop (didn't bet)


Poker Hand #HD1724624015: Hold'em No Limit ($0.02/$0.05) - 2024/04/10 20:43:25
Table 'NLHBlue24' 6-max Seat #5 is the button
Seat 1: Hero ($6.58 in chips)
Seat 2: 148e211d ($5.07 in chips)
Seat 3: dd54495c ($5 in chips)
Seat 5: ca94f02f ($4.26 in chips)
Seat 6: 837ac8c6 ($1.52 in chips)
837ac8c6: posts small blind $0.02
Hero: posts big blind $0.05
*** HOLE CARDS ***
Dealt to Hero [8c Qh]
Dealt to 148e211d 
Dealt to dd54495c 
Dealt to ca94f02f 
Dealt to 837ac8c6 
148e211d: folds
dd54495c: folds
ca94f02f: folds
837ac8c6: calls $0.03
Hero: checks
*** FLOP *** [Kh 3d Ks]
837ac8c6: checks
Hero: checks
*** TURN *** [Kh 3d Ks] [2d]
837ac8c6: bets $0.05
Hero: folds
Uncalled bet ($0.05) returned to 837ac8c6
*** SHOWDOWN ***
837ac8c6 collected $0.1 from pot
*** SUMMARY ***
Total pot $0.1 | Rake $0 | Jackpot $0 | Bingo $0 | Fortune $0 | Tax $0
Board [Kh 3d Ks 2d]
Seat 1: Hero (big blind) folded on the Turn
Seat 2: 148e211d folded before Flop (didn't bet)
Seat 3: dd54495c folded before Flop (didn't bet)
Seat 5: ca94f02f (button) folded before Flop (didn't bet)
Seat 6: 837ac8c6 (small blind) won ($0.1)


Poker Hand #HD1724623942: Hold'em No Limit ($0.02/$0.05) - 2024/04/10 20:42:54
Table 'NLHBlue24' 6-max Seat #3 is the button
Seat 1: Hero ($6.58 in chips)
Seat 2: 148e211d ($5.07 in chips)
Seat 3: dd54495c ($5 in chips)
Seat 5: ca94f02f ($4.39 in chips)
Seat 6: 837ac8c6 ($1.4 in chips)
ca94f02f: posts small blind $0.02
837ac8c6: posts big blind $0.05
*** HOLE CARDS ***
Dealt to Hero [Qh 2h]
Dealt to 148e211d 
Dealt to dd54495c 
Dealt to ca94f02f 
Dealt to 837ac8c6 
Hero: folds
148e211d: folds
dd54495c: folds
ca94f02f: calls $0.03
837ac8c6: checks
*** FLOP *** [Ah 4s Ks]
ca94f02f: bets $0.08
837ac8c6: calls $0.08
*** TURN *** [Ah 4s Ks] [6h]
ca94f02f: checks
837ac8c6: checks
*** RIVER *** [Ah 4s Ks 6h] [8d]
ca94f02f: checks
837ac8c6: checks
ca94f02f: shows [7h 6c] (Pair of Sixes)
837ac8c6: shows [Kd 2s] (Pair of Kings)
*** SHOWDOWN ***
837ac8c6 collected $0.25 from pot
*** SUMMARY ***
Total pot $0.26 | Rake $0.01 | Jackpot $0 | Bingo $0 | Fortune $0 | Tax $0
Board [Ah 4s Ks 6h 8d]
Seat 1: Hero folded before Flop (didn't bet)
Seat 2: 148e211d folded before Flop (didn't bet)
Seat 3: dd54495c (button) folded before Flop (didn't bet)
Seat 5: ca94f02f (small blind) showed [7h 6c] and lost with Pair of Sixes
Seat 6: 837ac8c6 (big blind) showed [Kd 2s] and won ($0.25) with Pair of Kings


Poker Hand #HD1724623914: Hold'em No Limit ($0.02/$0.05) - 2024/04/10 20:42:39
Table 'NLHBlue24' 6-max Seat #2 is the button
Seat 1: Hero ($6.58 in chips)
Seat 2: 148e211d ($5 in chips)
Seat 3: dd54495c ($5 in chips)
Seat 5: ca94f02f ($4.44 in chips)
Seat 6: 837ac8c6 ($1.4 in chips)
dd54495c: posts small blind $0.02
ca94f02f: posts big blind $0.05
*** HOLE CARDS ***
Dealt to Hero [2s 8d]
Dealt to 148e211d 
Dealt to dd54495c 
Dealt to ca94f02f 
Dealt to 837ac8c6 
837ac8c6: folds
Hero: folds
148e211d: raises $0.07 to $0.12
dd54495c: folds
ca94f02f: folds
Uncalled bet ($0.07) returned to 148e211d
*** SHOWDOWN ***
148e211d collected $0.12 from pot
*** SUMMARY ***
Total pot $0.12 | Rake $0 | Jackpot $0 | Bingo $0 | Fortune $0 | Tax $0
Seat 1: Hero folded before Flop (didn't bet)
Seat 2: 148e211d (button) collected ($0.12)
Seat 3: dd54495c (small blind) folded before Flop
Seat 5: ca94f02f (big blind) folded before Flop
Seat 6: 837ac8c6 folded before Flop (didn't bet)


Poker Hand #HD1724623847: Hold'em No Limit ($0.02/$0.05) - 2024/04/10 20:42:08
Table 'NLHBlue24' 6-max Seat #1 is the button
Seat 1: Hero ($6.73 in chips)
Seat 2: 148e211d ($5 in chips)
Seat 3: dd54495c ($5 in chips)
Seat 5: ca94f02f ($4.24 in chips)
148e211d: posts small blind $0.02
dd54495c: posts big blind $0.05
*** HOLE CARDS ***
Dealt to Hero [Kd As]
Dealt to 148e211d 
Dealt to dd54495c 
Dealt to ca94f02f 
ca94f02f: calls $0.05
Hero: raises $0.1 to $0.15
148e211d: folds
dd54495c: folds
ca94f02f: calls $0.1
*** FLOP *** [Jh 2c 9s]
ca94f02f: bets $0.28
Hero: folds
Uncalled bet ($0.28) returned to ca94f02f
*** SHOWDOWN ***
ca94f02f collected $0.35 from pot
*** SUMMARY ***
Total pot $0.37 | Rake $0.02 | Jackpot $0 | Bingo $0 | Fortune $0 | Tax $0
Board [Jh 2c 9s]
Seat 1: Hero (button) folded on the Flop
Seat 2: 148e211d (small blind) folded before Flop
Seat 3: dd54495c (big blind) folded before Flop
Seat 5: ca94f02f won ($0.35)


Poker Hand #HD1724623649: Hold'em No Limit ($0.02/$0.05) - 2024/04/10 20:40:37
Table 'NLHBlue24' 6-max Seat #5 is the button
Seat 1: Hero ($6.78 in chips)
Seat 2: 148e211d ($5 in chips)
Seat 3: dd54495c ($5 in chips)
Seat 5: ca94f02f ($3.07 in chips)
Seat 6: 837ac8c6 ($1.33 in chips)
837ac8c6: posts small blind $0.02
Hero: posts big blind $0.05
*** HOLE CARDS ***
Dealt to Hero [3s Tc]
Dealt to 148e211d 
Dealt to dd54495c 
Dealt to ca94f02f 
Dealt to 837ac8c6 
148e211d: folds
dd54495c: folds
ca94f02f: raises $0.05 to $0.1
837ac8c6: raises $0.05 to $0.15
Hero: folds
ca94f02f: calls $0.05
*** FLOP *** [Jc 6d Ad]
837ac8c6: checks
ca94f02f: checks
*** TURN *** [Jc 6d Ad] [Jh]
837ac8c6: bets $0.18
ca94f02f: calls $0.18
*** RIVER *** [Jc 6d Ad Jh] [8d]
837ac8c6: bets $0.36
ca94f02f: raises $0.44 to $0.8
837ac8c6: raises $0.2 to $1 and is all-in
ca94f02f: calls $0.2
837ac8c6: shows [Kc Ah] (Pair of Aces and Pair of Jacks)
ca94f02f: shows [Kd Jd] (Ace High Flush)
*** SHOWDOWN ***
ca94f02f collected $2.5 from pot
*** SUMMARY ***
Total pot $2.71 | Rake $0.16 | Jackpot $0.05 | Bingo $0 | Fortune $0 | Tax $0
Board [Jc 6d Ad Jh 8d]
Seat 1: Hero (big blind) folded before Flop
Seat 2: 148e211d folded before Flop (didn't bet)
Seat 3: dd54495c folded before Flop (didn't bet)
Seat 5: ca94f02f (button) showed [Kd Jd] and won ($2.5) with Ace High Flush
Seat 6: 837ac8c6 (small blind) showed [Kc Ah] and lost with Pair of Aces and Pair of Jacks


Poker Hand #HD1724623551: Hold'em No Limit ($0.02/$0.05) - 2024/04/10 20:39:47
Table 'NLHBlue24' 6-max Seat #3 is the button
Seat 1: Hero ($6.64 in chips)
Seat 2: 148e211d ($5 in chips)
Seat 3: dd54495c ($5 in chips)
Seat 5: ca94f02f ($3.17 in chips)
Seat 6: 837ac8c6 ($1.38 in chips)
ca94f02f: posts small blind $0.02
837ac8c6: posts big blind $0.05
*** HOLE CARDS ***
Dealt to Hero [Ah 2h]
Dealt to 148e211d 
Dealt to dd54495c 
Dealt to ca94f02f 
Dealt to 837ac8c6 
Hero: raises $0.05 to $0.1
148e211d: folds
dd54495c: folds
ca94f02f: calls $0.08
837ac8c6: folds
*** FLOP *** [As 2s Kh]
ca94f02f: checks
Hero: bets $0.15
ca94f02f: folds
Uncalled bet ($0.15) returned to Hero
*** SHOWDOWN ***
Hero collected $0.24 from pot
*** SUMMARY ***
Total pot $0.25 | Rake $0.01 | Jackpot $0 | Bingo $0 | Fortune $0 | Tax $0
Board [As 2s Kh]
Seat 1: Hero won ($0.24)
Seat 2: 148e211d folded before Flop (didn't bet)
Seat 3: dd54495c (button) folded before Flop (didn't bet)
Seat 5: ca94f02f (small blind) folded on the Flop
Seat 6: 837ac8c6 (big blind) folded before Flop


Poker Hand #HD1724623402: Hold'em No Limit ($0.02/$0.05) - 2024/04/10 20:38:42
Table 'NLHBlue24' 6-max Seat #2 is the button
Seat 1: Hero ($6.64 in chips)
Seat 2: 148e211d ($5 in chips)
Seat 3: dd54495c ($5 in chips)
Seat 4: 41cfc3f2 ($11.51 in chips)
Seat 5: ca94f02f ($2.98 in chips)
Seat 6: 837ac8c6 ($1.52 in chips)
dd54495c: posts small blind $0.02
41cfc3f2: posts big blind $0.05
ca94f02f: posts big blind $0.05
*** HOLE CARDS ***
Dealt to Hero [2s 8h]
Dealt to 148e211d 
Dealt to dd54495c 
Dealt to 41cfc3f2 
Dealt to ca94f02f 
Dealt to 837ac8c6 
ca94f02f: checks
837ac8c6: calls $0.05
Hero: folds
148e211d: folds
dd54495c: folds
41cfc3f2: checks
*** FLOP *** [4c Qh 3h]
41cfc3f2: checks
ca94f02f: checks
837ac8c6: checks
*** TURN *** [4c Qh 3h] [9h]
41cfc3f2: checks
ca94f02f: bets $0.09
837ac8c6: calls $0.09
41cfc3f2: folds
*** RIVER *** [4c Qh 3h 9h] [9c]
ca94f02f: bets $0.18
837ac8c6: folds
Uncalled bet ($0.18) returned to ca94f02f
*** SHOWDOWN ***
ca94f02f collected $0.33 from pot
*** SUMMARY ***
Total pot $0.35 | Rake $0.02 | Jackpot $0 | Bingo $0 | Fortune $0 | Tax $0
Board [4c Qh 3h 9h 9c]
Seat 1: Hero folded before Flop (didn't bet)
Seat 2: 148e211d (button) folded before Flop (didn't bet)
Seat 3: dd54495c (small blind) folded before Flop
Seat 4: 41cfc3f2 (big blind) folded on the Turn
Seat 5: ca94f02f won ($0.33)
Seat 6: 837ac8c6 folded on the River


Poker Hand #HD1724623301: Hold'em No Limit ($0.02/$0.05) - 2024/04/10 20:37:51
Table 'NLHBlue24' 6-max Seat #1 is the button
Seat 1: Hero ($6.23 in chips)
Seat 2: 148e211d ($5 in chips)
Seat 3: dd54495c ($5 in chips)
Seat 4: 41cfc3f2 ($11.51 in chips)
Seat 6: 837ac8c6 ($1.9 in chips)
148e211d: posts small blind $0.02
dd54495c: posts big blind $0.05
*** HOLE CARDS ***
Dealt to Hero [8h Jh]
Dealt to 148e211d 
Dealt to dd54495c 
Dealt to 41cfc3f2 
Dealt to 837ac8c6 
41cfc3f2: folds
837ac8c6: calls $0.05
Hero: raises $0.12 to $0.17
148e211d: folds
dd54495c: folds
837ac8c6: calls $0.12
*** FLOP *** [Tc Jc 5d]
837ac8c6: bets $0.21
Hero: calls $0.21
*** TURN *** [Tc Jc 5d] [6s]
837ac8c6: checks
Hero: checks
*** RIVER *** [Tc Jc 5d 6s] [Kd]
837ac8c6: checks
Hero: checks
837ac8c6: shows [2s Ts] (Pair of Tens)
Hero: shows [8h Jh] (Pair of Jacks)
*** SHOWDOWN ***
Hero collected $0.79 from pot
*** SUMMARY ***
Total pot $0.83 | Rake $0.04 | Jackpot $0 | Bingo $0 | Fortune $0 | Tax $0
Board [Tc Jc 5d 6s Kd]
Seat 1: Hero (button) showed [8h Jh] and won ($0.79) with Pair of Jacks
Seat 2: 148e211d (small blind) folded before Flop
Seat 3: dd54495c (big blind) folded before Flop
Seat 4: 41cfc3f2 folded before Flop (didn't bet)
Seat 6: 837ac8c6 showed [2s Ts] and lost with Pair of Tens


Poker Hand #HD1724623179: Hold'em No Limit ($0.02/$0.05) - 2024/04/10 20:36:52
Table 'NLHBlue24' 6-max Seat #6 is the button
Seat 1: Hero ($6.04 in chips)
Seat 2: 148e211d ($5 in chips)
Seat 4: 41cfc3f2 ($11.51 in chips)
Seat 6: 837ac8c6 ($2.05 in chips)
Hero: posts small blind $0.02
148e211d: posts big blind $0.05
*** HOLE CARDS ***
Dealt to Hero [Ts 9c]
Dealt to 148e211d 
Dealt to 41cfc3f2 
Dealt to 837ac8c6 
41cfc3f2: folds
837ac8c6: calls $0.05
Hero: raises $0.1 to $0.15
148e211d: folds
837ac8c6: calls $0.1
*** FLOP *** [Tc 5c Td]
Hero: bets $0.2
837ac8c6: folds
Uncalled bet ($0.2) returned to Hero
*** SHOWDOWN ***
Hero collected $0.34 from pot
*** SUMMARY ***
Total pot $0.35 | Rake $0.01 | Jackpot $0 | Bingo $0 | Fortune $0 | Tax $0
Board [Tc 5c Td]
Seat 1: Hero (small blind) won ($0.34)
Seat 2: 148e211d (big blind) folded before Flop
Seat 4: 41cfc3f2 folded before Flop (didn't bet)
Seat 6: 837ac8c6 (button) folded on the Flop


Poker Hand #HD1724623135: Hold'em No Limit ($0.02/$0.05) - 2024/04/10 20:36:31
Table 'NLHBlue24' 6-max Seat #4 is the button
Seat 1: Hero ($6.09 in chips)
Seat 2: 148e211d ($5 in chips)
Seat 4: 41cfc3f2 ($11.44 in chips)
Seat 6: 837ac8c6 ($2.07 in chips)
837ac8c6: posts small blind $0.02
Hero: posts big blind $0.05
*** HOLE CARDS ***
Dealt to Hero [Qh 3s]
Dealt to 148e211d 
Dealt to 41cfc3f2 
Dealt to 837ac8c6 
148e211d: folds
41cfc3f2: raises $0.05 to $0.1
837ac8c6: folds
Hero: folds
Uncalled bet ($0.05) returned to 41cfc3f2
*** SHOWDOWN ***
41cfc3f2 collected $0.12 from pot
*** SUMMARY ***
Total pot $0.12 | Rake $0 | Jackpot $0 | Bingo $0 | Fortune $0 | Tax $0
Seat 1: Hero (big blind) folded before Flop
Seat 2: 148e211d folded before Flop (didn't bet)
Seat 4: 41cfc3f2 (button) collected ($0.12)
Seat 6: 837ac8c6 (small blind) folded before Flop


Poker Hand #HD1724623014: Hold'em No Limit ($0.02/$0.05) - 2024/04/10 20:35:31
Table 'NLHBlue24' 6-max Seat #3 is the button
Seat 1: Hero ($6.09 in chips)
Seat 2: 148e211d ($5 in chips)
Seat 3: 3e1f0c71 ($8.06 in chips)
Seat 4: 41cfc3f2 ($11.26 in chips)
Seat 6: 837ac8c6 ($2.27 in chips)
41cfc3f2: posts small blind $0.02
837ac8c6: posts big blind $0.05
*** HOLE CARDS ***
Dealt to Hero [4s 6d]
Dealt to 148e211d 
Dealt to 3e1f0c71 
Dealt to 41cfc3f2 
Dealt to 837ac8c6 
Hero: folds
148e211d: folds
3e1f0c71: folds
41cfc3f2: raises $0.05 to $0.1
837ac8c6: calls $0.05
*** FLOP *** [Qc Tc Kc]
41cfc3f2: checks
837ac8c6: checks
*** TURN *** [Qc Tc Kc] [Ts]
41cfc3f2: checks
837ac8c6: checks
*** RIVER *** [Qc Tc Kc Ts] [8c]
41cfc3f2: checks
837ac8c6: bets $0.1
41cfc3f2: calls $0.1
837ac8c6: shows [2h 8h] (Pair of Tens and Pair of Eights)
41cfc3f2: shows [7c 9d] (King High Flush)
*** SHOWDOWN ***
41cfc3f2 collected $0.38 from pot
*** SUMMARY ***
Total pot $0.4 | Rake $0.02 | Jackpot $0 | Bingo $0 | Fortune $0 | Tax $0
Board [Qc Tc Kc Ts 8c]
Seat 1: Hero folded before Flop (didn't bet)
Seat 2: 148e211d folded before Flop (didn't bet)
Seat 3: 3e1f0c71 (button) folded before Flop (didn't bet)
Seat 4: 41cfc3f2 (small blind) showed [7c 9d] and won ($0.38) with King High Flush
Seat 6: 837ac8c6 (big blind) showed [2h 8h] and lost with Pair of Tens and Pair of Eights


Poker Hand #HD1724622871: Hold'em No Limit ($0.02/$0.05) - 2024/04/10 20:34:23
Table 'NLHBlue24' 6-max Seat #2 is the button
Seat 1: Hero ($6.09 in chips)
Seat 2: 148e211d ($5 in chips)
Seat 3: 3e1f0c71 ($8.11 in chips)
Seat 4: 41cfc3f2 ($11.31 in chips)
Seat 5: 87f7b474 ($5 in chips)
Seat 6: 837ac8c6 ($2.17 in chips)
3e1f0c71: posts small blind $0.02
41cfc3f2: posts big blind $0.05
*** HOLE CARDS ***
Dealt to Hero [7d Ts]
Dealt to 148e211d 
Dealt to 3e1f0c71 
Dealt to 41cfc3f2 
Dealt to 87f7b474 
Dealt to 837ac8c6 
87f7b474: folds
837ac8c6: calls $0.05
Hero: folds
148e211d: folds
3e1f0c71: calls $0.03
41cfc3f2: checks
*** FLOP *** [Ac 7s Jc]
3e1f0c71: checks
41cfc3f2: checks
837ac8c6: checks
*** TURN *** [Ac 7s Jc] [7h]
3e1f0c71: checks
41cfc3f2: checks
837ac8c6: checks
*** RIVER *** [Ac 7s Jc 7h] [3s]
3e1f0c71: checks
41cfc3f2: checks
837ac8c6: bets $0.08
3e1f0c71: folds
41cfc3f2: folds
Uncalled bet ($0.08) returned to 837ac8c6
*** SHOWDOWN ***
837ac8c6 collected $0.15 from pot
*** SUMMARY ***
Total pot $0.15 | Rake $0 | Jackpot $0 | Bingo $0 | Fortune $0 | Tax $0
Board [Ac 7s Jc 7h 3s]
Seat 1: Hero folded before Flop (didn't bet)
Seat 2: 148e211d (button) folded before Flop (didn't bet)
Seat 3: 3e1f0c71 (small blind) folded on the River
Seat 4: 41cfc3f2 (big blind) folded on the River
Seat 5: 87f7b474 folded before Flop (didn't bet)
Seat 6: 837ac8c6 won ($0.15)


Poker Hand #HD1724622711: Hold'em No Limit ($0.02/$0.05) - 2024/04/10 20:33:04
Table 'NLHBlue24' 6-max Seat #1 is the button
Seat 1: Hero ($6.24 in chips)
Seat 2: 148e211d ($5.02 in chips)
Seat 3: 3e1f0c71 ($8.16 in chips)
Seat 4: 41cfc3f2 ($11.46 in chips)
Seat 5: 87f7b474 ($5 in chips)
Seat 6: 837ac8c6 ($1.57 in chips)
148e211d: posts small blind $0.02
3e1f0c71: posts big blind $0.05
*** HOLE CARDS ***
Dealt to Hero [Td Tc]
Dealt to 148e211d 
Dealt to 3e1f0c71 
Dealt to 41cfc3f2 
Dealt to 87f7b474 
Dealt to 837ac8c6 
41cfc3f2: calls $0.05
87f7b474: folds
837ac8c6: calls $0.05
Hero: raises $0.1 to $0.15
148e211d: calls $0.13
3e1f0c71: folds
41cfc3f2: calls $0.1
837ac8c6: calls $0.1
*** FLOP *** [Ah 5d 3s]
148e211d: checks
41cfc3f2: checks
837ac8c6: checks
Hero: checks
*** TURN *** [Ah 5d 3s] [6d]
148e211d: bets $0.14
41cfc3f2: folds
837ac8c6: calls $0.14
Hero: folds
*** RIVER *** [Ah 5d 3s 6d] [7s]
148e211d: checks
837ac8c6: checks
148e211d: shows [Qd Kd] (Ace-High)
837ac8c6: shows [7d Jd] (Pair of Sevens)
*** SHOWDOWN ***
837ac8c6 collected $0.89 from pot
*** SUMMARY ***
Total pot $0.93 | Rake $0.04 | Jackpot $0 | Bingo $0 | Fortune $0 | Tax $0
Board [Ah 5d 3s 6d 7s]
Seat 1: Hero (button) folded on the Turn
Seat 2: 148e211d (small blind) showed [Qd Kd] and lost with Ace-High
Seat 3: 3e1f0c71 (big blind) folded before Flop
Seat 4: 41cfc3f2 folded on the Turn
Seat 5: 87f7b474 folded before Flop (didn't bet)
Seat 6: 837ac8c6 showed [7d Jd] and won ($0.89) with Pair of Sevens


Poker Hand #HD1724622651: Hold'em No Limit ($0.02/$0.05) - 2024/04/10 20:32:37
Table 'NLHBlue24' 6-max Seat #6 is the button
Seat 1: Hero ($6.26 in chips)
Seat 2: 148e211d ($5.07 in chips)
Seat 3: 3e1f0c71 ($8.09 in chips)
Seat 4: 41cfc3f2 ($11.46 in chips)
Seat 5: 87f7b474 ($5 in chips)
Seat 6: 837ac8c6 ($1.57 in chips)
Hero: posts small blind $0.02
148e211d: posts big blind $0.05
*** HOLE CARDS ***
Dealt to Hero [Ts Qs]
Dealt to 148e211d 
Dealt to 3e1f0c71 
Dealt to 41cfc3f2 
Dealt to 87f7b474 
Dealt to 837ac8c6 
3e1f0c71: raises $0.15 to $0.2
41cfc3f2: folds
87f7b474: folds
837ac8c6: folds
Hero: folds
148e211d: folds
Uncalled bet ($0.15) returned to 3e1f0c71
*** SHOWDOWN ***
3e1f0c71 collected $0.12 from pot
*** SUMMARY ***
Total pot $0.12 | Rake $0 | Jackpot $0 | Bingo $0 | Fortune $0 | Tax $0
Seat 1: Hero (small blind) folded before Flop
Seat 2: 148e211d (big blind) folded before Flop
Seat 3: 3e1f0c71 collected ($0.12)
Seat 4: 41cfc3f2 folded before Flop (didn't bet)
Seat 5: 87f7b474 folded before Flop (didn't bet)
Seat 6: 837ac8c6 (button) folded before Flop (didn't bet)


Poker Hand #HD1724622539: Hold'em No Limit ($0.02/$0.05) - 2024/04/10 20:31:46
Table 'NLHBlue24' 6-max Seat #5 is the button
Seat 1: Hero ($6.31 in chips)
Seat 2: 148e211d ($5.07 in chips)
Seat 3: 3e1f0c71 ($8.09 in chips)
Seat 4: 41cfc3f2 ($11.46 in chips)
Seat 5: 87f7b474 ($5 in chips)
Seat 6: 837ac8c6 ($1.02 in chips)
837ac8c6: posts small blind $0.02
Hero: posts big blind $0.05
*** HOLE CARDS ***
Dealt to Hero [3s Kc]
Dealt to 148e211d 
Dealt to 3e1f0c71 
Dealt to 41cfc3f2 
Dealt to 87f7b474 
Dealt to 837ac8c6 
148e211d: folds
3e1f0c71: folds
41cfc3f2: folds
87f7b474: raises $0.1 to $0.15
837ac8c6: calls $0.13
Hero: folds
*** FLOP *** [7d 2c Js]
837ac8c6: checks
87f7b474: checks
*** TURN *** [7d 2c Js] [8d]
837ac8c6: checks
87f7b474: bets $0.2
837ac8c6: raises $0.2 to $0.4
87f7b474: calls $0.2
*** RIVER *** [7d 2c Js 8d] [Ah]
837ac8c6: bets $0.47 and is all-in
87f7b474: folds
Uncalled bet ($0.47) returned to 837ac8c6
*** SHOWDOWN ***
837ac8c6 collected $1.1 from pot
*** SUMMARY ***
Total pot $1.15 | Rake $0.05 | Jackpot $0 | Bingo $0 | Fortune $0 | Tax $0
Board [7d 2c Js 8d Ah]
Seat 1: Hero (big blind) folded before Flop
Seat 2: 148e211d folded before Flop (didn't bet)
Seat 3: 3e1f0c71 folded before Flop (didn't bet)
Seat 4: 41cfc3f2 folded before Flop (didn't bet)
Seat 5: 87f7b474 (button) folded on the River
Seat 6: 837ac8c6 (small blind) won ($1.1)


Poker Hand #HD1724622509: Hold'em No Limit ($0.02/$0.05) - 2024/04/10 20:31:34
Table 'NLHBlue24' 6-max Seat #4 is the button
Seat 1: Hero ($6.31 in chips)
Seat 2: 148e211d ($5.07 in chips)
Seat 3: 3e1f0c71 ($8.09 in chips)
Seat 4: 41cfc3f2 ($11.46 in chips)
Seat 5: 87f7b474 ($5 in chips)
Seat 6: 837ac8c6 ($1 in chips)
87f7b474: posts small blind $0.02
837ac8c6: posts big blind $0.05
*** HOLE CARDS ***
Dealt to Hero [Tc 3h]
Dealt to 148e211d 
Dealt to 3e1f0c71 
Dealt to 41cfc3f2 
Dealt to 87f7b474 
Dealt to 837ac8c6 
Hero: folds
148e211d: folds
3e1f0c71: folds
41cfc3f2: folds
87f7b474: folds
Uncalled bet ($0.03) returned to 837ac8c6
*** SHOWDOWN ***
837ac8c6 collected $0.04 from pot
*** SUMMARY ***
Total pot $0.04 | Rake $0 | Jackpot $0 | Bingo $0 | Fortune $0 | Tax $0
Seat 1: Hero folded before Flop (didn't bet)
Seat 2: 148e211d folded before Flop (didn't bet)
Seat 3: 3e1f0c71 folded before Flop (didn't bet)
Seat 4: 41cfc3f2 (button) folded before Flop (didn't bet)
Seat 5: 87f7b474 (small blind) folded before Flop
Seat 6: 837ac8c6 (big blind) collected ($0.04)


Poker Hand #HD1724622447: Hold'em No Limit ($0.02/$0.05) - 2024/04/10 20:31:01
Table 'NLHBlue24' 6-max Seat #3 is the button
Seat 1: Hero ($6.31 in chips)
Seat 2: 148e211d ($5.07 in chips)
Seat 3: 3e1f0c71 ($8.14 in chips)
Seat 4: 41cfc3f2 ($10.96 in chips)
Seat 5: 87f7b474 ($5.12 in chips)
Seat 6: f7e35463 ($6.2 in chips)
41cfc3f2: posts small blind $0.02
87f7b474: posts big blind $0.05
*** HOLE CARDS ***
Dealt to Hero [7d 4h]
Dealt to 148e211d 
Dealt to 3e1f0c71 
Dealt to 41cfc3f2 
Dealt to 87f7b474 
Dealt to f7e35463 
f7e35463: folds
Hero: folds
148e211d: folds
3e1f0c71: calls $0.05
41cfc3f2: raises $0.24 to $0.29
87f7b474: calls $0.24
3e1f0c71: folds
*** FLOP *** [4s Tc 6d]
41cfc3f2: bets $0.21
87f7b474: calls $0.21
*** TURN *** [4s Tc 6d] [2c]
41cfc3f2: bets $0.7
87f7b474: folds
Uncalled bet ($0.7) returned to 41cfc3f2
*** SHOWDOWN ***
41cfc3f2 collected $1 from pot
*** SUMMARY ***
Total pot $1.05 | Rake $0.05 | Jackpot $0 | Bingo $0 | Fortune $0 | Tax $0
Board [4s Tc 6d 2c]
Seat 1: Hero folded before Flop (didn't bet)
Seat 2: 148e211d folded before Flop (didn't bet)
Seat 3: 3e1f0c71 (button) folded before Flop
Seat 4: 41cfc3f2 (small blind) won ($1)
Seat 5: 87f7b474 (big blind) folded on the Turn
Seat 6: f7e35463 folded before Flop (didn't bet)


Poker Hand #HD1724622413: Hold'em No Limit ($0.02/$0.05) - 2024/04/10 20:30:46
Table 'NLHBlue24' 6-max Seat #2 is the button
Seat 1: Hero ($6.31 in chips)
Seat 2: 148e211d ($5 in chips)
Seat 3: 3e1f0c71 ($8.16 in chips)
Seat 4: 41cfc3f2 ($11.01 in chips)
Seat 5: 87f7b474 ($5.12 in chips)
Seat 6: f7e35463 ($6.2 in chips)
3e1f0c71: posts small blind $0.02
41cfc3f2: posts big blind $0.05
*** HOLE CARDS ***
Dealt to Hero [Th 5d]
Dealt to 148e211d 
Dealt to 3e1f0c71 
Dealt to 41cfc3f2 
Dealt to 87f7b474 
Dealt to f7e35463 
87f7b474: folds
f7e35463: folds
Hero: folds
148e211d: raises $0.07 to $0.12
3e1f0c71: folds
41cfc3f2: folds
Uncalled bet ($0.07) returned to 148e211d
*** SHOWDOWN ***
148e211d collected $0.12 from pot
*** SUMMARY ***
Total pot $0.12 | Rake $0 | Jackpot $0 | Bingo $0 | Fortune $0 | Tax $0
Seat 1: Hero folded before Flop (didn't bet)
Seat 2: 148e211d (button) collected ($0.12)
Seat 3: 3e1f0c71 (small blind) folded before Flop
Seat 4: 41cfc3f2 (big blind) folded before Flop
Seat 5: 87f7b474 folded before Flop (didn't bet)
Seat 6: f7e35463 folded before Flop (didn't bet)


Poker Hand #HD1724622300: Hold'em No Limit ($0.02/$0.05) - 2024/04/10 20:29:54
Table 'NLHBlue24' 6-max Seat #1 is the button
Seat 1: Hero ($6.31 in chips)
Seat 2: 148e211d ($5 in chips)
Seat 3: 3e1f0c71 ($7.97 in chips)
Seat 4: 41cfc3f2 ($11.11 in chips)
Seat 5: 87f7b474 ($5.12 in chips)
Seat 6: f7e35463 ($6.2 in chips)
148e211d: posts small blind $0.02
3e1f0c71: posts big blind $0.05
*** HOLE CARDS ***
Dealt to Hero [Qc 9c]
Dealt to 148e211d 
Dealt to 3e1f0c71 
Dealt to 41cfc3f2 
Dealt to 87f7b474 
Dealt to f7e35463 
41cfc3f2: raises $0.05 to $0.1
87f7b474: folds
f7e35463: folds
Hero: folds
148e211d: calls $0.08
3e1f0c71: calls $0.05
*** FLOP *** [2s 3s 5s]
148e211d: checks
3e1f0c71: checks
41cfc3f2: checks
*** TURN *** [2s 3s 5s] [Js]
148e211d: checks
3e1f0c71: checks
41cfc3f2: checks
*** RIVER *** [2s 3s 5s Js] [9d]
148e211d: checks
3e1f0c71: checks
41cfc3f2: checks
148e211d: shows [Kc Tc] (King-High)
3e1f0c71: shows [3c Ah] (Pair of Treys)
41cfc3f2: shows [Kd 8h] (King-High)
*** SHOWDOWN ***
3e1f0c71 collected $0.29 from pot
*** SUMMARY ***
Total pot $0.3 | Rake $0.01 | Jackpot $0 | Bingo $0 | Fortune $0 | Tax $0
Board [2s 3s 5s Js 9d]
Seat 1: Hero (button) folded before Flop (didn't bet)
Seat 2: 148e211d (small blind) showed [Kc Tc] and lost with King-High
Seat 3: 3e1f0c71 (big blind) showed [3c Ah] and won ($0.29) with Pair of Treys
Seat 4: 41cfc3f2 showed [Kd 8h] and lost with King-High
Seat 5: 87f7b474 folded before Flop (didn't bet)
Seat 6: f7e35463 folded before Flop (didn't bet)


Poker Hand #HD1724622171: Hold'em No Limit ($0.02/$0.05) - 2024/04/10 20:28:49
Table 'NLHBlue24' 6-max Seat #6 is the button
Seat 1: Hero ($5 in chips)
Seat 2: 148e211d ($5 in chips)
Seat 3: 3e1f0c71 ($7.97 in chips)
Seat 4: 41cfc3f2 ($12.56 in chips)
Seat 5: 87f7b474 ($5.12 in chips)
Seat 6: f7e35463 ($6.2 in chips)
Hero: posts small blind $0.02
148e211d: posts big blind $0.05
*** HOLE CARDS ***
Dealt to Hero [Ah Ks]
Dealt to 148e211d 
Dealt to 3e1f0c71 
Dealt to 41cfc3f2 
Dealt to 87f7b474 
Dealt to f7e35463 
3e1f0c71: folds
41cfc3f2: calls $0.05
87f7b474: folds
f7e35463: folds
Hero: raises $0.15 to $0.2
148e211d: folds
41cfc3f2: calls $0.15
*** FLOP *** [9h Jh Kc]
Hero: bets $0.2
41cfc3f2: calls $0.2
*** TURN *** [9h Jh Kc] [8h]
Hero: bets $0.6
41cfc3f2: calls $0.6
*** RIVER *** [9h Jh Kc 8h] [6d]
Hero: bets $0.45
41cfc3f2: calls $0.45
Hero: shows [Ah Ks] (Pair of Kings)
41cfc3f2: shows [Tc Th] (Pair of Tens)
*** SHOWDOWN ***
Hero collected $2.76 from pot
*** SUMMARY ***
Total pot $2.95 | Rake $0.14 | Jackpot $0.05 | Bingo $0 | Fortune $0 | Tax $0
Board [9h Jh Kc 8h 6d]
Seat 1: Hero (small blind) showed [Ah Ks] and won ($2.76) with Pair of Kings
Seat 2: 148e211d (big blind) folded before Flop
Seat 3: 3e1f0c71 folded before Flop (didn't bet)
Seat 4: 41cfc3f2 showed [Tc Th] and lost with Pair of Tens
Seat 5: 87f7b474 folded before Flop (didn't bet)
Seat 6: f7e35463 (button) folded before Flop (didn't bet)


Poker Hand #HD1724622043: Hold'em No Limit ($0.02/$0.05) - 2024/04/10 20:27:47
Table 'NLHBlue24' 6-max Seat #5 is the button
Seat 1: Hero ($5 in chips)
Seat 3: 3e1f0c71 ($7.63 in chips)
Seat 5: 87f7b474 ($5.12 in chips)
Seat 6: f7e35463 ($6.22 in chips)
f7e35463: posts small blind $0.02
Hero: posts big blind $0.05
*** HOLE CARDS ***
Dealt to Hero [7s Ks]
Dealt to 3e1f0c71 
Dealt to 87f7b474 
Dealt to f7e35463 
3e1f0c71: calls $0.05
87f7b474: folds
f7e35463: folds
Hero: checks
*** FLOP *** [Td 4d Jh]
Hero: checks
3e1f0c71: checks
*** TURN *** [Td 4d Jh] [9c]
Hero: bets $0.1
3e1f0c71: calls $0.1
*** RIVER *** [Td 4d Jh 9c] [3c]
Hero: bets $0.2
3e1f0c71: raises $0.54 to $0.74
Hero: folds
Uncalled bet ($0.54) returned to 3e1f0c71
*** SHOWDOWN ***
3e1f0c71 collected $0.69 from pot
*** SUMMARY ***
Total pot $0.72 | Rake $0.03 | Jackpot $0 | Bingo $0 | Fortune $0 | Tax $0
Board [Td 4d Jh 9c 3c]
Seat 1: Hero (big blind) folded on the River
Seat 3: 3e1f0c71 won ($0.69)
Seat 5: 87f7b474 (button) folded before Flop (didn't bet)
Seat 6: f7e35463 (small blind) folded before Flop


