Poker Hand #HD1775499896: Hold'em No Limit ($0.05/$0.1) - 2024/05/16 20:18:29
Table 'NLHRed23' 6-max Seat #2 is the button
Seat 1: 8ec1870 ($10.73 in chips)
Seat 2: 42202e9 ($31.46 in chips)
Seat 3: Hero ($16.8 in chips)
Seat 4: 9681dc27 ($15.71 in chips)
Seat 5: 3b85adab ($2.17 in chips)
Seat 6: b5e0f02d ($10.03 in chips)
Hero: posts small blind $0.05
9681dc27: posts big blind $0.1
*** HOLE CARDS ***
Dealt to 8ec1870 
Dealt to 42202e9 
Dealt to Hero [Jc 6h]
Dealt to 9681dc27 
Dealt to 3b85adab 
Dealt to b5e0f02d 
3b85adab: raises $0.1 to $0.2
b5e0f02d: folds
8ec1870: folds
42202e9: folds
Hero: folds
9681dc27: folds
Uncalled bet ($0.1) returned to 3b85adab
*** SHOWDOWN ***
3b85adab collected $0.25 from pot
*** SUMMARY ***
Total pot $0.25 | Rake $0 | Jackpot $0 | Bingo $0 | Fortune $0 | Tax $0
Seat 1: 8ec1870 folded before Flop (didn't bet)
Seat 2: 42202e9 (button) folded before Flop (didn't bet)
Seat 3: Hero (small blind) folded before Flop
Seat 4: 9681dc27 (big blind) folded before Flop
Seat 5: 3b85adab collected ($0.25)
Seat 6: b5e0f02d folded before Flop (didn't bet)


Poker Hand #HD1775499868: Hold'em No Limit ($0.05/$0.1) - 2024/05/16 20:18:12
Table 'NLHRed23' 6-max Seat #1 is the button
Seat 1: 8ec1870 ($10.73 in chips)
Seat 2: 42202e9 ($31.51 in chips)
Seat 3: Hero ($16.75 in chips)
Seat 4: 9681dc27 ($15.71 in chips)
Seat 5: 3b85adab ($2.17 in chips)
Seat 6: b5e0f02d ($10.03 in chips)
42202e9: posts small blind $0.05
Hero: posts big blind $0.1
*** HOLE CARDS ***
Dealt to 8ec1870 
Dealt to 42202e9 
Dealt to Hero [3h 4d]
Dealt to 9681dc27 
Dealt to 3b85adab 
Dealt to b5e0f02d 
9681dc27: folds
3b85adab: folds
b5e0f02d: folds
8ec1870: folds
42202e9: folds
Uncalled bet ($0.05) returned to Hero
*** SHOWDOWN ***
Hero collected $0.1 from pot
*** SUMMARY ***
Total pot $0.1 | Rake $0 | Jackpot $0 | Bingo $0 | Fortune $0 | Tax $0
Seat 1: 8ec1870 (button) folded before Flop (didn't bet)
Seat 2: 42202e9 (small blind) folded before Flop
Seat 3: Hero (big blind) collected ($0.1)
Seat 4: 9681dc27 folded before Flop (didn't bet)
Seat 5: 3b85adab folded before Flop (didn't bet)
Seat 6: b5e0f02d folded before Flop (didn't bet)


Poker Hand #HD1775499801: Hold'em No Limit ($0.05/$0.1) - 2024/05/16 20:17:24
Table 'NLHRed23' 6-max Seat #6 is the button
Seat 1: 8ec1870 ($10.78 in chips)
Seat 2: 42202e9 ($31.61 in chips)
Seat 3: Hero ($16.24 in chips)
Seat 4: 9681dc27 ($15.71 in chips)
Seat 5: 3b85adab ($2.57 in chips)
Seat 6: b5e0f02d ($10.03 in chips)
8ec1870: posts small blind $0.05
42202e9: posts big blind $0.1
*** HOLE CARDS ***
Dealt to 8ec1870 
Dealt to 42202e9 
Dealt to Hero [2d Ad]
Dealt to 9681dc27 
Dealt to 3b85adab 
Dealt to b5e0f02d 
Hero: raises $0.1 to $0.2
9681dc27: folds
3b85adab: calls $0.2
b5e0f02d: folds
8ec1870: folds
42202e9: folds
*** FLOP *** [Kh 5s 7s]
Hero: checks
3b85adab: checks
*** TURN *** [Kh 5s 7s] [Qh]
Hero: bets $0.2
3b85adab: calls $0.2
*** RIVER *** [Kh 5s 7s Qh] [7c]
Hero: bets $0.63
3b85adab: folds
Uncalled bet ($0.63) returned to Hero
*** SHOWDOWN ***
Hero collected $0.91 from pot
*** SUMMARY ***
Total pot $0.95 | Rake $0.04 | Jackpot $0 | Bingo $0 | Fortune $0 | Tax $0
Board [Kh 5s 7s Qh 7c]
Seat 1: 8ec1870 (small blind) folded before Flop
Seat 2: 42202e9 (big blind) folded before Flop
Seat 3: Hero won ($0.91)
Seat 4: 9681dc27 folded before Flop (didn't bet)
Seat 5: 3b85adab folded on the River
Seat 6: b5e0f02d (button) folded before Flop (didn't bet)


Poker Hand #HD1775499759: Hold'em No Limit ($0.05/$0.1) - 2024/05/16 20:16:59
Table 'NLHRed23' 6-max Seat #5 is the button
Seat 1: 8ec1870 ($10.88 in chips)
Seat 2: 42202e9 ($31.61 in chips)
Seat 3: Hero ($16.09 in chips)
Seat 4: 9681dc27 ($15.71 in chips)
Seat 5: 3b85adab ($2.57 in chips)
Seat 6: b5e0f02d ($10.08 in chips)
b5e0f02d: posts small blind $0.05
8ec1870: posts big blind $0.1
*** HOLE CARDS ***
Dealt to 8ec1870 
Dealt to 42202e9 
Dealt to Hero [Jc Qh]
Dealt to 9681dc27 
Dealt to 3b85adab 
Dealt to b5e0f02d 
42202e9: folds
Hero: raises $0.1 to $0.2
9681dc27: folds
3b85adab: folds
b5e0f02d: folds
8ec1870: folds
Uncalled bet ($0.1) returned to Hero
*** SHOWDOWN ***
Hero collected $0.25 from pot
*** SUMMARY ***
Total pot $0.25 | Rake $0 | Jackpot $0 | Bingo $0 | Fortune $0 | Tax $0
Seat 1: 8ec1870 (big blind) folded before Flop
Seat 2: 42202e9 folded before Flop (didn't bet)
Seat 3: Hero collected ($0.25)
Seat 4: 9681dc27 folded before Flop (didn't bet)
Seat 5: 3b85adab (button) folded before Flop (didn't bet)
Seat 6: b5e0f02d (small blind) folded before Flop


Poker Hand #HD1775499726: Hold'em No Limit ($0.05/$0.1) - 2024/05/16 20:16:38
Table 'NLHRed23' 6-max Seat #4 is the button
Seat 1: 8ec1870 ($10.88 in chips)
Seat 2: 42202e9 ($31.61 in chips)
Seat 3: Hero ($16.09 in chips)
Seat 4: 9681dc27 ($15.56 in chips)
Seat 5: 3b85adab ($2.62 in chips)
Seat 6: b5e0f02d ($10.18 in chips)
3b85adab: posts small blind $0.05
b5e0f02d: posts big blind $0.1
*** HOLE CARDS ***
Dealt to 8ec1870 
Dealt to 42202e9 
Dealt to Hero [9s 7d]
Dealt to 9681dc27 
Dealt to 3b85adab 
Dealt to b5e0f02d 
8ec1870: folds
42202e9: folds
Hero: folds
9681dc27: raises $0.15 to $0.25
3b85adab: folds
b5e0f02d: folds
Uncalled bet ($0.15) returned to 9681dc27
*** SHOWDOWN ***
9681dc27 collected $0.25 from pot
*** SUMMARY ***
Total pot $0.25 | Rake $0 | Jackpot $0 | Bingo $0 | Fortune $0 | Tax $0
Seat 1: 8ec1870 folded before Flop (didn't bet)
Seat 2: 42202e9 folded before Flop (didn't bet)
Seat 3: Hero folded before Flop (didn't bet)
Seat 4: 9681dc27 (button) collected ($0.25)
Seat 5: 3b85adab (small blind) folded before Flop
Seat 6: b5e0f02d (big blind) folded before Flop


Poker Hand #HD1775499661: Hold'em No Limit ($0.05/$0.1) - 2024/05/16 20:15:52
Table 'NLHRed23' 6-max Seat #3 is the button
Seat 1: 8ec1870 ($10.88 in chips)
Seat 2: 42202e9 ($31.86 in chips)
Seat 3: Hero ($16.09 in chips)
Seat 4: 9681dc27 ($15.24 in chips)
Seat 5: 3b85adab ($2.72 in chips)
Seat 6: b5e0f02d ($10.18 in chips)
9681dc27: posts small blind $0.05
3b85adab: posts big blind $0.1
*** HOLE CARDS ***
Dealt to 8ec1870 
Dealt to 42202e9 
Dealt to Hero [6c Qc]
Dealt to 9681dc27 
Dealt to 3b85adab 
Dealt to b5e0f02d 
b5e0f02d: folds
8ec1870: folds
42202e9: raises $0.15 to $0.25
Hero: folds
9681dc27: raises $0.85 to $1.1
3b85adab: folds
42202e9: folds
Uncalled bet ($0.85) returned to 9681dc27
*** SHOWDOWN ***
9681dc27 collected $0.57 from pot
*** SUMMARY ***
Total pot $0.6 | Rake $0.03 | Jackpot $0 | Bingo $0 | Fortune $0 | Tax $0
Seat 1: 8ec1870 folded before Flop (didn't bet)
Seat 2: 42202e9 folded before Flop
Seat 3: Hero (button) folded before Flop (didn't bet)
Seat 4: 9681dc27 (small blind) collected ($0.57)
Seat 5: 3b85adab (big blind) folded before Flop
Seat 6: b5e0f02d folded before Flop (didn't bet)


Poker Hand #HD1775499604: Hold'em No Limit ($0.05/$0.1) - 2024/05/16 20:15:18
Table 'NLHRed23' 6-max Seat #2 is the button
Seat 1: 8ec1870 ($11.13 in chips)
Seat 2: 42202e9 ($31.49 in chips)
Seat 3: Hero ($16.14 in chips)
Seat 4: 9681dc27 ($15.34 in chips)
Seat 5: 3b85adab ($2.72 in chips)
Seat 6: b5e0f02d ($10.18 in chips)
Hero: posts small blind $0.05
9681dc27: posts big blind $0.1
*** HOLE CARDS ***
Dealt to 8ec1870 
Dealt to 42202e9 
Dealt to Hero [6c 9c]
Dealt to 9681dc27 
Dealt to 3b85adab 
Dealt to b5e0f02d 
3b85adab: folds
b5e0f02d: folds
8ec1870: raises $0.15 to $0.25
42202e9: raises $0.55 to $0.8
Hero: folds
9681dc27: folds
8ec1870: folds
Uncalled bet ($0.55) returned to 42202e9
*** SHOWDOWN ***
42202e9 collected $0.62 from pot
*** SUMMARY ***
Total pot $0.65 | Rake $0.03 | Jackpot $0 | Bingo $0 | Fortune $0 | Tax $0
Seat 1: 8ec1870 folded before Flop
Seat 2: 42202e9 (button) collected ($0.62)
Seat 3: Hero (small blind) folded before Flop
Seat 4: 9681dc27 (big blind) folded before Flop
Seat 5: 3b85adab folded before Flop (didn't bet)
Seat 6: b5e0f02d folded before Flop (didn't bet)


Poker Hand #HD1775499504: Hold'em No Limit ($0.05/$0.1) - 2024/05/16 20:14:13
Table 'NLHRed23' 6-max Seat #1 is the button
Seat 1: 8ec1870 ($11.43 in chips)
Seat 2: 42202e9 ($31.03 in chips)
Seat 3: Hero ($16.24 in chips)
Seat 4: 9681dc27 ($15.34 in chips)
Seat 5: 3b85adab ($2.82 in chips)
Seat 6: b5e0f02d ($10.18 in chips)
42202e9: posts small blind $0.05
Hero: posts big blind $0.1
*** HOLE CARDS ***
Dealt to 8ec1870 
Dealt to 42202e9 
Dealt to Hero [Ts 7s]
Dealt to 9681dc27 
Dealt to 3b85adab 
Dealt to b5e0f02d 
9681dc27: folds
3b85adab: calls $0.1
b5e0f02d: folds
8ec1870: raises $0.2 to $0.3
42202e9: calls $0.25
Hero: folds
3b85adab: folds
*** FLOP *** [6s Jc 8h]
42202e9: bets $0.44
8ec1870: folds
Uncalled bet ($0.44) returned to 42202e9
*** SHOWDOWN ***
42202e9 collected $0.76 from pot
*** SUMMARY ***
Total pot $0.8 | Rake $0.04 | Jackpot $0 | Bingo $0 | Fortune $0 | Tax $0
Board [6s Jc 8h]
Seat 1: 8ec1870 (button) folded on the Flop
Seat 2: 42202e9 (small blind) won ($0.76)
Seat 3: Hero (big blind) folded before Flop
Seat 4: 9681dc27 folded before Flop (didn't bet)
Seat 5: 3b85adab folded before Flop
Seat 6: b5e0f02d folded before Flop (didn't bet)


Poker Hand #HD1775499429: Hold'em No Limit ($0.05/$0.1) - 2024/05/16 20:13:27
Table 'NLHRed23' 6-max Seat #6 is the button
Seat 1: 8ec1870 ($11.48 in chips)
Seat 2: 42202e9 ($30.89 in chips)
Seat 3: Hero ($16.24 in chips)
Seat 4: 9681dc27 ($15.34 in chips)
Seat 5: 3b85adab ($2.92 in chips)
Seat 6: b5e0f02d ($10.18 in chips)
8ec1870: posts small blind $0.05
42202e9: posts big blind $0.1
*** HOLE CARDS ***
Dealt to 8ec1870 
Dealt to 42202e9 
Dealt to Hero [9h Ts]
Dealt to 9681dc27 
Dealt to 3b85adab 
Dealt to b5e0f02d 
Hero: folds
9681dc27: folds
3b85adab: calls $0.1
b5e0f02d: folds
8ec1870: folds
42202e9: checks
*** FLOP *** [3c Kc 8h]
42202e9: checks
3b85adab: checks
*** TURN *** [3c Kc 8h] [Qd]
42202e9: checks
3b85adab: checks
*** RIVER *** [3c Kc 8h Qd] [9s]
42202e9: checks
3b85adab: checks
42202e9: shows [Jd 2d] (King-High)
3b85adab: shows [2s Td] (King-High)
*** SHOWDOWN ***
42202e9 collected $0.24 from pot
*** SUMMARY ***
Total pot $0.25 | Rake $0.01 | Jackpot $0 | Bingo $0 | Fortune $0 | Tax $0
Board [3c Kc 8h Qd 9s]
Seat 1: 8ec1870 (small blind) folded before Flop
Seat 2: 42202e9 (big blind) showed [Jd 2d] and won ($0.24) with King-High
Seat 3: Hero folded before Flop (didn't bet)
Seat 4: 9681dc27 folded before Flop (didn't bet)
Seat 5: 3b85adab showed [2s Td] and lost with King-High
Seat 6: b5e0f02d (button) folded before Flop (didn't bet)


Poker Hand #HD1775499354: Hold'em No Limit ($0.05/$0.1) - 2024/05/16 20:12:40
Table 'NLHRed23' 6-max Seat #5 is the button
Seat 1: 8ec1870 ($11.73 in chips)
Seat 2: 42202e9 ($30.61 in chips)
Seat 3: Hero ($16.24 in chips)
Seat 4: 9681dc27 ($15.34 in chips)
Seat 5: 3b85adab ($2.92 in chips)
Seat 6: b5e0f02d ($10.23 in chips)
b5e0f02d: posts small blind $0.05
8ec1870: posts big blind $0.1
*** HOLE CARDS ***
Dealt to 8ec1870 
Dealt to 42202e9 
Dealt to Hero [8s 5c]
Dealt to 9681dc27 
Dealt to 3b85adab 
Dealt to b5e0f02d 
42202e9: raises $0.15 to $0.25
Hero: folds
9681dc27: folds
3b85adab: folds
b5e0f02d: folds
8ec1870: calls $0.15
*** FLOP *** [Jh 2s Jc]
8ec1870: checks
42202e9: bets $0.3
8ec1870: folds
Uncalled bet ($0.3) returned to 42202e9
*** SHOWDOWN ***
42202e9 collected $0.53 from pot
*** SUMMARY ***
Total pot $0.55 | Rake $0.02 | Jackpot $0 | Bingo $0 | Fortune $0 | Tax $0
Board [Jh 2s Jc]
Seat 1: 8ec1870 (big blind) folded on the Flop
Seat 2: 42202e9 won ($0.53)
Seat 3: Hero folded before Flop (didn't bet)
Seat 4: 9681dc27 folded before Flop (didn't bet)
Seat 5: 3b85adab (button) folded before Flop (didn't bet)
Seat 6: b5e0f02d (small blind) folded before Flop


Poker Hand #HD1775499307: Hold'em No Limit ($0.05/$0.1) - 2024/05/16 20:12:08
Table 'NLHRed23' 6-max Seat #4 is the button
Seat 1: 8ec1870 ($11.73 in chips)
Seat 2: 42202e9 ($30.61 in chips)
Seat 3: Hero ($16.24 in chips)
Seat 4: 9681dc27 ($15.34 in chips)
Seat 5: 3b85adab ($3.17 in chips)
Seat 6: b5e0f02d ($10 in chips)
3b85adab: posts small blind $0.05
b5e0f02d: posts big blind $0.1
*** HOLE CARDS ***
Dealt to 8ec1870 
Dealt to 42202e9 
Dealt to Hero [Kh 8s]
Dealt to 9681dc27 
Dealt to 3b85adab 
Dealt to b5e0f02d 
8ec1870: folds
42202e9: folds
Hero: folds
9681dc27: folds
3b85adab: calls $0.05
b5e0f02d: raises $0.15 to $0.25
3b85adab: calls $0.15
*** FLOP *** [Qd 2h 8h]
3b85adab: checks
b5e0f02d: bets $0.38
3b85adab: folds
Uncalled bet ($0.38) returned to b5e0f02d
*** SHOWDOWN ***
b5e0f02d collected $0.48 from pot
*** SUMMARY ***
Total pot $0.5 | Rake $0.02 | Jackpot $0 | Bingo $0 | Fortune $0 | Tax $0
Board [Qd 2h 8h]
Seat 1: 8ec1870 folded before Flop (didn't bet)
Seat 2: 42202e9 folded before Flop (didn't bet)
Seat 3: Hero folded before Flop (didn't bet)
Seat 4: 9681dc27 (button) folded before Flop (didn't bet)
Seat 5: 3b85adab (small blind) folded on the Flop
Seat 6: b5e0f02d (big blind) won ($0.48)


Poker Hand #HD1775499256: Hold'em No Limit ($0.05/$0.1) - 2024/05/16 20:11:40
Table 'NLHRed23' 6-max Seat #3 is the button
Seat 1: 8ec1870 ($11.73 in chips)
Seat 2: 42202e9 ($30.61 in chips)
Seat 3: Hero ($16.24 in chips)
Seat 4: 9681dc27 ($15.07 in chips)
Seat 5: 3b85adab ($3.47 in chips)
Seat 6: b5e0f02d ($10 in chips)
9681dc27: posts small blind $0.05
3b85adab: posts big blind $0.1
*** HOLE CARDS ***
Dealt to 8ec1870 
Dealt to 42202e9 
Dealt to Hero [3h 6h]
Dealt to 9681dc27 
Dealt to 3b85adab 
Dealt to b5e0f02d 
b5e0f02d: folds
8ec1870: folds
42202e9: folds
Hero: folds
9681dc27: raises $0.2 to $0.3
3b85adab: calls $0.2
*** FLOP *** [4s Tc 7c]
9681dc27: bets $0.2
3b85adab: folds
Uncalled bet ($0.2) returned to 9681dc27
*** SHOWDOWN ***
9681dc27 collected $0.57 from pot
*** SUMMARY ***
Total pot $0.6 | Rake $0.03 | Jackpot $0 | Bingo $0 | Fortune $0 | Tax $0
Board [4s Tc 7c]
Seat 1: 8ec1870 folded before Flop (didn't bet)
Seat 2: 42202e9 folded before Flop (didn't bet)
Seat 3: Hero (button) folded before Flop (didn't bet)
Seat 4: 9681dc27 (small blind) won ($0.57)
Seat 5: 3b85adab (big blind) folded on the Flop
Seat 6: b5e0f02d folded before Flop (didn't bet)


Poker Hand #HD1775499204: Hold'em No Limit ($0.05/$0.1) - 2024/05/16 20:11:12
Table 'NLHRed23' 6-max Seat #2 is the button
Seat 1: 8ec1870 ($11.73 in chips)
Seat 2: 42202e9 ($30.61 in chips)
Seat 3: Hero ($16.29 in chips)
Seat 4: 9681dc27 ($15.17 in chips)
Seat 5: 3b85adab ($3.33 in chips)
Seat 6: b5e0f02d ($10 in chips)
Hero: posts small blind $0.05
9681dc27: posts big blind $0.1
*** HOLE CARDS ***
Dealt to 8ec1870 
Dealt to 42202e9 
Dealt to Hero [8h Kd]
Dealt to 9681dc27 
Dealt to 3b85adab 
Dealt to b5e0f02d 
3b85adab: calls $0.1
b5e0f02d: folds
8ec1870: folds
42202e9: folds
Hero: folds
9681dc27: checks
*** FLOP *** [Qh 6s 3d]
9681dc27: checks
3b85adab: bets $0.25
9681dc27: folds
Uncalled bet ($0.25) returned to 3b85adab
*** SHOWDOWN ***
3b85adab collected $0.24 from pot
*** SUMMARY ***
Total pot $0.25 | Rake $0.01 | Jackpot $0 | Bingo $0 | Fortune $0 | Tax $0
Board [Qh 6s 3d]
Seat 1: 8ec1870 folded before Flop (didn't bet)
Seat 2: 42202e9 (button) folded before Flop (didn't bet)
Seat 3: Hero (small blind) folded before Flop
Seat 4: 9681dc27 (big blind) folded on the Flop
Seat 5: 3b85adab won ($0.24)
Seat 6: b5e0f02d folded before Flop (didn't bet)


Poker Hand #HD1775499132: Hold'em No Limit ($0.05/$0.1) - 2024/05/16 20:10:23
Table 'NLHRed23' 6-max Seat #1 is the button
Seat 1: 8ec1870 ($11.73 in chips)
Seat 2: 42202e9 ($30.66 in chips)
Seat 3: Hero ($16.15 in chips)
Seat 4: 9681dc27 ($15.17 in chips)
Seat 5: 3b85adab ($3.43 in chips)
Seat 6: b5e0f02d ($10 in chips)
42202e9: posts small blind $0.05
Hero: posts big blind $0.1
*** HOLE CARDS ***
Dealt to 8ec1870 
Dealt to 42202e9 
Dealt to Hero [5h 4h]
Dealt to 9681dc27 
Dealt to 3b85adab 
Dealt to b5e0f02d 
9681dc27: folds
3b85adab: calls $0.1
b5e0f02d: folds
8ec1870: folds
42202e9: folds
Hero: checks
*** FLOP *** [9c 9d Th]
Hero: checks
3b85adab: checks
*** TURN *** [9c 9d Th] [Tc]
Hero: bets $0.1
3b85adab: folds
Uncalled bet ($0.1) returned to Hero
*** SHOWDOWN ***
Hero collected $0.24 from pot
*** SUMMARY ***
Total pot $0.25 | Rake $0.01 | Jackpot $0 | Bingo $0 | Fortune $0 | Tax $0
Board [9c 9d Th Tc]
Seat 1: 8ec1870 (button) folded before Flop (didn't bet)
Seat 2: 42202e9 (small blind) folded before Flop
Seat 3: Hero (big blind) won ($0.24)
Seat 4: 9681dc27 folded before Flop (didn't bet)
Seat 5: 3b85adab folded on the Turn
Seat 6: b5e0f02d folded before Flop (didn't bet)


Poker Hand #HD1775499098: Hold'em No Limit ($0.05/$0.1) - 2024/05/16 20:10:04
Table 'NLHRed23' 6-max Seat #6 is the button
Seat 1: 8ec1870 ($11.78 in chips)
Seat 2: 42202e9 ($30.76 in chips)
Seat 3: Hero ($16.15 in chips)
Seat 4: 9681dc27 ($15.02 in chips)
Seat 5: 3b85adab ($3.43 in chips)
Seat 6: b5e0f02d ($10 in chips)
8ec1870: posts small blind $0.05
42202e9: posts big blind $0.1
*** HOLE CARDS ***
Dealt to 8ec1870 
Dealt to 42202e9 
Dealt to Hero [6h 3h]
Dealt to 9681dc27 
Dealt to 3b85adab 
Dealt to b5e0f02d 
Hero: folds
9681dc27: raises $0.2 to $0.3
3b85adab: folds
b5e0f02d: folds
8ec1870: folds
42202e9: folds
Uncalled bet ($0.2) returned to 9681dc27
*** SHOWDOWN ***
9681dc27 collected $0.25 from pot
*** SUMMARY ***
Total pot $0.25 | Rake $0 | Jackpot $0 | Bingo $0 | Fortune $0 | Tax $0
Seat 1: 8ec1870 (small blind) folded before Flop
Seat 2: 42202e9 (big blind) folded before Flop
Seat 3: Hero folded before Flop (didn't bet)
Seat 4: 9681dc27 collected ($0.25)
Seat 5: 3b85adab folded before Flop (didn't bet)
Seat 6: b5e0f02d (button) folded before Flop (didn't bet)


Poker Hand #HD1775499028: Hold'em No Limit ($0.05/$0.1) - 2024/05/16 20:09:20
Table 'NLHRed23' 6-max Seat #5 is the button
Seat 1: 8ec1870 ($11.88 in chips)
Seat 3: Hero ($16.9 in chips)
Seat 4: 9681dc27 ($15.02 in chips)
Seat 5: 3b85adab ($2.61 in chips)
Seat 6: b5e0f02d ($10 in chips)
b5e0f02d: posts small blind $0.05
8ec1870: posts big blind $0.1
*** HOLE CARDS ***
Dealt to 8ec1870 
Dealt to Hero [6h Ah]
Dealt to 9681dc27 
Dealt to 3b85adab 
Dealt to b5e0f02d 
Hero: raises $0.1 to $0.2
9681dc27: folds
3b85adab: calls $0.2
b5e0f02d: folds
8ec1870: folds
*** FLOP *** [5s 7c Js]
Hero: checks
3b85adab: checks
*** TURN *** [5s 7c Js] [2c]
Hero: checks
3b85adab: checks
*** RIVER *** [5s 7c Js 2c] [5h]
Hero: checks
3b85adab: bets $0.55
Hero: calls $0.55
3b85adab: shows [6d 6c] (Pair of Sixes and Pair of Fives)
Hero: shows [6h Ah] (Pair of Fives)
*** SHOWDOWN ***
3b85adab collected $1.57 from pot
*** SUMMARY ***
Total pot $1.65 | Rake $0.08 | Jackpot $0 | Bingo $0 | Fortune $0 | Tax $0
Board [5s 7c Js 2c 5h]
Seat 1: 8ec1870 (big blind) folded before Flop
Seat 3: Hero showed [6h Ah] and lost with Pair of Fives
Seat 4: 9681dc27 folded before Flop (didn't bet)
Seat 5: 3b85adab (button) showed [6d 6c] and won ($1.57) with Pair of Sixes and Pair of Fives
Seat 6: b5e0f02d (small blind) folded before Flop


Poker Hand #HD1775498949: Hold'em No Limit ($0.05/$0.1) - 2024/05/16 20:08:21
Table 'NLHRed23' 6-max Seat #4 is the button
Seat 1: 8ec1870 ($11.88 in chips)
Seat 3: Hero ($16.9 in chips)
Seat 4: 9681dc27 ($14.52 in chips)
Seat 5: 3b85adab ($3.06 in chips)
Seat 6: b5e0f02d ($10 in chips)
3b85adab: posts small blind $0.05
b5e0f02d: posts big blind $0.1
*** HOLE CARDS ***
Dealt to 8ec1870 
Dealt to Hero [Jd 8h]
Dealt to 9681dc27 
Dealt to 3b85adab 
Dealt to b5e0f02d 
8ec1870: folds
Hero: folds
9681dc27: raises $0.15 to $0.25
3b85adab: calls $0.2
b5e0f02d: folds
*** FLOP *** [Kh 8s 7d]
3b85adab: checks
9681dc27: bets $0.2
3b85adab: calls $0.2
*** TURN *** [Kh 8s 7d] [7h]
3b85adab: checks
9681dc27: bets $0.77
3b85adab: folds
Uncalled bet ($0.77) returned to 9681dc27
*** SHOWDOWN ***
9681dc27 collected $0.95 from pot
*** SUMMARY ***
Total pot $1 | Rake $0.05 | Jackpot $0 | Bingo $0 | Fortune $0 | Tax $0
Board [Kh 8s 7d 7h]
Seat 1: 8ec1870 folded before Flop (didn't bet)
Seat 3: Hero folded before Flop (didn't bet)
Seat 4: 9681dc27 (button) won ($0.95)
Seat 5: 3b85adab (small blind) folded on the Turn
Seat 6: b5e0f02d (big blind) folded before Flop


Poker Hand #HD1775498907: Hold'em No Limit ($0.05/$0.1) - 2024/05/16 20:08:03
Table 'NLHRed23' 6-max Seat #3 is the button
Seat 1: 8ec1870 ($11.88 in chips)
Seat 3: Hero ($16.9 in chips)
Seat 4: 9681dc27 ($14.43 in chips)
Seat 5: 3b85adab ($3.16 in chips)
Seat 6: b5e0f02d ($10 in chips)
9681dc27: posts small blind $0.05
3b85adab: posts big blind $0.1
*** HOLE CARDS ***
Dealt to 8ec1870 
Dealt to Hero [2h Th]
Dealt to 9681dc27 
Dealt to 3b85adab 
Dealt to b5e0f02d 
b5e0f02d: folds
8ec1870: folds
Hero: folds
9681dc27: calls $0.05
3b85adab: checks
*** FLOP *** [6h Jc 6d]
9681dc27: bets $0.1
3b85adab: folds
Uncalled bet ($0.1) returned to 9681dc27
*** SHOWDOWN ***
9681dc27 collected $0.19 from pot
*** SUMMARY ***
Total pot $0.2 | Rake $0.01 | Jackpot $0 | Bingo $0 | Fortune $0 | Tax $0
Board [6h Jc 6d]
Seat 1: 8ec1870 folded before Flop (didn't bet)
Seat 3: Hero (button) folded before Flop (didn't bet)
Seat 4: 9681dc27 (small blind) won ($0.19)
Seat 5: 3b85adab (big blind) folded on the Flop
Seat 6: b5e0f02d folded before Flop (didn't bet)


Poker Hand #HD1775498827: Hold'em No Limit ($0.05/$0.1) - 2024/05/16 20:07:15
Table 'NLHRed23' 6-max Seat #1 is the button
Seat 1: 8ec1870 ($11.88 in chips)
Seat 3: Hero ($16.95 in chips)
Seat 4: 9681dc27 ($14.11 in chips)
Seat 5: 3b85adab ($3.46 in chips)
Seat 6: b5e0f02d ($10 in chips)
Hero: posts small blind $0.05
9681dc27: posts big blind $0.1
*** HOLE CARDS ***
Dealt to 8ec1870 
Dealt to Hero [7c 9s]
Dealt to 9681dc27 
Dealt to 3b85adab 
Dealt to b5e0f02d 
3b85adab: calls $0.1
b5e0f02d: folds
8ec1870: folds
Hero: folds
9681dc27: checks
*** FLOP *** [Tc Qd Ah]
9681dc27: checks
3b85adab: checks
*** TURN *** [Tc Qd Ah] [2s]
9681dc27: bets $0.1
3b85adab: calls $0.1
*** RIVER *** [Tc Qd Ah 2s] [4h]
9681dc27: bets $0.1
3b85adab: calls $0.1
9681dc27: shows [2c Js] (Pair of Twos)
3b85adab: shows [Jh 9c] (Ace-High)
*** SHOWDOWN ***
9681dc27 collected $0.62 from pot
*** SUMMARY ***
Total pot $0.65 | Rake $0.03 | Jackpot $0 | Bingo $0 | Fortune $0 | Tax $0
Board [Tc Qd Ah 2s 4h]
Seat 1: 8ec1870 (button) folded before Flop (didn't bet)
Seat 3: Hero (small blind) folded before Flop
Seat 4: 9681dc27 (big blind) showed [2c Js] and won ($0.62) with Pair of Twos
Seat 5: 3b85adab showed [Jh 9c] and lost with Ace-High
Seat 6: b5e0f02d folded before Flop (didn't bet)


Poker Hand #HD1775498732: Hold'em No Limit ($0.05/$0.1) - 2024/05/16 20:06:16
Table 'NLHRed23' 6-max Seat #6 is the button
Seat 1: 8ec1870 ($11.93 in chips)
Seat 3: Hero ($16.34 in chips)
Seat 4: 9681dc27 ($14.41 in chips)
Seat 5: 3b85adab ($3.76 in chips)
Seat 6: b5e0f02d ($10 in chips)
8ec1870: posts small blind $0.05
Hero: posts big blind $0.1
*** HOLE CARDS ***
Dealt to 8ec1870 
Dealt to Hero [Jc Ah]
Dealt to 9681dc27 
Dealt to 3b85adab 
Dealt to b5e0f02d 
9681dc27: raises $0.2 to $0.3
3b85adab: calls $0.3
b5e0f02d: folds
8ec1870: folds
Hero: calls $0.2
*** FLOP *** [As Th Kc]
Hero: checks
9681dc27: checks
3b85adab: checks
*** TURN *** [As Th Kc] [Ad]
Hero: bets $0.4
9681dc27: folds
3b85adab: folds
Uncalled bet ($0.4) returned to Hero
*** SHOWDOWN ***
Hero collected $0.91 from pot
*** SUMMARY ***
Total pot $0.95 | Rake $0.04 | Jackpot $0 | Bingo $0 | Fortune $0 | Tax $0
Board [As Th Kc Ad]
Seat 1: 8ec1870 (small blind) folded before Flop
Seat 3: Hero (big blind) won ($0.91)
Seat 4: 9681dc27 folded on the Turn
Seat 5: 3b85adab folded on the Turn
Seat 6: b5e0f02d (button) folded before Flop (didn't bet)


Poker Hand #HD1775498690: Hold'em No Limit ($0.05/$0.1) - 2024/05/16 20:05:51
Table 'NLHRed23' 6-max Seat #5 is the button
Seat 1: 8ec1870 ($11.88 in chips)
Seat 3: Hero ($16.34 in chips)
Seat 4: 9681dc27 ($14.41 in chips)
Seat 5: 3b85adab ($3.76 in chips)
Seat 6: b5e0f02d ($10 in chips)
b5e0f02d: posts small blind $0.05
8ec1870: posts big blind $0.1
*** HOLE CARDS ***
Dealt to 8ec1870 
Dealt to Hero [Tc 7c]
Dealt to 9681dc27 
Dealt to 3b85adab 
Dealt to b5e0f02d 
Hero: folds
9681dc27: folds
3b85adab: folds
b5e0f02d: folds
Uncalled bet ($0.05) returned to 8ec1870
*** SHOWDOWN ***
8ec1870 collected $0.1 from pot
*** SUMMARY ***
Total pot $0.1 | Rake $0 | Jackpot $0 | Bingo $0 | Fortune $0 | Tax $0
Seat 1: 8ec1870 (big blind) collected ($0.1)
Seat 3: Hero folded before Flop (didn't bet)
Seat 4: 9681dc27 folded before Flop (didn't bet)
Seat 5: 3b85adab (button) folded before Flop (didn't bet)
Seat 6: b5e0f02d (small blind) folded before Flop


Poker Hand #HD1775498594: Hold'em No Limit ($0.05/$0.1) - 2024/05/16 20:04:44
Table 'NLHRed23' 6-max Seat #4 is the button
Seat 1: 8ec1870 ($11.88 in chips)
Seat 2: deabc6ef ($30.76 in chips)
Seat 3: Hero ($16.34 in chips)
Seat 4: 9681dc27 ($15.74 in chips)
Seat 5: 3b85adab ($2.46 in chips)
Seat 6: b5e0f02d ($10 in chips)
3b85adab: posts small blind $0.05
b5e0f02d: posts big blind $0.1
*** HOLE CARDS ***
Dealt to 8ec1870 
Dealt to deabc6ef 
Dealt to Hero [3s 9h]
Dealt to 9681dc27 
Dealt to 3b85adab 
Dealt to b5e0f02d 
8ec1870: folds
deabc6ef: folds
Hero: folds
9681dc27: raises $0.15 to $0.25
3b85adab: calls $0.2
b5e0f02d: folds
*** FLOP *** [Tc Ah Kd]
3b85adab: bets $0.2
9681dc27: calls $0.2
*** TURN *** [Tc Ah Kd] [2d]
3b85adab: bets $0.33
9681dc27: calls $0.33
*** RIVER *** [Tc Ah Kd 2d] [5s]
3b85adab: bets $0.55
9681dc27: calls $0.55
3b85adab: shows [Qh As] (Pair of Aces)
9681dc27: shows [Qd Ks] (Pair of Kings)
*** SHOWDOWN ***
3b85adab collected $2.63 from pot
*** SUMMARY ***
Total pot $2.76 | Rake $0.13 | Jackpot $0 | Bingo $0 | Fortune $0 | Tax $0
Board [Tc Ah Kd 2d 5s]
Seat 1: 8ec1870 folded before Flop (didn't bet)
Seat 2: deabc6ef folded before Flop (didn't bet)
Seat 3: Hero folded before Flop (didn't bet)
Seat 4: 9681dc27 (button) showed [Qd Ks] and lost with Pair of Kings
Seat 5: 3b85adab (small blind) showed [Qh As] and won ($2.63) with Pair of Aces
Seat 6: b5e0f02d (big blind) folded before Flop


Poker Hand #HD1775498490: Hold'em No Limit ($0.05/$0.1) - 2024/05/16 20:03:40
Table 'NLHRed23' 6-max Seat #3 is the button
Seat 1: 8ec1870 ($11.88 in chips)
Seat 2: deabc6ef ($30.76 in chips)
Seat 3: Hero ($16.34 in chips)
Seat 4: 9681dc27 ($15.38 in chips)
Seat 5: 3b85adab ($2.86 in chips)
Seat 6: b5e0f02d ($10 in chips)
9681dc27: posts small blind $0.05
3b85adab: posts big blind $0.1
*** HOLE CARDS ***
Dealt to 8ec1870 
Dealt to deabc6ef 
Dealt to Hero [Jh 2h]
Dealt to 9681dc27 
Dealt to 3b85adab 
Dealt to b5e0f02d 
b5e0f02d: folds
8ec1870: folds
deabc6ef: folds
Hero: folds
9681dc27: raises $0.15 to $0.25
3b85adab: calls $0.15
*** FLOP *** [Th 4s Qd]
9681dc27: bets $0.15
3b85adab: calls $0.15
*** TURN *** [Th 4s Qd] [7h]
9681dc27: bets $0.4
3b85adab: folds
Uncalled bet ($0.4) returned to 9681dc27
*** SHOWDOWN ***
9681dc27 collected $0.76 from pot
*** SUMMARY ***
Total pot $0.8 | Rake $0.04 | Jackpot $0 | Bingo $0 | Fortune $0 | Tax $0
Board [Th 4s Qd 7h]
Seat 1: 8ec1870 folded before Flop (didn't bet)
Seat 2: deabc6ef folded before Flop (didn't bet)
Seat 3: Hero (button) folded before Flop (didn't bet)
Seat 4: 9681dc27 (small blind) won ($0.76)
Seat 5: 3b85adab (big blind) folded on the Turn
Seat 6: b5e0f02d folded before Flop (didn't bet)


Poker Hand #HD1775498383: Hold'em No Limit ($0.05/$0.1) - 2024/05/16 20:02:33
Table 'NLHRed23' 6-max Seat #2 is the button
Seat 1: 8ec1870 ($11.88 in chips)
Seat 2: deabc6ef ($30.76 in chips)
Seat 3: Hero ($16.39 in chips)
Seat 4: 9681dc27 ($15.06 in chips)
Seat 5: 3b85adab ($3.16 in chips)
Seat 6: b5e0f02d ($10 in chips)
Hero: posts small blind $0.05
9681dc27: posts big blind $0.1
*** HOLE CARDS ***
Dealt to 8ec1870 
Dealt to deabc6ef 
Dealt to Hero [Qc 5c]
Dealt to 9681dc27 
Dealt to 3b85adab 
Dealt to b5e0f02d 
3b85adab: calls $0.1
b5e0f02d: folds
8ec1870: folds
deabc6ef: folds
Hero: folds
9681dc27: checks
*** FLOP *** [6h 2c 3d]
9681dc27: checks
3b85adab: checks
*** TURN *** [6h 2c 3d] [9s]
9681dc27: bets $0.1
3b85adab: calls $0.1
*** RIVER *** [6h 2c 3d 9s] [6d]
9681dc27: bets $0.1
3b85adab: calls $0.1
9681dc27: shows [3c 8s] (Pair of Sixes and Pair of Treys)
3b85adab: shows [5h As] (Pair of Sixes)
*** SHOWDOWN ***
9681dc27 collected $0.62 from pot
*** SUMMARY ***
Total pot $0.65 | Rake $0.03 | Jackpot $0 | Bingo $0 | Fortune $0 | Tax $0
Board [6h 2c 3d 9s 6d]
Seat 1: 8ec1870 folded before Flop (didn't bet)
Seat 2: deabc6ef (button) folded before Flop (didn't bet)
Seat 3: Hero (small blind) folded before Flop
Seat 4: 9681dc27 (big blind) showed [3c 8s] and won ($0.62) with Pair of Sixes and Pair of Treys
Seat 5: 3b85adab showed [5h As] and lost with Pair of Sixes
Seat 6: b5e0f02d folded before Flop (didn't bet)


Poker Hand #HD1775498326: Hold'em No Limit ($0.05/$0.1) - 2024/05/16 20:02:02
Table 'NLHRed23' 6-max Seat #1 is the button
Seat 1: 8ec1870 ($11.88 in chips)
Seat 2: deabc6ef ($30.48 in chips)
Seat 3: Hero ($16.49 in chips)
Seat 4: 9681dc27 ($15.06 in chips)
Seat 5: 3b85adab ($3.16 in chips)
Seat 6: b5e0f02d ($10.1 in chips)
deabc6ef: posts small blind $0.05
Hero: posts big blind $0.1
*** HOLE CARDS ***
Dealt to 8ec1870 
Dealt to deabc6ef 
Dealt to Hero [Kd 5s]
Dealt to 9681dc27 
Dealt to 3b85adab 
Dealt to b5e0f02d 
9681dc27: folds
3b85adab: folds
b5e0f02d: raises $0.1 to $0.2
8ec1870: folds
deabc6ef: raises $0.6 to $0.8
Hero: folds
b5e0f02d: folds
Uncalled bet ($0.6) returned to deabc6ef
*** SHOWDOWN ***
deabc6ef collected $0.48 from pot
*** SUMMARY ***
Total pot $0.5 | Rake $0.02 | Jackpot $0 | Bingo $0 | Fortune $0 | Tax $0
Seat 1: 8ec1870 (button) folded before Flop (didn't bet)
Seat 2: deabc6ef (small blind) collected ($0.48)
Seat 3: Hero (big blind) folded before Flop
Seat 4: 9681dc27 folded before Flop (didn't bet)
Seat 5: 3b85adab folded before Flop (didn't bet)
Seat 6: b5e0f02d folded before Flop


Poker Hand #HD1775498305: Hold'em No Limit ($0.05/$0.1) - 2024/05/16 20:01:45
Table 'NLHRed23' 6-max Seat #6 is the button
Seat 1: 8ec1870 ($11.93 in chips)
Seat 2: deabc6ef ($30.43 in chips)
Seat 3: Hero ($16.49 in chips)
Seat 4: 9681dc27 ($15.06 in chips)
Seat 5: 3b85adab ($3.16 in chips)
Seat 6: b5e0f02d ($10.1 in chips)
8ec1870: posts small blind $0.05
deabc6ef: posts big blind $0.1
*** HOLE CARDS ***
Dealt to 8ec1870 
Dealt to deabc6ef 
Dealt to Hero [8d 2s]
Dealt to 9681dc27 
Dealt to 3b85adab 
Dealt to b5e0f02d 
Hero: folds
9681dc27: folds
3b85adab: folds
b5e0f02d: folds
8ec1870: folds
Uncalled bet ($0.05) returned to deabc6ef
*** SHOWDOWN ***
deabc6ef collected $0.1 from pot
*** SUMMARY ***
Total pot $0.1 | Rake $0 | Jackpot $0 | Bingo $0 | Fortune $0 | Tax $0
Seat 1: 8ec1870 (small blind) folded before Flop
Seat 2: deabc6ef (big blind) collected ($0.1)
Seat 3: Hero folded before Flop (didn't bet)
Seat 4: 9681dc27 folded before Flop (didn't bet)
Seat 5: 3b85adab folded before Flop (didn't bet)
Seat 6: b5e0f02d (button) folded before Flop (didn't bet)


Poker Hand #HD1775498272: Hold'em No Limit ($0.05/$0.1) - 2024/05/16 20:01:23
Table 'NLHRed23' 6-max Seat #5 is the button
Seat 1: 8ec1870 ($12.03 in chips)
Seat 2: deabc6ef ($30.43 in chips)
Seat 3: Hero ($16.49 in chips)
Seat 4: 9681dc27 ($15.06 in chips)
Seat 5: 3b85adab ($3.16 in chips)
Seat 6: b5e0f02d ($10 in chips)
b5e0f02d: posts small blind $0.05
8ec1870: posts big blind $0.1
*** HOLE CARDS ***
Dealt to 8ec1870 
Dealt to deabc6ef 
Dealt to Hero [6d Kd]
Dealt to 9681dc27 
Dealt to 3b85adab 
Dealt to b5e0f02d 
deabc6ef: folds
Hero: folds
9681dc27: folds
3b85adab: folds
b5e0f02d: raises $0.2 to $0.3
8ec1870: folds
Uncalled bet ($0.2) returned to b5e0f02d
*** SHOWDOWN ***
b5e0f02d collected $0.2 from pot
*** SUMMARY ***
Total pot $0.2 | Rake $0 | Jackpot $0 | Bingo $0 | Fortune $0 | Tax $0
Seat 1: 8ec1870 (big blind) folded before Flop
Seat 2: deabc6ef folded before Flop (didn't bet)
Seat 3: Hero folded before Flop (didn't bet)
Seat 4: 9681dc27 folded before Flop (didn't bet)
Seat 5: 3b85adab (button) folded before Flop (didn't bet)
Seat 6: b5e0f02d (small blind) collected ($0.2)


Poker Hand #HD1775498202: Hold'em No Limit ($0.05/$0.1) - 2024/05/16 20:00:45
Table 'NLHRed23' 6-max Seat #4 is the button
Seat 1: 8ec1870 ($12.03 in chips)
Seat 2: deabc6ef ($30.43 in chips)
Seat 3: Hero ($16.73 in chips)
Seat 4: 9681dc27 ($15.06 in chips)
Seat 5: 3b85adab ($2.84 in chips)
Seat 6: b5e0f02d ($10 in chips)
3b85adab: posts small blind $0.05
b5e0f02d: posts big blind $0.1
*** HOLE CARDS ***
Dealt to 8ec1870 
Dealt to deabc6ef 
Dealt to Hero [4d 4c]
Dealt to 9681dc27 
Dealt to 3b85adab 
Dealt to b5e0f02d 
8ec1870: folds
deabc6ef: folds
Hero: raises $0.14 to $0.24
9681dc27: folds
3b85adab: calls $0.19
b5e0f02d: folds
*** FLOP *** [7d 5h Ac]
3b85adab: bets $0.58
Hero: folds
Uncalled bet ($0.58) returned to 3b85adab
*** SHOWDOWN ***
3b85adab collected $0.56 from pot
*** SUMMARY ***
Total pot $0.58 | Rake $0.02 | Jackpot $0 | Bingo $0 | Fortune $0 | Tax $0
Board [7d 5h Ac]
Seat 1: 8ec1870 folded before Flop (didn't bet)
Seat 2: deabc6ef folded before Flop (didn't bet)
Seat 3: Hero folded on the Flop
Seat 4: 9681dc27 (button) folded before Flop (didn't bet)
Seat 5: 3b85adab (small blind) won ($0.56)
Seat 6: b5e0f02d (big blind) folded before Flop


Poker Hand #HD1775498086: Hold'em No Limit ($0.05/$0.1) - 2024/05/16 19:59:43
Table 'NLHRed23' 6-max Seat #3 is the button
Seat 1: 8ec1870 ($12.03 in chips)
Seat 2: deabc6ef ($28.43 in chips)
Seat 3: Hero ($18.9 in chips)
Seat 4: 9681dc27 ($15.11 in chips)
Seat 5: 3b85adab ($2.94 in chips)
Seat 6: 16633c83 ($13.51 in chips)
9681dc27: posts small blind $0.05
3b85adab: posts big blind $0.1
*** HOLE CARDS ***
Dealt to 8ec1870 
Dealt to deabc6ef 
Dealt to Hero [Js Kc]
Dealt to 9681dc27 
Dealt to 3b85adab 
Dealt to 16633c83 
16633c83: folds
8ec1870: folds
deabc6ef: raises $0.15 to $0.25
Hero: raises $0.75 to $1
9681dc27: folds
3b85adab: folds
deabc6ef: calls $0.75
*** FLOP *** [7h 8s Kh]
deabc6ef: checks
Hero: checks
*** TURN *** [7h 8s Kh] [2h]
deabc6ef: bets $1.17
Hero: calls $1.17
*** RIVER *** [7h 8s Kh 2h] [Th]
deabc6ef: bets $1.49
Hero: folds
Uncalled bet ($1.49) returned to deabc6ef
*** SHOWDOWN ***
deabc6ef collected $4.17 from pot
*** SUMMARY ***
Total pot $4.49 | Rake $0.22 | Jackpot $0.1 | Bingo $0 | Fortune $0 | Tax $0
Board [7h 8s Kh 2h Th]
Seat 1: 8ec1870 folded before Flop (didn't bet)
Seat 2: deabc6ef won ($4.17)
Seat 3: Hero (button) folded on the River
Seat 4: 9681dc27 (small blind) folded before Flop
Seat 5: 3b85adab (big blind) folded before Flop
Seat 6: 16633c83 folded before Flop (didn't bet)


Poker Hand #HD1775498008: Hold'em No Limit ($0.05/$0.1) - 2024/05/16 19:59:03
Table 'NLHRed23' 6-max Seat #2 is the button
Seat 1: 8ec1870 ($12.03 in chips)
Seat 2: deabc6ef ($28.43 in chips)
Seat 3: Hero ($18.95 in chips)
Seat 4: 9681dc27 ($14.88 in chips)
Seat 5: 3b85adab ($3.14 in chips)
Seat 6: 16633c83 ($13.51 in chips)
Hero: posts small blind $0.05
9681dc27: posts big blind $0.1
*** HOLE CARDS ***
Dealt to 8ec1870 
Dealt to deabc6ef 
Dealt to Hero [Jh 3s]
Dealt to 9681dc27 
Dealt to 3b85adab 
Dealt to 16633c83 
3b85adab: calls $0.1
16633c83: folds
8ec1870: folds
deabc6ef: folds
Hero: folds
9681dc27: checks
*** FLOP *** [5h Kh Jc]
9681dc27: checks
3b85adab: checks
*** TURN *** [5h Kh Jc] [9d]
9681dc27: bets $0.1
3b85adab: calls $0.1
*** RIVER *** [5h Kh Jc 9d] [Ac]
9681dc27: bets $0.2
3b85adab: folds
Uncalled bet ($0.2) returned to 9681dc27
*** SHOWDOWN ***
9681dc27 collected $0.43 from pot
*** SUMMARY ***
Total pot $0.45 | Rake $0.02 | Jackpot $0 | Bingo $0 | Fortune $0 | Tax $0
Board [5h Kh Jc 9d Ac]
Seat 1: 8ec1870 folded before Flop (didn't bet)
Seat 2: deabc6ef (button) folded before Flop (didn't bet)
Seat 3: Hero (small blind) folded before Flop
Seat 4: 9681dc27 (big blind) won ($0.43)
Seat 5: 3b85adab folded on the River
Seat 6: 16633c83 folded before Flop (didn't bet)


Poker Hand #HD1775497911: Hold'em No Limit ($0.05/$0.1) - 2024/05/16 19:58:08
Table 'NLHRed23' 6-max Seat #1 is the button
Seat 1: 8ec1870 ($12.03 in chips)
Seat 2: deabc6ef ($28.48 in chips)
Seat 3: Hero ($19.05 in chips)
Seat 4: 9681dc27 ($14.88 in chips)
Seat 5: 3b85adab ($3 in chips)
Seat 6: 16633c83 ($13.51 in chips)
deabc6ef: posts small blind $0.05
Hero: posts big blind $0.1
*** HOLE CARDS ***
Dealt to 8ec1870 
Dealt to deabc6ef 
Dealt to Hero [5s 6s]
Dealt to 9681dc27 
Dealt to 3b85adab 
Dealt to 16633c83 
9681dc27: folds
3b85adab: calls $0.1
16633c83: folds
8ec1870: folds
deabc6ef: folds
Hero: checks
*** FLOP *** [Qh Td Ad]
Hero: checks
3b85adab: checks
*** TURN *** [Qh Td Ad] [6h]
Hero: checks
3b85adab: checks
*** RIVER *** [Qh Td Ad 6h] [7h]
Hero: checks
3b85adab: bets $0.25
Hero: folds
Uncalled bet ($0.25) returned to 3b85adab
*** SHOWDOWN ***
3b85adab collected $0.24 from pot
*** SUMMARY ***
Total pot $0.25 | Rake $0.01 | Jackpot $0 | Bingo $0 | Fortune $0 | Tax $0
Board [Qh Td Ad 6h 7h]
Seat 1: 8ec1870 (button) folded before Flop (didn't bet)
Seat 2: deabc6ef (small blind) folded before Flop
Seat 3: Hero (big blind) folded on the River
Seat 4: 9681dc27 folded before Flop (didn't bet)
Seat 5: 3b85adab won ($0.24)
Seat 6: 16633c83 folded before Flop (didn't bet)


Poker Hand #HD1775497764: Hold'em No Limit ($0.05/$0.1) - 2024/05/16 19:56:48
Table 'NLHRed23' 6-max Seat #6 is the button
Seat 1: 8ec1870 ($12.08 in chips)
Seat 2: deabc6ef ($28.98 in chips)
Seat 3: Hero ($19.05 in chips)
Seat 4: 9681dc27 ($14.38 in chips)
Seat 6: 16633c83 ($13.51 in chips)
8ec1870: posts small blind $0.05
deabc6ef: posts big blind $0.1
*** HOLE CARDS ***
Dealt to 8ec1870 
Dealt to deabc6ef 
Dealt to Hero [6c 4s]
Dealt to 9681dc27 
Dealt to 16633c83 
Hero: folds
9681dc27: raises $0.2 to $0.3
16633c83: folds
8ec1870: folds
deabc6ef: calls $0.2
*** FLOP *** [5c 2s Kh]
deabc6ef: checks
9681dc27: bets $0.2
deabc6ef: calls $0.2
*** TURN *** [5c 2s Kh] [5h]
deabc6ef: checks
9681dc27: bets $0.81
deabc6ef: folds
Uncalled bet ($0.81) returned to 9681dc27
*** SHOWDOWN ***
9681dc27 collected $1 from pot
*** SUMMARY ***
Total pot $1.05 | Rake $0.05 | Jackpot $0 | Bingo $0 | Fortune $0 | Tax $0
Board [5c 2s Kh 5h]
Seat 1: 8ec1870 (small blind) folded before Flop
Seat 2: deabc6ef (big blind) folded on the Turn
Seat 3: Hero folded before Flop (didn't bet)
Seat 4: 9681dc27 won ($1)
Seat 6: 16633c83 (button) folded before Flop (didn't bet)


Poker Hand #HD1775497685: Hold'em No Limit ($0.05/$0.1) - 2024/05/16 19:56:00
Table 'NLHRed23' 6-max Seat #5 is the button
Seat 1: 8ec1870 ($12.18 in chips)
Seat 2: deabc6ef ($28.98 in chips)
Seat 3: Hero ($19.05 in chips)
Seat 4: 9681dc27 ($14.38 in chips)
Seat 5: 3b85adab ($0.33 in chips)
Seat 6: 16633c83 ($13.11 in chips)
16633c83: posts small blind $0.05
8ec1870: posts big blind $0.1
*** HOLE CARDS ***
Dealt to 8ec1870 
Dealt to deabc6ef 
Dealt to Hero [5s 9d]
Dealt to 9681dc27 
Dealt to 3b85adab 
Dealt to 16633c83 
deabc6ef: folds
Hero: folds
9681dc27: folds
3b85adab: calls $0.1
16633c83: raises $0.4 to $0.5
8ec1870: folds
3b85adab: calls $0.23 and is all-in
Uncalled bet ($0.17) returned to 16633c83
16633c83: shows [6s As]
3b85adab: shows [Kc 2d]
*** FLOP *** [Js Jh Tc]
*** TURN *** [Js Jh Tc] [6d]
*** RIVER *** [Js Jh Tc 6d] [Ts]
*** SHOWDOWN ***
16633c83 collected $0.73 from pot
*** SUMMARY ***
Total pot $0.76 | Rake $0.03 | Jackpot $0 | Bingo $0 | Fortune $0 | Tax $0
Board [Js Jh Tc 6d Ts]
Seat 1: 8ec1870 (big blind) folded before Flop
Seat 2: deabc6ef folded before Flop (didn't bet)
Seat 3: Hero folded before Flop (didn't bet)
Seat 4: 9681dc27 folded before Flop (didn't bet)
Seat 5: 3b85adab (button) showed [Kc 2d] and lost with Pair of Jacks and Pair of Tens
Seat 6: 16633c83 (small blind) showed [6s As] and won ($0.73) with Pair of Jacks and Pair of Tens


Poker Hand #HD1775497639: Hold'em No Limit ($0.05/$0.1) - 2024/05/16 19:55:35
Table 'NLHRed23' 6-max Seat #4 is the button
Seat 1: 8ec1870 ($12.18 in chips)
Seat 2: deabc6ef ($28.98 in chips)
Seat 3: Hero ($19.05 in chips)
Seat 4: 9681dc27 ($14.23 in chips)
Seat 5: 3b85adab ($0.38 in chips)
Seat 6: 16633c83 ($13.21 in chips)
3b85adab: posts small blind $0.05
16633c83: posts big blind $0.1
*** HOLE CARDS ***
Dealt to 8ec1870 
Dealt to deabc6ef 
Dealt to Hero [4d Jd]
Dealt to 9681dc27 
Dealt to 3b85adab 
Dealt to 16633c83 
8ec1870: folds
deabc6ef: folds
Hero: folds
9681dc27: raises $0.15 to $0.25
3b85adab: folds
16633c83: folds
Uncalled bet ($0.15) returned to 9681dc27
*** SHOWDOWN ***
9681dc27 collected $0.25 from pot
*** SUMMARY ***
Total pot $0.25 | Rake $0 | Jackpot $0 | Bingo $0 | Fortune $0 | Tax $0
Seat 1: 8ec1870 folded before Flop (didn't bet)
Seat 2: deabc6ef folded before Flop (didn't bet)
Seat 3: Hero folded before Flop (didn't bet)
Seat 4: 9681dc27 (button) collected ($0.25)
Seat 5: 3b85adab (small blind) folded before Flop
Seat 6: 16633c83 (big blind) folded before Flop


Poker Hand #HD1775497593: Hold'em No Limit ($0.05/$0.1) - 2024/05/16 19:55:09
Table 'NLHRed23' 6-max Seat #3 is the button
Seat 1: 8ec1870 ($12.18 in chips)
Seat 2: deabc6ef ($28.98 in chips)
Seat 3: Hero ($18.9 in chips)
Seat 4: 9681dc27 ($14.28 in chips)
Seat 5: 3b85adab ($0.48 in chips)
Seat 6: 16633c83 ($13.21 in chips)
9681dc27: posts small blind $0.05
3b85adab: posts big blind $0.1
*** HOLE CARDS ***
Dealt to 8ec1870 
Dealt to deabc6ef 
Dealt to Hero [Js Ad]
Dealt to 9681dc27 
Dealt to 3b85adab 
Dealt to 16633c83 
16633c83: folds
8ec1870: folds
deabc6ef: folds
Hero: raises $0.14 to $0.24
9681dc27: folds
3b85adab: folds
Uncalled bet ($0.14) returned to Hero
*** SHOWDOWN ***
Hero collected $0.25 from pot
*** SUMMARY ***
Total pot $0.25 | Rake $0 | Jackpot $0 | Bingo $0 | Fortune $0 | Tax $0
Seat 1: 8ec1870 folded before Flop (didn't bet)
Seat 2: deabc6ef folded before Flop (didn't bet)
Seat 3: Hero (button) collected ($0.25)
Seat 4: 9681dc27 (small blind) folded before Flop
Seat 5: 3b85adab (big blind) folded before Flop
Seat 6: 16633c83 folded before Flop (didn't bet)


Poker Hand #HD1775497446: Hold'em No Limit ($0.05/$0.1) - 2024/05/16 19:53:50
Table 'NLHRed23' 6-max Seat #2 is the button
Seat 1: 8ec1870 ($12.18 in chips)
Seat 2: deabc6ef ($28.98 in chips)
Seat 3: Hero ($18.95 in chips)
Seat 4: 9681dc27 ($14.05 in chips)
Seat 5: 3b85adab ($0.68 in chips)
Seat 6: 16633c83 ($13.21 in chips)
Hero: posts small blind $0.05
9681dc27: posts big blind $0.1
*** HOLE CARDS ***
Dealt to 8ec1870 
Dealt to deabc6ef 
Dealt to Hero [9h 2c]
Dealt to 9681dc27 
Dealt to 3b85adab 
Dealt to 16633c83 
3b85adab: calls $0.1
16633c83: folds
8ec1870: folds
deabc6ef: folds
Hero: folds
9681dc27: checks
*** FLOP *** [As 9d Kh]
9681dc27: checks
3b85adab: checks
*** TURN *** [As 9d Kh] [Ac]
9681dc27: checks
3b85adab: checks
*** RIVER *** [As 9d Kh Ac] [Qh]
9681dc27: bets $0.1
3b85adab: calls $0.1
9681dc27: shows [Kc 5h] (Pair of Aces and Pair of Kings)
3b85adab: shows [8s Ts] (Pair of Aces)
*** SHOWDOWN ***
9681dc27 collected $0.43 from pot
*** SUMMARY ***
Total pot $0.45 | Rake $0.02 | Jackpot $0 | Bingo $0 | Fortune $0 | Tax $0
Board [As 9d Kh Ac Qh]
Seat 1: 8ec1870 folded before Flop (didn't bet)
Seat 2: deabc6ef (button) folded before Flop (didn't bet)
Seat 3: Hero (small blind) folded before Flop
Seat 4: 9681dc27 (big blind) showed [Kc 5h] and won ($0.43) with Pair of Aces and Pair of Kings
Seat 5: 3b85adab showed [8s Ts] and lost with Pair of Aces
Seat 6: 16633c83 folded before Flop (didn't bet)


Poker Hand #HD1775497403: Hold'em No Limit ($0.05/$0.1) - 2024/05/16 19:53:25
Table 'NLHRed23' 6-max Seat #1 is the button
Seat 1: 8ec1870 ($12.18 in chips)
Seat 2: deabc6ef ($29.03 in chips)
Seat 3: Hero ($19.05 in chips)
Seat 4: 9681dc27 ($13.9 in chips)
Seat 5: 3b85adab ($0.68 in chips)
Seat 6: 16633c83 ($13.21 in chips)
deabc6ef: posts small blind $0.05
Hero: posts big blind $0.1
*** HOLE CARDS ***
Dealt to 8ec1870 
Dealt to deabc6ef 
Dealt to Hero [7c Tc]
Dealt to 9681dc27 
Dealt to 3b85adab 
Dealt to 16633c83 
9681dc27: raises $0.2 to $0.3
3b85adab: folds
16633c83: folds
8ec1870: folds
deabc6ef: folds
Hero: folds
Uncalled bet ($0.2) returned to 9681dc27
*** SHOWDOWN ***
9681dc27 collected $0.25 from pot
*** SUMMARY ***
Total pot $0.25 | Rake $0 | Jackpot $0 | Bingo $0 | Fortune $0 | Tax $0
Seat 1: 8ec1870 (button) folded before Flop (didn't bet)
Seat 2: deabc6ef (small blind) folded before Flop
Seat 3: Hero (big blind) folded before Flop
Seat 4: 9681dc27 collected ($0.25)
Seat 5: 3b85adab folded before Flop (didn't bet)
Seat 6: 16633c83 folded before Flop (didn't bet)


Poker Hand #HD1775497352: Hold'em No Limit ($0.05/$0.1) - 2024/05/16 19:52:57
Table 'NLHRed23' 6-max Seat #6 is the button
Seat 1: 8ec1870 ($11.86 in chips)
Seat 2: deabc6ef ($29.13 in chips)
Seat 3: Hero ($19.05 in chips)
Seat 4: 9681dc27 ($13.9 in chips)
Seat 5: 3b85adab ($0.68 in chips)
Seat 6: 16633c83 ($13.46 in chips)
8ec1870: posts small blind $0.05
deabc6ef: posts big blind $0.1
*** HOLE CARDS ***
Dealt to 8ec1870 
Dealt to deabc6ef 
Dealt to Hero [Jc 9d]
Dealt to 9681dc27 
Dealt to 3b85adab 
Dealt to 16633c83 
Hero: folds
9681dc27: folds
3b85adab: folds
16633c83: raises $0.15 to $0.25
8ec1870: raises $0.85 to $1.1
deabc6ef: folds
16633c83: folds
Uncalled bet ($0.85) returned to 8ec1870
*** SHOWDOWN ***
8ec1870 collected $0.57 from pot
*** SUMMARY ***
Total pot $0.6 | Rake $0.03 | Jackpot $0 | Bingo $0 | Fortune $0 | Tax $0
Seat 1: 8ec1870 (small blind) collected ($0.57)
Seat 2: deabc6ef (big blind) folded before Flop
Seat 3: Hero folded before Flop (didn't bet)
Seat 4: 9681dc27 folded before Flop (didn't bet)
Seat 5: 3b85adab folded before Flop (didn't bet)
Seat 6: 16633c83 (button) folded before Flop


Poker Hand #HD1775497277: Hold'em No Limit ($0.05/$0.1) - 2024/05/16 19:52:08
Table 'NLHRed23' 6-max Seat #5 is the button
Seat 1: 8ec1870 ($11.49 in chips)
Seat 2: deabc6ef ($29.13 in chips)
Seat 3: Hero ($19.05 in chips)
Seat 4: 9681dc27 ($13.9 in chips)
Seat 5: 3b85adab ($1.03 in chips)
Seat 6: 16633c83 ($13.51 in chips)
16633c83: posts small blind $0.05
8ec1870: posts big blind $0.1
*** HOLE CARDS ***
Dealt to 8ec1870 
Dealt to deabc6ef 
Dealt to Hero [5s 2h]
Dealt to 9681dc27 
Dealt to 3b85adab 
Dealt to 16633c83 
deabc6ef: folds
Hero: folds
9681dc27: folds
3b85adab: calls $0.1
16633c83: folds
8ec1870: checks
*** FLOP *** [5h 8d 9c]
8ec1870: checks
3b85adab: checks
*** TURN *** [5h 8d 9c] [2d]
8ec1870: checks
3b85adab: checks
*** RIVER *** [5h 8d 9c 2d] [7c]
8ec1870: bets $0.25
3b85adab: calls $0.25
8ec1870: shows [6c Kc] (Nines-High Straight)
3b85adab: shows [4h Ad] (Ace-High)
*** SHOWDOWN ***
8ec1870 collected $0.72 from pot
*** SUMMARY ***
Total pot $0.75 | Rake $0.03 | Jackpot $0 | Bingo $0 | Fortune $0 | Tax $0
Board [5h 8d 9c 2d 7c]
Seat 1: 8ec1870 (big blind) showed [6c Kc] and won ($0.72) with Nines-High Straight
Seat 2: deabc6ef folded before Flop (didn't bet)
Seat 3: Hero folded before Flop (didn't bet)
Seat 4: 9681dc27 folded before Flop (didn't bet)
Seat 5: 3b85adab (button) showed [4h Ad] and lost with Ace-High
Seat 6: 16633c83 (small blind) folded before Flop


Poker Hand #HD1775497103: Hold'em No Limit ($0.05/$0.1) - 2024/05/16 19:50:23
Table 'NLHRed23' 6-max Seat #4 is the button
Seat 1: 8ec1870 ($11.49 in chips)
Seat 2: deabc6ef ($39.13 in chips)
Seat 3: Hero ($10 in chips)
Seat 4: 9681dc27 ($13.9 in chips)
Seat 5: 3b85adab ($1.08 in chips)
Seat 6: 16633c83 ($13.61 in chips)
3b85adab: posts small blind $0.05
16633c83: posts big blind $0.1
*** HOLE CARDS ***
Dealt to 8ec1870 
Dealt to deabc6ef 
Dealt to Hero [Ah Qh]
Dealt to 9681dc27 
Dealt to 3b85adab 
Dealt to 16633c83 
8ec1870: folds
deabc6ef: raises $0.15 to $0.25
Hero: raises $0.65 to $0.9
9681dc27: folds
3b85adab: folds
16633c83: folds
deabc6ef: calls $0.65
*** FLOP *** [Ac 8c Jc]
deabc6ef: bets $1.06
Hero: calls $1.06
*** TURN *** [Ac 8c Jc] [5h]
deabc6ef: bets $2.2
Hero: calls $2.2
*** RIVER *** [Ac 8c Jc 5h] [9d]
deabc6ef: bets $8.2
Hero: calls $5.84 and is all-in
Uncalled bet ($2.36) returned to deabc6ef
deabc6ef: shows [Qd Kc] (Ace-High)
Hero: shows [Ah Qh] (Pair of Aces)
*** SHOWDOWN ***
Hero collected $19.05 from pot
*** SUMMARY ***
Total pot $20.15 | Rake $1 | Jackpot $0.1 | Bingo $0 | Fortune $0 | Tax $0
Board [Ac 8c Jc 5h 9d]
Seat 1: 8ec1870 folded before Flop (didn't bet)
Seat 2: deabc6ef showed [Qd Kc] and lost with Ace-High
Seat 3: Hero showed [Ah Qh] and won ($19.05) with Pair of Aces
Seat 4: 9681dc27 (button) folded before Flop (didn't bet)
Seat 5: 3b85adab (small blind) folded before Flop
Seat 6: 16633c83 (big blind) folded before Flop


Poker Hand #HD1775497079: Hold'em No Limit ($0.05/$0.1) - 2024/05/16 19:50:09
Table 'NLHRed23' 6-max Seat #3 is the button
Seat 1: 8ec1870 ($11.49 in chips)
Seat 2: deabc6ef ($39.13 in chips)
Seat 3: Hero ($10 in chips)
Seat 4: 9681dc27 ($13.95 in chips)
Seat 5: 3b85adab ($1.18 in chips)
Seat 6: 16633c83 ($13.46 in chips)
9681dc27: posts small blind $0.05
3b85adab: posts big blind $0.1
*** HOLE CARDS ***
Dealt to 8ec1870 
Dealt to deabc6ef 
Dealt to Hero [5s 9h]
Dealt to 9681dc27 
Dealt to 3b85adab 
Dealt to 16633c83 
16633c83: raises $0.15 to $0.25
8ec1870: folds
deabc6ef: folds
Hero: folds
9681dc27: folds
3b85adab: folds
Uncalled bet ($0.15) returned to 16633c83
*** SHOWDOWN ***
16633c83 collected $0.25 from pot
*** SUMMARY ***
Total pot $0.25 | Rake $0 | Jackpot $0 | Bingo $0 | Fortune $0 | Tax $0
Seat 1: 8ec1870 folded before Flop (didn't bet)
Seat 2: deabc6ef folded before Flop (didn't bet)
Seat 3: Hero (button) folded before Flop (didn't bet)
Seat 4: 9681dc27 (small blind) folded before Flop
Seat 5: 3b85adab (big blind) folded before Flop
Seat 6: 16633c83 collected ($0.25)


Poker Hand #HD1775497059: Hold'em No Limit ($0.05/$0.1) - 2024/05/16 19:49:52
Table 'NLHRed23' 6-max Seat #2 is the button
Seat 1: 8ec1870 ($11.49 in chips)
Seat 2: deabc6ef ($39.13 in chips)
Seat 3: Hero ($10.05 in chips)
Seat 4: 9681dc27 ($13.9 in chips)
Seat 5: 3b85adab ($1.18 in chips)
Seat 6: 16633c83 ($13.46 in chips)
Hero: posts small blind $0.05
9681dc27: posts big blind $0.1
*** HOLE CARDS ***
Dealt to 8ec1870 
Dealt to deabc6ef 
Dealt to Hero [4d 8h]
Dealt to 9681dc27 
Dealt to 3b85adab 
Dealt to 16633c83 
3b85adab: folds
16633c83: folds
8ec1870: folds
deabc6ef: folds
Hero: folds
Uncalled bet ($0.05) returned to 9681dc27
*** SHOWDOWN ***
9681dc27 collected $0.1 from pot
*** SUMMARY ***
Total pot $0.1 | Rake $0 | Jackpot $0 | Bingo $0 | Fortune $0 | Tax $0
Seat 1: 8ec1870 folded before Flop (didn't bet)
Seat 2: deabc6ef (button) folded before Flop (didn't bet)
Seat 3: Hero (small blind) folded before Flop
Seat 4: 9681dc27 (big blind) collected ($0.1)
Seat 5: 3b85adab folded before Flop (didn't bet)
Seat 6: 16633c83 folded before Flop (didn't bet)


Poker Hand #HD1775497032: Hold'em No Limit ($0.05/$0.1) - 2024/05/16 19:49:33
Table 'NLHRed23' 6-max Seat #1 is the button
Seat 1: 8ec1870 ($11.34 in chips)
Seat 2: deabc6ef ($39.18 in chips)
Seat 3: Hero ($10.15 in chips)
Seat 4: 9681dc27 ($13.9 in chips)
Seat 5: 3b85adab ($1.18 in chips)
Seat 6: 16633c83 ($13.46 in chips)
deabc6ef: posts small blind $0.05
Hero: posts big blind $0.1
*** HOLE CARDS ***
Dealt to 8ec1870 
Dealt to deabc6ef 
Dealt to Hero [9d Qc]
Dealt to 9681dc27 
Dealt to 3b85adab 
Dealt to 16633c83 
9681dc27: folds
3b85adab: folds
16633c83: folds
8ec1870: raises $0.15 to $0.25
deabc6ef: folds
Hero: folds
Uncalled bet ($0.15) returned to 8ec1870
*** SHOWDOWN ***
8ec1870 collected $0.25 from pot
*** SUMMARY ***
Total pot $0.25 | Rake $0 | Jackpot $0 | Bingo $0 | Fortune $0 | Tax $0
Seat 1: 8ec1870 (button) collected ($0.25)
Seat 2: deabc6ef (small blind) folded before Flop
Seat 3: Hero (big blind) folded before Flop
Seat 4: 9681dc27 folded before Flop (didn't bet)
Seat 5: 3b85adab folded before Flop (didn't bet)
Seat 6: 16633c83 folded before Flop (didn't bet)


Poker Hand #HD1775496963: Hold'em No Limit ($0.05/$0.1) - 2024/05/16 19:48:50
Table 'NLHRed23' 6-max Seat #6 is the button
Seat 1: 8ec1870 ($11.15 in chips)
Seat 2: deabc6ef ($39.28 in chips)
Seat 3: Hero ($10.15 in chips)
Seat 4: 9681dc27 ($13.9 in chips)
Seat 5: 3b85adab ($1.28 in chips)
Seat 6: 16633c83 ($13.46 in chips)
8ec1870: posts small blind $0.05
deabc6ef: posts big blind $0.1
*** HOLE CARDS ***
Dealt to 8ec1870 
Dealt to deabc6ef 
Dealt to Hero [7s Tc]
Dealt to 9681dc27 
Dealt to 3b85adab 
Dealt to 16633c83 
Hero: folds
9681dc27: folds
3b85adab: calls $0.1
16633c83: folds
8ec1870: raises $0.3 to $0.4
deabc6ef: folds
3b85adab: folds
Uncalled bet ($0.3) returned to 8ec1870
*** SHOWDOWN ***
8ec1870 collected $0.29 from pot
*** SUMMARY ***
Total pot $0.3 | Rake $0.01 | Jackpot $0 | Bingo $0 | Fortune $0 | Tax $0
Seat 1: 8ec1870 (small blind) collected ($0.29)
Seat 2: deabc6ef (big blind) folded before Flop
Seat 3: Hero folded before Flop (didn't bet)
Seat 4: 9681dc27 folded before Flop (didn't bet)
Seat 5: 3b85adab folded before Flop
Seat 6: 16633c83 (button) folded before Flop (didn't bet)


Poker Hand #HD1775496826: Hold'em No Limit ($0.05/$0.1) - 2024/05/16 19:47:32
Table 'NLHRed23' 6-max Seat #5 is the button
Seat 1: 8ec1870 ($11.4 in chips)
Seat 2: deabc6ef ($39.28 in chips)
Seat 3: Hero ($10.15 in chips)
Seat 4: 9681dc27 ($13.62 in chips)
Seat 5: 3b85adab ($1.28 in chips)
Seat 6: 16633c83 ($13.51 in chips)
16633c83: posts small blind $0.05
8ec1870: posts big blind $0.1
*** HOLE CARDS ***
Dealt to 8ec1870 
Dealt to deabc6ef 
Dealt to Hero [3d Ac]
Dealt to 9681dc27 
Dealt to 3b85adab 
Dealt to 16633c83 
deabc6ef: folds
Hero: folds
9681dc27: raises $0.15 to $0.25
3b85adab: folds
16633c83: folds
8ec1870: calls $0.15
*** FLOP *** [5d Td 3h]
8ec1870: checks
9681dc27: checks
*** TURN *** [5d Td 3h] [Qh]
8ec1870: checks
9681dc27: bets $0.35
8ec1870: folds
Uncalled bet ($0.35) returned to 9681dc27
*** SHOWDOWN ***
9681dc27 collected $0.53 from pot
*** SUMMARY ***
Total pot $0.55 | Rake $0.02 | Jackpot $0 | Bingo $0 | Fortune $0 | Tax $0
Board [5d Td 3h Qh]
Seat 1: 8ec1870 (big blind) folded on the Turn
Seat 2: deabc6ef folded before Flop (didn't bet)
Seat 3: Hero folded before Flop (didn't bet)
Seat 4: 9681dc27 won ($0.53)
Seat 5: 3b85adab (button) folded before Flop (didn't bet)
Seat 6: 16633c83 (small blind) folded before Flop


Poker Hand #HD1775496794: Hold'em No Limit ($0.05/$0.1) - 2024/05/16 19:47:11
Table 'NLHRed23' 6-max Seat #4 is the button
Seat 1: 8ec1870 ($11.4 in chips)
Seat 2: deabc6ef ($39.13 in chips)
Seat 3: Hero ($10.15 in chips)
Seat 4: 9681dc27 ($13.62 in chips)
Seat 5: 3b85adab ($1.33 in chips)
Seat 6: 16633c83 ($13.61 in chips)
3b85adab: posts small blind $0.05
16633c83: posts big blind $0.1
*** HOLE CARDS ***
Dealt to 8ec1870 
Dealt to deabc6ef 
Dealt to Hero [Qh 3c]
Dealt to 9681dc27 
Dealt to 3b85adab 
Dealt to 16633c83 
8ec1870: folds
deabc6ef: raises $0.15 to $0.25
Hero: folds
9681dc27: folds
3b85adab: folds
16633c83: folds
Uncalled bet ($0.15) returned to deabc6ef
*** SHOWDOWN ***
deabc6ef collected $0.25 from pot
*** SUMMARY ***
Total pot $0.25 | Rake $0 | Jackpot $0 | Bingo $0 | Fortune $0 | Tax $0
Seat 1: 8ec1870 folded before Flop (didn't bet)
Seat 2: deabc6ef collected ($0.25)
Seat 3: Hero folded before Flop (didn't bet)
Seat 4: 9681dc27 (button) folded before Flop (didn't bet)
Seat 5: 3b85adab (small blind) folded before Flop
Seat 6: 16633c83 (big blind) folded before Flop


Poker Hand #HD1775496760: Hold'em No Limit ($0.05/$0.1) - 2024/05/16 19:46:51
Table 'NLHRed23' 6-max Seat #3 is the button
Seat 1: 8ec1870 ($11.4 in chips)
Seat 2: deabc6ef ($39.13 in chips)
Seat 3: Hero ($10 in chips)
Seat 4: 9681dc27 ($13.67 in chips)
Seat 5: 3b85adab ($1.43 in chips)
Seat 6: 16633c83 ($13.61 in chips)
9681dc27: posts small blind $0.05
3b85adab: posts big blind $0.1
*** HOLE CARDS ***
Dealt to 8ec1870 
Dealt to deabc6ef 
Dealt to Hero [Qh As]
Dealt to 9681dc27 
Dealt to 3b85adab 
Dealt to 16633c83 
16633c83: folds
8ec1870: folds
deabc6ef: folds
Hero: raises $0.14 to $0.24
9681dc27: folds
3b85adab: folds
Uncalled bet ($0.14) returned to Hero
*** SHOWDOWN ***
Hero collected $0.25 from pot
*** SUMMARY ***
Total pot $0.25 | Rake $0 | Jackpot $0 | Bingo $0 | Fortune $0 | Tax $0
Seat 1: 8ec1870 folded before Flop (didn't bet)
Seat 2: deabc6ef folded before Flop (didn't bet)
Seat 3: Hero (button) collected ($0.25)
Seat 4: 9681dc27 (small blind) folded before Flop
Seat 5: 3b85adab (big blind) folded before Flop
Seat 6: 16633c83 folded before Flop (didn't bet)


Poker Hand #HD1775496677: Hold'em No Limit ($0.05/$0.1) - 2024/05/16 19:46:03
Table 'NLHRed23' 6-max Seat #2 is the button
Seat 1: 8ec1870 ($11.4 in chips)
Seat 2: deabc6ef ($39.13 in chips)
Seat 3: Hero ($10 in chips)
Seat 4: 9681dc27 ($13.17 in chips)
Seat 5: 3b85adab ($1.93 in chips)
Seat 6: 16633c83 ($13.61 in chips)
Hero: posts small blind $0.05
9681dc27: posts big blind $0.1
*** HOLE CARDS ***
Dealt to 8ec1870 
Dealt to deabc6ef 
Dealt to Hero [9s 6s]
Dealt to 9681dc27 
Dealt to 3b85adab 
Dealt to 16633c83 
3b85adab: calls $0.1
16633c83: folds
8ec1870: folds
deabc6ef: folds
Hero: folds
9681dc27: raises $0.4 to $0.5
3b85adab: calls $0.4
*** FLOP *** [2s Tc Ah]
9681dc27: bets $0.81
3b85adab: folds
Uncalled bet ($0.81) returned to 9681dc27
*** SHOWDOWN ***
9681dc27 collected $1 from pot
*** SUMMARY ***
Total pot $1.05 | Rake $0.05 | Jackpot $0 | Bingo $0 | Fortune $0 | Tax $0
Board [2s Tc Ah]
Seat 1: 8ec1870 folded before Flop (didn't bet)
Seat 2: deabc6ef (button) folded before Flop (didn't bet)
Seat 3: Hero (small blind) folded before Flop
Seat 4: 9681dc27 (big blind) won ($1)
Seat 5: 3b85adab folded on the Flop
Seat 6: 16633c83 folded before Flop (didn't bet)


Poker Hand #HD1775496569: Hold'em No Limit ($0.05/$0.1) - 2024/05/16 19:45:04
Table 'NLHRed23' 6-max Seat #1 is the button
Seat 1: 8ec1870 ($11.4 in chips)
Seat 2: deabc6ef ($39.18 in chips)
Seat 3: Hero ($10 in chips)
Seat 4: 9681dc27 ($13.17 in chips)
Seat 5: 3b85adab ($1.67 in chips)
Seat 6: 16633c83 ($13.61 in chips)
deabc6ef: posts small blind $0.05
Hero: posts big blind $0.1
*** HOLE CARDS ***
Dealt to 8ec1870 
Dealt to deabc6ef 
Dealt to Hero [Th Qh]
Dealt to 9681dc27 
Dealt to 3b85adab 
Dealt to 16633c83 
9681dc27: folds
3b85adab: calls $0.1
16633c83: folds
8ec1870: folds
deabc6ef: folds
Hero: checks
*** FLOP *** [7h 6s 7c]
Hero: checks
3b85adab: bets $0.13
Hero: calls $0.13
*** TURN *** [7h 6s 7c] [As]
Hero: checks
3b85adab: bets $0.26
Hero: folds
Uncalled bet ($0.26) returned to 3b85adab
*** SHOWDOWN ***
3b85adab collected $0.49 from pot
*** SUMMARY ***
Total pot $0.51 | Rake $0.02 | Jackpot $0 | Bingo $0 | Fortune $0 | Tax $0
Board [7h 6s 7c As]
Seat 1: 8ec1870 (button) folded before Flop (didn't bet)
Seat 2: deabc6ef (small blind) folded before Flop
Seat 3: Hero (big blind) folded on the Turn
Seat 4: 9681dc27 folded before Flop (didn't bet)
Seat 5: 3b85adab won ($0.49)
Seat 6: 16633c83 folded before Flop (didn't bet)


Poker Hand #HD1775496493: Hold'em No Limit ($0.05/$0.1) - 2024/05/16 19:44:10
Table 'NLHRed23' 6-max Seat #6 is the button
Seat 1: 8ec1870 ($11.45 in chips)
Seat 2: deabc6ef ($39.28 in chips)
Seat 3: Hero ($10 in chips)
Seat 4: 9681dc27 ($12.73 in chips)
Seat 5: 3b85adab ($2 in chips)
Seat 6: 16633c83 ($13.61 in chips)
8ec1870: posts small blind $0.05
deabc6ef: posts big blind $0.1
3b85adab: posts big blind $0.1
*** HOLE CARDS ***
Dealt to 8ec1870 
Dealt to deabc6ef 
Dealt to Hero [Td 3d]
Dealt to 9681dc27 
Dealt to 3b85adab 
Dealt to 16633c83 
Hero: folds
9681dc27: raises $0.23 to $0.33
3b85adab: calls $0.23
16633c83: folds
8ec1870: folds
deabc6ef: folds
*** FLOP *** [9h 8h Js]
9681dc27: checks
3b85adab: checks
*** TURN *** [9h 8h Js] [Qd]
9681dc27: checks
3b85adab: checks
*** RIVER *** [9h 8h Js Qd] [Jd]
9681dc27: bets $0.83
3b85adab: folds
Uncalled bet ($0.83) returned to 9681dc27
*** SHOWDOWN ***
9681dc27 collected $0.77 from pot
*** SUMMARY ***
Total pot $0.81 | Rake $0.04 | Jackpot $0 | Bingo $0 | Fortune $0 | Tax $0
Board [9h 8h Js Qd Jd]
Seat 1: 8ec1870 (small blind) folded before Flop
Seat 2: deabc6ef (big blind) folded before Flop
Seat 3: Hero folded before Flop (didn't bet)
Seat 4: 9681dc27 won ($0.77)
Seat 5: 3b85adab folded on the River
Seat 6: 16633c83 (button) folded before Flop (didn't bet)


Poker Hand #HD1775496470: Hold'em No Limit ($0.05/$0.1) - 2024/05/16 19:43:57
Table 'NLHRed23' 6-max Seat #4 is the button
Seat 1: 8ec1870 ($11.4 in chips)
Seat 2: deabc6ef ($39.28 in chips)
Seat 3: Hero ($10 in chips)
Seat 4: 9681dc27 ($12.73 in chips)
Seat 6: 16633c83 ($13.66 in chips)
16633c83: posts small blind $0.05
8ec1870: posts big blind $0.1
*** HOLE CARDS ***
Dealt to 8ec1870 
Dealt to deabc6ef 
Dealt to Hero [2d Kc]
Dealt to 9681dc27 
Dealt to 16633c83 
deabc6ef: folds
Hero: folds
9681dc27: folds
16633c83: folds
Uncalled bet ($0.05) returned to 8ec1870
*** SHOWDOWN ***
8ec1870 collected $0.1 from pot
*** SUMMARY ***
Total pot $0.1 | Rake $0 | Jackpot $0 | Bingo $0 | Fortune $0 | Tax $0
Seat 1: 8ec1870 (big blind) collected ($0.1)
Seat 2: deabc6ef folded before Flop (didn't bet)
Seat 3: Hero folded before Flop (didn't bet)
Seat 4: 9681dc27 (button) folded before Flop (didn't bet)
Seat 6: 16633c83 (small blind) folded before Flop


Poker Hand #HD1775496456: Hold'em No Limit ($0.05/$0.1) - 2024/05/16 19:43:49
Table 'NLHRed23' 6-max Seat #3 is the button
Seat 1: 8ec1870 ($11.4 in chips)
Seat 2: deabc6ef ($39.28 in chips)
Seat 3: Hero ($10 in chips)
Seat 4: 9681dc27 ($12.78 in chips)
Seat 6: 16633c83 ($13.61 in chips)
9681dc27: posts small blind $0.05
16633c83: posts big blind $0.1
*** HOLE CARDS ***
Dealt to 8ec1870 
Dealt to deabc6ef 
Dealt to Hero [Td 9s]
Dealt to 9681dc27 
Dealt to 16633c83 
8ec1870: folds
deabc6ef: folds
Hero: folds
9681dc27: folds
Uncalled bet ($0.05) returned to 16633c83
*** SHOWDOWN ***
16633c83 collected $0.1 from pot
*** SUMMARY ***
Total pot $0.1 | Rake $0 | Jackpot $0 | Bingo $0 | Fortune $0 | Tax $0
Seat 1: 8ec1870 folded before Flop (didn't bet)
Seat 2: deabc6ef folded before Flop (didn't bet)
Seat 3: Hero (button) folded before Flop (didn't bet)
Seat 4: 9681dc27 (small blind) folded before Flop
Seat 6: 16633c83 (big blind) collected ($0.1)


Poker Hand #HD1775496401: Hold'em No Limit ($0.05/$0.1) - 2024/05/16 19:43:11
Table 'NLHRed23' 6-max Seat #2 is the button
Seat 1: 8ec1870 ($11.03 in chips)
Seat 2: deabc6ef ($39.28 in chips)
Seat 3: Hero ($10 in chips)
Seat 4: 9681dc27 ($12.88 in chips)
Seat 5: 554f1c70 ($11.61 in chips)
Seat 6: 16633c83 ($13.86 in chips)
Hero: posts small blind $0.05
9681dc27: posts big blind $0.1
*** HOLE CARDS ***
Dealt to 8ec1870 
Dealt to deabc6ef 
Dealt to Hero [Js 9d]
Dealt to 9681dc27 
Dealt to 554f1c70 
Dealt to 16633c83 
554f1c70: folds
16633c83: raises $0.15 to $0.25
8ec1870: raises $0.5 to $0.75
deabc6ef: folds
Hero: folds
9681dc27: folds
16633c83: folds
Uncalled bet ($0.5) returned to 8ec1870
*** SHOWDOWN ***
8ec1870 collected $0.62 from pot
*** SUMMARY ***
Total pot $0.65 | Rake $0.03 | Jackpot $0 | Bingo $0 | Fortune $0 | Tax $0
Seat 1: 8ec1870 collected ($0.62)
Seat 2: deabc6ef (button) folded before Flop (didn't bet)
Seat 3: Hero (small blind) folded before Flop
Seat 4: 9681dc27 (big blind) folded before Flop
Seat 5: 554f1c70 folded before Flop (didn't bet)
Seat 6: 16633c83 folded before Flop


Poker Hand #HD1775496310: Hold'em No Limit ($0.05/$0.1) - 2024/05/16 19:42:15
Table 'NLHRed23' 6-max Seat #1 is the button
Seat 1: 8ec1870 ($10.57 in chips)
Seat 2: deabc6ef ($39.33 in chips)
Seat 3: Hero ($10 in chips)
Seat 4: 9681dc27 ($12.88 in chips)
Seat 5: 554f1c70 ($11.61 in chips)
Seat 6: 16633c83 ($13.86 in chips)
deabc6ef: posts small blind $0.05
Hero: posts big blind $0.1
*** HOLE CARDS ***
Dealt to 8ec1870 
Dealt to deabc6ef 
Dealt to Hero [9s Td]
Dealt to 9681dc27 
Dealt to 554f1c70 
Dealt to 16633c83 
9681dc27: folds
554f1c70: folds
16633c83: folds
8ec1870: raises $0.15 to $0.25
deabc6ef: folds
Hero: calls $0.15
*** FLOP *** [3c Th 6d]
Hero: bets $0.2
8ec1870: raises $0.45 to $0.65
Hero: folds
Uncalled bet ($0.45) returned to 8ec1870
*** SHOWDOWN ***
8ec1870 collected $0.91 from pot
*** SUMMARY ***
Total pot $0.95 | Rake $0.04 | Jackpot $0 | Bingo $0 | Fortune $0 | Tax $0
Board [3c Th 6d]
Seat 1: 8ec1870 (button) won ($0.91)
Seat 2: deabc6ef (small blind) folded before Flop
Seat 3: Hero (big blind) folded on the Flop
Seat 4: 9681dc27 folded before Flop (didn't bet)
Seat 5: 554f1c70 folded before Flop (didn't bet)
Seat 6: 16633c83 folded before Flop (didn't bet)


