Poker Hand #RC2774814105: Hold'em No Limit ($0.05/$0.1) - 2024/08/05 13:26:49
Table 'RushAndCash21409365' 6-max Seat #1 is the button
Seat 1: Hero ($10.6 in chips)
Seat 2: 3451d07b ($13.26 in chips)
Seat 3: d2338f98 ($10.04 in chips)
Seat 4: fdb7f034 ($48.4 in chips)
Seat 5: d3f1e5af ($10 in chips)
Seat 6: 73207420 ($12.88 in chips)
3451d07b: posts small blind $0.05
d2338f98: posts big blind $0.1
*** HOLE CARDS ***
Dealt to Hero [Td Jh]
Dealt to 3451d07b 
Dealt to d2338f98 
Dealt to fdb7f034 
Dealt to d3f1e5af 
Dealt to 73207420 
fdb7f034: folds
d3f1e5af: folds
73207420: folds
Hero: raises $0.14 to $0.24
3451d07b: folds
d2338f98: folds
Uncalled bet ($0.14) returned to Hero
*** SHOWDOWN ***
Hero collected $0.25 from pot
*** SUMMARY ***
Total pot $0.25 | Rake $0 | Jackpot $0 | Bingo $0 | Fortune $0 | Tax $0
Seat 1: Hero (button) collected ($0.25)
Seat 2: 3451d07b (small blind) folded before Flop
Seat 3: d2338f98 (big blind) folded before Flop
Seat 4: fdb7f034 folded before Flop (didn't bet)
Seat 5: d3f1e5af folded before Flop (didn't bet)
Seat 6: 73207420 folded before Flop (didn't bet)


Poker Hand #RC2774814078: Hold'em No Limit ($0.05/$0.1) - 2024/08/05 13:26:45
Table 'RushAndCash21409338' 6-max Seat #1 is the button
Seat 1: ff56ca58 ($10.15 in chips)
Seat 2: 75e0bf ($11.06 in chips)
Seat 3: fe94a06f ($10 in chips)
Seat 4: Hero ($10.6 in chips)
Seat 5: 4e92708a ($10.15 in chips)
Seat 6: 4a344507 ($27.08 in chips)
75e0bf: posts small blind $0.05
fe94a06f: posts big blind $0.1
*** HOLE CARDS ***
Dealt to ff56ca58 
Dealt to 75e0bf 
Dealt to fe94a06f 
Dealt to Hero [9c Qh]
Dealt to 4e92708a 
Dealt to 4a344507 
Hero: folds
4e92708a: folds
4a344507: folds
ff56ca58: folds
75e0bf: raises $0.2 to $0.3
fe94a06f: calls $0.2
*** FLOP *** [5c Ah 2s]
75e0bf: checks
fe94a06f: bets $0.3
75e0bf: calls $0.3
*** TURN *** [5c Ah 2s] [Ts]
75e0bf: checks
fe94a06f: checks
*** RIVER *** [5c Ah 2s Ts] [As]
75e0bf: checks
fe94a06f: checks
75e0bf: shows [Kc Kd] (Pair of Aces and Pair of Kings)
fe94a06f: shows [9s Td] (Pair of Aces and Pair of Tens)
*** SHOWDOWN ***
75e0bf collected $1.14 from pot
*** SUMMARY ***
Total pot $1.2 | Rake $0.06 | Jackpot $0 | Bingo $0 | Fortune $0 | Tax $0
Board [5c Ah 2s Ts As]
Seat 1: ff56ca58 (button) folded before Flop (didn't bet)
Seat 2: 75e0bf (small blind) showed [Kc Kd] and won ($1.14) with Pair of Aces and Pair of Kings
Seat 3: fe94a06f (big blind) showed [9s Td] and lost with Pair of Aces and Pair of Tens
Seat 4: Hero folded before Flop (didn't bet)
Seat 5: 4e92708a folded before Flop (didn't bet)
Seat 6: 4a344507 folded before Flop (didn't bet)


Poker Hand #RC2774814055: Hold'em No Limit ($0.05/$0.1) - 2024/08/05 13:26:42
Table 'RushAndCash21409315' 6-max Seat #1 is the button
Seat 1: 65bf2349 ($10.1 in chips)
Seat 2: 189bc2bd ($10.17 in chips)
Seat 3: Hero ($10.7 in chips)
Seat 4: c4c7add6 ($10.32 in chips)
Seat 5: 3ac1552b ($12.28 in chips)
Seat 6: 6ded3506 ($12.71 in chips)
189bc2bd: posts small blind $0.05
Hero: posts big blind $0.1
*** HOLE CARDS ***
Dealt to 65bf2349 
Dealt to 189bc2bd 
Dealt to Hero [6c 5s]
Dealt to c4c7add6 
Dealt to 3ac1552b 
Dealt to 6ded3506 
c4c7add6: raises $0.1 to $0.2
3ac1552b: folds
6ded3506: folds
65bf2349: folds
189bc2bd: folds
Hero: folds
Uncalled bet ($0.1) returned to c4c7add6
*** SHOWDOWN ***
c4c7add6 collected $0.25 from pot
*** SUMMARY ***
Total pot $0.25 | Rake $0 | Jackpot $0 | Bingo $0 | Fortune $0 | Tax $0
Seat 1: 65bf2349 (button) folded before Flop (didn't bet)
Seat 2: 189bc2bd (small blind) folded before Flop
Seat 3: Hero (big blind) folded before Flop
Seat 4: c4c7add6 collected ($0.25)
Seat 5: 3ac1552b folded before Flop (didn't bet)
Seat 6: 6ded3506 folded before Flop (didn't bet)


Poker Hand #RC2774813963: Hold'em No Limit ($0.05/$0.1) - 2024/08/05 13:26:29
Table 'RushAndCash21409223' 6-max Seat #1 is the button
Seat 1: d0a5f098 ($33.91 in chips)
Seat 2: 1e125cc0 ($11.83 in chips)
Seat 3: 357d5395 ($13.46 in chips)
Seat 4: cbcf06f4 ($11.61 in chips)
Seat 5: 9f6ee343 ($17.65 in chips)
Seat 6: Hero ($10.7 in chips)
1e125cc0: posts small blind $0.05
357d5395: posts big blind $0.1
*** HOLE CARDS ***
Dealt to d0a5f098 
Dealt to 1e125cc0 
Dealt to 357d5395 
Dealt to cbcf06f4 
Dealt to 9f6ee343 
Dealt to Hero [6s 9s]
cbcf06f4: folds
9f6ee343: raises $0.11 to $0.21
Hero: folds
d0a5f098: folds
1e125cc0: folds
357d5395: folds
Uncalled bet ($0.11) returned to 9f6ee343
*** SHOWDOWN ***
9f6ee343 collected $0.25 from pot
*** SUMMARY ***
Total pot $0.25 | Rake $0 | Jackpot $0 | Bingo $0 | Fortune $0 | Tax $0
Seat 1: d0a5f098 (button) folded before Flop (didn't bet)
Seat 2: 1e125cc0 (small blind) folded before Flop
Seat 3: 357d5395 (big blind) folded before Flop
Seat 4: cbcf06f4 folded before Flop (didn't bet)
Seat 5: 9f6ee343 collected ($0.25)
Seat 6: Hero folded before Flop (didn't bet)


Poker Hand #RC2774813936: Hold'em No Limit ($0.05/$0.1) - 2024/08/05 13:26:26
Table 'RushAndCash21409196' 6-max Seat #1 is the button
Seat 1: Hero ($10.7 in chips)
Seat 2: b123c7a2 ($10 in chips)
Seat 3: c429440f ($12.97 in chips)
Seat 4: cb1fc7ad ($18.14 in chips)
Seat 5: 73c8d5ef ($32.16 in chips)
Seat 6: f695a391 ($11.2 in chips)
b123c7a2: posts small blind $0.05
c429440f: posts big blind $0.1
*** HOLE CARDS ***
Dealt to Hero [4s 9c]
Dealt to b123c7a2 
Dealt to c429440f 
Dealt to cb1fc7ad 
Dealt to 73c8d5ef 
Dealt to f695a391 
cb1fc7ad: raises $0.15 to $0.25
73c8d5ef: folds
f695a391: raises $0.65 to $0.9
Hero: folds
b123c7a2: folds
c429440f: folds
cb1fc7ad: calls $0.65
*** FLOP *** [Jh 9s Tc]
cb1fc7ad: checks
f695a391: bets $0.52
cb1fc7ad: calls $0.52
*** TURN *** [Jh 9s Tc] [2s]
cb1fc7ad: checks
f695a391: bets $2.25
cb1fc7ad: calls $2.25
*** RIVER *** [Jh 9s Tc 2s] [6c]
cb1fc7ad: checks
f695a391: bets $7.53 and is all-in
cb1fc7ad: calls $7.53
f695a391: shows [Ad Qc] (Ace-High)
cb1fc7ad: shows [Js Kc] (Pair of Jacks)
*** SHOWDOWN ***
cb1fc7ad collected $22.1 from pot
*** SUMMARY ***
Total pot $22.55 | Rake $0.3 | Jackpot $0.15 | Bingo $0 | Fortune $0 | Tax $0
Board [Jh 9s Tc 2s 6c]
Seat 1: Hero (button) folded before Flop (didn't bet)
Seat 2: b123c7a2 (small blind) folded before Flop
Seat 3: c429440f (big blind) folded before Flop
Seat 4: cb1fc7ad showed [Js Kc] and won ($22.1) with Pair of Jacks
Seat 5: 73c8d5ef folded before Flop (didn't bet)
Seat 6: f695a391 showed [Ad Qc] and lost with Ace-High


Poker Hand #RC2774813913: Hold'em No Limit ($0.05/$0.1) - 2024/08/05 13:26:23
Table 'RushAndCash21409173' 6-max Seat #1 is the button
Seat 1: 75c4d76c ($7.06 in chips)
Seat 2: d88fba59 ($10.74 in chips)
Seat 3: e78f912e ($10.41 in chips)
Seat 4: Hero ($10.7 in chips)
Seat 5: 92e556de ($31.77 in chips)
Seat 6: c429440f ($12.97 in chips)
d88fba59: posts small blind $0.05
e78f912e: posts big blind $0.1
*** HOLE CARDS ***
Dealt to 75c4d76c 
Dealt to d88fba59 
Dealt to e78f912e 
Dealt to Hero [3h 9s]
Dealt to 92e556de 
Dealt to c429440f 
Hero: folds
92e556de: raises $0.15 to $0.25
c429440f: folds
75c4d76c: raises $0.15 to $0.4
d88fba59: folds
e78f912e: calls $0.3
92e556de: calls $0.15
*** FLOP *** [5h Kh 9h]
e78f912e: checks
92e556de: checks
75c4d76c: bets $1.25
e78f912e: calls $1.25
92e556de: folds
*** TURN *** [5h Kh 9h] [Jh]
e78f912e: checks
75c4d76c: bets $1.88
e78f912e: raises $6.88 to $8.76 and is all-in
75c4d76c: calls $3.53 and is all-in
Uncalled bet ($3.35) returned to e78f912e
e78f912e: shows [6h Ah] (Ace High Flush)
75c4d76c: shows [Th Ad] (King High Flush)
*** RIVER *** [5h Kh 9h Jh] [2h]
*** SHOWDOWN ***
e78f912e collected $14.12 from pot
*** SUMMARY ***
Total pot $14.57 | Rake $0.3 | Jackpot $0.15 | Bingo $0 | Fortune $0 | Tax $0
Board [5h Kh 9h Jh 2h]
Seat 1: 75c4d76c (button) showed [Th Ad] and lost with King High Flush
Seat 2: d88fba59 (small blind) folded before Flop
Seat 3: e78f912e (big blind) showed [6h Ah] and won ($14.12) with Ace High Flush
Seat 4: Hero folded before Flop (didn't bet)
Seat 5: 92e556de folded on the Flop
Seat 6: c429440f folded before Flop (didn't bet)


Poker Hand #RC2774813859: Hold'em No Limit ($0.05/$0.1) - 2024/08/05 13:26:15
Table 'RushAndCash21409119' 6-max Seat #1 is the button
Seat 1: Hero ($10.7 in chips)
Seat 2: 41520222 ($15.83 in chips)
Seat 3: 25cc1eb4 ($12.86 in chips)
Seat 4: 356b0e4 ($8.01 in chips)
Seat 5: d2df06cf ($24.35 in chips)
Seat 6: 3888f290 ($12.9 in chips)
41520222: posts small blind $0.05
25cc1eb4: posts big blind $0.1
*** HOLE CARDS ***
Dealt to Hero [9c Th]
Dealt to 41520222 
Dealt to 25cc1eb4 
Dealt to 356b0e4 
Dealt to d2df06cf 
Dealt to 3888f290 
356b0e4: folds
d2df06cf: folds
3888f290: raises $0.15 to $0.25
Hero: folds
41520222: folds
25cc1eb4: folds
Uncalled bet ($0.15) returned to 3888f290
*** SHOWDOWN ***
3888f290 collected $0.25 from pot
*** SUMMARY ***
Total pot $0.25 | Rake $0 | Jackpot $0 | Bingo $0 | Fortune $0 | Tax $0
Seat 1: Hero (button) folded before Flop (didn't bet)
Seat 2: 41520222 (small blind) folded before Flop
Seat 3: 25cc1eb4 (big blind) folded before Flop
Seat 4: 356b0e4 folded before Flop (didn't bet)
Seat 5: d2df06cf folded before Flop (didn't bet)
Seat 6: 3888f290 collected ($0.25)


Poker Hand #RC2774813818: Hold'em No Limit ($0.05/$0.1) - 2024/08/05 13:26:09
Table 'RushAndCash21409078' 6-max Seat #1 is the button
Seat 1: 4d21dd90 ($11.35 in chips)
Seat 2: c07da810 ($13.35 in chips)
Seat 3: b4fe4ce8 ($10.63 in chips)
Seat 4: dd79782c ($16.09 in chips)
Seat 5: 15d5d7c6 ($9.48 in chips)
Seat 6: Hero ($10.7 in chips)
c07da810: posts small blind $0.05
b4fe4ce8: posts big blind $0.1
*** HOLE CARDS ***
Dealt to 4d21dd90 
Dealt to c07da810 
Dealt to b4fe4ce8 
Dealt to dd79782c 
Dealt to 15d5d7c6 
Dealt to Hero [As 5d]
dd79782c: folds
15d5d7c6: folds
Hero: folds
4d21dd90: folds
c07da810: folds
Uncalled bet ($0.05) returned to b4fe4ce8
*** SHOWDOWN ***
b4fe4ce8 collected $0.1 from pot
*** SUMMARY ***
Total pot $0.1 | Rake $0 | Jackpot $0 | Bingo $0 | Fortune $0 | Tax $0
Seat 1: 4d21dd90 (button) folded before Flop (didn't bet)
Seat 2: c07da810 (small blind) folded before Flop
Seat 3: b4fe4ce8 (big blind) collected ($0.1)
Seat 4: dd79782c folded before Flop (didn't bet)
Seat 5: 15d5d7c6 folded before Flop (didn't bet)
Seat 6: Hero folded before Flop (didn't bet)


Poker Hand #RC2774813741: Hold'em No Limit ($0.05/$0.1) - 2024/08/05 13:26:00
Table 'RushAndCash21409001' 6-max Seat #1 is the button
Seat 1: Hero ($10.55 in chips)
Seat 2: 118c7a ($10.62 in chips)
Seat 3: 1fa51315 ($10.68 in chips)
Seat 4: ca4f3055 ($10.95 in chips)
Seat 5: d3454833 ($11.23 in chips)
Seat 6: 608a09cc ($18.63 in chips)
118c7a: posts small blind $0.05
1fa51315: posts big blind $0.1
*** HOLE CARDS ***
Dealt to Hero [Td Jd]
Dealt to 118c7a 
Dealt to 1fa51315 
Dealt to ca4f3055 
Dealt to d3454833 
Dealt to 608a09cc 
ca4f3055: folds
d3454833: folds
608a09cc: folds
Hero: raises $0.14 to $0.24
118c7a: folds
1fa51315: folds
Uncalled bet ($0.14) returned to Hero
*** SHOWDOWN ***
Hero collected $0.25 from pot
*** SUMMARY ***
Total pot $0.25 | Rake $0 | Jackpot $0 | Bingo $0 | Fortune $0 | Tax $0
Seat 1: Hero (button) collected ($0.25)
Seat 2: 118c7a (small blind) folded before Flop
Seat 3: 1fa51315 (big blind) folded before Flop
Seat 4: ca4f3055 folded before Flop (didn't bet)
Seat 5: d3454833 folded before Flop (didn't bet)
Seat 6: 608a09cc folded before Flop (didn't bet)


Poker Hand #RC2774813707: Hold'em No Limit ($0.05/$0.1) - 2024/08/05 13:25:56
Table 'RushAndCash21408967' 6-max Seat #1 is the button
Seat 1: f4b7710d ($10 in chips)
Seat 2: 56764068 ($28.79 in chips)
Seat 3: 53043d79 ($8.83 in chips)
Seat 4: Hero ($10.55 in chips)
Seat 5: 8efe54e0 ($10.5 in chips)
Seat 6: 64326c84 ($27.88 in chips)
56764068: posts small blind $0.05
53043d79: posts big blind $0.1
*** HOLE CARDS ***
Dealt to f4b7710d 
Dealt to 56764068 
Dealt to 53043d79 
Dealt to Hero [Ks 3d]
Dealt to 8efe54e0 
Dealt to 64326c84 
Hero: folds
8efe54e0: raises $0.15 to $0.25
64326c84: folds
f4b7710d: folds
56764068: calls $0.2
53043d79: calls $0.15
*** FLOP *** [8h Kd 9s]
56764068: checks
53043d79: checks
8efe54e0: checks
*** TURN *** [8h Kd 9s] [6c]
56764068: checks
53043d79: bets $0.25
8efe54e0: folds
56764068: folds
Uncalled bet ($0.25) returned to 53043d79
*** SHOWDOWN ***
53043d79 collected $0.72 from pot
*** SUMMARY ***
Total pot $0.75 | Rake $0.03 | Jackpot $0 | Bingo $0 | Fortune $0 | Tax $0
Board [8h Kd 9s 6c]
Seat 1: f4b7710d (button) folded before Flop (didn't bet)
Seat 2: 56764068 (small blind) folded on the Turn
Seat 3: 53043d79 (big blind) won ($0.72)
Seat 4: Hero folded before Flop (didn't bet)
Seat 5: 8efe54e0 folded on the Turn
Seat 6: 64326c84 folded before Flop (didn't bet)


Poker Hand #RC2774813681: Hold'em No Limit ($0.05/$0.1) - 2024/08/05 13:25:52
Table 'RushAndCash21408941' 6-max Seat #1 is the button
Seat 1: 62b68b95 ($11.46 in chips)
Seat 2: d5b9f3ac ($9.42 in chips)
Seat 3: 483ddea4 ($10 in chips)
Seat 4: 1e125cc0 ($12.04 in chips)
Seat 5: e1203f00 ($11.57 in chips)
Seat 6: Hero ($10.55 in chips)
d5b9f3ac: posts small blind $0.05
483ddea4: posts big blind $0.1
*** HOLE CARDS ***
Dealt to 62b68b95 
Dealt to d5b9f3ac 
Dealt to 483ddea4 
Dealt to 1e125cc0 
Dealt to e1203f00 
Dealt to Hero [3s Ad]
1e125cc0: folds
e1203f00: raises $0.11 to $0.21
Hero: folds
62b68b95: folds
d5b9f3ac: folds
483ddea4: calls $0.11
*** FLOP *** [6d Jd Ts]
483ddea4: checks
e1203f00: bets $0.2
483ddea4: folds
Uncalled bet ($0.2) returned to e1203f00
*** SHOWDOWN ***
e1203f00 collected $0.45 from pot
*** SUMMARY ***
Total pot $0.47 | Rake $0.02 | Jackpot $0 | Bingo $0 | Fortune $0 | Tax $0
Board [6d Jd Ts]
Seat 1: 62b68b95 (button) folded before Flop (didn't bet)
Seat 2: d5b9f3ac (small blind) folded before Flop
Seat 3: 483ddea4 (big blind) folded on the Flop
Seat 4: 1e125cc0 folded before Flop (didn't bet)
Seat 5: e1203f00 won ($0.45)
Seat 6: Hero folded before Flop (didn't bet)


Poker Hand #RC2774813653: Hold'em No Limit ($0.05/$0.1) - 2024/08/05 13:25:48
Table 'RushAndCash21408913' 6-max Seat #1 is the button
Seat 1: 6c2f5f31 ($9.34 in chips)
Seat 2: Hero ($10.6 in chips)
Seat 3: f3b4cb31 ($8.78 in chips)
Seat 4: 605962a ($29.72 in chips)
Seat 5: 1fa51315 ($10.68 in chips)
Seat 6: 1e125cc0 ($12.04 in chips)
Hero: posts small blind $0.05
f3b4cb31: posts big blind $0.1
*** HOLE CARDS ***
Dealt to 6c2f5f31 
Dealt to Hero [9c 3h]
Dealt to f3b4cb31 
Dealt to 605962a 
Dealt to 1fa51315 
Dealt to 1e125cc0 
605962a: folds
1fa51315: folds
1e125cc0: folds
6c2f5f31: raises $0.2 to $0.3
Hero: folds
f3b4cb31: folds
Uncalled bet ($0.2) returned to 6c2f5f31
*** SHOWDOWN ***
6c2f5f31 collected $0.25 from pot
*** SUMMARY ***
Total pot $0.25 | Rake $0 | Jackpot $0 | Bingo $0 | Fortune $0 | Tax $0
Seat 1: 6c2f5f31 (button) collected ($0.25)
Seat 2: Hero (small blind) folded before Flop
Seat 3: f3b4cb31 (big blind) folded before Flop
Seat 4: 605962a folded before Flop (didn't bet)
Seat 5: 1fa51315 folded before Flop (didn't bet)
Seat 6: 1e125cc0 folded before Flop (didn't bet)


Poker Hand #RC2774813620: Hold'em No Limit ($0.05/$0.1) - 2024/08/05 13:25:45
Table 'RushAndCash21408880' 6-max Seat #1 is the button
Seat 1: f3b4cb31 ($8.78 in chips)
Seat 2: Hero ($10.65 in chips)
Seat 3: e324ddcf ($14.85 in chips)
Seat 4: b20ba683 ($10.56 in chips)
Seat 5: 257ad3a6 ($14.94 in chips)
Seat 6: 1e125cc0 ($12.04 in chips)
Hero: posts small blind $0.05
e324ddcf: posts big blind $0.1
*** HOLE CARDS ***
Dealt to f3b4cb31 
Dealt to Hero [6h Ad]
Dealt to e324ddcf 
Dealt to b20ba683 
Dealt to 257ad3a6 
Dealt to 1e125cc0 
b20ba683: folds
257ad3a6: folds
1e125cc0: folds
f3b4cb31: folds
Hero: folds
Uncalled bet ($0.05) returned to e324ddcf
*** SHOWDOWN ***
e324ddcf collected $0.1 from pot
*** SUMMARY ***
Total pot $0.1 | Rake $0 | Jackpot $0 | Bingo $0 | Fortune $0 | Tax $0
Seat 1: f3b4cb31 (button) folded before Flop (didn't bet)
Seat 2: Hero (small blind) folded before Flop
Seat 3: e324ddcf (big blind) collected ($0.1)
Seat 4: b20ba683 folded before Flop (didn't bet)
Seat 5: 257ad3a6 folded before Flop (didn't bet)
Seat 6: 1e125cc0 folded before Flop (didn't bet)


Poker Hand #RC2774813581: Hold'em No Limit ($0.05/$0.1) - 2024/08/05 13:25:40
Table 'RushAndCash21408841' 6-max Seat #1 is the button
Seat 1: f9bb38e0 ($10 in chips)
Seat 2: ceb76905 ($11.62 in chips)
Seat 3: 18c8d70c ($10 in chips)
Seat 4: Hero ($10.65 in chips)
Seat 5: dc17a754 ($12.88 in chips)
Seat 6: c519f7aa ($24.61 in chips)
ceb76905: posts small blind $0.05
18c8d70c: posts big blind $0.1
*** HOLE CARDS ***
Dealt to f9bb38e0 
Dealt to ceb76905 
Dealt to 18c8d70c 
Dealt to Hero [Kc 6d]
Dealt to dc17a754 
Dealt to c519f7aa 
Hero: folds
dc17a754: folds
c519f7aa: raises $0.13 to $0.23
f9bb38e0: folds
ceb76905: calls $0.18
18c8d70c: folds
*** FLOP *** [6s Tc 9d]
ceb76905: checks
c519f7aa: checks
*** TURN *** [6s Tc 9d] [Qc]
ceb76905: bets $0.28
c519f7aa: calls $0.28
*** RIVER *** [6s Tc 9d Qc] [6c]
ceb76905: checks
c519f7aa: bets $0.56
ceb76905: folds
Uncalled bet ($0.56) returned to c519f7aa
*** SHOWDOWN ***
c519f7aa collected $1.07 from pot
*** SUMMARY ***
Total pot $1.12 | Rake $0.05 | Jackpot $0 | Bingo $0 | Fortune $0 | Tax $0
Board [6s Tc 9d Qc 6c]
Seat 1: f9bb38e0 (button) folded before Flop (didn't bet)
Seat 2: ceb76905 (small blind) folded on the River
Seat 3: 18c8d70c (big blind) folded before Flop
Seat 4: Hero folded before Flop (didn't bet)
Seat 5: dc17a754 folded before Flop (didn't bet)
Seat 6: c519f7aa won ($1.07)


Poker Hand #RC2774813523: Hold'em No Limit ($0.05/$0.1) - 2024/08/05 13:25:33
Table 'RushAndCash21408783' 6-max Seat #1 is the button
Seat 1: a045810b ($10 in chips)
Seat 2: ce5980dc ($15.36 in chips)
Seat 3: Hero ($10.75 in chips)
Seat 4: 3227eef8 ($5.21 in chips)
Seat 5: 7badbad4 ($12.37 in chips)
Seat 6: f19c0b4d ($10.89 in chips)
ce5980dc: posts small blind $0.05
Hero: posts big blind $0.1
*** HOLE CARDS ***
Dealt to a045810b 
Dealt to ce5980dc 
Dealt to Hero [6h As]
Dealt to 3227eef8 
Dealt to 7badbad4 
Dealt to f19c0b4d 
3227eef8: folds
7badbad4: raises $0.1 to $0.2
f19c0b4d: folds
a045810b: folds
ce5980dc: folds
Hero: folds
Uncalled bet ($0.1) returned to 7badbad4
*** SHOWDOWN ***
7badbad4 collected $0.25 from pot
*** SUMMARY ***
Total pot $0.25 | Rake $0 | Jackpot $0 | Bingo $0 | Fortune $0 | Tax $0
Seat 1: a045810b (button) folded before Flop (didn't bet)
Seat 2: ce5980dc (small blind) folded before Flop
Seat 3: Hero (big blind) folded before Flop
Seat 4: 3227eef8 folded before Flop (didn't bet)
Seat 5: 7badbad4 collected ($0.25)
Seat 6: f19c0b4d folded before Flop (didn't bet)


Poker Hand #RC2774813497: Hold'em No Limit ($0.05/$0.1) - 2024/08/05 13:25:29
Table 'RushAndCash21408757' 6-max Seat #1 is the button
Seat 1: 14ce2d5c ($10 in chips)
Seat 2: a13a1754 ($11.12 in chips)
Seat 3: 6a80f11f ($10.15 in chips)
Seat 4: Hero ($10.75 in chips)
Seat 5: e25d0386 ($10 in chips)
Seat 6: 99d264c4 ($14.66 in chips)
a13a1754: posts small blind $0.05
6a80f11f: posts big blind $0.1
*** HOLE CARDS ***
Dealt to 14ce2d5c 
Dealt to a13a1754 
Dealt to 6a80f11f 
Dealt to Hero [5c 6h]
Dealt to e25d0386 
Dealt to 99d264c4 
Hero: folds
e25d0386: raises $0.1 to $0.2
99d264c4: folds
14ce2d5c: folds
a13a1754: folds
6a80f11f: calls $0.1
*** FLOP *** [7c Tc 6d]
6a80f11f: checks
e25d0386: checks
*** TURN *** [7c Tc 6d] [2c]
6a80f11f: bets $0.34
e25d0386: folds
Uncalled bet ($0.34) returned to 6a80f11f
*** SHOWDOWN ***
6a80f11f collected $0.43 from pot
*** SUMMARY ***
Total pot $0.45 | Rake $0.02 | Jackpot $0 | Bingo $0 | Fortune $0 | Tax $0
Board [7c Tc 6d 2c]
Seat 1: 14ce2d5c (button) folded before Flop (didn't bet)
Seat 2: a13a1754 (small blind) folded before Flop
Seat 3: 6a80f11f (big blind) won ($0.43)
Seat 4: Hero folded before Flop (didn't bet)
Seat 5: e25d0386 folded on the Turn
Seat 6: 99d264c4 folded before Flop (didn't bet)


Poker Hand #RC2774813377: Hold'em No Limit ($0.05/$0.1) - 2024/08/05 13:25:13
Table 'RushAndCash21408637' 6-max Seat #1 is the button
Seat 1: Hero ($10.75 in chips)
Seat 2: ac74022f ($10.05 in chips)
Seat 3: 94218f2 ($11.14 in chips)
Seat 4: 8f7c02cf ($11.69 in chips)
Seat 5: d07531c1 ($10 in chips)
Seat 6: 118c7a ($10.47 in chips)
ac74022f: posts small blind $0.05
94218f2: posts big blind $0.1
*** HOLE CARDS ***
Dealt to Hero [Jd Qc]
Dealt to ac74022f 
Dealt to 94218f2 
Dealt to 8f7c02cf 
Dealt to d07531c1 
Dealt to 118c7a 
8f7c02cf: folds
d07531c1: folds
118c7a: raises $0.12 to $0.22
Hero: folds
ac74022f: folds
94218f2: calls $0.12
*** FLOP *** [4c Qd As]
94218f2: checks
118c7a: bets $0.33
94218f2: folds
Uncalled bet ($0.33) returned to 118c7a
*** SHOWDOWN ***
118c7a collected $0.47 from pot
*** SUMMARY ***
Total pot $0.49 | Rake $0.02 | Jackpot $0 | Bingo $0 | Fortune $0 | Tax $0
Board [4c Qd As]
Seat 1: Hero (button) folded before Flop (didn't bet)
Seat 2: ac74022f (small blind) folded before Flop
Seat 3: 94218f2 (big blind) folded on the Flop
Seat 4: 8f7c02cf folded before Flop (didn't bet)
Seat 5: d07531c1 folded before Flop (didn't bet)
Seat 6: 118c7a won ($0.47)


Poker Hand #RC2774813317: Hold'em No Limit ($0.05/$0.1) - 2024/08/05 13:25:06
Table 'RushAndCash21408577' 6-max Seat #1 is the button
Seat 1: Hero ($10.75 in chips)
Seat 2: 18c8d70c ($10 in chips)
Seat 3: 241244c8 ($16.54 in chips)
Seat 4: d2df06cf ($24.02 in chips)
Seat 5: de3c243c ($11.16 in chips)
Seat 6: 8cb8eab9 ($10.5 in chips)
18c8d70c: posts small blind $0.05
241244c8: posts big blind $0.1
*** HOLE CARDS ***
Dealt to Hero [4h 4c]
Dealt to 18c8d70c 
Dealt to 241244c8 
Dealt to d2df06cf 
Dealt to de3c243c 
Dealt to 8cb8eab9 
d2df06cf: raises $0.13 to $0.23
de3c243c: folds
8cb8eab9: folds
Hero: folds
18c8d70c: folds
241244c8: folds
Uncalled bet ($0.13) returned to d2df06cf
*** SHOWDOWN ***
d2df06cf collected $0.25 from pot
*** SUMMARY ***
Total pot $0.25 | Rake $0 | Jackpot $0 | Bingo $0 | Fortune $0 | Tax $0
Seat 1: Hero (button) folded before Flop (didn't bet)
Seat 2: 18c8d70c (small blind) folded before Flop
Seat 3: 241244c8 (big blind) folded before Flop
Seat 4: d2df06cf collected ($0.25)
Seat 5: de3c243c folded before Flop (didn't bet)
Seat 6: 8cb8eab9 folded before Flop (didn't bet)


Poker Hand #RC2774813274: Hold'em No Limit ($0.05/$0.1) - 2024/08/05 13:25:00
Table 'RushAndCash21408534' 6-max Seat #1 is the button
Seat 1: Hero ($10.75 in chips)
Seat 2: 6b429b28 ($10.4 in chips)
Seat 3: 68a22383 ($9.85 in chips)
Seat 4: 7991388d ($31.55 in chips)
Seat 5: 8b72aa95 ($10.37 in chips)
Seat 6: ae23f551 ($10 in chips)
6b429b28: posts small blind $0.05
68a22383: posts big blind $0.1
*** HOLE CARDS ***
Dealt to Hero [Ks 3h]
Dealt to 6b429b28 
Dealt to 68a22383 
Dealt to 7991388d 
Dealt to 8b72aa95 
Dealt to ae23f551 
7991388d: folds
8b72aa95: folds
ae23f551: folds
Hero: folds
6b429b28: folds
Uncalled bet ($0.05) returned to 68a22383
*** SHOWDOWN ***
68a22383 collected $0.1 from pot
*** SUMMARY ***
Total pot $0.1 | Rake $0 | Jackpot $0 | Bingo $0 | Fortune $0 | Tax $0
Seat 1: Hero (button) folded before Flop (didn't bet)
Seat 2: 6b429b28 (small blind) folded before Flop
Seat 3: 68a22383 (big blind) collected ($0.1)
Seat 4: 7991388d folded before Flop (didn't bet)
Seat 5: 8b72aa95 folded before Flop (didn't bet)
Seat 6: ae23f551 folded before Flop (didn't bet)


Poker Hand #RC2774813161: Hold'em No Limit ($0.05/$0.1) - 2024/08/05 13:24:45
Table 'RushAndCash21408421' 6-max Seat #1 is the button
Seat 1: 59cf4dd4 ($10.55 in chips)
Seat 2: 1ab91021 ($11.94 in chips)
Seat 3: Hero ($10.85 in chips)
Seat 4: f80c7735 ($10.22 in chips)
Seat 5: 4fd3ce55 ($11.41 in chips)
Seat 6: 26f11e2a ($6.66 in chips)
1ab91021: posts small blind $0.05
Hero: posts big blind $0.1
*** HOLE CARDS ***
Dealt to 59cf4dd4 
Dealt to 1ab91021 
Dealt to Hero [8c Kc]
Dealt to f80c7735 
Dealt to 4fd3ce55 
Dealt to 26f11e2a 
f80c7735: folds
4fd3ce55: folds
26f11e2a: folds
59cf4dd4: raises $0.15 to $0.25
1ab91021: folds
Hero: folds
Uncalled bet ($0.15) returned to 59cf4dd4
*** SHOWDOWN ***
59cf4dd4 collected $0.25 from pot
*** SUMMARY ***
Total pot $0.25 | Rake $0 | Jackpot $0 | Bingo $0 | Fortune $0 | Tax $0
Seat 1: 59cf4dd4 (button) collected ($0.25)
Seat 2: 1ab91021 (small blind) folded before Flop
Seat 3: Hero (big blind) folded before Flop
Seat 4: f80c7735 folded before Flop (didn't bet)
Seat 5: 4fd3ce55 folded before Flop (didn't bet)
Seat 6: 26f11e2a folded before Flop (didn't bet)


Poker Hand #RC2774813136: Hold'em No Limit ($0.05/$0.1) - 2024/08/05 13:24:41
Table 'RushAndCash21408396' 6-max Seat #1 is the button
Seat 1: 45e15610 ($10.23 in chips)
Seat 2: Hero ($10.9 in chips)
Seat 3: d63d27c2 ($10.04 in chips)
Seat 4: 56764068 ($28.52 in chips)
Seat 5: b65d2a12 ($24.79 in chips)
Seat 6: db444bcd ($10.31 in chips)
Hero: posts small blind $0.05
d63d27c2: posts big blind $0.1
*** HOLE CARDS ***
Dealt to 45e15610 
Dealt to Hero [8s Qd]
Dealt to d63d27c2 
Dealt to 56764068 
Dealt to b65d2a12 
Dealt to db444bcd 
56764068: raises $0.15 to $0.25
b65d2a12: folds
db444bcd: folds
45e15610: folds
Hero: folds
d63d27c2: folds
Uncalled bet ($0.15) returned to 56764068
*** SHOWDOWN ***
56764068 collected $0.25 from pot
*** SUMMARY ***
Total pot $0.25 | Rake $0 | Jackpot $0 | Bingo $0 | Fortune $0 | Tax $0
Seat 1: 45e15610 (button) folded before Flop (didn't bet)
Seat 2: Hero (small blind) folded before Flop
Seat 3: d63d27c2 (big blind) folded before Flop
Seat 4: 56764068 collected ($0.25)
Seat 5: b65d2a12 folded before Flop (didn't bet)
Seat 6: db444bcd folded before Flop (didn't bet)


Poker Hand #RC2774813111: Hold'em No Limit ($0.05/$0.1) - 2024/08/05 13:24:38
Table 'RushAndCash21408371' 6-max Seat #1 is the button
Seat 1: f61f268d ($12.25 in chips)
Seat 2: ea29259a ($13.21 in chips)
Seat 3: 38d4fec3 ($11.02 in chips)
Seat 4: 241244c8 ($16.59 in chips)
Seat 5: Hero ($10.9 in chips)
Seat 6: 56764068 ($28.52 in chips)
ea29259a: posts small blind $0.05
38d4fec3: posts big blind $0.1
*** HOLE CARDS ***
Dealt to f61f268d 
Dealt to ea29259a 
Dealt to 38d4fec3 
Dealt to 241244c8 
Dealt to Hero [7s Kd]
Dealt to 56764068 
241244c8: folds
Hero: folds
56764068: folds
f61f268d: raises $0.15 to $0.25
ea29259a: folds
38d4fec3: folds
Uncalled bet ($0.15) returned to f61f268d
*** SHOWDOWN ***
f61f268d collected $0.25 from pot
*** SUMMARY ***
Total pot $0.25 | Rake $0 | Jackpot $0 | Bingo $0 | Fortune $0 | Tax $0
Seat 1: f61f268d (button) collected ($0.25)
Seat 2: ea29259a (small blind) folded before Flop
Seat 3: 38d4fec3 (big blind) folded before Flop
Seat 4: 241244c8 folded before Flop (didn't bet)
Seat 5: Hero folded before Flop (didn't bet)
Seat 6: 56764068 folded before Flop (didn't bet)


Poker Hand #RC2774813079: Hold'em No Limit ($0.05/$0.1) - 2024/08/05 13:24:34
Table 'RushAndCash21408339' 6-max Seat #1 is the button
Seat 1: 9fd31f2b ($10 in chips)
Seat 2: a8ce07e9 ($13.05 in chips)
Seat 3: f192758 ($11.43 in chips)
Seat 4: 2df71d52 ($10.15 in chips)
Seat 5: 8c0516d1 ($18.11 in chips)
Seat 6: Hero ($10.9 in chips)
a8ce07e9: posts small blind $0.05
f192758: posts big blind $0.1
*** HOLE CARDS ***
Dealt to 9fd31f2b 
Dealt to a8ce07e9 
Dealt to f192758 
Dealt to 2df71d52 
Dealt to 8c0516d1 
Dealt to Hero [5h 6s]
2df71d52: folds
8c0516d1: raises $0.2 to $0.3
Hero: folds
9fd31f2b: folds
a8ce07e9: folds
f192758: calls $0.2
*** FLOP *** [Qc 4d 2h]
f192758: checks
8c0516d1: checks
*** TURN *** [Qc 4d 2h] [2d]
f192758: bets $0.35
8c0516d1: folds
Uncalled bet ($0.35) returned to f192758
*** SHOWDOWN ***
f192758 collected $0.62 from pot
*** SUMMARY ***
Total pot $0.65 | Rake $0.03 | Jackpot $0 | Bingo $0 | Fortune $0 | Tax $0
Board [Qc 4d 2h 2d]
Seat 1: 9fd31f2b (button) folded before Flop (didn't bet)
Seat 2: a8ce07e9 (small blind) folded before Flop
Seat 3: f192758 (big blind) won ($0.62)
Seat 4: 2df71d52 folded before Flop (didn't bet)
Seat 5: 8c0516d1 folded on the Turn
Seat 6: Hero folded before Flop (didn't bet)


Poker Hand #RC2774813055: Hold'em No Limit ($0.05/$0.1) - 2024/08/05 13:24:30
Table 'RushAndCash21408315' 6-max Seat #1 is the button
Seat 1: ab1097c2 ($10.28 in chips)
Seat 2: 15e8bc52 ($25.59 in chips)
Seat 3: e155962f ($28.19 in chips)
Seat 4: Hero ($10.9 in chips)
Seat 5: 25a4b4f ($11.39 in chips)
Seat 6: 9e29158a ($16.6 in chips)
15e8bc52: posts small blind $0.05
e155962f: posts big blind $0.1
*** HOLE CARDS ***
Dealt to ab1097c2 
Dealt to 15e8bc52 
Dealt to e155962f 
Dealt to Hero [Qh 6c]
Dealt to 25a4b4f 
Dealt to 9e29158a 
Hero: folds
25a4b4f: folds
9e29158a: folds
ab1097c2: folds
15e8bc52: raises $0.2 to $0.3
e155962f: calls $0.2
*** FLOP *** [9d Js 8d]
15e8bc52: checks
e155962f: checks
*** TURN *** [9d Js 8d] [3c]
15e8bc52: checks
e155962f: bets $0.15
15e8bc52: folds
Uncalled bet ($0.15) returned to e155962f
*** SHOWDOWN ***
e155962f collected $0.57 from pot
*** SUMMARY ***
Total pot $0.6 | Rake $0.03 | Jackpot $0 | Bingo $0 | Fortune $0 | Tax $0
Board [9d Js 8d 3c]
Seat 1: ab1097c2 (button) folded before Flop (didn't bet)
Seat 2: 15e8bc52 (small blind) folded on the Turn
Seat 3: e155962f (big blind) won ($0.57)
Seat 4: Hero folded before Flop (didn't bet)
Seat 5: 25a4b4f folded before Flop (didn't bet)
Seat 6: 9e29158a folded before Flop (didn't bet)


Poker Hand #RC2774813032: Hold'em No Limit ($0.05/$0.1) - 2024/08/05 13:24:27
Table 'RushAndCash21408292' 6-max Seat #1 is the button
Seat 1: 58771be3 ($11.36 in chips)
Seat 2: 57c66431 ($49.7 in chips)
Seat 3: d6bef32a ($10 in chips)
Seat 4: 8f3c3ed7 ($7.6 in chips)
Seat 5: c4c7add6 ($10.28 in chips)
Seat 6: Hero ($10.9 in chips)
57c66431: posts small blind $0.05
d6bef32a: posts big blind $0.1
*** HOLE CARDS ***
Dealt to 58771be3 
Dealt to 57c66431 
Dealt to d6bef32a 
Dealt to 8f3c3ed7 
Dealt to c4c7add6 
Dealt to Hero [3d Ac]
8f3c3ed7: folds
c4c7add6: folds
Hero: folds
58771be3: raises $0.12 to $0.22
57c66431: folds
d6bef32a: calls $0.12
*** FLOP *** [2s 6h Ah]
d6bef32a: checks
58771be3: bets $0.17
d6bef32a: calls $0.17
*** TURN *** [2s 6h Ah] [Jd]
d6bef32a: checks
58771be3: checks
*** RIVER *** [2s 6h Ah Jd] [9h]
d6bef32a: checks
58771be3: checks
d6bef32a: shows [3c Ad] (Pair of Aces)
58771be3: shows [Kc Jc] (Pair of Jacks)
*** SHOWDOWN ***
d6bef32a collected $0.79 from pot
*** SUMMARY ***
Total pot $0.83 | Rake $0.04 | Jackpot $0 | Bingo $0 | Fortune $0 | Tax $0
Board [2s 6h Ah Jd 9h]
Seat 1: 58771be3 (button) showed [Kc Jc] and lost with Pair of Jacks
Seat 2: 57c66431 (small blind) folded before Flop
Seat 3: d6bef32a (big blind) showed [3c Ad] and won ($0.79) with Pair of Aces
Seat 4: 8f3c3ed7 folded before Flop (didn't bet)
Seat 5: c4c7add6 folded before Flop (didn't bet)
Seat 6: Hero folded before Flop (didn't bet)


Poker Hand #RC2774813003: Hold'em No Limit ($0.05/$0.1) - 2024/08/05 13:24:23
Table 'RushAndCash21408263' 6-max Seat #1 is the button
Seat 1: 869b3bdb ($14.49 in chips)
Seat 2: e5e26648 ($37.28 in chips)
Seat 3: Hero ($11 in chips)
Seat 4: aa88b9b0 ($15.34 in chips)
Seat 5: afe19f66 ($26.87 in chips)
Seat 6: 1b1f16d3 ($15.25 in chips)
e5e26648: posts small blind $0.05
Hero: posts big blind $0.1
*** HOLE CARDS ***
Dealt to 869b3bdb 
Dealt to e5e26648 
Dealt to Hero [Ts 6s]
Dealt to aa88b9b0 
Dealt to afe19f66 
Dealt to 1b1f16d3 
aa88b9b0: raises $0.15 to $0.25
afe19f66: folds
1b1f16d3: calls $0.25
869b3bdb: folds
e5e26648: folds
Hero: folds
*** FLOP *** [Qd 7h 6h]
aa88b9b0: checks
1b1f16d3: checks
*** TURN *** [Qd 7h 6h] [3c]
aa88b9b0: bets $0.31
1b1f16d3: folds
Uncalled bet ($0.31) returned to aa88b9b0
*** SHOWDOWN ***
aa88b9b0 collected $0.62 from pot
*** SUMMARY ***
Total pot $0.65 | Rake $0.03 | Jackpot $0 | Bingo $0 | Fortune $0 | Tax $0
Board [Qd 7h 6h 3c]
Seat 1: 869b3bdb (button) folded before Flop (didn't bet)
Seat 2: e5e26648 (small blind) folded before Flop
Seat 3: Hero (big blind) folded before Flop
Seat 4: aa88b9b0 won ($0.62)
Seat 5: afe19f66 folded before Flop (didn't bet)
Seat 6: 1b1f16d3 folded on the Turn


Poker Hand #RC2774812974: Hold'em No Limit ($0.05/$0.1) - 2024/08/05 13:24:19
Table 'RushAndCash21408234' 6-max Seat #1 is the button
Seat 1: fa3fec8e ($16.24 in chips)
Seat 2: Hero ($11.05 in chips)
Seat 3: 9dc9ad21 ($21.3 in chips)
Seat 4: ba4cd173 ($18.95 in chips)
Seat 5: c519f7aa ($25.09 in chips)
Seat 6: 9e8e5ab ($22.05 in chips)
Hero: posts small blind $0.05
9dc9ad21: posts big blind $0.1
*** HOLE CARDS ***
Dealt to fa3fec8e 
Dealt to Hero [2c Th]
Dealt to 9dc9ad21 
Dealt to ba4cd173 
Dealt to c519f7aa 
Dealt to 9e8e5ab 
ba4cd173: folds
c519f7aa: folds
9e8e5ab: folds
fa3fec8e: folds
Hero: folds
Uncalled bet ($0.05) returned to 9dc9ad21
*** SHOWDOWN ***
9dc9ad21 collected $0.1 from pot
*** SUMMARY ***
Total pot $0.1 | Rake $0 | Jackpot $0 | Bingo $0 | Fortune $0 | Tax $0
Seat 1: fa3fec8e (button) folded before Flop (didn't bet)
Seat 2: Hero (small blind) folded before Flop
Seat 3: 9dc9ad21 (big blind) collected ($0.1)
Seat 4: ba4cd173 folded before Flop (didn't bet)
Seat 5: c519f7aa folded before Flop (didn't bet)
Seat 6: 9e8e5ab folded before Flop (didn't bet)


Poker Hand #RC2774812931: Hold'em No Limit ($0.05/$0.1) - 2024/08/05 13:24:13
Table 'RushAndCash21408191' 6-max Seat #1 is the button
Seat 1: 72a60a97 ($28.32 in chips)
Seat 2: 5d9de9dd ($8.35 in chips)
Seat 3: bae62c2a ($10.44 in chips)
Seat 4: 1fa51315 ($10.2 in chips)
Seat 5: 3bb79280 ($10.73 in chips)
Seat 6: Hero ($11.05 in chips)
5d9de9dd: posts small blind $0.05
bae62c2a: posts big blind $0.1
*** HOLE CARDS ***
Dealt to 72a60a97 
Dealt to 5d9de9dd 
Dealt to bae62c2a 
Dealt to 1fa51315 
Dealt to 3bb79280 
Dealt to Hero [4d Td]
1fa51315: folds
3bb79280: folds
Hero: folds
72a60a97: folds
5d9de9dd: raises $0.13 to $0.23
bae62c2a: calls $0.13
*** FLOP *** [Qs 9h Jc]
5d9de9dd: checks
bae62c2a: checks
*** TURN *** [Qs 9h Jc] [Js]
5d9de9dd: bets $0.25
bae62c2a: calls $0.25
*** RIVER *** [Qs 9h Jc Js] [7h]
5d9de9dd: checks
bae62c2a: bets $0.68
5d9de9dd: calls $0.68
bae62c2a: shows [Ac 8d] (Pair of Jacks)
5d9de9dd: shows [Ts Th] (Pair of Jacks and Pair of Tens)
*** SHOWDOWN ***
5d9de9dd collected $2.21 from pot
*** SUMMARY ***
Total pot $2.32 | Rake $0.11 | Jackpot $0 | Bingo $0 | Fortune $0 | Tax $0
Board [Qs 9h Jc Js 7h]
Seat 1: 72a60a97 (button) folded before Flop (didn't bet)
Seat 2: 5d9de9dd (small blind) showed [Ts Th] and won ($2.21) with Pair of Jacks and Pair of Tens
Seat 3: bae62c2a (big blind) showed [Ac 8d] and lost with Pair of Jacks
Seat 4: 1fa51315 folded before Flop (didn't bet)
Seat 5: 3bb79280 folded before Flop (didn't bet)
Seat 6: Hero folded before Flop (didn't bet)


Poker Hand #RC2774812901: Hold'em No Limit ($0.05/$0.1) - 2024/08/05 13:24:09
Table 'RushAndCash21408161' 6-max Seat #1 is the button
Seat 1: 1fa51315 ($10.2 in chips)
Seat 2: 6ff89eee ($8 in chips)
Seat 3: d0d0d57a ($10.63 in chips)
Seat 4: f3b4cb31 ($9.95 in chips)
Seat 5: ba4cd173 ($19 in chips)
Seat 6: Hero ($11.05 in chips)
6ff89eee: posts small blind $0.05
d0d0d57a: posts big blind $0.1
*** HOLE CARDS ***
Dealt to 1fa51315 
Dealt to 6ff89eee 
Dealt to d0d0d57a 
Dealt to f3b4cb31 
Dealt to ba4cd173 
Dealt to Hero [7d 6s]
f3b4cb31: folds
ba4cd173: folds
Hero: folds
1fa51315: folds
6ff89eee: raises $0.3 to $0.4
d0d0d57a: folds
Uncalled bet ($0.3) returned to 6ff89eee
*** SHOWDOWN ***
6ff89eee collected $0.2 from pot
*** SUMMARY ***
Total pot $0.2 | Rake $0 | Jackpot $0 | Bingo $0 | Fortune $0 | Tax $0
Seat 1: 1fa51315 (button) folded before Flop (didn't bet)
Seat 2: 6ff89eee (small blind) collected ($0.2)
Seat 3: d0d0d57a (big blind) folded before Flop
Seat 4: f3b4cb31 folded before Flop (didn't bet)
Seat 5: ba4cd173 folded before Flop (didn't bet)
Seat 6: Hero folded before Flop (didn't bet)


Poker Hand #RC2774812871: Hold'em No Limit ($0.05/$0.1) - 2024/08/05 13:24:06
Table 'RushAndCash21408131' 6-max Seat #1 is the button
Seat 1: a4aad96a ($10.28 in chips)
Seat 2: Hero ($11.1 in chips)
Seat 3: 644022ea ($10.77 in chips)
Seat 4: ba4cd173 ($19 in chips)
Seat 5: d2338f98 ($10.3 in chips)
Seat 6: cd78b009 ($12.41 in chips)
Hero: posts small blind $0.05
644022ea: posts big blind $0.1
*** HOLE CARDS ***
Dealt to a4aad96a 
Dealt to Hero [Kh 4c]
Dealt to 644022ea 
Dealt to ba4cd173 
Dealt to d2338f98 
Dealt to cd78b009 
ba4cd173: folds
d2338f98: folds
cd78b009: folds
a4aad96a: raises $0.15 to $0.25
Hero: folds
644022ea: folds
Uncalled bet ($0.15) returned to a4aad96a
*** SHOWDOWN ***
a4aad96a collected $0.25 from pot
*** SUMMARY ***
Total pot $0.25 | Rake $0 | Jackpot $0 | Bingo $0 | Fortune $0 | Tax $0
Seat 1: a4aad96a (button) collected ($0.25)
Seat 2: Hero (small blind) folded before Flop
Seat 3: 644022ea (big blind) folded before Flop
Seat 4: ba4cd173 folded before Flop (didn't bet)
Seat 5: d2338f98 folded before Flop (didn't bet)
Seat 6: cd78b009 folded before Flop (didn't bet)


Poker Hand #RC2774812834: Hold'em No Limit ($0.05/$0.1) - 2024/08/05 13:24:02
Table 'RushAndCash21408094' 6-max Seat #1 is the button
Seat 1: c96e0080 ($13.29 in chips)
Seat 2: 4ef61c4f ($10.13 in chips)
Seat 3: c8f62ef2 ($5.13 in chips)
Seat 4: 406fc8eb ($10.58 in chips)
Seat 5: e8ec4f2b ($23.88 in chips)
Seat 6: Hero ($11.1 in chips)
4ef61c4f: posts small blind $0.05
c8f62ef2: posts big blind $0.1
*** HOLE CARDS ***
Dealt to c96e0080 
Dealt to 4ef61c4f 
Dealt to c8f62ef2 
Dealt to 406fc8eb 
Dealt to e8ec4f2b 
Dealt to Hero [Th 3h]
406fc8eb: folds
e8ec4f2b: raises $0.14 to $0.24
Hero: folds
c96e0080: folds
4ef61c4f: folds
c8f62ef2: calls $0.14
*** FLOP *** [7c Kc Ac]
c8f62ef2: checks
e8ec4f2b: bets $0.18
c8f62ef2: folds
Uncalled bet ($0.18) returned to e8ec4f2b
*** SHOWDOWN ***
e8ec4f2b collected $0.51 from pot
*** SUMMARY ***
Total pot $0.53 | Rake $0.02 | Jackpot $0 | Bingo $0 | Fortune $0 | Tax $0
Board [7c Kc Ac]
Seat 1: c96e0080 (button) folded before Flop (didn't bet)
Seat 2: 4ef61c4f (small blind) folded before Flop
Seat 3: c8f62ef2 (big blind) folded on the Flop
Seat 4: 406fc8eb folded before Flop (didn't bet)
Seat 5: e8ec4f2b won ($0.51)
Seat 6: Hero folded before Flop (didn't bet)


Poker Hand #RC2774812754: Hold'em No Limit ($0.05/$0.1) - 2024/08/05 13:23:52
Table 'RushAndCash21408014' 6-max Seat #1 is the button
Seat 1: d434bc61 ($10 in chips)
Seat 2: 6e6756d9 ($10.6 in chips)
Seat 3: Hero ($11.2 in chips)
Seat 4: 68a22383 ($9.85 in chips)
Seat 5: 2189bb8c ($14.45 in chips)
Seat 6: 4cb0a216 ($11.24 in chips)
Cash Drop to Pot : total $1 
6e6756d9: posts small blind $0.05
Hero: posts big blind $0.1
*** HOLE CARDS ***
Dealt to d434bc61 
Dealt to 6e6756d9 
Dealt to Hero [Js 3s]
Dealt to 68a22383 
Dealt to 2189bb8c 
Dealt to 4cb0a216 
68a22383: folds
2189bb8c: calls $0.1
4cb0a216: calls $0.1
d434bc61: calls $0.1
6e6756d9: raises $10.5 to $10.6 and is all-in
Hero: folds
2189bb8c: folds
4cb0a216: folds
d434bc61: folds
Uncalled bet ($10.5) returned to 6e6756d9
*** SHOWDOWN ***
6e6756d9 collected $1.43 from pot
*** SUMMARY ***
Total pot $1.5 | Rake $0.07 | Jackpot $0 | Bingo $0 | Fortune $0 | Tax $0
Seat 1: d434bc61 (button) folded before Flop
Seat 2: 6e6756d9 (small blind) collected ($1.43)
Seat 3: Hero (big blind) folded before Flop
Seat 4: 68a22383 folded before Flop (didn't bet)
Seat 5: 2189bb8c folded before Flop
Seat 6: 4cb0a216 folded before Flop


Poker Hand #RC2774812633: Hold'em No Limit ($0.05/$0.1) - 2024/08/05 13:23:38
Table 'RushAndCash21407893' 6-max Seat #1 is the button
Seat 1: 28dc6712 ($13.07 in chips)
Seat 2: afe19f66 ($28.87 in chips)
Seat 3: b3c9ccb4 ($12.71 in chips)
Seat 4: 8675d202 ($12.03 in chips)
Seat 5: 8666fbab ($10 in chips)
Seat 6: Hero ($11.05 in chips)
afe19f66: posts small blind $0.05
b3c9ccb4: posts big blind $0.1
*** HOLE CARDS ***
Dealt to 28dc6712 
Dealt to afe19f66 
Dealt to b3c9ccb4 
Dealt to 8675d202 
Dealt to 8666fbab 
Dealt to Hero [Qc Td]
8675d202: folds
8666fbab: folds
Hero: raises $0.14 to $0.24
28dc6712: folds
afe19f66: folds
b3c9ccb4: folds
Uncalled bet ($0.14) returned to Hero
*** SHOWDOWN ***
Hero collected $0.25 from pot
*** SUMMARY ***
Total pot $0.25 | Rake $0 | Jackpot $0 | Bingo $0 | Fortune $0 | Tax $0
Seat 1: 28dc6712 (button) folded before Flop (didn't bet)
Seat 2: afe19f66 (small blind) folded before Flop
Seat 3: b3c9ccb4 (big blind) folded before Flop
Seat 4: 8675d202 folded before Flop (didn't bet)
Seat 5: 8666fbab folded before Flop (didn't bet)
Seat 6: Hero collected ($0.25)


Poker Hand #RC2774812601: Hold'em No Limit ($0.05/$0.1) - 2024/08/05 13:23:33
Table 'RushAndCash21407861' 6-max Seat #1 is the button
Seat 1: 71824a6 ($8.41 in chips)
Seat 2: ade57da9 ($14.37 in chips)
Seat 3: 2b6fca08 ($10.15 in chips)
Seat 4: 3c64da5 ($19.78 in chips)
Seat 5: Hero ($11.05 in chips)
Seat 6: 6e0d8dad ($10.15 in chips)
ade57da9: posts small blind $0.05
2b6fca08: posts big blind $0.1
*** HOLE CARDS ***
Dealt to 71824a6 
Dealt to ade57da9 
Dealt to 2b6fca08 
Dealt to 3c64da5 
Dealt to Hero [2s 4h]
Dealt to 6e0d8dad 
3c64da5: folds
Hero: folds
6e0d8dad: folds
71824a6: raises $0.1 to $0.2
ade57da9: folds
2b6fca08: folds
Uncalled bet ($0.1) returned to 71824a6
*** SHOWDOWN ***
71824a6 collected $0.25 from pot
*** SUMMARY ***
Total pot $0.25 | Rake $0 | Jackpot $0 | Bingo $0 | Fortune $0 | Tax $0
Seat 1: 71824a6 (button) collected ($0.25)
Seat 2: ade57da9 (small blind) folded before Flop
Seat 3: 2b6fca08 (big blind) folded before Flop
Seat 4: 3c64da5 folded before Flop (didn't bet)
Seat 5: Hero folded before Flop (didn't bet)
Seat 6: 6e0d8dad folded before Flop (didn't bet)


Poker Hand #RC2774812574: Hold'em No Limit ($0.05/$0.1) - 2024/08/05 13:23:30
Table 'RushAndCash21407834' 6-max Seat #1 is the button
Seat 1: 3d337591 ($13.9 in chips)
Seat 2: d3454833 ($11.06 in chips)
Seat 3: a7d7e5ec ($10.3 in chips)
Seat 4: 2b6fca08 ($10.15 in chips)
Seat 5: Hero ($11.05 in chips)
Seat 6: ada7213f ($10 in chips)
d3454833: posts small blind $0.05
a7d7e5ec: posts big blind $0.1
*** HOLE CARDS ***
Dealt to 3d337591 
Dealt to d3454833 
Dealt to a7d7e5ec 
Dealt to 2b6fca08 
Dealt to Hero [Jc 7d]
Dealt to ada7213f 
2b6fca08: folds
Hero: folds
ada7213f: folds
3d337591: raises $0.1 to $0.2
d3454833: folds
a7d7e5ec: calls $0.1
*** FLOP *** [8s Qh Ks]
a7d7e5ec: checks
3d337591: checks
*** TURN *** [8s Qh Ks] [3d]
a7d7e5ec: checks
3d337591: bets $0.2
a7d7e5ec: calls $0.2
*** RIVER *** [8s Qh Ks 3d] [9h]
a7d7e5ec: checks
3d337591: checks
a7d7e5ec: shows [Qc 7c] (Pair of Queens)
3d337591: shows [Jd Qs] (Pair of Queens)
*** SHOWDOWN ***
3d337591 collected $0.81 from pot
*** SUMMARY ***
Total pot $0.85 | Rake $0.04 | Jackpot $0 | Bingo $0 | Fortune $0 | Tax $0
Board [8s Qh Ks 3d 9h]
Seat 1: 3d337591 (button) showed [Jd Qs] and won ($0.81) with Pair of Queens
Seat 2: d3454833 (small blind) folded before Flop
Seat 3: a7d7e5ec (big blind) showed [Qc 7c] and lost with Pair of Queens
Seat 4: 2b6fca08 folded before Flop (didn't bet)
Seat 5: Hero folded before Flop (didn't bet)
Seat 6: ada7213f folded before Flop (didn't bet)


Poker Hand #RC2774812532: Hold'em No Limit ($0.05/$0.1) - 2024/08/05 13:23:25
Table 'RushAndCash21407792' 6-max Seat #1 is the button
Seat 1: 51ff7f48 ($7.94 in chips)
Seat 2: a5801292 ($11.58 in chips)
Seat 3: 5af02dc4 ($10 in chips)
Seat 4: 443b24f4 ($7.81 in chips)
Seat 5: Hero ($11.05 in chips)
Seat 6: bf288ec9 ($9.33 in chips)
a5801292: posts small blind $0.05
5af02dc4: posts big blind $0.1
*** HOLE CARDS ***
Dealt to 51ff7f48 
Dealt to a5801292 
Dealt to 5af02dc4 
Dealt to 443b24f4 
Dealt to Hero [6s Qh]
Dealt to bf288ec9 
443b24f4: folds
Hero: folds
bf288ec9: folds
51ff7f48: folds
a5801292: folds
Uncalled bet ($0.05) returned to 5af02dc4
*** SHOWDOWN ***
5af02dc4 collected $0.1 from pot
*** SUMMARY ***
Total pot $0.1 | Rake $0 | Jackpot $0 | Bingo $0 | Fortune $0 | Tax $0
Seat 1: 51ff7f48 (button) folded before Flop (didn't bet)
Seat 2: a5801292 (small blind) folded before Flop
Seat 3: 5af02dc4 (big blind) collected ($0.1)
Seat 4: 443b24f4 folded before Flop (didn't bet)
Seat 5: Hero folded before Flop (didn't bet)
Seat 6: bf288ec9 folded before Flop (didn't bet)


Poker Hand #RC2774812462: Hold'em No Limit ($0.05/$0.1) - 2024/08/05 13:23:16
Table 'RushAndCash21407722' 6-max Seat #1 is the button
Seat 1: 1d87c189 ($10.37 in chips)
Seat 2: Hero ($10.95 in chips)
Seat 3: 63c91dca ($12.93 in chips)
Seat 4: 4a5029c2 ($12.12 in chips)
Seat 5: dbffffb3 ($30.19 in chips)
Seat 6: cbe44fcb ($12.55 in chips)
Hero: posts small blind $0.05
63c91dca: posts big blind $0.1
*** HOLE CARDS ***
Dealt to 1d87c189 
Dealt to Hero [Th Ts]
Dealt to 63c91dca 
Dealt to 4a5029c2 
Dealt to dbffffb3 
Dealt to cbe44fcb 
4a5029c2: folds
dbffffb3: folds
cbe44fcb: folds
1d87c189: folds
Hero: raises $0.2 to $0.3
63c91dca: folds
Uncalled bet ($0.2) returned to Hero
*** SHOWDOWN ***
Hero collected $0.2 from pot
*** SUMMARY ***
Total pot $0.2 | Rake $0 | Jackpot $0 | Bingo $0 | Fortune $0 | Tax $0
Seat 1: 1d87c189 (button) folded before Flop (didn't bet)
Seat 2: Hero (small blind) collected ($0.2)
Seat 3: 63c91dca (big blind) folded before Flop
Seat 4: 4a5029c2 folded before Flop (didn't bet)
Seat 5: dbffffb3 folded before Flop (didn't bet)
Seat 6: cbe44fcb folded before Flop (didn't bet)


Poker Hand #RC2774812421: Hold'em No Limit ($0.05/$0.1) - 2024/08/05 13:23:11
Table 'RushAndCash21407681' 6-max Seat #1 is the button
Seat 1: 7badbad4 ($11.5 in chips)
Seat 2: 48da6689 ($10.05 in chips)
Seat 3: b65d2a12 ($25.04 in chips)
Seat 4: Hero ($10.95 in chips)
Seat 5: de3c243c ($11.09 in chips)
Seat 6: 6e22e07 ($10 in chips)
48da6689: posts small blind $0.05
b65d2a12: posts big blind $0.1
*** HOLE CARDS ***
Dealt to 7badbad4 
Dealt to 48da6689 
Dealt to b65d2a12 
Dealt to Hero [3s Ad]
Dealt to de3c243c 
Dealt to 6e22e07 
Hero: folds
de3c243c: folds
6e22e07: raises $0.14 to $0.24
7badbad4: raises $0.56 to $0.8
48da6689: folds
b65d2a12: folds
6e22e07: calls $0.56
*** FLOP *** [5s 2s 5h]
6e22e07: checks
7badbad4: bets $0.88
6e22e07: folds
Uncalled bet ($0.88) returned to 7badbad4
*** SHOWDOWN ***
7badbad4 collected $1.67 from pot
*** SUMMARY ***
Total pot $1.75 | Rake $0.08 | Jackpot $0 | Bingo $0 | Fortune $0 | Tax $0
Board [5s 2s 5h]
Seat 1: 7badbad4 (button) won ($1.67)
Seat 2: 48da6689 (small blind) folded before Flop
Seat 3: b65d2a12 (big blind) folded before Flop
Seat 4: Hero folded before Flop (didn't bet)
Seat 5: de3c243c folded before Flop (didn't bet)
Seat 6: 6e22e07 folded on the Flop


Poker Hand #RC2774812332: Hold'em No Limit ($0.05/$0.1) - 2024/08/05 13:23:00
Table 'RushAndCash21407592' 6-max Seat #1 is the button
Seat 1: 364902ff ($28.33 in chips)
Seat 2: 1708a5a4 ($8.58 in chips)
Seat 3: Hero ($11.05 in chips)
Seat 4: a58a0072 ($26.59 in chips)
Seat 5: 34f8bad ($29.41 in chips)
Seat 6: 9918ddc0 ($10.15 in chips)
1708a5a4: posts small blind $0.05
Hero: posts big blind $0.1
*** HOLE CARDS ***
Dealt to 364902ff 
Dealt to 1708a5a4 
Dealt to Hero [Jd 8s]
Dealt to a58a0072 
Dealt to 34f8bad 
Dealt to 9918ddc0 
a58a0072: folds
34f8bad: folds
9918ddc0: raises $0.12 to $0.22
364902ff: folds
1708a5a4: folds
Hero: folds
Uncalled bet ($0.12) returned to 9918ddc0
*** SHOWDOWN ***
9918ddc0 collected $0.25 from pot
*** SUMMARY ***
Total pot $0.25 | Rake $0 | Jackpot $0 | Bingo $0 | Fortune $0 | Tax $0
Seat 1: 364902ff (button) folded before Flop (didn't bet)
Seat 2: 1708a5a4 (small blind) folded before Flop
Seat 3: Hero (big blind) folded before Flop
Seat 4: a58a0072 folded before Flop (didn't bet)
Seat 5: 34f8bad folded before Flop (didn't bet)
Seat 6: 9918ddc0 collected ($0.25)


Poker Hand #RC2774812033: Hold'em No Limit ($0.05/$0.1) - 2024/08/05 13:22:23
Table 'RushAndCash21407293' 6-max Seat #1 is the button
Seat 1: Hero ($11.75 in chips)
Seat 2: f9bb38e0 ($11.34 in chips)
Seat 3: cde11cbc ($19.89 in chips)
Seat 4: fb88a35b ($14.24 in chips)
Seat 5: 644022ea ($11.59 in chips)
Seat 6: 1708a5a4 ($7.8 in chips)
f9bb38e0: posts small blind $0.05
cde11cbc: posts big blind $0.1
*** HOLE CARDS ***
Dealt to Hero [Ac Js]
Dealt to f9bb38e0 
Dealt to cde11cbc 
Dealt to fb88a35b 
Dealt to 644022ea 
Dealt to 1708a5a4 
fb88a35b: folds
644022ea: folds
1708a5a4: raises $0.1 to $0.2
Hero: raises $0.5 to $0.7
f9bb38e0: folds
cde11cbc: folds
1708a5a4: calls $0.5
*** FLOP *** [6d 8s 2c]
1708a5a4: checks
Hero: checks
*** TURN *** [6d 8s 2c] [8h]
1708a5a4: bets $0.55
Hero: folds
Uncalled bet ($0.55) returned to 1708a5a4
*** SHOWDOWN ***
1708a5a4 collected $1.48 from pot
*** SUMMARY ***
Total pot $1.55 | Rake $0.07 | Jackpot $0 | Bingo $0 | Fortune $0 | Tax $0
Board [6d 8s 2c 8h]
Seat 1: Hero (button) folded on the Turn
Seat 2: f9bb38e0 (small blind) folded before Flop
Seat 3: cde11cbc (big blind) folded before Flop
Seat 4: fb88a35b folded before Flop (didn't bet)
Seat 5: 644022ea folded before Flop (didn't bet)
Seat 6: 1708a5a4 won ($1.48)


Poker Hand #RC2774811435: Hold'em No Limit ($0.05/$0.1) - 2024/08/05 13:21:11
Table 'RushAndCash21406695' 6-max Seat #1 is the button
Seat 1: beccd4ad ($11.92 in chips)
Seat 2: b5584a1a ($10 in chips)
Seat 3: f9bb38e0 ($10.93 in chips)
Seat 4: 3984093b ($12.18 in chips)
Seat 5: Hero ($12.15 in chips)
Seat 6: 7721c598 ($10 in chips)
b5584a1a: posts small blind $0.05
f9bb38e0: posts big blind $0.1
*** HOLE CARDS ***
Dealt to beccd4ad 
Dealt to b5584a1a 
Dealt to f9bb38e0 
Dealt to 3984093b 
Dealt to Hero [Kc Ks]
Dealt to 7721c598 
3984093b: folds
Hero: raises $0.1 to $0.2
7721c598: folds
beccd4ad: folds
b5584a1a: folds
f9bb38e0: calls $0.1
*** FLOP *** [3c 3h 5d]
f9bb38e0: checks
Hero: bets $0.2
f9bb38e0: calls $0.2
*** TURN *** [3c 3h 5d] [Ah]
f9bb38e0: checks
Hero: checks
*** RIVER *** [3c 3h 5d Ah] [5s]
f9bb38e0: bets $0.64
Hero: folds
Uncalled bet ($0.64) returned to f9bb38e0
*** SHOWDOWN ***
f9bb38e0 collected $0.81 from pot
*** SUMMARY ***
Total pot $0.85 | Rake $0.04 | Jackpot $0 | Bingo $0 | Fortune $0 | Tax $0
Board [3c 3h 5d Ah 5s]
Seat 1: beccd4ad (button) folded before Flop (didn't bet)
Seat 2: b5584a1a (small blind) folded before Flop
Seat 3: f9bb38e0 (big blind) won ($0.81)
Seat 4: 3984093b folded before Flop (didn't bet)
Seat 5: Hero folded on the River
Seat 6: 7721c598 folded before Flop (didn't bet)


Poker Hand #RC2774811414: Hold'em No Limit ($0.05/$0.1) - 2024/08/05 13:21:08
Table 'RushAndCash21406674' 6-max Seat #1 is the button
Seat 1: 53e38554 ($9.97 in chips)
Seat 2: d3454833 ($11.33 in chips)
Seat 3: cbe44fcb ($12.78 in chips)
Seat 4: 687bb32e ($12.94 in chips)
Seat 5: a7d7e5ec ($10 in chips)
Seat 6: Hero ($12.15 in chips)
d3454833: posts small blind $0.05
cbe44fcb: posts big blind $0.1
*** HOLE CARDS ***
Dealt to 53e38554 
Dealt to d3454833 
Dealt to cbe44fcb 
Dealt to 687bb32e 
Dealt to a7d7e5ec 
Dealt to Hero [6d 2c]
687bb32e: raises $0.15 to $0.25
a7d7e5ec: folds
Hero: folds
53e38554: folds
d3454833: folds
cbe44fcb: folds
Uncalled bet ($0.15) returned to 687bb32e
*** SHOWDOWN ***
687bb32e collected $0.25 from pot
*** SUMMARY ***
Total pot $0.25 | Rake $0 | Jackpot $0 | Bingo $0 | Fortune $0 | Tax $0
Seat 1: 53e38554 (button) folded before Flop (didn't bet)
Seat 2: d3454833 (small blind) folded before Flop
Seat 3: cbe44fcb (big blind) folded before Flop
Seat 4: 687bb32e collected ($0.25)
Seat 5: a7d7e5ec folded before Flop (didn't bet)
Seat 6: Hero folded before Flop (didn't bet)


Poker Hand #RC2774811154: Hold'em No Limit ($0.05/$0.1) - 2024/08/05 13:20:38
Table 'RushAndCash21406414' 6-max Seat #1 is the button
Seat 1: 4cb0a216 ($12.16 in chips)
Seat 2: 53e38554 ($9.6 in chips)
Seat 3: Hero ($12.35 in chips)
Seat 4: 71824a6 ($8.58 in chips)
Seat 5: 30a0d8df ($10 in chips)
Seat 6: ebf21aa ($29.94 in chips)
53e38554: posts small blind $0.05
Hero: posts big blind $0.1
*** HOLE CARDS ***
Dealt to 4cb0a216 
Dealt to 53e38554 
Dealt to Hero [4d Ad]
Dealt to 71824a6 
Dealt to 30a0d8df 
Dealt to ebf21aa 
71824a6: folds
30a0d8df: folds
ebf21aa: folds
4cb0a216: raises $0.1 to $0.2
53e38554: calls $0.15
Hero: calls $0.1
*** FLOP *** [6s Jd Qs]
53e38554: checks
Hero: checks
4cb0a216: checks
*** TURN *** [6s Jd Qs] [Jh]
53e38554: bets $0.2
Hero: folds
4cb0a216: folds
Uncalled bet ($0.2) returned to 53e38554
*** SHOWDOWN ***
53e38554 collected $0.57 from pot
*** SUMMARY ***
Total pot $0.6 | Rake $0.03 | Jackpot $0 | Bingo $0 | Fortune $0 | Tax $0
Board [6s Jd Qs Jh]
Seat 1: 4cb0a216 (button) folded on the Turn
Seat 2: 53e38554 (small blind) won ($0.57)
Seat 3: Hero (big blind) folded on the Turn
Seat 4: 71824a6 folded before Flop (didn't bet)
Seat 5: 30a0d8df folded before Flop (didn't bet)
Seat 6: ebf21aa folded before Flop (didn't bet)


Poker Hand #RC2774811095: Hold'em No Limit ($0.05/$0.1) - 2024/08/05 13:20:30
Table 'RushAndCash21406355' 6-max Seat #1 is the button
Seat 1: 1ab91021 ($11.32 in chips)
Seat 2: Hero ($12.4 in chips)
Seat 3: 2c602ac2 ($11.82 in chips)
Seat 4: 1d87c189 ($10 in chips)
Seat 5: 4fe4b721 ($16.97 in chips)
Seat 6: f8681bf0 ($19.21 in chips)
Hero: posts small blind $0.05
2c602ac2: posts big blind $0.1
*** HOLE CARDS ***
Dealt to 1ab91021 
Dealt to Hero [8h Tc]
Dealt to 2c602ac2 
Dealt to 1d87c189 
Dealt to 4fe4b721 
Dealt to f8681bf0 
1d87c189: raises $0.1 to $0.2
4fe4b721: calls $0.2
f8681bf0: folds
1ab91021: folds
Hero: folds
2c602ac2: folds
*** FLOP *** [9c Kd 9h]
1d87c189: bets $0.19
4fe4b721: folds
Uncalled bet ($0.19) returned to 1d87c189
*** SHOWDOWN ***
1d87c189 collected $0.53 from pot
*** SUMMARY ***
Total pot $0.55 | Rake $0.02 | Jackpot $0 | Bingo $0 | Fortune $0 | Tax $0
Board [9c Kd 9h]
Seat 1: 1ab91021 (button) folded before Flop (didn't bet)
Seat 2: Hero (small blind) folded before Flop
Seat 3: 2c602ac2 (big blind) folded before Flop
Seat 4: 1d87c189 won ($0.53)
Seat 5: 4fe4b721 folded on the Flop
Seat 6: f8681bf0 folded before Flop (didn't bet)


Poker Hand #RC2774811066: Hold'em No Limit ($0.05/$0.1) - 2024/08/05 13:20:27
Table 'RushAndCash21406326' 6-max Seat #1 is the button
Seat 1: 357d5395 ($15.3 in chips)
Seat 2: 8cb8eab9 ($10 in chips)
Seat 3: abf72fef ($13.09 in chips)
Seat 4: 20c154a7 ($25.15 in chips)
Seat 5: Hero ($12.4 in chips)
Seat 6: 1d87c189 ($10 in chips)
8cb8eab9: posts small blind $0.05
abf72fef: posts big blind $0.1
*** HOLE CARDS ***
Dealt to 357d5395 
Dealt to 8cb8eab9 
Dealt to abf72fef 
Dealt to 20c154a7 
Dealt to Hero [4s Tc]
Dealt to 1d87c189 
20c154a7: folds
Hero: folds
1d87c189: folds
357d5395: folds
8cb8eab9: folds
Uncalled bet ($0.05) returned to abf72fef
*** SHOWDOWN ***
abf72fef collected $0.1 from pot
*** SUMMARY ***
Total pot $0.1 | Rake $0 | Jackpot $0 | Bingo $0 | Fortune $0 | Tax $0
Seat 1: 357d5395 (button) folded before Flop (didn't bet)
Seat 2: 8cb8eab9 (small blind) folded before Flop
Seat 3: abf72fef (big blind) collected ($0.1)
Seat 4: 20c154a7 folded before Flop (didn't bet)
Seat 5: Hero folded before Flop (didn't bet)
Seat 6: 1d87c189 folded before Flop (didn't bet)


Poker Hand #RC2774811023: Hold'em No Limit ($0.05/$0.1) - 2024/08/05 13:20:23
Table 'RushAndCash21406283' 6-max Seat #1 is the button
Seat 1: Hero ($12.4 in chips)
Seat 2: d47b999b ($9.93 in chips)
Seat 3: 7448bb3b ($20.94 in chips)
Seat 4: 9c60b231 ($22.14 in chips)
Seat 5: f87952d7 ($10 in chips)
Seat 6: 4d21dd90 ($17.97 in chips)
d47b999b: posts small blind $0.05
7448bb3b: posts big blind $0.1
*** HOLE CARDS ***
Dealt to Hero [3s Ks]
Dealt to d47b999b 
Dealt to 7448bb3b 
Dealt to 9c60b231 
Dealt to f87952d7 
Dealt to 4d21dd90 
9c60b231: folds
f87952d7: folds
4d21dd90: raises $0.12 to $0.22
Hero: folds
d47b999b: folds
7448bb3b: calls $0.12
*** FLOP *** [6h 8d 8s]
7448bb3b: checks
4d21dd90: checks
*** TURN *** [6h 8d 8s] [2d]
7448bb3b: checks
4d21dd90: checks
*** RIVER *** [6h 8d 8s 2d] [Jc]
7448bb3b: checks
4d21dd90: checks
7448bb3b: shows [7h 9h] (Pair of Eights)
4d21dd90: shows [Ad 9s] (Pair of Eights)
*** SHOWDOWN ***
4d21dd90 collected $0.46 from pot
*** SUMMARY ***
Total pot $0.49 | Rake $0.03 | Jackpot $0 | Bingo $0 | Fortune $0 | Tax $0
Board [6h 8d 8s 2d Jc]
Seat 1: Hero (button) folded before Flop (didn't bet)
Seat 2: d47b999b (small blind) folded before Flop
Seat 3: 7448bb3b (big blind) showed [7h 9h] and lost with Pair of Eights
Seat 4: 9c60b231 folded before Flop (didn't bet)
Seat 5: f87952d7 folded before Flop (didn't bet)
Seat 6: 4d21dd90 showed [Ad 9s] and won ($0.46) with Pair of Eights


Poker Hand #RC2774810994: Hold'em No Limit ($0.05/$0.1) - 2024/08/05 13:20:19
Table 'RushAndCash21406254' 6-max Seat #1 is the button
Seat 1: 8cb8eab9 ($10 in chips)
Seat 2: Hero ($12.45 in chips)
Seat 3: 5c5f83ea ($10 in chips)
Seat 4: 53e38554 ($9.7 in chips)
Seat 5: cbcf06f4 ($10 in chips)
Seat 6: 16356f6d ($10 in chips)
Hero: posts small blind $0.05
5c5f83ea: posts big blind $0.1
*** HOLE CARDS ***
Dealt to 8cb8eab9 
Dealt to Hero [5h Ks]
Dealt to 5c5f83ea 
Dealt to 53e38554 
Dealt to cbcf06f4 
Dealt to 16356f6d 
53e38554: folds
cbcf06f4: folds
16356f6d: folds
8cb8eab9: folds
Hero: folds
Uncalled bet ($0.05) returned to 5c5f83ea
*** SHOWDOWN ***
5c5f83ea collected $0.1 from pot
*** SUMMARY ***
Total pot $0.1 | Rake $0 | Jackpot $0 | Bingo $0 | Fortune $0 | Tax $0
Seat 1: 8cb8eab9 (button) folded before Flop (didn't bet)
Seat 2: Hero (small blind) folded before Flop
Seat 3: 5c5f83ea (big blind) collected ($0.1)
Seat 4: 53e38554 folded before Flop (didn't bet)
Seat 5: cbcf06f4 folded before Flop (didn't bet)
Seat 6: 16356f6d folded before Flop (didn't bet)


Poker Hand #RC2774810968: Hold'em No Limit ($0.05/$0.1) - 2024/08/05 13:20:16
Table 'RushAndCash21406228' 6-max Seat #1 is the button
Seat 1: 9f10f7db ($38.88 in chips)
Seat 2: 7448bb3b ($20.99 in chips)
Seat 3: Hero ($12.55 in chips)
Seat 4: 874e341 ($4.52 in chips)
Seat 5: d3bf5c4 ($10 in chips)
Seat 6: cb28bed9 ($9.85 in chips)
7448bb3b: posts small blind $0.05
Hero: posts big blind $0.1
*** HOLE CARDS ***
Dealt to 9f10f7db 
Dealt to 7448bb3b 
Dealt to Hero [4d 9s]
Dealt to 874e341 
Dealt to d3bf5c4 
Dealt to cb28bed9 
874e341: folds
d3bf5c4: raises $0.2 to $0.3
cb28bed9: folds
9f10f7db: raises $0.75 to $1.05
7448bb3b: folds
Hero: folds
d3bf5c4: calls $0.75
*** FLOP *** [8c Jh 9h]
d3bf5c4: checks
9f10f7db: bets $1.05
d3bf5c4: calls $1.05
*** TURN *** [8c Jh 9h] [3c]
d3bf5c4: checks
9f10f7db: bets $2.78
d3bf5c4: calls $2.78
*** RIVER *** [8c Jh 9h 3c] [7h]
d3bf5c4: bets $5.12 and is all-in
9f10f7db: calls $5.12
d3bf5c4: shows [Kd Qd] (King-High)
9f10f7db: shows [As Ah] (Pair of Aces)
*** SHOWDOWN ***
9f10f7db collected $19.7 from pot
*** SUMMARY ***
Total pot $20.15 | Rake $0.3 | Jackpot $0.15 | Bingo $0 | Fortune $0 | Tax $0
Board [8c Jh 9h 3c 7h]
Seat 1: 9f10f7db (button) showed [As Ah] and won ($19.7) with Pair of Aces
Seat 2: 7448bb3b (small blind) folded before Flop
Seat 3: Hero (big blind) folded before Flop
Seat 4: 874e341 folded before Flop (didn't bet)
Seat 5: d3bf5c4 showed [Kd Qd] and lost with King-High
Seat 6: cb28bed9 folded before Flop (didn't bet)


Poker Hand #RC2774810936: Hold'em No Limit ($0.05/$0.1) - 2024/08/05 13:20:12
Table 'RushAndCash21406196' 6-max Seat #1 is the button
Seat 1: 8af1362 ($18.43 in chips)
Seat 2: 5067513a ($10.07 in chips)
Seat 3: a4aad96a ($11.28 in chips)
Seat 4: 42322d75 ($34.61 in chips)
Seat 5: Hero ($12.55 in chips)
Seat 6: a604c6fc ($10 in chips)
5067513a: posts small blind $0.05
a4aad96a: posts big blind $0.1
*** HOLE CARDS ***
Dealt to 8af1362 
Dealt to 5067513a 
Dealt to a4aad96a 
Dealt to 42322d75 
Dealt to Hero [5c 8d]
Dealt to a604c6fc 
42322d75: folds
Hero: folds
a604c6fc: folds
8af1362: folds
5067513a: raises $0.1 to $0.2
a4aad96a: folds
Uncalled bet ($0.1) returned to 5067513a
*** SHOWDOWN ***
5067513a collected $0.2 from pot
*** SUMMARY ***
Total pot $0.2 | Rake $0 | Jackpot $0 | Bingo $0 | Fortune $0 | Tax $0
Seat 1: 8af1362 (button) folded before Flop (didn't bet)
Seat 2: 5067513a (small blind) collected ($0.2)
Seat 3: a4aad96a (big blind) folded before Flop
Seat 4: 42322d75 folded before Flop (didn't bet)
Seat 5: Hero folded before Flop (didn't bet)
Seat 6: a604c6fc folded before Flop (didn't bet)


Poker Hand #RC2774810908: Hold'em No Limit ($0.05/$0.1) - 2024/08/05 13:20:09
Table 'RushAndCash21406168' 6-max Seat #1 is the button
Seat 1: db7332b9 ($10 in chips)
Seat 2: c9cbe43b ($11.05 in chips)
Seat 3: 707b78f5 ($10 in chips)
Seat 4: Hero ($12.55 in chips)
Seat 5: 4544b2ab ($10 in chips)
Seat 6: 6e3cbccf ($24.58 in chips)
c9cbe43b: posts small blind $0.05
707b78f5: posts big blind $0.1
*** HOLE CARDS ***
Dealt to db7332b9 
Dealt to c9cbe43b 
Dealt to 707b78f5 
Dealt to Hero [6s 8d]
Dealt to 4544b2ab 
Dealt to 6e3cbccf 
Hero: folds
4544b2ab: raises $0.15 to $0.25
6e3cbccf: folds
db7332b9: raises $0.5 to $0.75
c9cbe43b: folds
707b78f5: folds
4544b2ab: calls $0.5
*** FLOP *** [3s Qh 9s]
4544b2ab: checks
db7332b9: bets $0.88
4544b2ab: folds
Uncalled bet ($0.88) returned to db7332b9
*** SHOWDOWN ***
db7332b9 collected $1.56 from pot
*** SUMMARY ***
Total pot $1.65 | Rake $0.09 | Jackpot $0 | Bingo $0 | Fortune $0 | Tax $0
Board [3s Qh 9s]
Seat 1: db7332b9 (button) won ($1.56)
Seat 2: c9cbe43b (small blind) folded before Flop
Seat 3: 707b78f5 (big blind) folded before Flop
Seat 4: Hero folded before Flop (didn't bet)
Seat 5: 4544b2ab folded on the Flop
Seat 6: 6e3cbccf folded before Flop (didn't bet)


Poker Hand #RC2774810875: Hold'em No Limit ($0.05/$0.1) - 2024/08/05 13:20:05
Table 'RushAndCash21406135' 6-max Seat #1 is the button
Seat 1: 6dbe20b7 ($10.08 in chips)
Seat 2: 90dbb409 ($10.83 in chips)
Seat 3: afe19f66 ($28.23 in chips)
Seat 4: cbf26d60 ($31.6 in chips)
Seat 5: 7ef3e576 ($12 in chips)
Seat 6: Hero ($12.55 in chips)
90dbb409: posts small blind $0.05
afe19f66: posts big blind $0.1
*** HOLE CARDS ***
Dealt to 6dbe20b7 
Dealt to 90dbb409 
Dealt to afe19f66 
Dealt to cbf26d60 
Dealt to 7ef3e576 
Dealt to Hero [4h Kc]
cbf26d60: folds
7ef3e576: raises $0.11 to $0.21
Hero: folds
6dbe20b7: folds
90dbb409: folds
afe19f66: folds
Uncalled bet ($0.11) returned to 7ef3e576
*** SHOWDOWN ***
7ef3e576 collected $0.25 from pot
*** SUMMARY ***
Total pot $0.25 | Rake $0 | Jackpot $0 | Bingo $0 | Fortune $0 | Tax $0
Seat 1: 6dbe20b7 (button) folded before Flop (didn't bet)
Seat 2: 90dbb409 (small blind) folded before Flop
Seat 3: afe19f66 (big blind) folded before Flop
Seat 4: cbf26d60 folded before Flop (didn't bet)
Seat 5: 7ef3e576 collected ($0.25)
Seat 6: Hero folded before Flop (didn't bet)


Poker Hand #RC2774810804: Hold'em No Limit ($0.05/$0.1) - 2024/08/05 13:19:56
Table 'RushAndCash21406064' 6-max Seat #1 is the button
Seat 1: 181147a1 ($10.92 in chips)
Seat 2: aad2fdf5 ($11.65 in chips)
Seat 3: 7db9a084 ($6.82 in chips)
Seat 4: 12dc7f1a ($11.84 in chips)
Seat 5: efeafe15 ($11.09 in chips)
Seat 6: Hero ($12.55 in chips)
aad2fdf5: posts small blind $0.05
7db9a084: posts big blind $0.1
*** HOLE CARDS ***
Dealt to 181147a1 
Dealt to aad2fdf5 
Dealt to 7db9a084 
Dealt to 12dc7f1a 
Dealt to efeafe15 
Dealt to Hero [Qc 6s]
12dc7f1a: folds
efeafe15: folds
Hero: folds
181147a1: raises $0.11 to $0.21
aad2fdf5: folds
7db9a084: folds
Uncalled bet ($0.11) returned to 181147a1
*** SHOWDOWN ***
181147a1 collected $0.25 from pot
*** SUMMARY ***
Total pot $0.25 | Rake $0 | Jackpot $0 | Bingo $0 | Fortune $0 | Tax $0
Seat 1: 181147a1 (button) collected ($0.25)
Seat 2: aad2fdf5 (small blind) folded before Flop
Seat 3: 7db9a084 (big blind) folded before Flop
Seat 4: 12dc7f1a folded before Flop (didn't bet)
Seat 5: efeafe15 folded before Flop (didn't bet)
Seat 6: Hero folded before Flop (didn't bet)


Poker Hand #RC2774810776: Hold'em No Limit ($0.05/$0.1) - 2024/08/05 13:19:52
Table 'RushAndCash21406036' 6-max Seat #1 is the button
Seat 1: 848e9033 ($10.71 in chips)
Seat 2: 3dff8483 ($10.05 in chips)
Seat 3: b2ec1eae ($7.78 in chips)
Seat 4: Hero ($12.55 in chips)
Seat 5: c74379b8 ($13.37 in chips)
Seat 6: 96d7955 ($22.43 in chips)
3dff8483: posts small blind $0.05
b2ec1eae: posts big blind $0.1
*** HOLE CARDS ***
Dealt to 848e9033 
Dealt to 3dff8483 
Dealt to b2ec1eae 
Dealt to Hero [8c 7c]
Dealt to c74379b8 
Dealt to 96d7955 
Hero: folds
c74379b8: folds
96d7955: folds
848e9033: folds
3dff8483: raises $0.18 to $0.28
b2ec1eae: calls $0.18
*** FLOP *** [6c 4h 6h]
3dff8483: checks
b2ec1eae: bets $0.25
3dff8483: folds
Uncalled bet ($0.25) returned to b2ec1eae
*** SHOWDOWN ***
b2ec1eae collected $0.54 from pot
*** SUMMARY ***
Total pot $0.56 | Rake $0.02 | Jackpot $0 | Bingo $0 | Fortune $0 | Tax $0
Board [6c 4h 6h]
Seat 1: 848e9033 (button) folded before Flop (didn't bet)
Seat 2: 3dff8483 (small blind) folded on the Flop
Seat 3: b2ec1eae (big blind) won ($0.54)
Seat 4: Hero folded before Flop (didn't bet)
Seat 5: c74379b8 folded before Flop (didn't bet)
Seat 6: 96d7955 folded before Flop (didn't bet)


Poker Hand #RC2774810750: Hold'em No Limit ($0.05/$0.1) - 2024/08/05 13:19:49
Table 'RushAndCash21406010' 6-max Seat #1 is the button
Seat 1: 3eab91b4 ($17.31 in chips)
Seat 2: 53fb9d87 ($10 in chips)
Seat 3: 9941da91 ($22.76 in chips)
Seat 4: 196ed1fe ($11.3 in chips)
Seat 5: 71e51e91 ($22.42 in chips)
Seat 6: Hero ($12.55 in chips)
53fb9d87: posts small blind $0.05
9941da91: posts big blind $0.1
*** HOLE CARDS ***
Dealt to 3eab91b4 
Dealt to 53fb9d87 
Dealt to 9941da91 
Dealt to 196ed1fe 
Dealt to 71e51e91 
Dealt to Hero [Js 5s]
196ed1fe: raises $0.1 to $0.2
71e51e91: folds
Hero: folds
3eab91b4: folds
53fb9d87: folds
9941da91: folds
Uncalled bet ($0.1) returned to 196ed1fe
*** SHOWDOWN ***
196ed1fe collected $0.25 from pot
*** SUMMARY ***
Total pot $0.25 | Rake $0 | Jackpot $0 | Bingo $0 | Fortune $0 | Tax $0
Seat 1: 3eab91b4 (button) folded before Flop (didn't bet)
Seat 2: 53fb9d87 (small blind) folded before Flop
Seat 3: 9941da91 (big blind) folded before Flop
Seat 4: 196ed1fe collected ($0.25)
Seat 5: 71e51e91 folded before Flop (didn't bet)
Seat 6: Hero folded before Flop (didn't bet)


Poker Hand #RC2774810693: Hold'em No Limit ($0.05/$0.1) - 2024/08/05 13:19:42
Table 'RushAndCash21405953' 6-max Seat #1 is the button
Seat 1: be337453 ($13.06 in chips)
Seat 2: Hero ($12.6 in chips)
Seat 3: 3a92409a ($10 in chips)
Seat 4: 73c7cc0d ($11.93 in chips)
Seat 5: 848e9033 ($10.71 in chips)
Seat 6: 2b6fca08 ($10.15 in chips)
Hero: posts small blind $0.05
3a92409a: posts big blind $0.1
*** HOLE CARDS ***
Dealt to be337453 
Dealt to Hero [Kc 4h]
Dealt to 3a92409a 
Dealt to 73c7cc0d 
Dealt to 848e9033 
Dealt to 2b6fca08 
73c7cc0d: folds
848e9033: folds
2b6fca08: folds
be337453: folds
Hero: folds
Uncalled bet ($0.05) returned to 3a92409a
*** SHOWDOWN ***
3a92409a collected $0.1 from pot
*** SUMMARY ***
Total pot $0.1 | Rake $0 | Jackpot $0 | Bingo $0 | Fortune $0 | Tax $0
Seat 1: be337453 (button) folded before Flop (didn't bet)
Seat 2: Hero (small blind) folded before Flop
Seat 3: 3a92409a (big blind) collected ($0.1)
Seat 4: 73c7cc0d folded before Flop (didn't bet)
Seat 5: 848e9033 folded before Flop (didn't bet)
Seat 6: 2b6fca08 folded before Flop (didn't bet)


Poker Hand #RC2774810588: Hold'em No Limit ($0.05/$0.1) - 2024/08/05 13:19:29
Table 'RushAndCash21405848' 6-max Seat #1 is the button
Seat 1: 20c154a7 ($25.15 in chips)
Seat 2: d47b999b ($9.75 in chips)
Seat 3: Hero ($12.7 in chips)
Seat 4: c50c9615 ($10 in chips)
Seat 5: 4c571a3b ($9.44 in chips)
Seat 6: 319443e2 ($11 in chips)
d47b999b: posts small blind $0.05
Hero: posts big blind $0.1
*** HOLE CARDS ***
Dealt to 20c154a7 
Dealt to d47b999b 
Dealt to Hero [Kc Qd]
Dealt to c50c9615 
Dealt to 4c571a3b 
Dealt to 319443e2 
c50c9615: folds
4c571a3b: raises $0.1 to $0.2
319443e2: folds
20c154a7: folds
d47b999b: raises $0.9 to $1.1
Hero: folds
4c571a3b: folds
Uncalled bet ($0.9) returned to d47b999b
*** SHOWDOWN ***
d47b999b collected $0.48 from pot
*** SUMMARY ***
Total pot $0.5 | Rake $0.02 | Jackpot $0 | Bingo $0 | Fortune $0 | Tax $0
Seat 1: 20c154a7 (button) folded before Flop (didn't bet)
Seat 2: d47b999b (small blind) collected ($0.48)
Seat 3: Hero (big blind) folded before Flop
Seat 4: c50c9615 folded before Flop (didn't bet)
Seat 5: 4c571a3b folded before Flop
Seat 6: 319443e2 folded before Flop (didn't bet)


Poker Hand #RC2774810561: Hold'em No Limit ($0.05/$0.1) - 2024/08/05 13:19:25
Table 'RushAndCash21405821' 6-max Seat #1 is the button
Seat 1: e155962f ($28.55 in chips)
Seat 2: d88fba59 ($10.11 in chips)
Seat 3: 97a73937 ($10.22 in chips)
Seat 4: d1e44e47 ($20.28 in chips)
Seat 5: Hero ($12.7 in chips)
Seat 6: c43c25b0 ($24.74 in chips)
d88fba59: posts small blind $0.05
97a73937: posts big blind $0.1
*** HOLE CARDS ***
Dealt to e155962f 
Dealt to d88fba59 
Dealt to 97a73937 
Dealt to d1e44e47 
Dealt to Hero [3s 4s]
Dealt to c43c25b0 
d1e44e47: folds
Hero: folds
c43c25b0: folds
e155962f: raises $0.1 to $0.2
d88fba59: folds
97a73937: folds
Uncalled bet ($0.1) returned to e155962f
*** SHOWDOWN ***
e155962f collected $0.25 from pot
*** SUMMARY ***
Total pot $0.25 | Rake $0 | Jackpot $0 | Bingo $0 | Fortune $0 | Tax $0
Seat 1: e155962f (button) collected ($0.25)
Seat 2: d88fba59 (small blind) folded before Flop
Seat 3: 97a73937 (big blind) folded before Flop
Seat 4: d1e44e47 folded before Flop (didn't bet)
Seat 5: Hero folded before Flop (didn't bet)
Seat 6: c43c25b0 folded before Flop (didn't bet)


Poker Hand #RC2774810498: Hold'em No Limit ($0.05/$0.1) - 2024/08/05 13:19:18
Table 'RushAndCash21405758' 6-max Seat #1 is the button
Seat 1: cbf26d60 ($32 in chips)
Seat 2: 5315745e ($12.57 in chips)
Seat 3: ee289422 ($22.37 in chips)
Seat 4: Hero ($12.7 in chips)
Seat 5: e64dfb19 ($10.59 in chips)
Seat 6: fbeccf9e ($13.2 in chips)
5315745e: posts small blind $0.05
ee289422: posts big blind $0.1
*** HOLE CARDS ***
Dealt to cbf26d60 
Dealt to 5315745e 
Dealt to ee289422 
Dealt to Hero [3c 9s]
Dealt to e64dfb19 
Dealt to fbeccf9e 
Hero: folds
e64dfb19: raises $0.11 to $0.21
fbeccf9e: folds
cbf26d60: folds
5315745e: folds
ee289422: calls $0.11
*** FLOP *** [7c Kc 3h]
ee289422: checks
e64dfb19: bets $0.16
ee289422: folds
Uncalled bet ($0.16) returned to e64dfb19
*** SHOWDOWN ***
e64dfb19 collected $0.45 from pot
*** SUMMARY ***
Total pot $0.47 | Rake $0.02 | Jackpot $0 | Bingo $0 | Fortune $0 | Tax $0
Board [7c Kc 3h]
Seat 1: cbf26d60 (button) folded before Flop (didn't bet)
Seat 2: 5315745e (small blind) folded before Flop
Seat 3: ee289422 (big blind) folded on the Flop
Seat 4: Hero folded before Flop (didn't bet)
Seat 5: e64dfb19 won ($0.45)
Seat 6: fbeccf9e folded before Flop (didn't bet)


Poker Hand #RC2774810430: Hold'em No Limit ($0.05/$0.1) - 2024/08/05 13:19:10
Table 'RushAndCash21405690' 6-max Seat #1 is the button
Seat 1: Hero ($12.7 in chips)
Seat 2: a37ca90d ($9.9 in chips)
Seat 3: 241244c8 ($9.05 in chips)
Seat 4: 30a0d8df ($10.42 in chips)
Seat 5: 6b429b28 ($10.6 in chips)
Seat 6: 96270f96 ($10 in chips)
a37ca90d: posts small blind $0.05
241244c8: posts big blind $0.1
*** HOLE CARDS ***
Dealt to Hero [2d 3s]
Dealt to a37ca90d 
Dealt to 241244c8 
Dealt to 30a0d8df 
Dealt to 6b429b28 
Dealt to 96270f96 
30a0d8df: folds
6b429b28: folds
96270f96: raises $0.15 to $0.25
Hero: folds
a37ca90d: folds
241244c8: calls $0.15
*** FLOP *** [Kh Ah Qh]
241244c8: checks
96270f96: checks
*** TURN *** [Kh Ah Qh] [6c]
241244c8: bets $0.28
96270f96: folds
Uncalled bet ($0.28) returned to 241244c8
*** SHOWDOWN ***
241244c8 collected $0.53 from pot
*** SUMMARY ***
Total pot $0.55 | Rake $0.02 | Jackpot $0 | Bingo $0 | Fortune $0 | Tax $0
Board [Kh Ah Qh 6c]
Seat 1: Hero (button) folded before Flop (didn't bet)
Seat 2: a37ca90d (small blind) folded before Flop
Seat 3: 241244c8 (big blind) won ($0.53)
Seat 4: 30a0d8df folded before Flop (didn't bet)
Seat 5: 6b429b28 folded before Flop (didn't bet)
Seat 6: 96270f96 folded on the Turn


Poker Hand #RC2774810375: Hold'em No Limit ($0.05/$0.1) - 2024/08/05 13:19:04
Table 'RushAndCash21405635' 6-max Seat #1 is the button
Seat 1: 77dc05e8 ($22.45 in chips)
Seat 2: e45850f1 ($7.33 in chips)
Seat 3: dd51c1d ($12.4 in chips)
Seat 4: Hero ($12.7 in chips)
Seat 5: 83e3542a ($1.98 in chips)
Seat 6: e3d464d3 ($20.25 in chips)
e45850f1: posts small blind $0.05
dd51c1d: posts big blind $0.1
*** HOLE CARDS ***
Dealt to 77dc05e8 
Dealt to e45850f1 
Dealt to dd51c1d 
Dealt to Hero [8h Js]
Dealt to 83e3542a 
Dealt to e3d464d3 
Hero: folds
83e3542a: folds
e3d464d3: raises $0.15 to $0.25
77dc05e8: folds
e45850f1: calls $0.2
dd51c1d: calls $0.15
*** FLOP *** [Qs 6d 5s]
e45850f1: checks
dd51c1d: bets $0.25
e3d464d3: calls $0.25
e45850f1: folds
*** TURN *** [Qs 6d 5s] [Kc]
dd51c1d: checks
e3d464d3: bets $0.94
dd51c1d: calls $0.94
*** RIVER *** [Qs 6d 5s Kc] [Ah]
dd51c1d: checks
e3d464d3: bets $2.35
dd51c1d: folds
Uncalled bet ($2.35) returned to e3d464d3
*** SHOWDOWN ***
e3d464d3 collected $2.84 from pot
*** SUMMARY ***
Total pot $3.13 | Rake $0.14 | Jackpot $0.15 | Bingo $0 | Fortune $0 | Tax $0
Board [Qs 6d 5s Kc Ah]
Seat 1: 77dc05e8 (button) folded before Flop (didn't bet)
Seat 2: e45850f1 (small blind) folded on the Flop
Seat 3: dd51c1d (big blind) folded on the River
Seat 4: Hero folded before Flop (didn't bet)
Seat 5: 83e3542a folded before Flop (didn't bet)
Seat 6: e3d464d3 won ($2.84)


Poker Hand #RC2774810296: Hold'em No Limit ($0.05/$0.1) - 2024/08/05 13:18:53
Table 'RushAndCash21405556' 6-max Seat #1 is the button
Seat 1: 77dc05e8 ($22.55 in chips)
Seat 2: 2da240f5 ($24.3 in chips)
Seat 3: 7160826f ($17.23 in chips)
Seat 4: 25cc1eb4 ($15.4 in chips)
Seat 5: 63c91dca ($11.08 in chips)
Seat 6: Hero ($12.7 in chips)
2da240f5: posts small blind $0.05
7160826f: posts big blind $0.1
*** HOLE CARDS ***
Dealt to 77dc05e8 
Dealt to 2da240f5 
Dealt to 7160826f 
Dealt to 25cc1eb4 
Dealt to 63c91dca 
Dealt to Hero [8h Qs]
25cc1eb4: folds
63c91dca: folds
Hero: folds
77dc05e8: folds
2da240f5: folds
Uncalled bet ($0.05) returned to 7160826f
*** SHOWDOWN ***
7160826f collected $0.1 from pot
*** SUMMARY ***
Total pot $0.1 | Rake $0 | Jackpot $0 | Bingo $0 | Fortune $0 | Tax $0
Seat 1: 77dc05e8 (button) folded before Flop (didn't bet)
Seat 2: 2da240f5 (small blind) folded before Flop
Seat 3: 7160826f (big blind) collected ($0.1)
Seat 4: 25cc1eb4 folded before Flop (didn't bet)
Seat 5: 63c91dca folded before Flop (didn't bet)
Seat 6: Hero folded before Flop (didn't bet)


Poker Hand #RC2774810260: Hold'em No Limit ($0.05/$0.1) - 2024/08/05 13:18:49
Table 'RushAndCash21405520' 6-max Seat #1 is the button
Seat 1: Hero ($12.7 in chips)
Seat 2: 5469f960 ($10 in chips)
Seat 3: 3451d07b ($9.95 in chips)
Seat 4: f19c0b4d ($11.03 in chips)
Seat 5: c9a2f192 ($14.49 in chips)
Seat 6: dd51c1d ($12.4 in chips)
5469f960: posts small blind $0.05
3451d07b: posts big blind $0.1
*** HOLE CARDS ***
Dealt to Hero [8d Th]
Dealt to 5469f960 
Dealt to 3451d07b 
Dealt to f19c0b4d 
Dealt to c9a2f192 
Dealt to dd51c1d 
f19c0b4d: raises $0.2 to $0.3
c9a2f192: folds
dd51c1d: folds
Hero: folds
5469f960: folds
3451d07b: folds
Uncalled bet ($0.2) returned to f19c0b4d
*** SHOWDOWN ***
f19c0b4d collected $0.25 from pot
*** SUMMARY ***
Total pot $0.25 | Rake $0 | Jackpot $0 | Bingo $0 | Fortune $0 | Tax $0
Seat 1: Hero (button) folded before Flop (didn't bet)
Seat 2: 5469f960 (small blind) folded before Flop
Seat 3: 3451d07b (big blind) folded before Flop
Seat 4: f19c0b4d collected ($0.25)
Seat 5: c9a2f192 folded before Flop (didn't bet)
Seat 6: dd51c1d folded before Flop (didn't bet)


Poker Hand #RC2774810228: Hold'em No Limit ($0.05/$0.1) - 2024/08/05 13:18:46
Table 'RushAndCash21405488' 6-max Seat #1 is the button
Seat 1: fa3fec8e ($11.06 in chips)
Seat 2: Hero ($12.75 in chips)
Seat 3: 287983a9 ($11.52 in chips)
Seat 4: 14ce2d5c ($13.46 in chips)
Seat 5: abf72fef ($8.9 in chips)
Seat 6: cca2c2ed ($10 in chips)
Hero: posts small blind $0.05
287983a9: posts big blind $0.1
*** HOLE CARDS ***
Dealt to fa3fec8e 
Dealt to Hero [2c 9h]
Dealt to 287983a9 
Dealt to 14ce2d5c 
Dealt to abf72fef 
Dealt to cca2c2ed 
14ce2d5c: folds
abf72fef: folds
cca2c2ed: raises $0.1 to $0.2
fa3fec8e: folds
Hero: folds
287983a9: folds
Uncalled bet ($0.1) returned to cca2c2ed
*** SHOWDOWN ***
cca2c2ed collected $0.25 from pot
*** SUMMARY ***
Total pot $0.25 | Rake $0 | Jackpot $0 | Bingo $0 | Fortune $0 | Tax $0
Seat 1: fa3fec8e (button) folded before Flop (didn't bet)
Seat 2: Hero (small blind) folded before Flop
Seat 3: 287983a9 (big blind) folded before Flop
Seat 4: 14ce2d5c folded before Flop (didn't bet)
Seat 5: abf72fef folded before Flop (didn't bet)
Seat 6: cca2c2ed collected ($0.25)


Poker Hand #RC2774810201: Hold'em No Limit ($0.05/$0.1) - 2024/08/05 13:18:43
Table 'RushAndCash21405461' 6-max Seat #1 is the button
Seat 1: 6e30e639 ($14.94 in chips)
Seat 2: 128f6aab ($5.8 in chips)
Seat 3: 7f874253 ($12.21 in chips)
Seat 4: 6dbe20b7 ($10 in chips)
Seat 5: 4d21dd90 ($18.73 in chips)
Seat 6: Hero ($12.75 in chips)
128f6aab: posts small blind $0.05
7f874253: posts big blind $0.1
*** HOLE CARDS ***
Dealt to 6e30e639 
Dealt to 128f6aab 
Dealt to 7f874253 
Dealt to 6dbe20b7 
Dealt to 4d21dd90 
Dealt to Hero [8h Jd]
6dbe20b7: raises $0.15 to $0.25
4d21dd90: folds
Hero: folds
6e30e639: folds
128f6aab: folds
7f874253: calls $0.15
*** FLOP *** [6s Ts 8d]
7f874253: checks
6dbe20b7: bets $0.28
7f874253: folds
Uncalled bet ($0.28) returned to 6dbe20b7
*** SHOWDOWN ***
6dbe20b7 collected $0.53 from pot
*** SUMMARY ***
Total pot $0.55 | Rake $0.02 | Jackpot $0 | Bingo $0 | Fortune $0 | Tax $0
Board [6s Ts 8d]
Seat 1: 6e30e639 (button) folded before Flop (didn't bet)
Seat 2: 128f6aab (small blind) folded before Flop
Seat 3: 7f874253 (big blind) folded on the Flop
Seat 4: 6dbe20b7 won ($0.53)
Seat 5: 4d21dd90 folded before Flop (didn't bet)
Seat 6: Hero folded before Flop (didn't bet)


Poker Hand #RC2774810173: Hold'em No Limit ($0.05/$0.1) - 2024/08/05 13:18:39
Table 'RushAndCash21405433' 6-max Seat #1 is the button
Seat 1: 78296eba ($10 in chips)
Seat 2: 94d35445 ($14.81 in chips)
Seat 3: Hero ($12.85 in chips)
Seat 4: 72a60a97 ($27.16 in chips)
Seat 5: ff56ca58 ($10 in chips)
Seat 6: 43eb1c85 ($11.18 in chips)
94d35445: posts small blind $0.05
Hero: posts big blind $0.1
*** HOLE CARDS ***
Dealt to 78296eba 
Dealt to 94d35445 
Dealt to Hero [6s 7h]
Dealt to 72a60a97 
Dealt to ff56ca58 
Dealt to 43eb1c85 
72a60a97: folds
ff56ca58: folds
43eb1c85: folds
78296eba: raises $0.15 to $0.25
94d35445: folds
Hero: folds
Uncalled bet ($0.15) returned to 78296eba
*** SHOWDOWN ***
78296eba collected $0.25 from pot
*** SUMMARY ***
Total pot $0.25 | Rake $0 | Jackpot $0 | Bingo $0 | Fortune $0 | Tax $0
Seat 1: 78296eba (button) collected ($0.25)
Seat 2: 94d35445 (small blind) folded before Flop
Seat 3: Hero (big blind) folded before Flop
Seat 4: 72a60a97 folded before Flop (didn't bet)
Seat 5: ff56ca58 folded before Flop (didn't bet)
Seat 6: 43eb1c85 folded before Flop (didn't bet)


Poker Hand #RC2774810147: Hold'em No Limit ($0.05/$0.1) - 2024/08/05 13:18:36
Table 'RushAndCash21405407' 6-max Seat #1 is the button
Seat 1: c9a2f192 ($14.34 in chips)
Seat 2: 8666fbab ($10 in chips)
Seat 3: ab1097c2 ($10.45 in chips)
Seat 4: 76e3afaf ($10.02 in chips)
Seat 5: Hero ($12.85 in chips)
Seat 6: 43eb1c85 ($11.18 in chips)
8666fbab: posts small blind $0.05
ab1097c2: posts big blind $0.1
*** HOLE CARDS ***
Dealt to c9a2f192 
Dealt to 8666fbab 
Dealt to ab1097c2 
Dealt to 76e3afaf 
Dealt to Hero [Jh 8s]
Dealt to 43eb1c85 
76e3afaf: folds
Hero: folds
43eb1c85: folds
c9a2f192: raises $0.16 to $0.26
8666fbab: folds
ab1097c2: folds
Uncalled bet ($0.16) returned to c9a2f192
*** SHOWDOWN ***
c9a2f192 collected $0.25 from pot
*** SUMMARY ***
Total pot $0.25 | Rake $0 | Jackpot $0 | Bingo $0 | Fortune $0 | Tax $0
Seat 1: c9a2f192 (button) collected ($0.25)
Seat 2: 8666fbab (small blind) folded before Flop
Seat 3: ab1097c2 (big blind) folded before Flop
Seat 4: 76e3afaf folded before Flop (didn't bet)
Seat 5: Hero folded before Flop (didn't bet)
Seat 6: 43eb1c85 folded before Flop (didn't bet)


Poker Hand #RC2774810124: Hold'em No Limit ($0.05/$0.1) - 2024/08/05 13:18:33
Table 'RushAndCash21405384' 6-max Seat #1 is the button
Seat 1: Hero ($12.85 in chips)
Seat 2: f192758 ($10.68 in chips)
Seat 3: be337453 ($13.36 in chips)
Seat 4: 43eb1c85 ($11.18 in chips)
Seat 5: f18d426a ($10.15 in chips)
Seat 6: c4c7add6 ($10 in chips)
f192758: posts small blind $0.05
be337453: posts big blind $0.1
*** HOLE CARDS ***
Dealt to Hero [3c Js]
Dealt to f192758 
Dealt to be337453 
Dealt to 43eb1c85 
Dealt to f18d426a 
Dealt to c4c7add6 
43eb1c85: folds
f18d426a: folds
c4c7add6: folds
Hero: folds
f192758: folds
Uncalled bet ($0.05) returned to be337453
*** SHOWDOWN ***
be337453 collected $0.1 from pot
*** SUMMARY ***
Total pot $0.1 | Rake $0 | Jackpot $0 | Bingo $0 | Fortune $0 | Tax $0
Seat 1: Hero (button) folded before Flop (didn't bet)
Seat 2: f192758 (small blind) folded before Flop
Seat 3: be337453 (big blind) collected ($0.1)
Seat 4: 43eb1c85 folded before Flop (didn't bet)
Seat 5: f18d426a folded before Flop (didn't bet)
Seat 6: c4c7add6 folded before Flop (didn't bet)


Poker Hand #RC2774810049: Hold'em No Limit ($0.05/$0.1) - 2024/08/05 13:18:24
Table 'RushAndCash21405309' 6-max Seat #1 is the button
Seat 1: 738a8979 ($15.6 in chips)
Seat 2: Hero ($12.9 in chips)
Seat 3: 2335ee6 ($4.97 in chips)
Seat 4: 98e2d761 ($21.17 in chips)
Seat 5: 5ce43794 ($21.57 in chips)
Seat 6: 204bd1bb ($10.66 in chips)
Hero: posts small blind $0.05
2335ee6: posts big blind $0.1
*** HOLE CARDS ***
Dealt to 738a8979 
Dealt to Hero [Ts 9h]
Dealt to 2335ee6 
Dealt to 98e2d761 
Dealt to 5ce43794 
Dealt to 204bd1bb 
98e2d761: folds
5ce43794: folds
204bd1bb: folds
738a8979: raises $0.1 to $0.2
Hero: folds
2335ee6: raises $0.45 to $0.65
738a8979: calls $0.45
*** FLOP *** [8c 6s Kc]
2335ee6: checks
738a8979: checks
*** TURN *** [8c 6s Kc] [4s]
2335ee6: bets $0.68
738a8979: calls $0.68
*** RIVER *** [8c 6s Kc 4s] [7h]
2335ee6: bets $3.64 and is all-in
738a8979: folds
Uncalled bet ($3.64) returned to 2335ee6
*** SHOWDOWN ***
2335ee6 collected $2.58 from pot
*** SUMMARY ***
Total pot $2.71 | Rake $0.13 | Jackpot $0 | Bingo $0 | Fortune $0 | Tax $0
Board [8c 6s Kc 4s 7h]
Seat 1: 738a8979 (button) folded on the River
Seat 2: Hero (small blind) folded before Flop
Seat 3: 2335ee6 (big blind) won ($2.58)
Seat 4: 98e2d761 folded before Flop (didn't bet)
Seat 5: 5ce43794 folded before Flop (didn't bet)
Seat 6: 204bd1bb folded before Flop (didn't bet)


Poker Hand #RC2774809710: Hold'em No Limit ($0.05/$0.1) - 2024/08/05 13:17:41
Table 'RushAndCash21404970' 6-max Seat #1 is the button
Seat 1: Hero ($13.14 in chips)
Seat 2: ccbada3e ($11.7 in chips)
Seat 3: a5c2c2c9 ($6 in chips)
Seat 4: c3f97c7e ($8.3 in chips)
Seat 5: 64703012 ($20.74 in chips)
Seat 6: 16cacf93 ($14.9 in chips)
ccbada3e: posts small blind $0.05
a5c2c2c9: posts big blind $0.1
*** HOLE CARDS ***
Dealt to Hero [Ac Ts]
Dealt to ccbada3e 
Dealt to a5c2c2c9 
Dealt to c3f97c7e 
Dealt to 64703012 
Dealt to 16cacf93 
c3f97c7e: folds
64703012: folds
16cacf93: folds
Hero: raises $0.14 to $0.24
ccbada3e: folds
a5c2c2c9: calls $0.14
*** FLOP *** [6d 9c Kh]
a5c2c2c9: checks
Hero: checks
*** TURN *** [6d 9c Kh] [8c]
a5c2c2c9: checks
Hero: checks
*** RIVER *** [6d 9c Kh 8c] [3h]
a5c2c2c9: checks
Hero: checks
a5c2c2c9: shows [6s Qs] (Pair of Sixes)
Hero: shows [Ac Ts] (Ace-High)
*** SHOWDOWN ***
a5c2c2c9 collected $0.51 from pot
*** SUMMARY ***
Total pot $0.53 | Rake $0.02 | Jackpot $0 | Bingo $0 | Fortune $0 | Tax $0
Board [6d 9c Kh 8c 3h]
Seat 1: Hero (button) showed [Ac Ts] and lost with Ace-High
Seat 2: ccbada3e (small blind) folded before Flop
Seat 3: a5c2c2c9 (big blind) showed [6s Qs] and won ($0.51) with Pair of Sixes
Seat 4: c3f97c7e folded before Flop (didn't bet)
Seat 5: 64703012 folded before Flop (didn't bet)
Seat 6: 16cacf93 folded before Flop (didn't bet)


Poker Hand #RC2774809685: Hold'em No Limit ($0.05/$0.1) - 2024/08/05 13:17:38
Table 'RushAndCash21404945' 6-max Seat #1 is the button
Seat 1: 76b2da90 ($14 in chips)
Seat 2: bedbd59c ($15.11 in chips)
Seat 3: Hero ($13.24 in chips)
Seat 4: 2b6fca08 ($10 in chips)
Seat 5: b57e7a49 ($10.46 in chips)
Seat 6: db7332b9 ($10.41 in chips)
bedbd59c: posts small blind $0.05
Hero: posts big blind $0.1
*** HOLE CARDS ***
Dealt to 76b2da90 
Dealt to bedbd59c 
Dealt to Hero [3h 9d]
Dealt to 2b6fca08 
Dealt to b57e7a49 
Dealt to db7332b9 
2b6fca08: folds
b57e7a49: raises $0.3 to $0.4
db7332b9: folds
76b2da90: calls $0.4
bedbd59c: folds
Hero: folds
*** FLOP *** [Qh 3d 7h]
b57e7a49: bets $0.48
76b2da90: calls $0.48
*** TURN *** [Qh 3d 7h] [Qd]
b57e7a49: checks
76b2da90: bets $1.06
b57e7a49: folds
Uncalled bet ($1.06) returned to 76b2da90
*** SHOWDOWN ***
76b2da90 collected $1.82 from pot
*** SUMMARY ***
Total pot $1.91 | Rake $0.09 | Jackpot $0 | Bingo $0 | Fortune $0 | Tax $0
Board [Qh 3d 7h Qd]
Seat 1: 76b2da90 (button) won ($1.82)
Seat 2: bedbd59c (small blind) folded before Flop
Seat 3: Hero (big blind) folded before Flop
Seat 4: 2b6fca08 folded before Flop (didn't bet)
Seat 5: b57e7a49 folded on the Turn
Seat 6: db7332b9 folded before Flop (didn't bet)


Poker Hand #RC2774809610: Hold'em No Limit ($0.05/$0.1) - 2024/08/05 13:17:30
Table 'RushAndCash21404870' 6-max Seat #1 is the button
Seat 1: a289ba4e ($13.73 in chips)
Seat 2: c4c7add6 ($10.4 in chips)
Seat 3: d434bc61 ($10.61 in chips)
Seat 4: 25cc1eb4 ($15 in chips)
Seat 5: 95e28b9 ($14.49 in chips)
Seat 6: Hero ($13.24 in chips)
c4c7add6: posts small blind $0.05
d434bc61: posts big blind $0.1
*** HOLE CARDS ***
Dealt to a289ba4e 
Dealt to c4c7add6 
Dealt to d434bc61 
Dealt to 25cc1eb4 
Dealt to 95e28b9 
Dealt to Hero [5s 2h]
25cc1eb4: folds
95e28b9: folds
Hero: folds
a289ba4e: folds
c4c7add6: folds
Uncalled bet ($0.05) returned to d434bc61
*** SHOWDOWN ***
d434bc61 collected $0.1 from pot
*** SUMMARY ***
Total pot $0.1 | Rake $0 | Jackpot $0 | Bingo $0 | Fortune $0 | Tax $0
Seat 1: a289ba4e (button) folded before Flop (didn't bet)
Seat 2: c4c7add6 (small blind) folded before Flop
Seat 3: d434bc61 (big blind) collected ($0.1)
Seat 4: 25cc1eb4 folded before Flop (didn't bet)
Seat 5: 95e28b9 folded before Flop (didn't bet)
Seat 6: Hero folded before Flop (didn't bet)


Poker Hand #RC2774809550: Hold'em No Limit ($0.05/$0.1) - 2024/08/05 13:17:22
Table 'RushAndCash21404810' 6-max Seat #1 is the button
Seat 1: f3b4cb31 ($10.27 in chips)
Seat 2: Hero ($13.29 in chips)
Seat 3: bc31de8a ($18.89 in chips)
Seat 4: 992fa4b4 ($10.15 in chips)
Seat 5: 364902ff ($27.38 in chips)
Seat 6: e21f5f10 ($13.24 in chips)
Hero: posts small blind $0.05
bc31de8a: posts big blind $0.1
*** HOLE CARDS ***
Dealt to f3b4cb31 
Dealt to Hero [Tc 9s]
Dealt to bc31de8a 
Dealt to 992fa4b4 
Dealt to 364902ff 
Dealt to e21f5f10 
992fa4b4: raises $0.1 to $0.2
364902ff: folds
e21f5f10: folds
f3b4cb31: folds
Hero: folds
bc31de8a: folds
Uncalled bet ($0.1) returned to 992fa4b4
*** SHOWDOWN ***
992fa4b4 collected $0.25 from pot
*** SUMMARY ***
Total pot $0.25 | Rake $0 | Jackpot $0 | Bingo $0 | Fortune $0 | Tax $0
Seat 1: f3b4cb31 (button) folded before Flop (didn't bet)
Seat 2: Hero (small blind) folded before Flop
Seat 3: bc31de8a (big blind) folded before Flop
Seat 4: 992fa4b4 collected ($0.25)
Seat 5: 364902ff folded before Flop (didn't bet)
Seat 6: e21f5f10 folded before Flop (didn't bet)


Poker Hand #RC2774808933: Hold'em No Limit ($0.05/$0.1) - 2024/08/05 13:16:04
Table 'RushAndCash21404193' 6-max Seat #1 is the button
Seat 1: bc31de8a ($15.91 in chips)
Seat 2: b57e7a49 ($10 in chips)
Seat 3: 136b30cf ($20.77 in chips)
Seat 4: c9566016 ($10 in chips)
Seat 5: Hero ($16.57 in chips)
Seat 6: c9a2f192 ($14.45 in chips)
b57e7a49: posts small blind $0.05
136b30cf: posts big blind $0.1
*** HOLE CARDS ***
Dealt to bc31de8a 
Dealt to b57e7a49 
Dealt to 136b30cf 
Dealt to c9566016 
Dealt to Hero [Kd Qd]
Dealt to c9a2f192 
c9566016: folds
Hero: raises $0.1 to $0.2
c9a2f192: folds
bc31de8a: raises $0.7 to $0.9
b57e7a49: folds
136b30cf: folds
Hero: calls $0.7
*** FLOP *** [3h Jd 6s]
Hero: checks
bc31de8a: checks
*** TURN *** [3h Jd 6s] [Jh]
Hero: bets $0.8
bc31de8a: calls $0.8
*** RIVER *** [3h Jd 6s Jh] [Qs]
Hero: bets $1.58
bc31de8a: calls $1.58
Hero: shows [Kd Qd] (Pair of Queens and Pair of Jacks)
bc31de8a: shows [Qh As] (Pair of Queens and Pair of Jacks)
*** SHOWDOWN ***
bc31de8a collected $6.26 from pot
*** SUMMARY ***
Total pot $6.71 | Rake $0.3 | Jackpot $0.15 | Bingo $0 | Fortune $0 | Tax $0
Board [3h Jd 6s Jh Qs]
Seat 1: bc31de8a (button) showed [Qh As] and won ($6.26) with Pair of Queens and Pair of Jacks
Seat 2: b57e7a49 (small blind) folded before Flop
Seat 3: 136b30cf (big blind) folded before Flop
Seat 4: c9566016 folded before Flop (didn't bet)
Seat 5: Hero showed [Kd Qd] and lost with Pair of Queens and Pair of Jacks
Seat 6: c9a2f192 folded before Flop (didn't bet)


Poker Hand #RC2774808838: Hold'em No Limit ($0.05/$0.1) - 2024/08/05 13:15:51
Table 'RushAndCash21404098' 6-max Seat #1 is the button
Seat 1: b8212615 ($10.73 in chips)
Seat 2: cbd807c5 ($19.84 in chips)
Seat 3: Hero ($16.67 in chips)
Seat 4: 6ded3506 ($10 in chips)
Seat 5: e869d3d5 ($11.34 in chips)
Seat 6: 391694f4 ($10 in chips)
cbd807c5: posts small blind $0.05
Hero: posts big blind $0.1
*** HOLE CARDS ***
Dealt to b8212615 
Dealt to cbd807c5 
Dealt to Hero [7c 5s]
Dealt to 6ded3506 
Dealt to e869d3d5 
Dealt to 391694f4 
6ded3506: folds
e869d3d5: folds
391694f4: raises $0.15 to $0.25
b8212615: folds
cbd807c5: folds
Hero: folds
Uncalled bet ($0.15) returned to 391694f4
*** SHOWDOWN ***
391694f4 collected $0.25 from pot
*** SUMMARY ***
Total pot $0.25 | Rake $0 | Jackpot $0 | Bingo $0 | Fortune $0 | Tax $0
Seat 1: b8212615 (button) folded before Flop (didn't bet)
Seat 2: cbd807c5 (small blind) folded before Flop
Seat 3: Hero (big blind) folded before Flop
Seat 4: 6ded3506 folded before Flop (didn't bet)
Seat 5: e869d3d5 folded before Flop (didn't bet)
Seat 6: 391694f4 collected ($0.25)


Poker Hand #RC2774808816: Hold'em No Limit ($0.05/$0.1) - 2024/08/05 13:15:48
Table 'RushAndCash21404076' 6-max Seat #1 is the button
Seat 1: 92ce1fe1 ($8.17 in chips)
Seat 2: 6e69e168 ($10.94 in chips)
Seat 3: dd32754e ($10.59 in chips)
Seat 4: 96d7955 ($23.78 in chips)
Seat 5: Hero ($16.67 in chips)
Seat 6: e5e26648 ($44.27 in chips)
6e69e168: posts small blind $0.05
dd32754e: posts big blind $0.1
*** HOLE CARDS ***
Dealt to 92ce1fe1 
Dealt to 6e69e168 
Dealt to dd32754e 
Dealt to 96d7955 
Dealt to Hero [Qh 6d]
Dealt to e5e26648 
96d7955: folds
Hero: folds
e5e26648: raises $0.1 to $0.2
92ce1fe1: folds
6e69e168: folds
dd32754e: folds
Uncalled bet ($0.1) returned to e5e26648
*** SHOWDOWN ***
e5e26648 collected $0.25 from pot
*** SUMMARY ***
Total pot $0.25 | Rake $0 | Jackpot $0 | Bingo $0 | Fortune $0 | Tax $0
Seat 1: 92ce1fe1 (button) folded before Flop (didn't bet)
Seat 2: 6e69e168 (small blind) folded before Flop
Seat 3: dd32754e (big blind) folded before Flop
Seat 4: 96d7955 folded before Flop (didn't bet)
Seat 5: Hero folded before Flop (didn't bet)
Seat 6: e5e26648 collected ($0.25)


Poker Hand #RC2774808780: Hold'em No Limit ($0.05/$0.1) - 2024/08/05 13:15:43
Table 'RushAndCash21404040' 6-max Seat #1 is the button
Seat 1: cbd807c5 ($19.84 in chips)
Seat 2: e0e25537 ($10 in chips)
Seat 3: 357d5395 ($16.35 in chips)
Seat 4: a219470f ($10.05 in chips)
Seat 5: Hero ($16.67 in chips)
Seat 6: 25a4b4f ($22.78 in chips)
e0e25537: posts small blind $0.05
357d5395: posts big blind $0.1
*** HOLE CARDS ***
Dealt to cbd807c5 
Dealt to e0e25537 
Dealt to 357d5395 
Dealt to a219470f 
Dealt to Hero [4c Ts]
Dealt to 25a4b4f 
a219470f: folds
Hero: folds
25a4b4f: folds
cbd807c5: folds
e0e25537: raises $0.2 to $0.3
357d5395: calls $0.2
*** FLOP *** [Qh 9h 6c]
e0e25537: bets $0.3
357d5395: folds
Uncalled bet ($0.3) returned to e0e25537
*** SHOWDOWN ***
e0e25537 collected $0.57 from pot
*** SUMMARY ***
Total pot $0.6 | Rake $0.03 | Jackpot $0 | Bingo $0 | Fortune $0 | Tax $0
Board [Qh 9h 6c]
Seat 1: cbd807c5 (button) folded before Flop (didn't bet)
Seat 2: e0e25537 (small blind) won ($0.57)
Seat 3: 357d5395 (big blind) folded on the Flop
Seat 4: a219470f folded before Flop (didn't bet)
Seat 5: Hero folded before Flop (didn't bet)
Seat 6: 25a4b4f folded before Flop (didn't bet)


Poker Hand #RC2774808757: Hold'em No Limit ($0.05/$0.1) - 2024/08/05 13:15:40
Table 'RushAndCash21404017' 6-max Seat #1 is the button
Seat 1: ef8e92d0 ($22.75 in chips)
Seat 2: 95e28b9 ($14.73 in chips)
Seat 3: a6ec6733 ($17.39 in chips)
Seat 4: 365532b4 ($12 in chips)
Seat 5: dc17a754 ($10.93 in chips)
Seat 6: Hero ($16.67 in chips)
95e28b9: posts small blind $0.05
a6ec6733: posts big blind $0.1
*** HOLE CARDS ***
Dealt to ef8e92d0 
Dealt to 95e28b9 
Dealt to a6ec6733 
Dealt to 365532b4 
Dealt to dc17a754 
Dealt to Hero [As 6d]
365532b4: folds
dc17a754: folds
Hero: folds
ef8e92d0: folds
95e28b9: raises $0.14 to $0.24
a6ec6733: folds
Uncalled bet ($0.14) returned to 95e28b9
*** SHOWDOWN ***
95e28b9 collected $0.2 from pot
*** SUMMARY ***
Total pot $0.2 | Rake $0 | Jackpot $0 | Bingo $0 | Fortune $0 | Tax $0
Seat 1: ef8e92d0 (button) folded before Flop (didn't bet)
Seat 2: 95e28b9 (small blind) collected ($0.2)
Seat 3: a6ec6733 (big blind) folded before Flop
Seat 4: 365532b4 folded before Flop (didn't bet)
Seat 5: dc17a754 folded before Flop (didn't bet)
Seat 6: Hero folded before Flop (didn't bet)


Poker Hand #RC2774808461: Hold'em No Limit ($0.05/$0.1) - 2024/08/05 13:15:05
Table 'RushAndCash21403721' 6-max Seat #1 is the button
Seat 1: a0ab68d2 ($18.75 in chips)
Seat 2: Hero ($16.35 in chips)
Seat 3: d4638148 ($7.06 in chips)
Seat 4: 220b27f4 ($10.27 in chips)
Seat 5: 7cc07ecd ($9.23 in chips)
Seat 6: 95e28b9 ($14.97 in chips)
Hero: posts small blind $0.05
d4638148: posts big blind $0.1
*** HOLE CARDS ***
Dealt to a0ab68d2 
Dealt to Hero [Qd Jd]
Dealt to d4638148 
Dealt to 220b27f4 
Dealt to 7cc07ecd 
Dealt to 95e28b9 
220b27f4: folds
7cc07ecd: folds
95e28b9: raises $0.14 to $0.24
a0ab68d2: folds
Hero: raises $0.86 to $1.1
d4638148: folds
95e28b9: folds
Uncalled bet ($0.86) returned to Hero
*** SHOWDOWN ***
Hero collected $0.56 from pot
*** SUMMARY ***
Total pot $0.58 | Rake $0.02 | Jackpot $0 | Bingo $0 | Fortune $0 | Tax $0
Seat 1: a0ab68d2 (button) folded before Flop (didn't bet)
Seat 2: Hero (small blind) collected ($0.56)
Seat 3: d4638148 (big blind) folded before Flop
Seat 4: 220b27f4 folded before Flop (didn't bet)
Seat 5: 7cc07ecd folded before Flop (didn't bet)
Seat 6: 95e28b9 folded before Flop


Poker Hand #RC2774808410: Hold'em No Limit ($0.05/$0.1) - 2024/08/05 13:14:59
Table 'RushAndCash21403670' 6-max Seat #1 is the button
Seat 1: Hero ($16.35 in chips)
Seat 2: efeafe15 ($11.91 in chips)
Seat 3: f172e294 ($11.05 in chips)
Seat 4: a0ab68d2 ($18.75 in chips)
Seat 5: 5580da68 ($10.05 in chips)
Seat 6: d12dc75 ($22.02 in chips)
efeafe15: posts small blind $0.05
f172e294: posts big blind $0.1
*** HOLE CARDS ***
Dealt to Hero [4h Ac]
Dealt to efeafe15 
Dealt to f172e294 
Dealt to a0ab68d2 
Dealt to 5580da68 
Dealt to d12dc75 
a0ab68d2: folds
5580da68: folds
d12dc75: raises $0.1 to $0.2
Hero: folds
efeafe15: folds
f172e294: folds
Uncalled bet ($0.1) returned to d12dc75
*** SHOWDOWN ***
d12dc75 collected $0.25 from pot
*** SUMMARY ***
Total pot $0.25 | Rake $0 | Jackpot $0 | Bingo $0 | Fortune $0 | Tax $0
Seat 1: Hero (button) folded before Flop (didn't bet)
Seat 2: efeafe15 (small blind) folded before Flop
Seat 3: f172e294 (big blind) folded before Flop
Seat 4: a0ab68d2 folded before Flop (didn't bet)
Seat 5: 5580da68 folded before Flop (didn't bet)
Seat 6: d12dc75 collected ($0.25)


Poker Hand #RC2774808385: Hold'em No Limit ($0.05/$0.1) - 2024/08/05 13:14:55
Table 'RushAndCash21403645' 6-max Seat #1 is the button
Seat 1: 8b8c29f1 ($34.66 in chips)
Seat 2: 63c91dca ($10.41 in chips)
Seat 3: 2c8ec31b ($25.6 in chips)
Seat 4: Hero ($16.35 in chips)
Seat 5: d68e075 ($18.38 in chips)
Seat 6: dd8f8926 ($10.61 in chips)
63c91dca: posts small blind $0.05
2c8ec31b: posts big blind $0.1
*** HOLE CARDS ***
Dealt to 8b8c29f1 
Dealt to 63c91dca 
Dealt to 2c8ec31b 
Dealt to Hero [Qc 6s]
Dealt to d68e075 
Dealt to dd8f8926 
Hero: folds
d68e075: folds
dd8f8926: folds
8b8c29f1: raises $0.1 to $0.2
63c91dca: folds
2c8ec31b: calls $0.1
*** FLOP *** [4d 3s Td]
2c8ec31b: checks
8b8c29f1: checks
*** TURN *** [4d 3s Td] [5h]
2c8ec31b: bets $0.23
8b8c29f1: folds
Uncalled bet ($0.23) returned to 2c8ec31b
*** SHOWDOWN ***
2c8ec31b collected $0.43 from pot
*** SUMMARY ***
Total pot $0.45 | Rake $0.02 | Jackpot $0 | Bingo $0 | Fortune $0 | Tax $0
Board [4d 3s Td 5h]
Seat 1: 8b8c29f1 (button) folded on the Turn
Seat 2: 63c91dca (small blind) folded before Flop
Seat 3: 2c8ec31b (big blind) won ($0.43)
Seat 4: Hero folded before Flop (didn't bet)
Seat 5: d68e075 folded before Flop (didn't bet)
Seat 6: dd8f8926 folded before Flop (didn't bet)


Poker Hand #RC2774808354: Hold'em No Limit ($0.05/$0.1) - 2024/08/05 13:14:51
Table 'RushAndCash21403614' 6-max Seat #1 is the button
Seat 1: a289ba4e ($12.43 in chips)
Seat 2: 364902ff ($27.13 in chips)
Seat 3: Hero ($16.45 in chips)
Seat 4: f758d044 ($10 in chips)
Seat 5: 9fd31f2b ($10.3 in chips)
Seat 6: f172e294 ($11.05 in chips)
364902ff: posts small blind $0.05
Hero: posts big blind $0.1
*** HOLE CARDS ***
Dealt to a289ba4e 
Dealt to 364902ff 
Dealt to Hero [Kc 9d]
Dealt to f758d044 
Dealt to 9fd31f2b 
Dealt to f172e294 
f758d044: folds
9fd31f2b: folds
f172e294: folds
a289ba4e: folds
364902ff: raises $0.22 to $0.32
Hero: folds
Uncalled bet ($0.22) returned to 364902ff
*** SHOWDOWN ***
364902ff collected $0.2 from pot
*** SUMMARY ***
Total pot $0.2 | Rake $0 | Jackpot $0 | Bingo $0 | Fortune $0 | Tax $0
Seat 1: a289ba4e (button) folded before Flop (didn't bet)
Seat 2: 364902ff (small blind) collected ($0.2)
Seat 3: Hero (big blind) folded before Flop
Seat 4: f758d044 folded before Flop (didn't bet)
Seat 5: 9fd31f2b folded before Flop (didn't bet)
Seat 6: f172e294 folded before Flop (didn't bet)


Poker Hand #RC2774808157: Hold'em No Limit ($0.05/$0.1) - 2024/08/05 13:14:27
Table 'RushAndCash21403417' 6-max Seat #1 is the button
Seat 1: Hero ($16.18 in chips)
Seat 2: ac724a39 ($6.21 in chips)
Seat 3: 4ef61c4f ($10.1 in chips)
Seat 4: 35351de3 ($19.59 in chips)
Seat 5: ef76fdc ($20.09 in chips)
Seat 6: 3b0c26fe ($22.08 in chips)
ac724a39: posts small blind $0.05
4ef61c4f: posts big blind $0.1
*** HOLE CARDS ***
Dealt to Hero [Jd Ks]
Dealt to ac724a39 
Dealt to 4ef61c4f 
Dealt to 35351de3 
Dealt to ef76fdc 
Dealt to 3b0c26fe 
35351de3: folds
ef76fdc: folds
3b0c26fe: folds
Hero: raises $0.14 to $0.24
ac724a39: folds
4ef61c4f: calls $0.14
*** FLOP *** [Qd 6h As]
4ef61c4f: checks
Hero: bets $0.35
4ef61c4f: folds
Uncalled bet ($0.35) returned to Hero
*** SHOWDOWN ***
Hero collected $0.51 from pot
*** SUMMARY ***
Total pot $0.53 | Rake $0.02 | Jackpot $0 | Bingo $0 | Fortune $0 | Tax $0
Board [Qd 6h As]
Seat 1: Hero (button) won ($0.51)
Seat 2: ac724a39 (small blind) folded before Flop
Seat 3: 4ef61c4f (big blind) folded on the Flop
Seat 4: 35351de3 folded before Flop (didn't bet)
Seat 5: ef76fdc folded before Flop (didn't bet)
Seat 6: 3b0c26fe folded before Flop (didn't bet)


Poker Hand #RC2774808130: Hold'em No Limit ($0.05/$0.1) - 2024/08/05 13:14:23
Table 'RushAndCash21403390' 6-max Seat #1 is the button
Seat 1: 39a23968 ($14.48 in chips)
Seat 2: 356b0e4 ($17.69 in chips)
Seat 3: 5dcefc6c ($23.67 in chips)
Seat 4: 8f7c02cf ($13.78 in chips)
Seat 5: Hero ($16.18 in chips)
Seat 6: 2672cac2 ($10 in chips)
356b0e4: posts small blind $0.05
5dcefc6c: posts big blind $0.1
*** HOLE CARDS ***
Dealt to 39a23968 
Dealt to 356b0e4 
Dealt to 5dcefc6c 
Dealt to 8f7c02cf 
Dealt to Hero [6c 4c]
Dealt to 2672cac2 
8f7c02cf: folds
Hero: folds
2672cac2: raises $0.14 to $0.24
39a23968: folds
356b0e4: calls $0.19
5dcefc6c: folds
*** FLOP *** [Kc 3c 9s]
356b0e4: checks
2672cac2: bets $0.45
356b0e4: calls $0.45
*** TURN *** [Kc 3c 9s] [8s]
356b0e4: checks
2672cac2: bets $1.15
356b0e4: calls $1.15
*** RIVER *** [Kc 3c 9s 8s] [Js]
356b0e4: checks
2672cac2: checks
356b0e4: shows [Qc Jc] (Pair of Jacks)
2672cac2: shows [9c 7c] (Pair of Nines)
*** SHOWDOWN ***
356b0e4 collected $3.45 from pot
*** SUMMARY ***
Total pot $3.78 | Rake $0.18 | Jackpot $0.15 | Bingo $0 | Fortune $0 | Tax $0
Board [Kc 3c 9s 8s Js]
Seat 1: 39a23968 (button) folded before Flop (didn't bet)
Seat 2: 356b0e4 (small blind) showed [Qc Jc] and won ($3.45) with Pair of Jacks
Seat 3: 5dcefc6c (big blind) folded before Flop
Seat 4: 8f7c02cf folded before Flop (didn't bet)
Seat 5: Hero folded before Flop (didn't bet)
Seat 6: 2672cac2 showed [9c 7c] and lost with Pair of Nines


Poker Hand #RC2774808082: Hold'em No Limit ($0.05/$0.1) - 2024/08/05 13:14:17
Table 'RushAndCash21403342' 6-max Seat #1 is the button
Seat 1: 750f4df2 ($10.06 in chips)
Seat 2: dae24d3f ($10 in chips)
Seat 3: ea9291e4 ($10 in chips)
Seat 4: 92ce1fe1 ($9.4 in chips)
Seat 5: 9ee89df4 ($11.36 in chips)
Seat 6: Hero ($16.18 in chips)
dae24d3f: posts small blind $0.05
ea9291e4: posts big blind $0.1
*** HOLE CARDS ***
Dealt to 750f4df2 
Dealt to dae24d3f 
Dealt to ea9291e4 
Dealt to 92ce1fe1 
Dealt to 9ee89df4 
Dealt to Hero [6h 6c]
92ce1fe1: raises $0.1 to $0.2
9ee89df4: folds
Hero: folds
750f4df2: raises $0.42 to $0.62
dae24d3f: folds
ea9291e4: folds
92ce1fe1: calls $0.42
*** FLOP *** [Kh 2s 9c]
92ce1fe1: checks
750f4df2: bets $0.46
92ce1fe1: calls $0.46
*** TURN *** [Kh 2s 9c] [Ac]
92ce1fe1: checks
750f4df2: bets $1.16
92ce1fe1: folds
Uncalled bet ($1.16) returned to 750f4df2
*** SHOWDOWN ***
750f4df2 collected $2.2 from pot
*** SUMMARY ***
Total pot $2.31 | Rake $0.11 | Jackpot $0 | Bingo $0 | Fortune $0 | Tax $0
Board [Kh 2s 9c Ac]
Seat 1: 750f4df2 (button) won ($2.2)
Seat 2: dae24d3f (small blind) folded before Flop
Seat 3: ea9291e4 (big blind) folded before Flop
Seat 4: 92ce1fe1 folded on the Turn
Seat 5: 9ee89df4 folded before Flop (didn't bet)
Seat 6: Hero folded before Flop (didn't bet)


Poker Hand #RC2774808036: Hold'em No Limit ($0.05/$0.1) - 2024/08/05 13:14:11
Table 'RushAndCash21403296' 6-max Seat #1 is the button
Seat 1: Hero ($16.18 in chips)
Seat 2: e4b6b928 ($17.86 in chips)
Seat 3: 6e6756d9 ($10 in chips)
Seat 4: 26f11e2a ($9.48 in chips)
Seat 5: bae62c2a ($12.42 in chips)
Seat 6: f2099604 ($8.31 in chips)
e4b6b928: posts small blind $0.05
6e6756d9: posts big blind $0.1
*** HOLE CARDS ***
Dealt to Hero [5s 6d]
Dealt to e4b6b928 
Dealt to 6e6756d9 
Dealt to 26f11e2a 
Dealt to bae62c2a 
Dealt to f2099604 
26f11e2a: folds
bae62c2a: folds
f2099604: folds
Hero: folds
e4b6b928: calls $0.05
6e6756d9: checks
*** FLOP *** [8d Kc 3h]
e4b6b928: checks
6e6756d9: checks
*** TURN *** [8d Kc 3h] [6c]
e4b6b928: bets $0.15
6e6756d9: calls $0.15
*** RIVER *** [8d Kc 3h 6c] [6s]
e4b6b928: bets $0.3
6e6756d9: folds
Uncalled bet ($0.3) returned to e4b6b928
*** SHOWDOWN ***
e4b6b928 collected $0.48 from pot
*** SUMMARY ***
Total pot $0.5 | Rake $0.02 | Jackpot $0 | Bingo $0 | Fortune $0 | Tax $0
Board [8d Kc 3h 6c 6s]
Seat 1: Hero (button) folded before Flop (didn't bet)
Seat 2: e4b6b928 (small blind) won ($0.48)
Seat 3: 6e6756d9 (big blind) folded on the River
Seat 4: 26f11e2a folded before Flop (didn't bet)
Seat 5: bae62c2a folded before Flop (didn't bet)
Seat 6: f2099604 folded before Flop (didn't bet)


Poker Hand #RC2774808004: Hold'em No Limit ($0.05/$0.1) - 2024/08/05 13:14:07
Table 'RushAndCash21403264' 6-max Seat #1 is the button
Seat 1: 35740261 ($10.03 in chips)
Seat 2: 5aa33875 ($11.44 in chips)
Seat 3: 68955af7 ($17.1 in chips)
Seat 4: 1ab91021 ($11.8 in chips)
Seat 5: 73c8d5ef ($36.29 in chips)
Seat 6: Hero ($16.18 in chips)
5aa33875: posts small blind $0.05
68955af7: posts big blind $0.1
*** HOLE CARDS ***
Dealt to 35740261 
Dealt to 5aa33875 
Dealt to 68955af7 
Dealt to 1ab91021 
Dealt to 73c8d5ef 
Dealt to Hero [3s 7c]
1ab91021: folds
73c8d5ef: folds
Hero: folds
35740261: folds
5aa33875: raises $0.13 to $0.23
68955af7: folds
Uncalled bet ($0.13) returned to 5aa33875
*** SHOWDOWN ***
5aa33875 collected $0.2 from pot
*** SUMMARY ***
Total pot $0.2 | Rake $0 | Jackpot $0 | Bingo $0 | Fortune $0 | Tax $0
Seat 1: 35740261 (button) folded before Flop (didn't bet)
Seat 2: 5aa33875 (small blind) collected ($0.2)
Seat 3: 68955af7 (big blind) folded before Flop
Seat 4: 1ab91021 folded before Flop (didn't bet)
Seat 5: 73c8d5ef folded before Flop (didn't bet)
Seat 6: Hero folded before Flop (didn't bet)


Poker Hand #RC2774807580: Hold'em No Limit ($0.05/$0.1) - 2024/08/05 13:13:13
Table 'RushAndCash21402840' 6-max Seat #1 is the button
Seat 1: 8dc77ce6 ($11.21 in chips)
Seat 2: Hero ($18.8 in chips)
Seat 3: c4584975 ($10.94 in chips)
Seat 4: 73c8d5ef ($33.98 in chips)
Seat 5: d68e075 ($19.26 in chips)
Seat 6: 3681db75 ($11.48 in chips)
Hero: posts small blind $0.05
c4584975: posts big blind $0.1
*** HOLE CARDS ***
Dealt to 8dc77ce6 
Dealt to Hero [As Kd]
Dealt to c4584975 
Dealt to 73c8d5ef 
Dealt to d68e075 
Dealt to 3681db75 
73c8d5ef: raises $0.1 to $0.2
d68e075: folds
3681db75: folds
8dc77ce6: folds
Hero: raises $0.8 to $1
c4584975: folds
73c8d5ef: raises $1.62 to $2.62
Hero: calls $1.62
*** FLOP *** [9c 4s 7c]
Hero: checks
73c8d5ef: bets $2.94
Hero: folds
Uncalled bet ($2.94) returned to 73c8d5ef
*** SHOWDOWN ***
73c8d5ef collected $4.93 from pot
*** SUMMARY ***
Total pot $5.34 | Rake $0.26 | Jackpot $0.15 | Bingo $0 | Fortune $0 | Tax $0
Board [9c 4s 7c]
Seat 1: 8dc77ce6 (button) folded before Flop (didn't bet)
Seat 2: Hero (small blind) folded on the Flop
Seat 3: c4584975 (big blind) folded before Flop
Seat 4: 73c8d5ef won ($4.93)
Seat 5: d68e075 folded before Flop (didn't bet)
Seat 6: 3681db75 folded before Flop (didn't bet)


Poker Hand #RC2774807554: Hold'em No Limit ($0.05/$0.1) - 2024/08/05 13:13:09
Table 'RushAndCash21402814' 6-max Seat #1 is the button
Seat 1: 3451d07b ($9.07 in chips)
Seat 2: eed55452 ($10 in chips)
Seat 3: 96655300 ($10.79 in chips)
Seat 4: Hero ($18.8 in chips)
Seat 5: bc31de8a ($14.42 in chips)
Seat 6: bd1d5d64 ($13.87 in chips)
eed55452: posts small blind $0.05
96655300: posts big blind $0.1
*** HOLE CARDS ***
Dealt to 3451d07b 
Dealt to eed55452 
Dealt to 96655300 
Dealt to Hero [3c 8s]
Dealt to bc31de8a 
Dealt to bd1d5d64 
Hero: folds
bc31de8a: folds
bd1d5d64: folds
3451d07b: raises $0.2 to $0.3
eed55452: folds
96655300: calls $0.2
*** FLOP *** [Td 5s Kc]
96655300: checks
3451d07b: checks
*** TURN *** [Td 5s Kc] [Qc]
96655300: bets $0.33
3451d07b: calls $0.33
*** RIVER *** [Td 5s Kc Qc] [4h]
96655300: checks
3451d07b: checks
96655300: shows [4d Ah] (Pair of Fours)
3451d07b: shows [Qs 9s] (Pair of Queens)
*** SHOWDOWN ***
3451d07b collected $1.25 from pot
*** SUMMARY ***
Total pot $1.31 | Rake $0.06 | Jackpot $0 | Bingo $0 | Fortune $0 | Tax $0
Board [Td 5s Kc Qc 4h]
Seat 1: 3451d07b (button) showed [Qs 9s] and won ($1.25) with Pair of Queens
Seat 2: eed55452 (small blind) folded before Flop
Seat 3: 96655300 (big blind) showed [4d Ah] and lost with Pair of Fours
Seat 4: Hero folded before Flop (didn't bet)
Seat 5: bc31de8a folded before Flop (didn't bet)
Seat 6: bd1d5d64 folded before Flop (didn't bet)


Poker Hand #RC2774807518: Hold'em No Limit ($0.05/$0.1) - 2024/08/05 13:13:05
Table 'RushAndCash21402778' 6-max Seat #1 is the button
Seat 1: 1dc8e473 ($17.22 in chips)
Seat 2: 43eb1c85 ($10.77 in chips)
Seat 3: Hero ($18.9 in chips)
Seat 4: 53fb9d87 ($10 in chips)
Seat 5: 5a13a01 ($14.65 in chips)
Seat 6: 2b58b37c ($5.56 in chips)
43eb1c85: posts small blind $0.05
Hero: posts big blind $0.1
*** HOLE CARDS ***
Dealt to 1dc8e473 
Dealt to 43eb1c85 
Dealt to Hero [4s Kd]
Dealt to 53fb9d87 
Dealt to 5a13a01 
Dealt to 2b58b37c 
53fb9d87: folds
5a13a01: folds
2b58b37c: folds
1dc8e473: raises $0.15 to $0.25
43eb1c85: folds
Hero: folds
Uncalled bet ($0.15) returned to 1dc8e473
*** SHOWDOWN ***
1dc8e473 collected $0.25 from pot
*** SUMMARY ***
Total pot $0.25 | Rake $0 | Jackpot $0 | Bingo $0 | Fortune $0 | Tax $0
Seat 1: 1dc8e473 (button) collected ($0.25)
Seat 2: 43eb1c85 (small blind) folded before Flop
Seat 3: Hero (big blind) folded before Flop
Seat 4: 53fb9d87 folded before Flop (didn't bet)
Seat 5: 5a13a01 folded before Flop (didn't bet)
Seat 6: 2b58b37c folded before Flop (didn't bet)


Poker Hand #RC2774807495: Hold'em No Limit ($0.05/$0.1) - 2024/08/05 13:13:02
Table 'RushAndCash21402755' 6-max Seat #1 is the button
Seat 1: 2b58b37c ($5.56 in chips)
Seat 2: 62ef8cc4 ($27.37 in chips)
Seat 3: 25cc1eb4 ($14.54 in chips)
Seat 4: c8f62ef2 ($8.06 in chips)
Seat 5: Hero ($18.9 in chips)
Seat 6: ac724a39 ($6.36 in chips)
62ef8cc4: posts small blind $0.05
25cc1eb4: posts big blind $0.1
*** HOLE CARDS ***
Dealt to 2b58b37c 
Dealt to 62ef8cc4 
Dealt to 25cc1eb4 
Dealt to c8f62ef2 
Dealt to Hero [3c 6c]
Dealt to ac724a39 
c8f62ef2: folds
Hero: folds
ac724a39: folds
2b58b37c: folds
62ef8cc4: raises $0.2 to $0.3
25cc1eb4: raises $0.7 to $1
62ef8cc4: folds
Uncalled bet ($0.7) returned to 25cc1eb4
*** SHOWDOWN ***
25cc1eb4 collected $0.57 from pot
*** SUMMARY ***
Total pot $0.6 | Rake $0.03 | Jackpot $0 | Bingo $0 | Fortune $0 | Tax $0
Seat 1: 2b58b37c (button) folded before Flop (didn't bet)
Seat 2: 62ef8cc4 (small blind) folded before Flop
Seat 3: 25cc1eb4 (big blind) collected ($0.57)
Seat 4: c8f62ef2 folded before Flop (didn't bet)
Seat 5: Hero folded before Flop (didn't bet)
Seat 6: ac724a39 folded before Flop (didn't bet)


Poker Hand #RC2774807035: Hold'em No Limit ($0.05/$0.1) - 2024/08/05 13:12:02
Table 'RushAndCash21402295' 6-max Seat #1 is the button
Seat 1: 1959a88a ($19.7 in chips)
Seat 2: 6ad3e4ae ($11.3 in chips)
Seat 3: 319443e2 ($10 in chips)
Seat 4: 73207420 ($16.55 in chips)
Seat 5: 67717882 ($12.97 in chips)
Seat 6: Hero ($17.04 in chips)
6ad3e4ae: posts small blind $0.05
319443e2: posts big blind $0.1
*** HOLE CARDS ***
Dealt to 1959a88a 
Dealt to 6ad3e4ae 
Dealt to 319443e2 
Dealt to 73207420 
Dealt to 67717882 
Dealt to Hero [Ks Kd]
73207420: folds
67717882: folds
Hero: raises $0.14 to $0.24
1959a88a: folds
6ad3e4ae: folds
319443e2: calls $0.14
*** FLOP *** [5s 6c Tc]
319443e2: checks
Hero: checks
*** TURN *** [5s 6c Tc] [6d]
319443e2: bets $0.36
Hero: calls $0.36
*** RIVER *** [5s 6c Tc 6d] [Qs]
319443e2: bets $1.57
Hero: calls $1.57
319443e2: shows [Js 7s] (Pair of Sixes)
Hero: shows [Ks Kd] (Pair of Kings and Pair of Sixes)
*** SHOWDOWN ***
Hero collected $4.03 from pot
*** SUMMARY ***
Total pot $4.39 | Rake $0.21 | Jackpot $0.15 | Bingo $0 | Fortune $0 | Tax $0
Board [5s 6c Tc 6d Qs]
Seat 1: 1959a88a (button) folded before Flop (didn't bet)
Seat 2: 6ad3e4ae (small blind) folded before Flop
Seat 3: 319443e2 (big blind) showed [Js 7s] and lost with Pair of Sixes
Seat 4: 73207420 folded before Flop (didn't bet)
Seat 5: 67717882 folded before Flop (didn't bet)
Seat 6: Hero showed [Ks Kd] and won ($4.03) with Pair of Kings and Pair of Sixes


Poker Hand #RC2774807010: Hold'em No Limit ($0.05/$0.1) - 2024/08/05 13:11:59
Table 'RushAndCash21402270' 6-max Seat #1 is the button
Seat 1: a18ebac8 ($10.56 in chips)
Seat 2: 96655300 ($11.04 in chips)
Seat 3: aad2fdf5 ($10.56 in chips)
Seat 4: ab4ad387 ($13.35 in chips)
Seat 5: Hero ($17.04 in chips)
Seat 6: 3210978c ($6.08 in chips)
96655300: posts small blind $0.05
aad2fdf5: posts big blind $0.1
*** HOLE CARDS ***
Dealt to a18ebac8 
Dealt to 96655300 
Dealt to aad2fdf5 
Dealt to ab4ad387 
Dealt to Hero [3h Qd]
Dealt to 3210978c 
ab4ad387: folds
Hero: folds
3210978c: folds
a18ebac8: folds
96655300: raises $0.15 to $0.25
aad2fdf5: calls $0.15
*** FLOP *** [8h 6h 6d]
96655300: checks
aad2fdf5: bets $0.38
96655300: folds
Uncalled bet ($0.38) returned to aad2fdf5
*** SHOWDOWN ***
aad2fdf5 collected $0.48 from pot
*** SUMMARY ***
Total pot $0.5 | Rake $0.02 | Jackpot $0 | Bingo $0 | Fortune $0 | Tax $0
Board [8h 6h 6d]
Seat 1: a18ebac8 (button) folded before Flop (didn't bet)
Seat 2: 96655300 (small blind) folded on the Flop
Seat 3: aad2fdf5 (big blind) won ($0.48)
Seat 4: ab4ad387 folded before Flop (didn't bet)
Seat 5: Hero folded before Flop (didn't bet)
Seat 6: 3210978c folded before Flop (didn't bet)


Poker Hand #RC2774806982: Hold'em No Limit ($0.05/$0.1) - 2024/08/05 13:11:55
Table 'RushAndCash21402242' 6-max Seat #1 is the button
Seat 1: 7721c598 ($10.94 in chips)
Seat 2: dae24d3f ($10 in chips)
Seat 3: Hero ($17.14 in chips)
Seat 4: 2ac9ccfa ($13.42 in chips)
Seat 5: 1894db5f ($18.34 in chips)
Seat 6: a72114e6 ($10.48 in chips)
dae24d3f: posts small blind $0.05
Hero: posts big blind $0.1
*** HOLE CARDS ***
Dealt to 7721c598 
Dealt to dae24d3f 
Dealt to Hero [3s 2c]
Dealt to 2ac9ccfa 
Dealt to 1894db5f 
Dealt to a72114e6 
2ac9ccfa: folds
1894db5f: folds
a72114e6: folds
7721c598: raises $0.11 to $0.21
dae24d3f: raises $0.78 to $0.99
Hero: folds
7721c598: folds
Uncalled bet ($0.78) returned to dae24d3f
*** SHOWDOWN ***
dae24d3f collected $0.5 from pot
*** SUMMARY ***
Total pot $0.52 | Rake $0.02 | Jackpot $0 | Bingo $0 | Fortune $0 | Tax $0
Seat 1: 7721c598 (button) folded before Flop
Seat 2: dae24d3f (small blind) collected ($0.5)
Seat 3: Hero (big blind) folded before Flop
Seat 4: 2ac9ccfa folded before Flop (didn't bet)
Seat 5: 1894db5f folded before Flop (didn't bet)
Seat 6: a72114e6 folded before Flop (didn't bet)


Poker Hand #RC2774806952: Hold'em No Limit ($0.05/$0.1) - 2024/08/05 13:11:51
Table 'RushAndCash21402212' 6-max Seat #1 is the button
Seat 1: Hero ($17.14 in chips)
Seat 2: 13296c59 ($10.22 in chips)
Seat 3: d0c19c5d ($10.1 in chips)
Seat 4: 5d2015b5 ($10.74 in chips)
Seat 5: cfc1aeae ($10.62 in chips)
Seat 6: d28d30e4 ($23.27 in chips)
13296c59: posts small blind $0.05
d0c19c5d: posts big blind $0.1
*** HOLE CARDS ***
Dealt to Hero [Jh 5c]
Dealt to 13296c59 
Dealt to d0c19c5d 
Dealt to 5d2015b5 
Dealt to cfc1aeae 
Dealt to d28d30e4 
5d2015b5: folds
cfc1aeae: folds
d28d30e4: folds
Hero: folds
13296c59: raises $0.12 to $0.22
d0c19c5d: raises $0.68 to $0.9
13296c59: calls $0.68
*** FLOP *** [5h 3h 4h]
13296c59: checks
d0c19c5d: bets $1.19
13296c59: folds
Uncalled bet ($1.19) returned to d0c19c5d
*** SHOWDOWN ***
d0c19c5d collected $1.71 from pot
*** SUMMARY ***
Total pot $1.8 | Rake $0.09 | Jackpot $0 | Bingo $0 | Fortune $0 | Tax $0
Board [5h 3h 4h]
Seat 1: Hero (button) folded before Flop (didn't bet)
Seat 2: 13296c59 (small blind) folded on the Flop
Seat 3: d0c19c5d (big blind) won ($1.71)
Seat 4: 5d2015b5 folded before Flop (didn't bet)
Seat 5: cfc1aeae folded before Flop (didn't bet)
Seat 6: d28d30e4 folded before Flop (didn't bet)


Poker Hand #RC2774806924: Hold'em No Limit ($0.05/$0.1) - 2024/08/05 13:11:47
Table 'RushAndCash21402184' 6-max Seat #1 is the button
Seat 1: 14ce2d5c ($12.87 in chips)
Seat 2: 356b0e4 ($18.21 in chips)
Seat 3: 8ead4151 ($27.5 in chips)
Seat 4: Hero ($17.14 in chips)
Seat 5: 4fd3ce55 ($10 in chips)
Seat 6: a5c40612 ($11.55 in chips)
356b0e4: posts small blind $0.05
8ead4151: posts big blind $0.1
*** HOLE CARDS ***
Dealt to 14ce2d5c 
Dealt to 356b0e4 
Dealt to 8ead4151 
Dealt to Hero [9d Ks]
Dealt to 4fd3ce55 
Dealt to a5c40612 
Hero: folds
4fd3ce55: folds
a5c40612: raises $0.1 to $0.2
14ce2d5c: raises $0.7 to $0.9
356b0e4: folds
8ead4151: folds
a5c40612: folds
Uncalled bet ($0.7) returned to 14ce2d5c
*** SHOWDOWN ***
14ce2d5c collected $0.53 from pot
*** SUMMARY ***
Total pot $0.55 | Rake $0.02 | Jackpot $0 | Bingo $0 | Fortune $0 | Tax $0
Seat 1: 14ce2d5c (button) collected ($0.53)
Seat 2: 356b0e4 (small blind) folded before Flop
Seat 3: 8ead4151 (big blind) folded before Flop
Seat 4: Hero folded before Flop (didn't bet)
Seat 5: 4fd3ce55 folded before Flop (didn't bet)
Seat 6: a5c40612 folded before Flop


Poker Hand #RC2774806891: Hold'em No Limit ($0.05/$0.1) - 2024/08/05 13:11:43
Table 'RushAndCash21402151' 6-max Seat #1 is the button
Seat 1: bec0764 ($11.7 in chips)
Seat 2: Hero ($17.19 in chips)
Seat 3: 3d571954 ($25.05 in chips)
Seat 4: a58a0072 ($30.14 in chips)
Seat 5: c1fd9eb1 ($10 in chips)
Seat 6: 57c66431 ($47.96 in chips)
Hero: posts small blind $0.05
3d571954: posts big blind $0.1
*** HOLE CARDS ***
Dealt to bec0764 
Dealt to Hero [7s Jh]
Dealt to 3d571954 
Dealt to a58a0072 
Dealt to c1fd9eb1 
Dealt to 57c66431 
a58a0072: folds
c1fd9eb1: folds
57c66431: raises $0.16 to $0.26
bec0764: raises $0.56 to $0.82
Hero: folds
3d571954: folds
57c66431: raises $1.58 to $2.4
bec0764: folds
Uncalled bet ($1.58) returned to 57c66431
*** SHOWDOWN ***
57c66431 collected $1.7 from pot
*** SUMMARY ***
Total pot $1.79 | Rake $0.09 | Jackpot $0 | Bingo $0 | Fortune $0 | Tax $0
Seat 1: bec0764 (button) folded before Flop
Seat 2: Hero (small blind) folded before Flop
Seat 3: 3d571954 (big blind) folded before Flop
Seat 4: a58a0072 folded before Flop (didn't bet)
Seat 5: c1fd9eb1 folded before Flop (didn't bet)
Seat 6: 57c66431 collected ($1.7)


Poker Hand #RC2774806844: Hold'em No Limit ($0.05/$0.1) - 2024/08/05 13:11:38
Table 'RushAndCash21402104' 6-max Seat #1 is the button
Seat 1: 5580da68 ($10 in chips)
Seat 2: 9803275a ($10.89 in chips)
Seat 3: fbeccf9e ($11.02 in chips)
Seat 4: bff11e64 ($11.55 in chips)
Seat 5: dbffffb3 ($26.65 in chips)
Seat 6: Hero ($17.19 in chips)
9803275a: posts small blind $0.05
fbeccf9e: posts big blind $0.1
*** HOLE CARDS ***
Dealt to 5580da68 
Dealt to 9803275a 
Dealt to fbeccf9e 
Dealt to bff11e64 
Dealt to dbffffb3 
Dealt to Hero [7c As]
bff11e64: folds
dbffffb3: raises $0.12 to $0.22
Hero: folds
5580da68: folds
9803275a: folds
fbeccf9e: folds
Uncalled bet ($0.12) returned to dbffffb3
*** SHOWDOWN ***
dbffffb3 collected $0.25 from pot
*** SUMMARY ***
Total pot $0.25 | Rake $0 | Jackpot $0 | Bingo $0 | Fortune $0 | Tax $0
Seat 1: 5580da68 (button) folded before Flop (didn't bet)
Seat 2: 9803275a (small blind) folded before Flop
Seat 3: fbeccf9e (big blind) folded before Flop
Seat 4: bff11e64 folded before Flop (didn't bet)
Seat 5: dbffffb3 collected ($0.25)
Seat 6: Hero folded before Flop (didn't bet)


Poker Hand #RC2774806817: Hold'em No Limit ($0.05/$0.1) - 2024/08/05 13:11:34
Table 'RushAndCash21402077' 6-max Seat #1 is the button
Seat 1: 7a6fd0e3 ($4.3 in chips)
Seat 2: 10a76e0 ($10 in chips)
Seat 3: 273a25e9 ($11.31 in chips)
Seat 4: Hero ($17.19 in chips)
Seat 5: 2450185e ($10.58 in chips)
Seat 6: 90dbb409 ($10.15 in chips)
10a76e0: posts small blind $0.05
273a25e9: posts big blind $0.1
*** HOLE CARDS ***
Dealt to 7a6fd0e3 
Dealt to 10a76e0 
Dealt to 273a25e9 
Dealt to Hero [7d Ac]
Dealt to 2450185e 
Dealt to 90dbb409 
Hero: folds
2450185e: folds
90dbb409: folds
7a6fd0e3: folds
10a76e0: raises $0.1 to $0.2
273a25e9: folds
Uncalled bet ($0.1) returned to 10a76e0
*** SHOWDOWN ***
10a76e0 collected $0.2 from pot
*** SUMMARY ***
Total pot $0.2 | Rake $0 | Jackpot $0 | Bingo $0 | Fortune $0 | Tax $0
Seat 1: 7a6fd0e3 (button) folded before Flop (didn't bet)
Seat 2: 10a76e0 (small blind) collected ($0.2)
Seat 3: 273a25e9 (big blind) folded before Flop
Seat 4: Hero folded before Flop (didn't bet)
Seat 5: 2450185e folded before Flop (didn't bet)
Seat 6: 90dbb409 folded before Flop (didn't bet)


Poker Hand #RC2774806793: Hold'em No Limit ($0.05/$0.1) - 2024/08/05 13:11:31
Table 'RushAndCash21402053' 6-max Seat #1 is the button
Seat 1: f80c7735 ($10.08 in chips)
Seat 2: Hero ($17.24 in chips)
Seat 3: 9594a28c ($20.85 in chips)
Seat 4: 5a2ff57f ($26.84 in chips)
Seat 5: 20c154a7 ($25.38 in chips)
Seat 6: 131e152d ($7.82 in chips)
Hero: posts small blind $0.05
9594a28c: posts big blind $0.1
*** HOLE CARDS ***
Dealt to f80c7735 
Dealt to Hero [Kh 5s]
Dealt to 9594a28c 
Dealt to 5a2ff57f 
Dealt to 20c154a7 
Dealt to 131e152d 
5a2ff57f: raises $0.1 to $0.2
20c154a7: folds
131e152d: raises $0.28 to $0.48
f80c7735: raises $0.72 to $1.2
Hero: folds
9594a28c: folds
5a2ff57f: folds
131e152d: calls $0.72
*** FLOP *** [6h 4d Js]
131e152d: checks
f80c7735: bets $1.38
131e152d: calls $1.38
*** TURN *** [6h 4d Js] [6s]
131e152d: checks
f80c7735: bets $6.89
131e152d: calls $5.24 and is all-in
Uncalled bet ($1.65) returned to f80c7735
f80c7735: shows [Ks Qs] (Pair of Sixes)
131e152d: shows [Th Ts] (Pair of Tens and Pair of Sixes)
*** FIRST RIVER *** [6h 4d Js 6s] [5h]
*** SECOND RIVER *** [6h 4d Js 6s] [Qc]
*** FIRST SHOWDOWN ***
131e152d collected $7.77 from pot
*** SECOND SHOWDOWN ***
f80c7735 collected $7.77 from pot
*** SUMMARY ***
Total pot $15.99 | Rake $0.3 | Jackpot $0.15 | Bingo $0 | Fortune $0 | Tax $0
Hand was run two times
FIRST Board [6h 4d Js 6s 5h]
SECOND Board [Qc]
Seat 1: f80c7735 (button) showed [Ks Qs] and lost with Pair of Sixes, and won ($7.77)
Seat 2: Hero (small blind) folded before Flop
Seat 3: 9594a28c (big blind) folded before Flop
Seat 4: 5a2ff57f folded before Flop
Seat 5: 20c154a7 folded before Flop (didn't bet)
Seat 6: 131e152d showed [Th Ts] and won ($7.77) with Pair of Tens and Pair of Sixes, and lost


Poker Hand #RC2774806754: Hold'em No Limit ($0.05/$0.1) - 2024/08/05 13:11:25
Table 'RushAndCash21402014' 6-max Seat #1 is the button
Seat 1: 1624264a ($11.97 in chips)
Seat 2: 644022ea ($12.29 in chips)
Seat 3: Hero ($17.34 in chips)
Seat 4: 38d4fec3 ($10 in chips)
Seat 5: 608a09cc ($15.3 in chips)
Seat 6: bc9b23d3 ($10 in chips)
644022ea: posts small blind $0.05
Hero: posts big blind $0.1
*** HOLE CARDS ***
Dealt to 1624264a 
Dealt to 644022ea 
Dealt to Hero [8d Jc]
Dealt to 38d4fec3 
Dealt to 608a09cc 
Dealt to bc9b23d3 
38d4fec3: raises $0.15 to $0.25
608a09cc: calls $0.25
bc9b23d3: folds
1624264a: folds
644022ea: folds
Hero: folds
*** FLOP *** [9s 7s 6d]
38d4fec3: bets $0.22
608a09cc: calls $0.22
*** TURN *** [9s 7s 6d] [8c]
38d4fec3: checks
608a09cc: bets $0.55
38d4fec3: calls $0.55
*** RIVER *** [9s 7s 6d 8c] [5d]
38d4fec3: checks
608a09cc: bets $2.25
38d4fec3: folds
Uncalled bet ($2.25) returned to 608a09cc
608a09cc: shows [Ad Js] (Nines-High Straight)
*** SHOWDOWN ***
608a09cc collected $2.08 from pot
*** SUMMARY ***
Total pot $2.19 | Rake $0.11 | Jackpot $0 | Bingo $0 | Fortune $0 | Tax $0
Board [9s 7s 6d 8c 5d]
Seat 1: 1624264a (button) folded before Flop (didn't bet)
Seat 2: 644022ea (small blind) folded before Flop
Seat 3: Hero (big blind) folded before Flop
Seat 4: 38d4fec3 folded on the River
Seat 5: 608a09cc showed [Ad Js] and won ($2.08)
Seat 6: bc9b23d3 folded before Flop (didn't bet)


Poker Hand #RC2774806705: Hold'em No Limit ($0.05/$0.1) - 2024/08/05 13:11:19
Table 'RushAndCash21401965' 6-max Seat #1 is the button
Seat 1: 71824a6 ($9.91 in chips)
Seat 2: 76b2da90 ($13.11 in chips)
Seat 3: 68955af7 ($18.07 in chips)
Seat 4: eace9db7 ($17.75 in chips)
Seat 5: 10a76e0 ($10 in chips)
Seat 6: Hero ($17.34 in chips)
76b2da90: posts small blind $0.05
68955af7: posts big blind $0.1
*** HOLE CARDS ***
Dealt to 71824a6 
Dealt to 76b2da90 
Dealt to 68955af7 
Dealt to eace9db7 
Dealt to 10a76e0 
Dealt to Hero [Qd 2h]
eace9db7: folds
10a76e0: folds
Hero: folds
71824a6: folds
76b2da90: folds
Uncalled bet ($0.05) returned to 68955af7
*** SHOWDOWN ***
68955af7 collected $0.1 from pot
*** SUMMARY ***
Total pot $0.1 | Rake $0 | Jackpot $0 | Bingo $0 | Fortune $0 | Tax $0
Seat 1: 71824a6 (button) folded before Flop (didn't bet)
Seat 2: 76b2da90 (small blind) folded before Flop
Seat 3: 68955af7 (big blind) collected ($0.1)
Seat 4: eace9db7 folded before Flop (didn't bet)
Seat 5: 10a76e0 folded before Flop (didn't bet)
Seat 6: Hero folded before Flop (didn't bet)


Poker Hand #RC2774806646: Hold'em No Limit ($0.05/$0.1) - 2024/08/05 13:11:12
Table 'RushAndCash21401906' 6-max Seat #1 is the button
Seat 1: Hero ($17.34 in chips)
Seat 2: 41520222 ($15.04 in chips)
Seat 3: 49aca122 ($12.25 in chips)
Seat 4: 600f9532 ($11.27 in chips)
Seat 5: e574d31f ($10 in chips)
Seat 6: c286ea21 ($11.63 in chips)
41520222: posts small blind $0.05
49aca122: posts big blind $0.1
*** HOLE CARDS ***
Dealt to Hero [6h 4h]
Dealt to 41520222 
Dealt to 49aca122 
Dealt to 600f9532 
Dealt to e574d31f 
Dealt to c286ea21 
600f9532: folds
e574d31f: folds
c286ea21: raises $0.1 to $0.2
Hero: folds
41520222: folds
49aca122: calls $0.1
*** FLOP *** [7d Ts 9h]
49aca122: checks
c286ea21: bets $0.14
49aca122: calls $0.14
*** TURN *** [7d Ts 9h] [9s]
49aca122: bets $0.25
c286ea21: calls $0.25
*** RIVER *** [7d Ts 9h 9s] [6c]
49aca122: checks
c286ea21: checks
49aca122: shows [Tc Jc] (Pair of Tens and Pair of Nines)
c286ea21: shows [5s 5d] (Pair of Nines and Pair of Fives)
*** SHOWDOWN ***
49aca122 collected $1.17 from pot
*** SUMMARY ***
Total pot $1.23 | Rake $0.06 | Jackpot $0 | Bingo $0 | Fortune $0 | Tax $0
Board [7d Ts 9h 9s 6c]
Seat 1: Hero (button) folded before Flop (didn't bet)
Seat 2: 41520222 (small blind) folded before Flop
Seat 3: 49aca122 (big blind) showed [Tc Jc] and won ($1.17) with Pair of Tens and Pair of Nines
Seat 4: 600f9532 folded before Flop (didn't bet)
Seat 5: e574d31f folded before Flop (didn't bet)
Seat 6: c286ea21 showed [5s 5d] and lost with Pair of Nines and Pair of Fives


Poker Hand #RC2774806614: Hold'em No Limit ($0.05/$0.1) - 2024/08/05 13:11:09
Table 'RushAndCash21401874' 6-max Seat #1 is the button
Seat 1: 600f9532 ($11.27 in chips)
Seat 2: 6f93ebc9 ($10 in chips)
Seat 3: 394cd0b1 ($10 in chips)
Seat 4: cd4be1e5 ($29.49 in chips)
Seat 5: cbf26d60 ($24.16 in chips)
Seat 6: Hero ($17.34 in chips)
6f93ebc9: posts small blind $0.05
394cd0b1: posts big blind $0.1
*** HOLE CARDS ***
Dealt to 600f9532 
Dealt to 6f93ebc9 
Dealt to 394cd0b1 
Dealt to cd4be1e5 
Dealt to cbf26d60 
Dealt to Hero [8s 5d]
cd4be1e5: folds
cbf26d60: folds
Hero: folds
600f9532: folds
6f93ebc9: raises $0.1 to $0.2
394cd0b1: raises $0.3 to $0.5
6f93ebc9: folds
Uncalled bet ($0.3) returned to 394cd0b1
*** SHOWDOWN ***
394cd0b1 collected $0.38 from pot
*** SUMMARY ***
Total pot $0.4 | Rake $0.02 | Jackpot $0 | Bingo $0 | Fortune $0 | Tax $0
Seat 1: 600f9532 (button) folded before Flop (didn't bet)
Seat 2: 6f93ebc9 (small blind) folded before Flop
Seat 3: 394cd0b1 (big blind) collected ($0.38)
Seat 4: cd4be1e5 folded before Flop (didn't bet)
Seat 5: cbf26d60 folded before Flop (didn't bet)
Seat 6: Hero folded before Flop (didn't bet)


Poker Hand #RC2774806579: Hold'em No Limit ($0.05/$0.1) - 2024/08/05 13:11:05
Table 'RushAndCash21401839' 6-max Seat #1 is the button
Seat 1: 9b012cde ($54.74 in chips)
Seat 2: 53fb9d87 ($10.1 in chips)
Seat 3: 7a6fd0e3 ($4.08 in chips)
Seat 4: Hero ($17.34 in chips)
Seat 5: a58a0072 ($30.39 in chips)
Seat 6: 40d47c95 ($12.93 in chips)
53fb9d87: posts small blind $0.05
7a6fd0e3: posts big blind $0.1
*** HOLE CARDS ***
Dealt to 9b012cde 
Dealt to 53fb9d87 
Dealt to 7a6fd0e3 
Dealt to Hero [9d Js]
Dealt to a58a0072 
Dealt to 40d47c95 
Hero: folds
a58a0072: folds
40d47c95: raises $0.14 to $0.24
9b012cde: folds
53fb9d87: folds
7a6fd0e3: raises $0.31 to $0.55
40d47c95: folds
Uncalled bet ($0.31) returned to 7a6fd0e3
*** SHOWDOWN ***
7a6fd0e3 collected $0.51 from pot
*** SUMMARY ***
Total pot $0.53 | Rake $0.02 | Jackpot $0 | Bingo $0 | Fortune $0 | Tax $0
Seat 1: 9b012cde (button) folded before Flop (didn't bet)
Seat 2: 53fb9d87 (small blind) folded before Flop
Seat 3: 7a6fd0e3 (big blind) collected ($0.51)
Seat 4: Hero folded before Flop (didn't bet)
Seat 5: a58a0072 folded before Flop (didn't bet)
Seat 6: 40d47c95 folded before Flop


Poker Hand #RC2774806480: Hold'em No Limit ($0.05/$0.1) - 2024/08/05 13:10:52
Table 'RushAndCash21401740' 6-max Seat #1 is the button
Seat 1: 9e29158a ($14.19 in chips)
Seat 2: b251e2c6 ($11.65 in chips)
Seat 3: 8be257d4 ($10.1 in chips)
Seat 4: 7166ca79 ($2.96 in chips)
Seat 5: 42322d75 ($33.77 in chips)
Seat 6: Hero ($17.19 in chips)
b251e2c6: posts small blind $0.05
8be257d4: posts big blind $0.1
*** HOLE CARDS ***
Dealt to 9e29158a 
Dealt to b251e2c6 
Dealt to 8be257d4 
Dealt to 7166ca79 
Dealt to 42322d75 
Dealt to Hero [3h 3d]
7166ca79: folds
42322d75: folds
Hero: raises $0.14 to $0.24
9e29158a: folds
b251e2c6: folds
8be257d4: folds
Uncalled bet ($0.14) returned to Hero
*** SHOWDOWN ***
Hero collected $0.25 from pot
*** SUMMARY ***
Total pot $0.25 | Rake $0 | Jackpot $0 | Bingo $0 | Fortune $0 | Tax $0
Seat 1: 9e29158a (button) folded before Flop (didn't bet)
Seat 2: b251e2c6 (small blind) folded before Flop
Seat 3: 8be257d4 (big blind) folded before Flop
Seat 4: 7166ca79 folded before Flop (didn't bet)
Seat 5: 42322d75 folded before Flop (didn't bet)
Seat 6: Hero collected ($0.25)


Poker Hand #RC2774806427: Hold'em No Limit ($0.05/$0.1) - 2024/08/05 13:10:44
Table 'RushAndCash21401687' 6-max Seat #1 is the button
Seat 1: e0ad70cd ($17.41 in chips)
Seat 2: ebf21aa ($20.25 in chips)
Seat 3: Hero ($17.29 in chips)
Seat 4: 49aca122 ($12.3 in chips)
Seat 5: ab19c636 ($10.81 in chips)
Seat 6: d12dc75 ($22.09 in chips)
ebf21aa: posts small blind $0.05
Hero: posts big blind $0.1
*** HOLE CARDS ***
Dealt to e0ad70cd 
Dealt to ebf21aa 
Dealt to Hero [8s 3h]
Dealt to 49aca122 
Dealt to ab19c636 
Dealt to d12dc75 
49aca122: folds
ab19c636: folds
d12dc75: folds
e0ad70cd: folds
ebf21aa: raises $0.25 to $0.35
Hero: folds
Uncalled bet ($0.25) returned to ebf21aa
*** SHOWDOWN ***
ebf21aa collected $0.2 from pot
*** SUMMARY ***
Total pot $0.2 | Rake $0 | Jackpot $0 | Bingo $0 | Fortune $0 | Tax $0
Seat 1: e0ad70cd (button) folded before Flop (didn't bet)
Seat 2: ebf21aa (small blind) collected ($0.2)
Seat 3: Hero (big blind) folded before Flop
Seat 4: 49aca122 folded before Flop (didn't bet)
Seat 5: ab19c636 folded before Flop (didn't bet)
Seat 6: d12dc75 folded before Flop (didn't bet)


Poker Hand #RC2774806406: Hold'em No Limit ($0.05/$0.1) - 2024/08/05 13:10:41
Table 'RushAndCash21401666' 6-max Seat #1 is the button
Seat 1: 8358e054 ($17.9 in chips)
Seat 2: Hero ($17.34 in chips)
Seat 3: d3bf5c4 ($15.41 in chips)
Seat 4: f8303f3b ($22 in chips)
Seat 5: 33d4b5ad ($18.08 in chips)
Seat 6: 49aca122 ($12.3 in chips)
Hero: posts small blind $0.05
d3bf5c4: posts big blind $0.1
*** HOLE CARDS ***
Dealt to 8358e054 
Dealt to Hero [5c 8d]
Dealt to d3bf5c4 
Dealt to f8303f3b 
Dealt to 33d4b5ad 
Dealt to 49aca122 
f8303f3b: raises $0.1 to $0.2
33d4b5ad: folds
49aca122: folds
8358e054: folds
Hero: folds
d3bf5c4: folds
Uncalled bet ($0.1) returned to f8303f3b
*** SHOWDOWN ***
f8303f3b collected $0.25 from pot
*** SUMMARY ***
Total pot $0.25 | Rake $0 | Jackpot $0 | Bingo $0 | Fortune $0 | Tax $0
Seat 1: 8358e054 (button) folded before Flop (didn't bet)
Seat 2: Hero (small blind) folded before Flop
Seat 3: d3bf5c4 (big blind) folded before Flop
Seat 4: f8303f3b collected ($0.25)
Seat 5: 33d4b5ad folded before Flop (didn't bet)
Seat 6: 49aca122 folded before Flop (didn't bet)


Poker Hand #RC2774806384: Hold'em No Limit ($0.05/$0.1) - 2024/08/05 13:10:38
Table 'RushAndCash21401644' 6-max Seat #1 is the button
Seat 1: dc4de311 ($9.57 in chips)
Seat 2: Hero ($17.39 in chips)
Seat 3: adbf39ec ($10.09 in chips)
Seat 4: 12618372 ($10.97 in chips)
Seat 5: a5801292 ($9.45 in chips)
Seat 6: a76c5192 ($10.59 in chips)
Hero: posts small blind $0.05
adbf39ec: posts big blind $0.1
*** HOLE CARDS ***
Dealt to dc4de311 
Dealt to Hero [7c Kd]
Dealt to adbf39ec 
Dealt to 12618372 
Dealt to a5801292 
Dealt to a76c5192 
12618372: folds
a5801292: raises $0.1 to $0.2
a76c5192: folds
dc4de311: folds
Hero: folds
adbf39ec: folds
Uncalled bet ($0.1) returned to a5801292
*** SHOWDOWN ***
a5801292 collected $0.25 from pot
*** SUMMARY ***
Total pot $0.25 | Rake $0 | Jackpot $0 | Bingo $0 | Fortune $0 | Tax $0
Seat 1: dc4de311 (button) folded before Flop (didn't bet)
Seat 2: Hero (small blind) folded before Flop
Seat 3: adbf39ec (big blind) folded before Flop
Seat 4: 12618372 folded before Flop (didn't bet)
Seat 5: a5801292 collected ($0.25)
Seat 6: a76c5192 folded before Flop (didn't bet)


Poker Hand #RC2774806341: Hold'em No Limit ($0.05/$0.1) - 2024/08/05 13:10:32
Table 'RushAndCash21401601' 6-max Seat #1 is the button
Seat 1: Hero ($17.39 in chips)
Seat 2: 1ab91021 ($10.05 in chips)
Seat 3: 10a76e0 ($11.17 in chips)
Seat 4: 1444a840 ($11.49 in chips)
Seat 5: 6dd55590 ($20.24 in chips)
Seat 6: 8f7c02cf ($10.79 in chips)
1ab91021: posts small blind $0.05
10a76e0: posts big blind $0.1
*** HOLE CARDS ***
Dealt to Hero [Ts 6h]
Dealt to 1ab91021 
Dealt to 10a76e0 
Dealt to 1444a840 
Dealt to 6dd55590 
Dealt to 8f7c02cf 
1444a840: folds
6dd55590: folds
8f7c02cf: folds
Hero: folds
1ab91021: raises $0.15 to $0.25
10a76e0: raises $0.78 to $1.03
1ab91021: calls $0.78
*** FLOP *** [Jd 5c Qd]
1ab91021: checks
10a76e0: bets $0.68
1ab91021: raises $2.67 to $3.35
10a76e0: folds
Uncalled bet ($2.67) returned to 1ab91021
*** SHOWDOWN ***
1ab91021 collected $3.11 from pot
*** SUMMARY ***
Total pot $3.42 | Rake $0.16 | Jackpot $0.15 | Bingo $0 | Fortune $0 | Tax $0
Board [Jd 5c Qd]
Seat 1: Hero (button) folded before Flop (didn't bet)
Seat 2: 1ab91021 (small blind) won ($3.11)
Seat 3: 10a76e0 (big blind) folded on the Flop
Seat 4: 1444a840 folded before Flop (didn't bet)
Seat 5: 6dd55590 folded before Flop (didn't bet)
Seat 6: 8f7c02cf folded before Flop (didn't bet)


Poker Hand #RC2774806304: Hold'em No Limit ($0.05/$0.1) - 2024/08/05 13:10:28
Table 'RushAndCash21401564' 6-max Seat #1 is the button
Seat 1: 15e8bc52 ($17.01 in chips)
Seat 2: d68693bc ($11.85 in chips)
Seat 3: 67717882 ($13.07 in chips)
Seat 4: Hero ($17.39 in chips)
Seat 5: efeafe15 ($10.93 in chips)
Seat 6: a6f61f6e ($22.58 in chips)
d68693bc: posts small blind $0.05
67717882: posts big blind $0.1
*** HOLE CARDS ***
Dealt to 15e8bc52 
Dealt to d68693bc 
Dealt to 67717882 
Dealt to Hero [7h Ad]
Dealt to efeafe15 
Dealt to a6f61f6e 
Hero: folds
efeafe15: folds
a6f61f6e: folds
15e8bc52: raises $0.1 to $0.2
d68693bc: folds
67717882: folds
Uncalled bet ($0.1) returned to 15e8bc52
*** SHOWDOWN ***
15e8bc52 collected $0.25 from pot
*** SUMMARY ***
Total pot $0.25 | Rake $0 | Jackpot $0 | Bingo $0 | Fortune $0 | Tax $0
Seat 1: 15e8bc52 (button) collected ($0.25)
Seat 2: d68693bc (small blind) folded before Flop
Seat 3: 67717882 (big blind) folded before Flop
Seat 4: Hero folded before Flop (didn't bet)
Seat 5: efeafe15 folded before Flop (didn't bet)
Seat 6: a6f61f6e folded before Flop (didn't bet)


Poker Hand #RC2774806154: Hold'em No Limit ($0.05/$0.1) - 2024/08/05 13:10:07
Table 'RushAndCash21401414' 6-max Seat #1 is the button
Seat 1: Hero ($17.39 in chips)
Seat 2: 8a174497 ($9.9 in chips)
Seat 3: 24b8b991 ($12.46 in chips)
Seat 4: b5697b78 ($10.4 in chips)
Seat 5: c74379b8 ($10 in chips)
Seat 6: e8ec4f2b ($22.57 in chips)
8a174497: posts small blind $0.05
24b8b991: posts big blind $0.1
*** HOLE CARDS ***
Dealt to Hero [4h Kh]
Dealt to 8a174497 
Dealt to 24b8b991 
Dealt to b5697b78 
Dealt to c74379b8 
Dealt to e8ec4f2b 
b5697b78: folds
c74379b8: folds
e8ec4f2b: raises $0.14 to $0.24
Hero: folds
8a174497: folds
24b8b991: folds
Uncalled bet ($0.14) returned to e8ec4f2b
*** SHOWDOWN ***
e8ec4f2b collected $0.25 from pot
*** SUMMARY ***
Total pot $0.25 | Rake $0 | Jackpot $0 | Bingo $0 | Fortune $0 | Tax $0
Seat 1: Hero (button) folded before Flop (didn't bet)
Seat 2: 8a174497 (small blind) folded before Flop
Seat 3: 24b8b991 (big blind) folded before Flop
Seat 4: b5697b78 folded before Flop (didn't bet)
Seat 5: c74379b8 folded before Flop (didn't bet)
Seat 6: e8ec4f2b collected ($0.25)


Poker Hand #RC2774806064: Hold'em No Limit ($0.05/$0.1) - 2024/08/05 13:09:55
Table 'RushAndCash21401324' 6-max Seat #1 is the button
Seat 1: 7ef3e576 ($18.62 in chips)
Seat 2: ab19c636 ($10.56 in chips)
Seat 3: Hero ($17.49 in chips)
Seat 4: 98e2d761 ($23.17 in chips)
Seat 5: 6327f413 ($2.77 in chips)
Seat 6: 598b5954 ($11.29 in chips)
ab19c636: posts small blind $0.05
Hero: posts big blind $0.1
*** HOLE CARDS ***
Dealt to 7ef3e576 
Dealt to ab19c636 
Dealt to Hero [7d Kd]
Dealt to 98e2d761 
Dealt to 6327f413 
Dealt to 598b5954 
98e2d761: folds
6327f413: folds
598b5954: folds
7ef3e576: raises $0.11 to $0.21
ab19c636: folds
Hero: folds
Uncalled bet ($0.11) returned to 7ef3e576
*** SHOWDOWN ***
7ef3e576 collected $0.25 from pot
*** SUMMARY ***
Total pot $0.25 | Rake $0 | Jackpot $0 | Bingo $0 | Fortune $0 | Tax $0
Seat 1: 7ef3e576 (button) collected ($0.25)
Seat 2: ab19c636 (small blind) folded before Flop
Seat 3: Hero (big blind) folded before Flop
Seat 4: 98e2d761 folded before Flop (didn't bet)
Seat 5: 6327f413 folded before Flop (didn't bet)
Seat 6: 598b5954 folded before Flop (didn't bet)


Poker Hand #RC2774805969: Hold'em No Limit ($0.05/$0.1) - 2024/08/05 13:09:42
Table 'RushAndCash21401229' 6-max Seat #1 is the button
Seat 1: 7a6fd0e3 ($3.85 in chips)
Seat 2: 3ac1552b ($10.89 in chips)
Seat 3: 388eba86 ($10.1 in chips)
Seat 4: 7ef3e576 ($18.77 in chips)
Seat 5: 319443e2 ($10 in chips)
Seat 6: Hero ($17.34 in chips)
3ac1552b: posts small blind $0.05
388eba86: posts big blind $0.1
*** HOLE CARDS ***
Dealt to 7a6fd0e3 
Dealt to 3ac1552b 
Dealt to 388eba86 
Dealt to 7ef3e576 
Dealt to 319443e2 
Dealt to Hero [As Kd]
7ef3e576: folds
319443e2: folds
Hero: raises $0.14 to $0.24
7a6fd0e3: folds
3ac1552b: folds
388eba86: folds
Uncalled bet ($0.14) returned to Hero
*** SHOWDOWN ***
Hero collected $0.25 from pot
*** SUMMARY ***
Total pot $0.25 | Rake $0 | Jackpot $0 | Bingo $0 | Fortune $0 | Tax $0
Seat 1: 7a6fd0e3 (button) folded before Flop (didn't bet)
Seat 2: 3ac1552b (small blind) folded before Flop
Seat 3: 388eba86 (big blind) folded before Flop
Seat 4: 7ef3e576 folded before Flop (didn't bet)
Seat 5: 319443e2 folded before Flop (didn't bet)
Seat 6: Hero collected ($0.25)


Poker Hand #RC2774805915: Hold'em No Limit ($0.05/$0.1) - 2024/08/05 13:09:34
Table 'RushAndCash21401175' 6-max Seat #1 is the button
Seat 1: e5b05063 ($16.41 in chips)
Seat 2: Hero ($17.39 in chips)
Seat 3: 480aa7d0 ($11.27 in chips)
Seat 4: dddc9c97 ($10 in chips)
Seat 5: e45850f1 ($8.81 in chips)
Seat 6: 569beaa5 ($11.02 in chips)
Hero: posts small blind $0.05
480aa7d0: posts big blind $0.1
*** HOLE CARDS ***
Dealt to e5b05063 
Dealt to Hero [Th 4s]
Dealt to 480aa7d0 
Dealt to dddc9c97 
Dealt to e45850f1 
Dealt to 569beaa5 
dddc9c97: folds
e45850f1: folds
569beaa5: folds
e5b05063: raises $0.1 to $0.2
Hero: folds
480aa7d0: calls $0.1
*** FLOP *** [Ks Td Ac]
480aa7d0: checks
e5b05063: checks
*** TURN *** [Ks Td Ac] [2s]
480aa7d0: checks
e5b05063: bets $0.23
480aa7d0: folds
Uncalled bet ($0.23) returned to e5b05063
*** SHOWDOWN ***
e5b05063 collected $0.43 from pot
*** SUMMARY ***
Total pot $0.45 | Rake $0.02 | Jackpot $0 | Bingo $0 | Fortune $0 | Tax $0
Board [Ks Td Ac 2s]
Seat 1: e5b05063 (button) won ($0.43)
Seat 2: Hero (small blind) folded before Flop
Seat 3: 480aa7d0 (big blind) folded on the Turn
Seat 4: dddc9c97 folded before Flop (didn't bet)
Seat 5: e45850f1 folded before Flop (didn't bet)
Seat 6: 569beaa5 folded before Flop (didn't bet)


Poker Hand #RC2774805876: Hold'em No Limit ($0.05/$0.1) - 2024/08/05 13:09:30
Table 'RushAndCash21401136' 6-max Seat #1 is the button
Seat 1: df3fc675 ($10 in chips)
Seat 2: 3ccb1fbe ($11.59 in chips)
Seat 3: 608a09cc ($16.47 in chips)
Seat 4: Hero ($17.39 in chips)
Seat 5: 6566b3e4 ($10.67 in chips)
Seat 6: 7f318f41 ($17.26 in chips)
3ccb1fbe: posts small blind $0.05
608a09cc: posts big blind $0.1
*** HOLE CARDS ***
Dealt to df3fc675 
Dealt to 3ccb1fbe 
Dealt to 608a09cc 
Dealt to Hero [6d Th]
Dealt to 6566b3e4 
Dealt to 7f318f41 
Hero: folds
6566b3e4: folds
7f318f41: folds
df3fc675: raises $0.15 to $0.25
3ccb1fbe: folds
608a09cc: folds
Uncalled bet ($0.15) returned to df3fc675
*** SHOWDOWN ***
df3fc675 collected $0.25 from pot
*** SUMMARY ***
Total pot $0.25 | Rake $0 | Jackpot $0 | Bingo $0 | Fortune $0 | Tax $0
Seat 1: df3fc675 (button) collected ($0.25)
Seat 2: 3ccb1fbe (small blind) folded before Flop
Seat 3: 608a09cc (big blind) folded before Flop
Seat 4: Hero folded before Flop (didn't bet)
Seat 5: 6566b3e4 folded before Flop (didn't bet)
Seat 6: 7f318f41 folded before Flop (didn't bet)


Poker Hand #RC2774805838: Hold'em No Limit ($0.05/$0.1) - 2024/08/05 13:09:25
Table 'RushAndCash21401098' 6-max Seat #1 is the button
Seat 1: aeda1db9 ($10.22 in chips)
Seat 2: 15e8bc52 ($17.21 in chips)
Seat 3: Hero ($17.49 in chips)
Seat 4: b2ec1eae ($9.51 in chips)
Seat 5: e25d0386 ($10 in chips)
Seat 6: 97a73937 ($10.18 in chips)
15e8bc52: posts small blind $0.05
Hero: posts big blind $0.1
*** HOLE CARDS ***
Dealt to aeda1db9 
Dealt to 15e8bc52 
Dealt to Hero [Ks 4c]
Dealt to b2ec1eae 
Dealt to e25d0386 
Dealt to 97a73937 
b2ec1eae: folds
e25d0386: raises $0.1 to $0.2
97a73937: folds
aeda1db9: folds
15e8bc52: folds
Hero: folds
Uncalled bet ($0.1) returned to e25d0386
*** SHOWDOWN ***
e25d0386 collected $0.25 from pot
*** SUMMARY ***
Total pot $0.25 | Rake $0 | Jackpot $0 | Bingo $0 | Fortune $0 | Tax $0
Seat 1: aeda1db9 (button) folded before Flop (didn't bet)
Seat 2: 15e8bc52 (small blind) folded before Flop
Seat 3: Hero (big blind) folded before Flop
Seat 4: b2ec1eae folded before Flop (didn't bet)
Seat 5: e25d0386 collected ($0.25)
Seat 6: 97a73937 folded before Flop (didn't bet)


Poker Hand #RC2774805792: Hold'em No Limit ($0.05/$0.1) - 2024/08/05 13:09:19
Table 'RushAndCash21401052' 6-max Seat #1 is the button
Seat 1: b443b080 ($9.65 in chips)
Seat 2: 2dad5917 ($10.83 in chips)
Seat 3: 785352ba ($12.49 in chips)
Seat 4: Hero ($17.49 in chips)
Seat 5: a18ebac8 ($11.56 in chips)
Seat 6: f80c7735 ($10 in chips)
2dad5917: posts small blind $0.05
785352ba: posts big blind $0.1
*** HOLE CARDS ***
Dealt to b443b080 
Dealt to 2dad5917 
Dealt to 785352ba 
Dealt to Hero [9d 8s]
Dealt to a18ebac8 
Dealt to f80c7735 
Hero: folds
a18ebac8: folds
f80c7735: raises $0.1 to $0.2
b443b080: folds
2dad5917: folds
785352ba: folds
Uncalled bet ($0.1) returned to f80c7735
*** SHOWDOWN ***
f80c7735 collected $0.25 from pot
*** SUMMARY ***
Total pot $0.25 | Rake $0 | Jackpot $0 | Bingo $0 | Fortune $0 | Tax $0
Seat 1: b443b080 (button) folded before Flop (didn't bet)
Seat 2: 2dad5917 (small blind) folded before Flop
Seat 3: 785352ba (big blind) folded before Flop
Seat 4: Hero folded before Flop (didn't bet)
Seat 5: a18ebac8 folded before Flop (didn't bet)
Seat 6: f80c7735 collected ($0.25)


Poker Hand #RC2774805752: Hold'em No Limit ($0.05/$0.1) - 2024/08/05 13:09:14
Table 'RushAndCash21401012' 6-max Seat #1 is the button
Seat 1: 64bea18e ($24.41 in chips)
Seat 2: 6dd55590 ($20.53 in chips)
Seat 3: 87b7b835 ($13.2 in chips)
Seat 4: 67717882 ($13.97 in chips)
Seat 5: Hero ($17.49 in chips)
Seat 6: cb9c1345 ($19.47 in chips)
6dd55590: posts small blind $0.05
87b7b835: posts big blind $0.1
*** HOLE CARDS ***
Dealt to 64bea18e 
Dealt to 6dd55590 
Dealt to 87b7b835 
Dealt to 67717882 
Dealt to Hero [Jd 9c]
Dealt to cb9c1345 
67717882: folds
Hero: folds
cb9c1345: folds
64bea18e: folds
6dd55590: calls $0.05
87b7b835: checks
*** FLOP *** [3c Ah 6c]
6dd55590: bets $0.1
87b7b835: folds
Uncalled bet ($0.1) returned to 6dd55590
*** SHOWDOWN ***
6dd55590 collected $0.19 from pot
*** SUMMARY ***
Total pot $0.2 | Rake $0.01 | Jackpot $0 | Bingo $0 | Fortune $0 | Tax $0
Board [3c Ah 6c]
Seat 1: 64bea18e (button) folded before Flop (didn't bet)
Seat 2: 6dd55590 (small blind) won ($0.19)
Seat 3: 87b7b835 (big blind) folded on the Flop
Seat 4: 67717882 folded before Flop (didn't bet)
Seat 5: Hero folded before Flop (didn't bet)
Seat 6: cb9c1345 folded before Flop (didn't bet)


Poker Hand #RC2774805681: Hold'em No Limit ($0.05/$0.1) - 2024/08/05 13:09:04
Table 'RushAndCash21400941' 6-max Seat #1 is the button
Seat 1: 356b0e4 ($18.27 in chips)
Seat 2: e2f7fedf ($4.47 in chips)
Seat 3: cc0546d8 ($21.55 in chips)
Seat 4: 1420c485 ($9.95 in chips)
Seat 5: 64bea18e ($24.46 in chips)
Seat 6: Hero ($17.34 in chips)
e2f7fedf: posts small blind $0.05
cc0546d8: posts big blind $0.1
*** HOLE CARDS ***
Dealt to 356b0e4 
Dealt to e2f7fedf 
Dealt to cc0546d8 
Dealt to 1420c485 
Dealt to 64bea18e 
Dealt to Hero [8d 7d]
1420c485: folds
64bea18e: folds
Hero: raises $0.14 to $0.24
356b0e4: folds
e2f7fedf: folds
cc0546d8: folds
Uncalled bet ($0.14) returned to Hero
*** SHOWDOWN ***
Hero collected $0.25 from pot
*** SUMMARY ***
Total pot $0.25 | Rake $0 | Jackpot $0 | Bingo $0 | Fortune $0 | Tax $0
Seat 1: 356b0e4 (button) folded before Flop (didn't bet)
Seat 2: e2f7fedf (small blind) folded before Flop
Seat 3: cc0546d8 (big blind) folded before Flop
Seat 4: 1420c485 folded before Flop (didn't bet)
Seat 5: 64bea18e folded before Flop (didn't bet)
Seat 6: Hero collected ($0.25)


Poker Hand #RC2774805657: Hold'em No Limit ($0.05/$0.1) - 2024/08/05 13:09:01
Table 'RushAndCash21400917' 6-max Seat #1 is the button
Seat 1: Hero ($17.34 in chips)
Seat 2: 79b8113c ($10.05 in chips)
Seat 3: 57c66431 ($48.67 in chips)
Seat 4: e5b05063 ($16.71 in chips)
Seat 5: 6ad3e4ae ($11.94 in chips)
Seat 6: 4b22c6f1 ($9.47 in chips)
79b8113c: posts small blind $0.05
57c66431: posts big blind $0.1
*** HOLE CARDS ***
Dealt to Hero [Qc 2s]
Dealt to 79b8113c 
Dealt to 57c66431 
Dealt to e5b05063 
Dealt to 6ad3e4ae 
Dealt to 4b22c6f1 
e5b05063: raises $0.1 to $0.2
6ad3e4ae: raises $0.65 to $0.85
4b22c6f1: folds
Hero: folds
79b8113c: folds
57c66431: folds
e5b05063: folds
Uncalled bet ($0.65) returned to 6ad3e4ae
*** SHOWDOWN ***
6ad3e4ae collected $0.53 from pot
*** SUMMARY ***
Total pot $0.55 | Rake $0.02 | Jackpot $0 | Bingo $0 | Fortune $0 | Tax $0
Seat 1: Hero (button) folded before Flop (didn't bet)
Seat 2: 79b8113c (small blind) folded before Flop
Seat 3: 57c66431 (big blind) folded before Flop
Seat 4: e5b05063 folded before Flop
Seat 5: 6ad3e4ae collected ($0.53)
Seat 6: 4b22c6f1 folded before Flop (didn't bet)


Poker Hand #RC2774805618: Hold'em No Limit ($0.05/$0.1) - 2024/08/05 13:08:56
Table 'RushAndCash21400878' 6-max Seat #1 is the button
Seat 1: 3d571954 ($22.78 in chips)
Seat 2: Hero ($17.39 in chips)
Seat 3: 4fe4b721 ($11.73 in chips)
Seat 4: cb36ee1c ($11.6 in chips)
Seat 5: 9f6ee343 ($9.7 in chips)
Seat 6: cc0546d8 ($21.55 in chips)
Hero: posts small blind $0.05
4fe4b721: posts big blind $0.1
*** HOLE CARDS ***
Dealt to 3d571954 
Dealt to Hero [Ac 8s]
Dealt to 4fe4b721 
Dealt to cb36ee1c 
Dealt to 9f6ee343 
Dealt to cc0546d8 
cb36ee1c: folds
9f6ee343: folds
cc0546d8: folds
3d571954: folds
Hero: folds
Uncalled bet ($0.05) returned to 4fe4b721
*** SHOWDOWN ***
4fe4b721 collected $0.1 from pot
*** SUMMARY ***
Total pot $0.1 | Rake $0 | Jackpot $0 | Bingo $0 | Fortune $0 | Tax $0
Seat 1: 3d571954 (button) folded before Flop (didn't bet)
Seat 2: Hero (small blind) folded before Flop
Seat 3: 4fe4b721 (big blind) collected ($0.1)
Seat 4: cb36ee1c folded before Flop (didn't bet)
Seat 5: 9f6ee343 folded before Flop (didn't bet)
Seat 6: cc0546d8 folded before Flop (didn't bet)


Poker Hand #RC2774805581: Hold'em No Limit ($0.05/$0.1) - 2024/08/05 13:08:51
Table 'RushAndCash21400841' 6-max Seat #1 is the button
Seat 1: 20c154a7 ($30.48 in chips)
Seat 2: 4b22c6f1 ($9.52 in chips)
Seat 3: 5b615242 ($10.49 in chips)
Seat 4: cd78b009 ($10 in chips)
Seat 5: Hero ($17.39 in chips)
Seat 6: 4573cbdf ($10.85 in chips)
4b22c6f1: posts small blind $0.05
5b615242: posts big blind $0.1
*** HOLE CARDS ***
Dealt to 20c154a7 
Dealt to 4b22c6f1 
Dealt to 5b615242 
Dealt to cd78b009 
Dealt to Hero [6c 7s]
Dealt to 4573cbdf 
cd78b009: folds
Hero: folds
4573cbdf: folds
20c154a7: folds
4b22c6f1: folds
Uncalled bet ($0.05) returned to 5b615242
*** SHOWDOWN ***
5b615242 collected $0.1 from pot
*** SUMMARY ***
Total pot $0.1 | Rake $0 | Jackpot $0 | Bingo $0 | Fortune $0 | Tax $0
Seat 1: 20c154a7 (button) folded before Flop (didn't bet)
Seat 2: 4b22c6f1 (small blind) folded before Flop
Seat 3: 5b615242 (big blind) collected ($0.1)
Seat 4: cd78b009 folded before Flop (didn't bet)
Seat 5: Hero folded before Flop (didn't bet)
Seat 6: 4573cbdf folded before Flop (didn't bet)


Poker Hand #RC2774805503: Hold'em No Limit ($0.05/$0.1) - 2024/08/05 13:08:42
Table 'RushAndCash21400763' 6-max Seat #1 is the button
Seat 1: Hero ($17.39 in chips)
Seat 2: 296b28c7 ($10.53 in chips)
Seat 3: fbe6dd7e ($13.42 in chips)
Seat 4: 2672cac2 ($12.23 in chips)
Seat 5: 9f9a72c7 ($12.02 in chips)
Seat 6: a9fa9cd4 ($11.15 in chips)
296b28c7: posts small blind $0.05
fbe6dd7e: posts big blind $0.1
*** HOLE CARDS ***
Dealt to Hero [8h 4h]
Dealt to 296b28c7 
Dealt to fbe6dd7e 
Dealt to 2672cac2 
Dealt to 9f9a72c7 
Dealt to a9fa9cd4 
2672cac2: raises $0.19 to $0.29
9f9a72c7: folds
a9fa9cd4: folds
Hero: folds
296b28c7: folds
fbe6dd7e: calls $0.19
*** FLOP *** [6d Tc Js]
fbe6dd7e: checks
2672cac2: bets $0.5
fbe6dd7e: folds
Uncalled bet ($0.5) returned to 2672cac2
*** SHOWDOWN ***
2672cac2 collected $0.6 from pot
*** SUMMARY ***
Total pot $0.63 | Rake $0.03 | Jackpot $0 | Bingo $0 | Fortune $0 | Tax $0
Board [6d Tc Js]
Seat 1: Hero (button) folded before Flop (didn't bet)
Seat 2: 296b28c7 (small blind) folded before Flop
Seat 3: fbe6dd7e (big blind) folded on the Flop
Seat 4: 2672cac2 won ($0.6)
Seat 5: 9f9a72c7 folded before Flop (didn't bet)
Seat 6: a9fa9cd4 folded before Flop (didn't bet)


Poker Hand #RC2774805375: Hold'em No Limit ($0.05/$0.1) - 2024/08/05 13:08:25
Table 'RushAndCash21400635' 6-max Seat #1 is the button
Seat 1: b3c09d40 ($14.01 in chips)
Seat 2: a0ab68d2 ($10.2 in chips)
Seat 3: Hero ($17.49 in chips)
Seat 4: 785352ba ($13.39 in chips)
Seat 5: bec0764 ($10.82 in chips)
Seat 6: e293921a ($10.9 in chips)
a0ab68d2: posts small blind $0.05
Hero: posts big blind $0.1
*** HOLE CARDS ***
Dealt to b3c09d40 
Dealt to a0ab68d2 
Dealt to Hero [4c Js]
Dealt to 785352ba 
Dealt to bec0764 
Dealt to e293921a 
785352ba: folds
bec0764: folds
e293921a: folds
b3c09d40: raises $0.15 to $0.25
a0ab68d2: folds
Hero: folds
Uncalled bet ($0.15) returned to b3c09d40
*** SHOWDOWN ***
b3c09d40 collected $0.25 from pot
*** SUMMARY ***
Total pot $0.25 | Rake $0 | Jackpot $0 | Bingo $0 | Fortune $0 | Tax $0
Seat 1: b3c09d40 (button) collected ($0.25)
Seat 2: a0ab68d2 (small blind) folded before Flop
Seat 3: Hero (big blind) folded before Flop
Seat 4: 785352ba folded before Flop (didn't bet)
Seat 5: bec0764 folded before Flop (didn't bet)
Seat 6: e293921a folded before Flop (didn't bet)


Poker Hand #RC2774805350: Hold'em No Limit ($0.05/$0.1) - 2024/08/05 13:08:22
Table 'RushAndCash21400610' 6-max Seat #1 is the button
Seat 1: 4926243e ($10 in chips)
Seat 2: d88fba59 ($11.86 in chips)
Seat 3: 3fe53689 ($13.93 in chips)
Seat 4: bbbdeaa8 ($11.37 in chips)
Seat 5: Hero ($17.49 in chips)
Seat 6: bb387656 ($20.64 in chips)
d88fba59: posts small blind $0.05
3fe53689: posts big blind $0.1
*** HOLE CARDS ***
Dealt to 4926243e 
Dealt to d88fba59 
Dealt to 3fe53689 
Dealt to bbbdeaa8 
Dealt to Hero [9s 9d]
Dealt to bb387656 
bbbdeaa8: folds
Hero: folds
bb387656: folds
4926243e: folds
d88fba59: raises $0.2 to $0.3
3fe53689: folds
Uncalled bet ($0.2) returned to d88fba59
*** SHOWDOWN ***
d88fba59 collected $0.2 from pot
*** SUMMARY ***
Total pot $0.2 | Rake $0 | Jackpot $0 | Bingo $0 | Fortune $0 | Tax $0
Seat 1: 4926243e (button) folded before Flop (didn't bet)
Seat 2: d88fba59 (small blind) collected ($0.2)
Seat 3: 3fe53689 (big blind) folded before Flop
Seat 4: bbbdeaa8 folded before Flop (didn't bet)
Seat 5: Hero folded before Flop (didn't bet)
Seat 6: bb387656 folded before Flop (didn't bet)


Poker Hand #RC2774805294: Hold'em No Limit ($0.05/$0.1) - 2024/08/05 13:08:15
Table 'RushAndCash21400554' 6-max Seat #1 is the button
Seat 1: 7166ca79 ($3.55 in chips)
Seat 2: c261520c ($10.13 in chips)
Seat 3: 128f6aab ($9.99 in chips)
Seat 4: aad2fdf5 ($10.15 in chips)
Seat 5: fdb7f034 ($26.83 in chips)
Seat 6: Hero ($17.49 in chips)
c261520c: posts small blind $0.05
128f6aab: posts big blind $0.1
*** HOLE CARDS ***
Dealt to 7166ca79 
Dealt to c261520c 
Dealt to 128f6aab 
Dealt to aad2fdf5 
Dealt to fdb7f034 
Dealt to Hero [5h Th]
aad2fdf5: folds
fdb7f034: folds
Hero: folds
7166ca79: raises $0.1 to $0.2
c261520c: folds
128f6aab: folds
Uncalled bet ($0.1) returned to 7166ca79
*** SHOWDOWN ***
7166ca79 collected $0.25 from pot
*** SUMMARY ***
Total pot $0.25 | Rake $0 | Jackpot $0 | Bingo $0 | Fortune $0 | Tax $0
Seat 1: 7166ca79 (button) collected ($0.25)
Seat 2: c261520c (small blind) folded before Flop
Seat 3: 128f6aab (big blind) folded before Flop
Seat 4: aad2fdf5 folded before Flop (didn't bet)
Seat 5: fdb7f034 folded before Flop (didn't bet)
Seat 6: Hero folded before Flop (didn't bet)


Poker Hand #RC2774805235: Hold'em No Limit ($0.05/$0.1) - 2024/08/05 13:08:06
Table 'RushAndCash21400495' 6-max Seat #1 is the button
Seat 1: d02f7584 ($10 in chips)
Seat 2: 687bb32e ($10 in chips)
Seat 3: e25d0386 ($10.77 in chips)
Seat 4: Hero ($17.49 in chips)
Seat 5: 58493363 ($19.34 in chips)
Seat 6: d4638148 ($6.57 in chips)
687bb32e: posts small blind $0.05
e25d0386: posts big blind $0.1
*** HOLE CARDS ***
Dealt to d02f7584 
Dealt to 687bb32e 
Dealt to e25d0386 
Dealt to Hero [7c 2s]
Dealt to 58493363 
Dealt to d4638148 
Hero: folds
58493363: folds
d4638148: folds
d02f7584: raises $0.1 to $0.2
687bb32e: folds
e25d0386: calls $0.1
*** FLOP *** [Ac 4d Td]
e25d0386: checks
d02f7584: bets $0.15
e25d0386: calls $0.15
*** TURN *** [Ac 4d Td] [8s]
e25d0386: checks
d02f7584: bets $1.05
e25d0386: calls $1.05
*** RIVER *** [Ac 4d Td 8s] [3d]
e25d0386: bets $1.27
d02f7584: raises $7.33 to $8.6 and is all-in
e25d0386: folds
Uncalled bet ($7.33) returned to d02f7584
*** SHOWDOWN ***
d02f7584 collected $4.98 from pot
*** SUMMARY ***
Total pot $5.39 | Rake $0.26 | Jackpot $0.15 | Bingo $0 | Fortune $0 | Tax $0
Board [Ac 4d Td 8s 3d]
Seat 1: d02f7584 (button) won ($4.98)
Seat 2: 687bb32e (small blind) folded before Flop
Seat 3: e25d0386 (big blind) folded on the River
Seat 4: Hero folded before Flop (didn't bet)
Seat 5: 58493363 folded before Flop (didn't bet)
Seat 6: d4638148 folded before Flop (didn't bet)


Poker Hand #RC2774805163: Hold'em No Limit ($0.05/$0.1) - 2024/08/05 13:07:57
Table 'RushAndCash21400423' 6-max Seat #1 is the button
Seat 1: ac724a39 ($9.33 in chips)
Seat 2: 1f9d7383 ($10.92 in chips)
Seat 3: b46cd127 ($10.13 in chips)
Seat 4: c74379b8 ($10.2 in chips)
Seat 5: 2c6f3320 ($10 in chips)
Seat 6: Hero ($17.49 in chips)
1f9d7383: posts small blind $0.05
b46cd127: posts big blind $0.1
*** HOLE CARDS ***
Dealt to ac724a39 
Dealt to 1f9d7383 
Dealt to b46cd127 
Dealt to c74379b8 
Dealt to 2c6f3320 
Dealt to Hero [9s 8s]
c74379b8: folds
2c6f3320: raises $0.1 to $0.2
Hero: folds
ac724a39: folds
1f9d7383: folds
b46cd127: folds
Uncalled bet ($0.1) returned to 2c6f3320
*** SHOWDOWN ***
2c6f3320 collected $0.25 from pot
*** SUMMARY ***
Total pot $0.25 | Rake $0 | Jackpot $0 | Bingo $0 | Fortune $0 | Tax $0
Seat 1: ac724a39 (button) folded before Flop (didn't bet)
Seat 2: 1f9d7383 (small blind) folded before Flop
Seat 3: b46cd127 (big blind) folded before Flop
Seat 4: c74379b8 folded before Flop (didn't bet)
Seat 5: 2c6f3320 collected ($0.25)
Seat 6: Hero folded before Flop (didn't bet)


Poker Hand #RC2774805125: Hold'em No Limit ($0.05/$0.1) - 2024/08/05 13:07:52
Table 'RushAndCash21400385' 6-max Seat #1 is the button
Seat 1: ef76fdc ($21.84 in chips)
Seat 2: 667b2f9 ($10.29 in chips)
Seat 3: 64326c84 ($11.04 in chips)
Seat 4: Hero ($17.49 in chips)
Seat 5: 181147a1 ($10.21 in chips)
Seat 6: 2b02f739 ($10 in chips)
667b2f9: posts small blind $0.05
64326c84: posts big blind $0.1
*** HOLE CARDS ***
Dealt to ef76fdc 
Dealt to 667b2f9 
Dealt to 64326c84 
Dealt to Hero [8c 3c]
Dealt to 181147a1 
Dealt to 2b02f739 
Hero: folds
181147a1: folds
2b02f739: folds
ef76fdc: folds
667b2f9: folds
Uncalled bet ($0.05) returned to 64326c84
*** SHOWDOWN ***
64326c84 collected $0.1 from pot
*** SUMMARY ***
Total pot $0.1 | Rake $0 | Jackpot $0 | Bingo $0 | Fortune $0 | Tax $0
Seat 1: ef76fdc (button) folded before Flop (didn't bet)
Seat 2: 667b2f9 (small blind) folded before Flop
Seat 3: 64326c84 (big blind) collected ($0.1)
Seat 4: Hero folded before Flop (didn't bet)
Seat 5: 181147a1 folded before Flop (didn't bet)
Seat 6: 2b02f739 folded before Flop (didn't bet)


Poker Hand #RC2774805069: Hold'em No Limit ($0.05/$0.1) - 2024/08/05 13:07:44
Table 'RushAndCash21400329' 6-max Seat #1 is the button
Seat 1: 1dc8e473 ($18.53 in chips)
Seat 2: Hero ($17.54 in chips)
Seat 3: e293921a ($10.49 in chips)
Seat 4: eca0bbe7 ($5.45 in chips)
Seat 5: 2c8ec31b ($18.23 in chips)
Seat 6: 8a8ac0ba ($26.67 in chips)
Hero: posts small blind $0.05
e293921a: posts big blind $0.1
*** HOLE CARDS ***
Dealt to 1dc8e473 
Dealt to Hero [As 2c]
Dealt to e293921a 
Dealt to eca0bbe7 
Dealt to 2c8ec31b 
Dealt to 8a8ac0ba 
eca0bbe7: folds
2c8ec31b: raises $0.12 to $0.22
8a8ac0ba: folds
1dc8e473: folds
Hero: folds
e293921a: folds
Uncalled bet ($0.12) returned to 2c8ec31b
*** SHOWDOWN ***
2c8ec31b collected $0.25 from pot
*** SUMMARY ***
Total pot $0.25 | Rake $0 | Jackpot $0 | Bingo $0 | Fortune $0 | Tax $0
Seat 1: 1dc8e473 (button) folded before Flop (didn't bet)
Seat 2: Hero (small blind) folded before Flop
Seat 3: e293921a (big blind) folded before Flop
Seat 4: eca0bbe7 folded before Flop (didn't bet)
Seat 5: 2c8ec31b collected ($0.25)
Seat 6: 8a8ac0ba folded before Flop (didn't bet)


Poker Hand #RC2774764528: Hold'em No Limit ($0.05/$0.1) - 2024/08/05 13:06:28
Table 'RushAndCash21399788' 6-max Seat #1 is the button
Seat 1: 687bb32e ($10 in chips)
Seat 2: 2da240f5 ($27.86 in chips)
Seat 3: Hero ($16.95 in chips)
Seat 4: 8d51c9b1 ($33.75 in chips)
Seat 5: 8617f6d1 ($10.88 in chips)
Seat 6: 63c91dca ($12.02 in chips)
2da240f5: posts small blind $0.05
Hero: posts big blind $0.1
*** HOLE CARDS ***
Dealt to 687bb32e 
Dealt to 2da240f5 
Dealt to Hero [Kd 7d]
Dealt to 8d51c9b1 
Dealt to 8617f6d1 
Dealt to 63c91dca 
8d51c9b1: folds
8617f6d1: folds
63c91dca: folds
687bb32e: raises $0.15 to $0.25
2da240f5: folds
Hero: calls $0.15
*** FLOP *** [9h Ts 7c]
Hero: checks
687bb32e: bets $0.35
Hero: calls $0.35
*** TURN *** [9h Ts 7c] [8s]
Hero: checks
687bb32e: checks
*** RIVER *** [9h Ts 7c 8s] [3d]
Hero: bets $0.93
687bb32e: folds
Uncalled bet ($0.93) returned to Hero
*** SHOWDOWN ***
Hero collected $1.19 from pot
*** SUMMARY ***
Total pot $1.25 | Rake $0.06 | Jackpot $0 | Bingo $0 | Fortune $0 | Tax $0
Board [9h Ts 7c 8s 3d]
Seat 1: 687bb32e (button) folded on the River
Seat 2: 2da240f5 (small blind) folded before Flop
Seat 3: Hero (big blind) won ($1.19)
Seat 4: 8d51c9b1 folded before Flop (didn't bet)
Seat 5: 8617f6d1 folded before Flop (didn't bet)
Seat 6: 63c91dca folded before Flop (didn't bet)


Poker Hand #RC2774764502: Hold'em No Limit ($0.05/$0.1) - 2024/08/05 13:06:25
Table 'RushAndCash21399762' 6-max Seat #1 is the button
Seat 1: Hero ($16.95 in chips)
Seat 2: 8617f6d1 ($10.93 in chips)
Seat 3: ba4cd173 ($16.33 in chips)
Seat 4: 9c60b231 ($18.36 in chips)
Seat 5: 136b30cf ($21.06 in chips)
Seat 6: f9b9586e ($19.86 in chips)
8617f6d1: posts small blind $0.05
ba4cd173: posts big blind $0.1
*** HOLE CARDS ***
Dealt to Hero [6c 3c]
Dealt to 8617f6d1 
Dealt to ba4cd173 
Dealt to 9c60b231 
Dealt to 136b30cf 
Dealt to f9b9586e 
9c60b231: raises $0.1 to $0.2
136b30cf: folds
f9b9586e: folds
Hero: folds
8617f6d1: folds
ba4cd173: folds
Uncalled bet ($0.1) returned to 9c60b231
*** SHOWDOWN ***
9c60b231 collected $0.25 from pot
*** SUMMARY ***
Total pot $0.25 | Rake $0 | Jackpot $0 | Bingo $0 | Fortune $0 | Tax $0
Seat 1: Hero (button) folded before Flop (didn't bet)
Seat 2: 8617f6d1 (small blind) folded before Flop
Seat 3: ba4cd173 (big blind) folded before Flop
Seat 4: 9c60b231 collected ($0.25)
Seat 5: 136b30cf folded before Flop (didn't bet)
Seat 6: f9b9586e folded before Flop (didn't bet)


Poker Hand #RC2774764467: Hold'em No Limit ($0.05/$0.1) - 2024/08/05 13:06:21
Table 'RushAndCash21399727' 6-max Seat #1 is the button
Seat 1: ab7c1e6 ($13.11 in chips)
Seat 2: Hero ($17 in chips)
Seat 3: 5580da68 ($10.33 in chips)
Seat 4: 9f9a72c7 ($11.77 in chips)
Seat 5: 59cf4dd4 ($10 in chips)
Seat 6: 4edd5570 ($35.37 in chips)
Hero: posts small blind $0.05
5580da68: posts big blind $0.1
*** HOLE CARDS ***
Dealt to ab7c1e6 
Dealt to Hero [Jd 3h]
Dealt to 5580da68 
Dealt to 9f9a72c7 
Dealt to 59cf4dd4 
Dealt to 4edd5570 
9f9a72c7: folds
59cf4dd4: folds
4edd5570: folds
ab7c1e6: raises $0.2 to $0.3
Hero: folds
5580da68: folds
Uncalled bet ($0.2) returned to ab7c1e6
*** SHOWDOWN ***
ab7c1e6 collected $0.25 from pot
*** SUMMARY ***
Total pot $0.25 | Rake $0 | Jackpot $0 | Bingo $0 | Fortune $0 | Tax $0
Seat 1: ab7c1e6 (button) collected ($0.25)
Seat 2: Hero (small blind) folded before Flop
Seat 3: 5580da68 (big blind) folded before Flop
Seat 4: 9f9a72c7 folded before Flop (didn't bet)
Seat 5: 59cf4dd4 folded before Flop (didn't bet)
Seat 6: 4edd5570 folded before Flop (didn't bet)


Poker Hand #RC2774764441: Hold'em No Limit ($0.05/$0.1) - 2024/08/05 13:06:17
Table 'RushAndCash21399701' 6-max Seat #1 is the button
Seat 1: 51ff7f48 ($5.23 in chips)
Seat 2: 10a76e0 ($10 in chips)
Seat 3: Hero ($17.1 in chips)
Seat 4: c624f734 ($3.23 in chips)
Seat 5: 8ead4151 ($20.33 in chips)
Seat 6: 6a7f51e1 ($10.18 in chips)
10a76e0: posts small blind $0.05
Hero: posts big blind $0.1
*** HOLE CARDS ***
Dealt to 51ff7f48 
Dealt to 10a76e0 
Dealt to Hero [Qc 8s]
Dealt to c624f734 
Dealt to 8ead4151 
Dealt to 6a7f51e1 
c624f734: raises $0.1 to $0.2
8ead4151: raises $0.32 to $0.52
6a7f51e1: folds
51ff7f48: calls $0.52
10a76e0: folds
Hero: folds
c624f734: calls $0.32
*** FLOP *** [Ac Jc 5d]
c624f734: bets $0.57
8ead4151: calls $0.57
51ff7f48: calls $0.57
*** TURN *** [Ac Jc 5d] [Th]
c624f734: checks
8ead4151: checks
51ff7f48: checks
*** RIVER *** [Ac Jc 5d Th] [2s]
c624f734: bets $1.13
8ead4151: calls $1.13
51ff7f48: folds
c624f734: shows [As 5s] (Pair of Aces and Pair of Fives)
8ead4151: shows [4h Ah] (Pair of Aces)
*** SHOWDOWN ***
c624f734 collected $5.26 from pot
*** SUMMARY ***
Total pot $5.68 | Rake $0.27 | Jackpot $0.15 | Bingo $0 | Fortune $0 | Tax $0
Board [Ac Jc 5d Th 2s]
Seat 1: 51ff7f48 (button) folded on the River
Seat 2: 10a76e0 (small blind) folded before Flop
Seat 3: Hero (big blind) folded before Flop
Seat 4: c624f734 showed [As 5s] and won ($5.26) with Pair of Aces and Pair of Fives
Seat 5: 8ead4151 showed [4h Ah] and lost with Pair of Aces
Seat 6: 6a7f51e1 folded before Flop (didn't bet)


Poker Hand #RC2774764418: Hold'em No Limit ($0.05/$0.1) - 2024/08/05 13:06:13
Table 'RushAndCash21399678' 6-max Seat #1 is the button
Seat 1: Hero ($17.1 in chips)
Seat 2: 51ff7f48 ($5.28 in chips)
Seat 3: 62ef8cc4 ($26.48 in chips)
Seat 4: 34f8bad ($32.41 in chips)
Seat 5: 4aaba1a4 ($4.94 in chips)
Seat 6: 5a2ff57f ($10.15 in chips)
51ff7f48: posts small blind $0.05
62ef8cc4: posts big blind $0.1
*** HOLE CARDS ***
Dealt to Hero [3s 6h]
Dealt to 51ff7f48 
Dealt to 62ef8cc4 
Dealt to 34f8bad 
Dealt to 4aaba1a4 
Dealt to 5a2ff57f 
34f8bad: raises $0.1 to $0.2
4aaba1a4: folds
5a2ff57f: raises $0.41 to $0.61
Hero: folds
51ff7f48: folds
62ef8cc4: folds
34f8bad: calls $0.41
*** FLOP *** [7s Tc 2c]
34f8bad: checks
5a2ff57f: checks
*** TURN *** [7s Tc 2c] [7h]
34f8bad: bets $0.7
5a2ff57f: calls $0.7
*** RIVER *** [7s Tc 2c 7h] [7c]
34f8bad: bets $1.42
5a2ff57f: calls $1.42
34f8bad: shows [Qh Ah] (Three Sevens)
5a2ff57f: shows [4d 4h] (Sevens Full over Fours)
*** SHOWDOWN ***
5a2ff57f collected $5.19 from pot
*** SUMMARY ***
Total pot $5.61 | Rake $0.27 | Jackpot $0.15 | Bingo $0 | Fortune $0 | Tax $0
Board [7s Tc 2c 7h 7c]
Seat 1: Hero (button) folded before Flop (didn't bet)
Seat 2: 51ff7f48 (small blind) folded before Flop
Seat 3: 62ef8cc4 (big blind) folded before Flop
Seat 4: 34f8bad showed [Qh Ah] and lost with Three Sevens
Seat 5: 4aaba1a4 folded before Flop (didn't bet)
Seat 6: 5a2ff57f showed [4d 4h] and won ($5.19) with Sevens Full over Fours


Poker Hand #RC2774764393: Hold'em No Limit ($0.05/$0.1) - 2024/08/05 13:06:09
Table 'RushAndCash21399653' 6-max Seat #1 is the button
Seat 1: 22180e5d ($10 in chips)
Seat 2: 4f612bdf ($12.46 in chips)
Seat 3: 16cacf93 ($10 in chips)
Seat 4: Hero ($17.1 in chips)
Seat 5: 21f8b6f6 ($10.19 in chips)
Seat 6: 41727a67 ($10 in chips)
4f612bdf: posts small blind $0.05
16cacf93: posts big blind $0.1
*** HOLE CARDS ***
Dealt to 22180e5d 
Dealt to 4f612bdf 
Dealt to 16cacf93 
Dealt to Hero [6c Ts]
Dealt to 21f8b6f6 
Dealt to 41727a67 
Hero: folds
21f8b6f6: raises $0.1 to $0.2
41727a67: folds
22180e5d: folds
4f612bdf: folds
16cacf93: folds
Uncalled bet ($0.1) returned to 21f8b6f6
*** SHOWDOWN ***
21f8b6f6 collected $0.25 from pot
*** SUMMARY ***
Total pot $0.25 | Rake $0 | Jackpot $0 | Bingo $0 | Fortune $0 | Tax $0
Seat 1: 22180e5d (button) folded before Flop (didn't bet)
Seat 2: 4f612bdf (small blind) folded before Flop
Seat 3: 16cacf93 (big blind) folded before Flop
Seat 4: Hero folded before Flop (didn't bet)
Seat 5: 21f8b6f6 collected ($0.25)
Seat 6: 41727a67 folded before Flop (didn't bet)


Poker Hand #RC2774764369: Hold'em No Limit ($0.05/$0.1) - 2024/08/05 13:06:06
Table 'RushAndCash21399629' 6-max Seat #1 is the button
Seat 1: e574d31f ($10 in chips)
Seat 2: 13296c59 ($10 in chips)
Seat 3: 39458145 ($10.37 in chips)
Seat 4: 73207420 ($17.43 in chips)
Seat 5: 25f61eac ($11.78 in chips)
Seat 6: Hero ($17.1 in chips)
13296c59: posts small blind $0.05
39458145: posts big blind $0.1
*** HOLE CARDS ***
Dealt to e574d31f 
Dealt to 13296c59 
Dealt to 39458145 
Dealt to 73207420 
Dealt to 25f61eac 
Dealt to Hero [4h Tc]
73207420: raises $0.1 to $0.2
25f61eac: folds
Hero: folds
e574d31f: folds
13296c59: folds
39458145: folds
Uncalled bet ($0.1) returned to 73207420
*** SHOWDOWN ***
73207420 collected $0.25 from pot
*** SUMMARY ***
Total pot $0.25 | Rake $0 | Jackpot $0 | Bingo $0 | Fortune $0 | Tax $0
Seat 1: e574d31f (button) folded before Flop (didn't bet)
Seat 2: 13296c59 (small blind) folded before Flop
Seat 3: 39458145 (big blind) folded before Flop
Seat 4: 73207420 collected ($0.25)
Seat 5: 25f61eac folded before Flop (didn't bet)
Seat 6: Hero folded before Flop (didn't bet)


Poker Hand #RC2774764158: Hold'em No Limit ($0.05/$0.1) - 2024/08/05 13:05:35
Table 'RushAndCash21399418' 6-max Seat #1 is the button
Seat 1: cbe44fcb ($11.58 in chips)
Seat 2: 661faef ($16.24 in chips)
Seat 3: 92e556de ($36.97 in chips)
Seat 4: 41520222 ($10 in chips)
Seat 5: 7c936b7c ($19.7 in chips)
Seat 6: Hero ($16.32 in chips)
661faef: posts small blind $0.05
92e556de: posts big blind $0.1
*** HOLE CARDS ***
Dealt to cbe44fcb 
Dealt to 661faef 
Dealt to 92e556de 
Dealt to 41520222 
Dealt to 7c936b7c 
Dealt to Hero [9d 9s]
41520222: folds
7c936b7c: raises $0.1 to $0.2
Hero: raises $0.5 to $0.7
cbe44fcb: folds
661faef: folds
92e556de: folds
7c936b7c: calls $0.5
*** FLOP *** [Jd Ks 6d]
7c936b7c: checks
Hero: bets $0.7
7c936b7c: folds
Uncalled bet ($0.7) returned to Hero
*** SHOWDOWN ***
Hero collected $1.48 from pot
*** SUMMARY ***
Total pot $1.55 | Rake $0.07 | Jackpot $0 | Bingo $0 | Fortune $0 | Tax $0
Board [Jd Ks 6d]
Seat 1: cbe44fcb (button) folded before Flop (didn't bet)
Seat 2: 661faef (small blind) folded before Flop
Seat 3: 92e556de (big blind) folded before Flop
Seat 4: 41520222 folded before Flop (didn't bet)
Seat 5: 7c936b7c folded on the Flop
Seat 6: Hero won ($1.48)


Poker Hand #RC2774764132: Hold'em No Limit ($0.05/$0.1) - 2024/08/05 13:05:31
Table 'RushAndCash21399392' 6-max Seat #1 is the button
Seat 1: d1e44e47 ($20.99 in chips)
Seat 2: 70126d5c ($23.41 in chips)
Seat 3: b123c7a2 ($10.08 in chips)
Seat 4: Hero ($16.32 in chips)
Seat 5: e45850f1 ($12.51 in chips)
Seat 6: 71e51e91 ($15.12 in chips)
70126d5c: posts small blind $0.05
b123c7a2: posts big blind $0.1
*** HOLE CARDS ***
Dealt to d1e44e47 
Dealt to 70126d5c 
Dealt to b123c7a2 
Dealt to Hero [9h 8d]
Dealt to e45850f1 
Dealt to 71e51e91 
Hero: folds
e45850f1: raises $0.2 to $0.3
71e51e91: raises $0.57 to $0.87
d1e44e47: folds
70126d5c: folds
b123c7a2: folds
e45850f1: calls $0.57
*** FLOP *** [2h 3h Qs]
e45850f1: checks
71e51e91: bets $0.95
e45850f1: calls $0.95
*** TURN *** [2h 3h Qs] [Tc]
e45850f1: checks
71e51e91: bets $3.79
e45850f1: folds
Uncalled bet ($3.79) returned to 71e51e91
*** SHOWDOWN ***
71e51e91 collected $3.46 from pot
*** SUMMARY ***
Total pot $3.79 | Rake $0.18 | Jackpot $0.15 | Bingo $0 | Fortune $0 | Tax $0
Board [2h 3h Qs Tc]
Seat 1: d1e44e47 (button) folded before Flop (didn't bet)
Seat 2: 70126d5c (small blind) folded before Flop
Seat 3: b123c7a2 (big blind) folded before Flop
Seat 4: Hero folded before Flop (didn't bet)
Seat 5: e45850f1 folded on the Turn
Seat 6: 71e51e91 won ($3.46)


Poker Hand #RC2774763974: Hold'em No Limit ($0.05/$0.1) - 2024/08/05 13:05:08
Table 'RushAndCash21399234' 6-max Seat #1 is the button
Seat 1: f058296c ($14.06 in chips)
Seat 2: 136b30cf ($21.46 in chips)
Seat 3: Hero ($16.57 in chips)
Seat 4: a6028eea ($12.91 in chips)
Seat 5: d1e44e47 ($20.71 in chips)
Seat 6: 15e8bc52 ($13.93 in chips)
136b30cf: posts small blind $0.05
Hero: posts big blind $0.1
*** HOLE CARDS ***
Dealt to f058296c 
Dealt to 136b30cf 
Dealt to Hero [9s 9d]
Dealt to a6028eea 
Dealt to d1e44e47 
Dealt to 15e8bc52 
a6028eea: folds
d1e44e47: raises $0.15 to $0.25
15e8bc52: folds
f058296c: folds
136b30cf: folds
Hero: calls $0.15
*** FLOP *** [Ad Jd 7c]
Hero: checks
d1e44e47: bets $0.3
Hero: folds
Uncalled bet ($0.3) returned to d1e44e47
*** SHOWDOWN ***
d1e44e47 collected $0.53 from pot
*** SUMMARY ***
Total pot $0.55 | Rake $0.02 | Jackpot $0 | Bingo $0 | Fortune $0 | Tax $0
Board [Ad Jd 7c]
Seat 1: f058296c (button) folded before Flop (didn't bet)
Seat 2: 136b30cf (small blind) folded before Flop
Seat 3: Hero (big blind) folded on the Flop
Seat 4: a6028eea folded before Flop (didn't bet)
Seat 5: d1e44e47 won ($0.53)
Seat 6: 15e8bc52 folded before Flop (didn't bet)


Poker Hand #RC2774763947: Hold'em No Limit ($0.05/$0.1) - 2024/08/05 13:05:05
Table 'RushAndCash21399207' 6-max Seat #1 is the button
Seat 1: 2c8ec31b ($16.9 in chips)
Seat 2: Hero ($16.62 in chips)
Seat 3: b74de1f2 ($14.58 in chips)
Seat 4: 67ddcdcd ($27.92 in chips)
Seat 5: 7448bb3b ($18.89 in chips)
Seat 6: e5b05063 ($17.8 in chips)
Hero: posts small blind $0.05
b74de1f2: posts big blind $0.1
*** HOLE CARDS ***
Dealt to 2c8ec31b 
Dealt to Hero [3s 9s]
Dealt to b74de1f2 
Dealt to 67ddcdcd 
Dealt to 7448bb3b 
Dealt to e5b05063 
67ddcdcd: raises $0.1 to $0.2
7448bb3b: folds
e5b05063: folds
2c8ec31b: folds
Hero: folds
b74de1f2: folds
Uncalled bet ($0.1) returned to 67ddcdcd
*** SHOWDOWN ***
67ddcdcd collected $0.25 from pot
*** SUMMARY ***
Total pot $0.25 | Rake $0 | Jackpot $0 | Bingo $0 | Fortune $0 | Tax $0
Seat 1: 2c8ec31b (button) folded before Flop (didn't bet)
Seat 2: Hero (small blind) folded before Flop
Seat 3: b74de1f2 (big blind) folded before Flop
Seat 4: 67ddcdcd collected ($0.25)
Seat 5: 7448bb3b folded before Flop (didn't bet)
Seat 6: e5b05063 folded before Flop (didn't bet)


Poker Hand #RC2774763924: Hold'em No Limit ($0.05/$0.1) - 2024/08/05 13:05:01
Table 'RushAndCash21399184' 6-max Seat #1 is the button
Seat 1: e4b9a0ca ($10 in chips)
Seat 2: 2c8ec31b ($16.95 in chips)
Seat 3: 3e28455c ($10.15 in chips)
Seat 4: Hero ($16.62 in chips)
Seat 5: 5b8fbb9b ($5.82 in chips)
Seat 6: 8666fbab ($11.32 in chips)
2c8ec31b: posts small blind $0.05
3e28455c: posts big blind $0.1
*** HOLE CARDS ***
Dealt to e4b9a0ca 
Dealt to 2c8ec31b 
Dealt to 3e28455c 
Dealt to Hero [4d 4h]
Dealt to 5b8fbb9b 
Dealt to 8666fbab 
Hero: folds
5b8fbb9b: folds
8666fbab: raises $0.11 to $0.21
e4b9a0ca: raises $0.49 to $0.7
2c8ec31b: folds
3e28455c: folds
8666fbab: calls $0.49
*** FLOP *** [6s 2h 8d]
8666fbab: checks
e4b9a0ca: bets $0.38
8666fbab: folds
Uncalled bet ($0.38) returned to e4b9a0ca
*** SHOWDOWN ***
e4b9a0ca collected $1.48 from pot
*** SUMMARY ***
Total pot $1.55 | Rake $0.07 | Jackpot $0 | Bingo $0 | Fortune $0 | Tax $0
Board [6s 2h 8d]
Seat 1: e4b9a0ca (button) won ($1.48)
Seat 2: 2c8ec31b (small blind) folded before Flop
Seat 3: 3e28455c (big blind) folded before Flop
Seat 4: Hero folded before Flop (didn't bet)
Seat 5: 5b8fbb9b folded before Flop (didn't bet)
Seat 6: 8666fbab folded on the Flop


Poker Hand #RC2774763844: Hold'em No Limit ($0.05/$0.1) - 2024/08/05 13:04:50
Table 'RushAndCash21399104' 6-max Seat #1 is the button
Seat 1: Hero ($16.62 in chips)
Seat 2: 26f50e ($11.53 in chips)
Seat 3: c286ea21 ($10.05 in chips)
Seat 4: 96d7955 ($22.3 in chips)
Seat 5: 8f7c02cf ($14.74 in chips)
Seat 6: e293921a ($11.29 in chips)
26f50e: posts small blind $0.05
c286ea21: posts big blind $0.1
*** HOLE CARDS ***
Dealt to Hero [7s Js]
Dealt to 26f50e 
Dealt to c286ea21 
Dealt to 96d7955 
Dealt to 8f7c02cf 
Dealt to e293921a 
96d7955: raises $0.1 to $0.2
8f7c02cf: raises $0.4 to $0.6
e293921a: folds
Hero: folds
26f50e: folds
c286ea21: folds
96d7955: folds
Uncalled bet ($0.4) returned to 8f7c02cf
*** SHOWDOWN ***
8f7c02cf collected $0.53 from pot
*** SUMMARY ***
Total pot $0.55 | Rake $0.02 | Jackpot $0 | Bingo $0 | Fortune $0 | Tax $0
Seat 1: Hero (button) folded before Flop (didn't bet)
Seat 2: 26f50e (small blind) folded before Flop
Seat 3: c286ea21 (big blind) folded before Flop
Seat 4: 96d7955 folded before Flop
Seat 5: 8f7c02cf collected ($0.53)
Seat 6: e293921a folded before Flop (didn't bet)


Poker Hand #RC2774763758: Hold'em No Limit ($0.05/$0.1) - 2024/08/05 13:04:37
Table 'RushAndCash21399018' 6-max Seat #1 is the button
Seat 1: a4aad96a ($10 in chips)
Seat 2: df9a22ce ($2.91 in chips)
Seat 3: ac7d53db ($10 in chips)
Seat 4: Hero ($16.47 in chips)
Seat 5: 9c60b231 ($10.85 in chips)
Seat 6: 8dc77ce6 ($10 in chips)
df9a22ce: posts small blind $0.05
ac7d53db: posts big blind $0.1
*** HOLE CARDS ***
Dealt to a4aad96a 
Dealt to df9a22ce 
Dealt to ac7d53db 
Dealt to Hero [Ts Ks]
Dealt to 9c60b231 
Dealt to 8dc77ce6 
Hero: raises $0.1 to $0.2
9c60b231: folds
8dc77ce6: folds
a4aad96a: folds
df9a22ce: folds
ac7d53db: folds
Uncalled bet ($0.1) returned to Hero
*** SHOWDOWN ***
Hero collected $0.25 from pot
*** SUMMARY ***
Total pot $0.25 | Rake $0 | Jackpot $0 | Bingo $0 | Fortune $0 | Tax $0
Seat 1: a4aad96a (button) folded before Flop (didn't bet)
Seat 2: df9a22ce (small blind) folded before Flop
Seat 3: ac7d53db (big blind) folded before Flop
Seat 4: Hero collected ($0.25)
Seat 5: 9c60b231 folded before Flop (didn't bet)
Seat 6: 8dc77ce6 folded before Flop (didn't bet)


Poker Hand #RC2774763732: Hold'em No Limit ($0.05/$0.1) - 2024/08/05 13:04:33
Table 'RushAndCash21398992' 6-max Seat #1 is the button
Seat 1: 9eac8974 ($10.09 in chips)
Seat 2: cb9c1345 ($21.1 in chips)
Seat 3: 38043f9a ($11.95 in chips)
Seat 4: d9f4049e ($11.71 in chips)
Seat 5: Hero ($16.47 in chips)
Seat 6: 7721c598 ($10 in chips)
cb9c1345: posts small blind $0.05
38043f9a: posts big blind $0.1
*** HOLE CARDS ***
Dealt to 9eac8974 
Dealt to cb9c1345 
Dealt to 38043f9a 
Dealt to d9f4049e 
Dealt to Hero [8d 9s]
Dealt to 7721c598 
d9f4049e: raises $0.1 to $0.2
Hero: folds
7721c598: folds
9eac8974: folds
cb9c1345: folds
38043f9a: calls $0.1
*** FLOP *** [4h 4c Kd]
38043f9a: checks
d9f4049e: checks
*** TURN *** [4h 4c Kd] [Tc]
38043f9a: checks
d9f4049e: checks
*** RIVER *** [4h 4c Kd Tc] [5d]
38043f9a: bets $0.15
d9f4049e: folds
Uncalled bet ($0.15) returned to 38043f9a
*** SHOWDOWN ***
38043f9a collected $0.43 from pot
*** SUMMARY ***
Total pot $0.45 | Rake $0.02 | Jackpot $0 | Bingo $0 | Fortune $0 | Tax $0
Board [4h 4c Kd Tc 5d]
Seat 1: 9eac8974 (button) folded before Flop (didn't bet)
Seat 2: cb9c1345 (small blind) folded before Flop
Seat 3: 38043f9a (big blind) won ($0.43)
Seat 4: d9f4049e folded on the River
Seat 5: Hero folded before Flop (didn't bet)
Seat 6: 7721c598 folded before Flop (didn't bet)


Poker Hand #RC2774763708: Hold'em No Limit ($0.05/$0.1) - 2024/08/05 13:04:30
Table 'RushAndCash21398968' 6-max Seat #1 is the button
Seat 1: 70126d5c ($23.26 in chips)
Seat 2: 4a344507 ($25.15 in chips)
Seat 3: b4ad5959 ($10.23 in chips)
Seat 4: 1ebee98f ($11.22 in chips)
Seat 5: f758d044 ($10.15 in chips)
Seat 6: Hero ($16.47 in chips)
4a344507: posts small blind $0.05
b4ad5959: posts big blind $0.1
*** HOLE CARDS ***
Dealt to 70126d5c 
Dealt to 4a344507 
Dealt to b4ad5959 
Dealt to 1ebee98f 
Dealt to f758d044 
Dealt to Hero [8s 5c]
1ebee98f: folds
f758d044: folds
Hero: folds
70126d5c: folds
4a344507: folds
Uncalled bet ($0.05) returned to b4ad5959
*** SHOWDOWN ***
b4ad5959 collected $0.1 from pot
*** SUMMARY ***
Total pot $0.1 | Rake $0 | Jackpot $0 | Bingo $0 | Fortune $0 | Tax $0
Seat 1: 70126d5c (button) folded before Flop (didn't bet)
Seat 2: 4a344507 (small blind) folded before Flop
Seat 3: b4ad5959 (big blind) collected ($0.1)
Seat 4: 1ebee98f folded before Flop (didn't bet)
Seat 5: f758d044 folded before Flop (didn't bet)
Seat 6: Hero folded before Flop (didn't bet)


Poker Hand #RC2774763677: Hold'em No Limit ($0.05/$0.1) - 2024/08/05 13:04:26
Table 'RushAndCash21398937' 6-max Seat #1 is the button
Seat 1: 2ac9ccfa ($10.14 in chips)
Seat 2: bedbd59c ($14.55 in chips)
Seat 3: d28d30e4 ($21.43 in chips)
Seat 4: Hero ($16.47 in chips)
Seat 5: 98e2d761 ($24.89 in chips)
Seat 6: 13a3e945 ($9.4 in chips)
bedbd59c: posts small blind $0.05
d28d30e4: posts big blind $0.1
*** HOLE CARDS ***
Dealt to 2ac9ccfa 
Dealt to bedbd59c 
Dealt to d28d30e4 
Dealt to Hero [Qh 7h]
Dealt to 98e2d761 
Dealt to 13a3e945 
Hero: folds
98e2d761: folds
13a3e945: folds
2ac9ccfa: folds
bedbd59c: calls $0.05
d28d30e4: checks
*** FLOP *** [Kh 3d Qc]
bedbd59c: bets $0.1
d28d30e4: folds
Uncalled bet ($0.1) returned to bedbd59c
*** SHOWDOWN ***
bedbd59c collected $0.19 from pot
*** SUMMARY ***
Total pot $0.2 | Rake $0.01 | Jackpot $0 | Bingo $0 | Fortune $0 | Tax $0
Board [Kh 3d Qc]
Seat 1: 2ac9ccfa (button) folded before Flop (didn't bet)
Seat 2: bedbd59c (small blind) won ($0.19)
Seat 3: d28d30e4 (big blind) folded on the Flop
Seat 4: Hero folded before Flop (didn't bet)
Seat 5: 98e2d761 folded before Flop (didn't bet)
Seat 6: 13a3e945 folded before Flop (didn't bet)


Poker Hand #RC2774763655: Hold'em No Limit ($0.05/$0.1) - 2024/08/05 13:04:23
Table 'RushAndCash21398915' 6-max Seat #1 is the button
Seat 1: 1420c485 ($9.56 in chips)
Seat 2: Hero ($16.52 in chips)
Seat 3: e4b9a0ca ($10.16 in chips)
Seat 4: d28d30e4 ($21.43 in chips)
Seat 5: d9f4049e ($11.56 in chips)
Seat 6: 419adba8 ($13.55 in chips)
Hero: posts small blind $0.05
e4b9a0ca: posts big blind $0.1
*** HOLE CARDS ***
Dealt to 1420c485 
Dealt to Hero [4c 9s]
Dealt to e4b9a0ca 
Dealt to d28d30e4 
Dealt to d9f4049e 
Dealt to 419adba8 
d28d30e4: folds
d9f4049e: raises $0.1 to $0.2
419adba8: folds
1420c485: folds
Hero: folds
e4b9a0ca: folds
Uncalled bet ($0.1) returned to d9f4049e
*** SHOWDOWN ***
d9f4049e collected $0.25 from pot
*** SUMMARY ***
Total pot $0.25 | Rake $0 | Jackpot $0 | Bingo $0 | Fortune $0 | Tax $0
Seat 1: 1420c485 (button) folded before Flop (didn't bet)
Seat 2: Hero (small blind) folded before Flop
Seat 3: e4b9a0ca (big blind) folded before Flop
Seat 4: d28d30e4 folded before Flop (didn't bet)
Seat 5: d9f4049e collected ($0.25)
Seat 6: 419adba8 folded before Flop (didn't bet)


Poker Hand #RC2774763623: Hold'em No Limit ($0.05/$0.1) - 2024/08/05 13:04:18
Table 'RushAndCash21398883' 6-max Seat #1 is the button
Seat 1: 3c894328 ($11.26 in chips)
Seat 2: f19c0b4d ($20.75 in chips)
Seat 3: Hero ($16.62 in chips)
Seat 4: d0c19c5d ($9.57 in chips)
Seat 5: 8f2b3fe6 ($11.71 in chips)
Seat 6: a6ec6733 ($17.89 in chips)
f19c0b4d: posts small blind $0.05
Hero: posts big blind $0.1
*** HOLE CARDS ***
Dealt to 3c894328 
Dealt to f19c0b4d 
Dealt to Hero [6h 2c]
Dealt to d0c19c5d 
Dealt to 8f2b3fe6 
Dealt to a6ec6733 
d0c19c5d: folds
8f2b3fe6: raises $0.1 to $0.2
a6ec6733: raises $0.45 to $0.65
3c894328: folds
f19c0b4d: folds
Hero: folds
8f2b3fe6: folds
Uncalled bet ($0.45) returned to a6ec6733
*** SHOWDOWN ***
a6ec6733 collected $0.53 from pot
*** SUMMARY ***
Total pot $0.55 | Rake $0.02 | Jackpot $0 | Bingo $0 | Fortune $0 | Tax $0
Seat 1: 3c894328 (button) folded before Flop (didn't bet)
Seat 2: f19c0b4d (small blind) folded before Flop
Seat 3: Hero (big blind) folded before Flop
Seat 4: d0c19c5d folded before Flop (didn't bet)
Seat 5: 8f2b3fe6 folded before Flop
Seat 6: a6ec6733 collected ($0.53)


Poker Hand #RC2774763470: Hold'em No Limit ($0.05/$0.1) - 2024/08/05 13:03:57
Table 'RushAndCash21398730' 6-max Seat #1 is the button
Seat 1: Hero ($16.47 in chips)
Seat 2: 938dc1b0 ($10.24 in chips)
Seat 3: f05e617a ($10.73 in chips)
Seat 4: 15a0f224 ($8.67 in chips)
Seat 5: 257ad3a6 ($16.8 in chips)
Seat 6: 4edd5570 ($29.18 in chips)
938dc1b0: posts small blind $0.05
f05e617a: posts big blind $0.1
*** HOLE CARDS ***
Dealt to Hero [As Ks]
Dealt to 938dc1b0 
Dealt to f05e617a 
Dealt to 15a0f224 
Dealt to 257ad3a6 
Dealt to 4edd5570 
15a0f224: folds
257ad3a6: folds
4edd5570: folds
Hero: raises $0.14 to $0.24
938dc1b0: folds
f05e617a: folds
Uncalled bet ($0.14) returned to Hero
*** SHOWDOWN ***
Hero collected $0.25 from pot
*** SUMMARY ***
Total pot $0.25 | Rake $0 | Jackpot $0 | Bingo $0 | Fortune $0 | Tax $0
Seat 1: Hero (button) collected ($0.25)
Seat 2: 938dc1b0 (small blind) folded before Flop
Seat 3: f05e617a (big blind) folded before Flop
Seat 4: 15a0f224 folded before Flop (didn't bet)
Seat 5: 257ad3a6 folded before Flop (didn't bet)
Seat 6: 4edd5570 folded before Flop (didn't bet)


Poker Hand #RC2774763324: Hold'em No Limit ($0.05/$0.1) - 2024/08/05 13:03:37
Table 'RushAndCash21398584' 6-max Seat #1 is the button
Seat 1: 1420c485 ($9.56 in chips)
Seat 2: 39458145 ($10 in chips)
Seat 3: Hero ($16.29 in chips)
Seat 4: 9957f83a ($17.37 in chips)
Seat 5: c20c6f3d ($16.5 in chips)
Seat 6: 527de330 ($13.77 in chips)
39458145: posts small blind $0.05
Hero: posts big blind $0.1
*** HOLE CARDS ***
Dealt to 1420c485 
Dealt to 39458145 
Dealt to Hero [Jc Kc]
Dealt to 9957f83a 
Dealt to c20c6f3d 
Dealt to 527de330 
9957f83a: folds
c20c6f3d: folds
527de330: folds
1420c485: folds
39458145: raises $0.1 to $0.2
Hero: raises $0.4 to $0.6
39458145: folds
Uncalled bet ($0.4) returned to Hero
*** SHOWDOWN ***
Hero collected $0.38 from pot
*** SUMMARY ***
Total pot $0.4 | Rake $0.02 | Jackpot $0 | Bingo $0 | Fortune $0 | Tax $0
Seat 1: 1420c485 (button) folded before Flop (didn't bet)
Seat 2: 39458145 (small blind) folded before Flop
Seat 3: Hero (big blind) collected ($0.38)
Seat 4: 9957f83a folded before Flop (didn't bet)
Seat 5: c20c6f3d folded before Flop (didn't bet)
Seat 6: 527de330 folded before Flop (didn't bet)


Poker Hand #RC2774763304: Hold'em No Limit ($0.05/$0.1) - 2024/08/05 13:03:34
Table 'RushAndCash21398564' 6-max Seat #1 is the button
Seat 1: d58e8ad8 ($10.7 in chips)
Seat 2: 36112634 ($10 in chips)
Seat 3: eca0bbe7 ($6.7 in chips)
Seat 4: Hero ($16.29 in chips)
Seat 5: b407a400 ($10 in chips)
Seat 6: cc7203b4 ($10.36 in chips)
36112634: posts small blind $0.05
eca0bbe7: posts big blind $0.1
*** HOLE CARDS ***
Dealt to d58e8ad8 
Dealt to 36112634 
Dealt to eca0bbe7 
Dealt to Hero [Th 4d]
Dealt to b407a400 
Dealt to cc7203b4 
Hero: folds
b407a400: folds
cc7203b4: raises $0.15 to $0.25
d58e8ad8: folds
36112634: folds
eca0bbe7: calls $0.15
*** FLOP *** [3c 6d 2h]
eca0bbe7: checks
cc7203b4: checks
*** TURN *** [3c 6d 2h] [8c]
eca0bbe7: checks
cc7203b4: checks
*** RIVER *** [3c 6d 2h 8c] [9d]
eca0bbe7: checks
cc7203b4: checks
eca0bbe7: shows [Td Ks] (King-High)
cc7203b4: shows [Ad Qc] (Ace-High)
*** SHOWDOWN ***
cc7203b4 collected $0.53 from pot
*** SUMMARY ***
Total pot $0.55 | Rake $0.02 | Jackpot $0 | Bingo $0 | Fortune $0 | Tax $0
Board [3c 6d 2h 8c 9d]
Seat 1: d58e8ad8 (button) folded before Flop (didn't bet)
Seat 2: 36112634 (small blind) folded before Flop
Seat 3: eca0bbe7 (big blind) showed [Td Ks] and lost with King-High
Seat 4: Hero folded before Flop (didn't bet)
Seat 5: b407a400 folded before Flop (didn't bet)
Seat 6: cc7203b4 showed [Ad Qc] and won ($0.53) with Ace-High


Poker Hand #RC2774763284: Hold'em No Limit ($0.05/$0.1) - 2024/08/05 13:03:30
Table 'RushAndCash21398544' 6-max Seat #1 is the button
Seat 1: 2672cac2 ($13.22 in chips)
Seat 2: 92e556de ($35.5 in chips)
Seat 3: 718e6bb6 ($4.85 in chips)
Seat 4: 71e51e91 ($15.17 in chips)
Seat 5: bcf55df6 ($24.11 in chips)
Seat 6: Hero ($16.29 in chips)
92e556de: posts small blind $0.05
718e6bb6: posts big blind $0.1
*** HOLE CARDS ***
Dealt to 2672cac2 
Dealt to 92e556de 
Dealt to 718e6bb6 
Dealt to 71e51e91 
Dealt to bcf55df6 
Dealt to Hero [6h Ts]
71e51e91: folds
bcf55df6: folds
Hero: folds
2672cac2: folds
92e556de: raises $0.15 to $0.25
718e6bb6: calls $0.15
*** FLOP *** [Qs 9s Jh]
92e556de: bets $0.17
718e6bb6: calls $0.17
*** TURN *** [Qs 9s Jh] [Jd]
92e556de: checks
718e6bb6: checks
*** RIVER *** [Qs 9s Jh Jd] [3d]
92e556de: bets $0.63
718e6bb6: raises $0.63 to $1.26
92e556de: calls $0.63
718e6bb6: shows [Qd Td] (Pair of Queens and Pair of Jacks)
92e556de: shows [As Ac] (Pair of Aces and Pair of Jacks)
*** SHOWDOWN ***
92e556de collected $3.05 from pot
*** SUMMARY ***
Total pot $3.36 | Rake $0.16 | Jackpot $0.15 | Bingo $0 | Fortune $0 | Tax $0
Board [Qs 9s Jh Jd 3d]
Seat 1: 2672cac2 (button) folded before Flop (didn't bet)
Seat 2: 92e556de (small blind) showed [As Ac] and won ($3.05) with Pair of Aces and Pair of Jacks
Seat 3: 718e6bb6 (big blind) showed [Qd Td] and lost with Pair of Queens and Pair of Jacks
Seat 4: 71e51e91 folded before Flop (didn't bet)
Seat 5: bcf55df6 folded before Flop (didn't bet)
Seat 6: Hero folded before Flop (didn't bet)


Poker Hand #RC2774763255: Hold'em No Limit ($0.05/$0.1) - 2024/08/05 13:03:27
Table 'RushAndCash21398515' 6-max Seat #1 is the button
Seat 1: 8f7c02cf ($15.04 in chips)
Seat 2: f3dab514 ($15.99 in chips)
Seat 3: 70a2e858 ($10 in chips)
Seat 4: 7448bb3b ($18.89 in chips)
Seat 5: 3b0c26fe ($20.21 in chips)
Seat 6: Hero ($16.29 in chips)
f3dab514: posts small blind $0.05
70a2e858: posts big blind $0.1
*** HOLE CARDS ***
Dealt to 8f7c02cf 
Dealt to f3dab514 
Dealt to 70a2e858 
Dealt to 7448bb3b 
Dealt to 3b0c26fe 
Dealt to Hero [Td Jc]
7448bb3b: folds
3b0c26fe: raises $0.1 to $0.2
Hero: folds
8f7c02cf: folds
f3dab514: folds
70a2e858: folds
Uncalled bet ($0.1) returned to 3b0c26fe
*** SHOWDOWN ***
3b0c26fe collected $0.25 from pot
*** SUMMARY ***
Total pot $0.25 | Rake $0 | Jackpot $0 | Bingo $0 | Fortune $0 | Tax $0
Seat 1: 8f7c02cf (button) folded before Flop (didn't bet)
Seat 2: f3dab514 (small blind) folded before Flop
Seat 3: 70a2e858 (big blind) folded before Flop
Seat 4: 7448bb3b folded before Flop (didn't bet)
Seat 5: 3b0c26fe collected ($0.25)
Seat 6: Hero folded before Flop (didn't bet)


Poker Hand #RC2774763171: Hold'em No Limit ($0.05/$0.1) - 2024/08/05 13:03:16
Table 'RushAndCash21398431' 6-max Seat #1 is the button
Seat 1: Hero ($16.14 in chips)
Seat 2: fbea8788 ($11.41 in chips)
Seat 3: e21f5f10 ($13.58 in chips)
Seat 4: 50b79063 ($5.8 in chips)
Seat 5: 63c91dca ($10 in chips)
Seat 6: 41520222 ($10 in chips)
fbea8788: posts small blind $0.05
e21f5f10: posts big blind $0.1
*** HOLE CARDS ***
Dealt to Hero [Jc Js]
Dealt to fbea8788 
Dealt to e21f5f10 
Dealt to 50b79063 
Dealt to 63c91dca 
Dealt to 41520222 
50b79063: folds
63c91dca: folds
41520222: folds
Hero: raises $0.14 to $0.24
fbea8788: folds
e21f5f10: folds
Uncalled bet ($0.14) returned to Hero
*** SHOWDOWN ***
Hero collected $0.25 from pot
*** SUMMARY ***
Total pot $0.25 | Rake $0 | Jackpot $0 | Bingo $0 | Fortune $0 | Tax $0
Seat 1: Hero (button) collected ($0.25)
Seat 2: fbea8788 (small blind) folded before Flop
Seat 3: e21f5f10 (big blind) folded before Flop
Seat 4: 50b79063 folded before Flop (didn't bet)
Seat 5: 63c91dca folded before Flop (didn't bet)
Seat 6: 41520222 folded before Flop (didn't bet)


Poker Hand #RC2774763055: Hold'em No Limit ($0.05/$0.1) - 2024/08/05 13:03:02
Table 'RushAndCash21398315' 6-max Seat #1 is the button
Seat 1: e9b8904b ($11.44 in chips)
Seat 2: Hero ($16.04 in chips)
Seat 3: 7c936b7c ($11.85 in chips)
Seat 4: d103f66a ($11.35 in chips)
Seat 5: 6ff89eee ($8.54 in chips)
Seat 6: 41727a67 ($10.72 in chips)
Hero: posts small blind $0.05
7c936b7c: posts big blind $0.1
*** HOLE CARDS ***
Dealt to e9b8904b 
Dealt to Hero [Ts Ac]
Dealt to 7c936b7c 
Dealt to d103f66a 
Dealt to 6ff89eee 
Dealt to 41727a67 
d103f66a: folds
6ff89eee: folds
41727a67: folds
e9b8904b: folds
Hero: raises $0.2 to $0.3
7c936b7c: folds
Uncalled bet ($0.2) returned to Hero
*** SHOWDOWN ***
Hero collected $0.2 from pot
*** SUMMARY ***
Total pot $0.2 | Rake $0 | Jackpot $0 | Bingo $0 | Fortune $0 | Tax $0
Seat 1: e9b8904b (button) folded before Flop (didn't bet)
Seat 2: Hero (small blind) collected ($0.2)
Seat 3: 7c936b7c (big blind) folded before Flop
Seat 4: d103f66a folded before Flop (didn't bet)
Seat 5: 6ff89eee folded before Flop (didn't bet)
Seat 6: 41727a67 folded before Flop (didn't bet)


Poker Hand #RC2774762745: Hold'em No Limit ($0.05/$0.1) - 2024/08/05 13:02:19
Table 'RushAndCash21398005' 6-max Seat #1 is the button
Seat 1: 41727a67 ($11.43 in chips)
Seat 2: a72114e6 ($10.41 in chips)
Seat 3: 4f898a10 ($10 in chips)
Seat 4: cd4be1e5 ($27.79 in chips)
Seat 5: bff84f90 ($9.21 in chips)
Seat 6: Hero ($15.25 in chips)
a72114e6: posts small blind $0.05
4f898a10: posts big blind $0.1
*** HOLE CARDS ***
Dealt to 41727a67 
Dealt to a72114e6 
Dealt to 4f898a10 
Dealt to cd4be1e5 
Dealt to bff84f90 
Dealt to Hero [Qh Qc]
cd4be1e5: folds
bff84f90: folds
Hero: raises $0.14 to $0.24
41727a67: raises $0.47 to $0.71
a72114e6: folds
4f898a10: folds
Hero: raises $1.29 to $2
41727a67: folds
Uncalled bet ($1.29) returned to Hero
*** SHOWDOWN ***
Hero collected $1.5 from pot
*** SUMMARY ***
Total pot $1.57 | Rake $0.07 | Jackpot $0 | Bingo $0 | Fortune $0 | Tax $0
Seat 1: 41727a67 (button) folded before Flop
Seat 2: a72114e6 (small blind) folded before Flop
Seat 3: 4f898a10 (big blind) folded before Flop
Seat 4: cd4be1e5 folded before Flop (didn't bet)
Seat 5: bff84f90 folded before Flop (didn't bet)
Seat 6: Hero collected ($1.5)


Poker Hand #RC2774762713: Hold'em No Limit ($0.05/$0.1) - 2024/08/05 13:02:15
Table 'RushAndCash21397973' 6-max Seat #1 is the button
Seat 1: 9a65e146 ($20.02 in chips)
Seat 2: Hero ($15.3 in chips)
Seat 3: 57be38bf ($7.7 in chips)
Seat 4: 3984093b ($14.6 in chips)
Seat 5: df3fc675 ($10.15 in chips)
Seat 6: 23be08af ($14.03 in chips)
Hero: posts small blind $0.05
57be38bf: posts big blind $0.1
*** HOLE CARDS ***
Dealt to 9a65e146 
Dealt to Hero [6s 5h]
Dealt to 57be38bf 
Dealt to 3984093b 
Dealt to df3fc675 
Dealt to 23be08af 
3984093b: folds
df3fc675: folds
23be08af: folds
9a65e146: folds
Hero: folds
Uncalled bet ($0.05) returned to 57be38bf
*** SHOWDOWN ***
57be38bf collected $0.1 from pot
*** SUMMARY ***
Total pot $0.1 | Rake $0 | Jackpot $0 | Bingo $0 | Fortune $0 | Tax $0
Seat 1: 9a65e146 (button) folded before Flop (didn't bet)
Seat 2: Hero (small blind) folded before Flop
Seat 3: 57be38bf (big blind) collected ($0.1)
Seat 4: 3984093b folded before Flop (didn't bet)
Seat 5: df3fc675 folded before Flop (didn't bet)
Seat 6: 23be08af folded before Flop (didn't bet)


Poker Hand #RC2774762666: Hold'em No Limit ($0.05/$0.1) - 2024/08/05 13:02:08
Table 'RushAndCash21397926' 6-max Seat #1 is the button
Seat 1: 4a0e451f ($8.76 in chips)
Seat 2: 15a0f224 ($9.27 in chips)
Seat 3: 9f10f7db ($46.59 in chips)
Seat 4: b958f85c ($7.21 in chips)
Seat 5: 7155dca ($18.85 in chips)
Seat 6: Hero ($15.3 in chips)
15a0f224: posts small blind $0.05
9f10f7db: posts big blind $0.1
*** HOLE CARDS ***
Dealt to 4a0e451f 
Dealt to 15a0f224 
Dealt to 9f10f7db 
Dealt to b958f85c 
Dealt to 7155dca 
Dealt to Hero [9c 8d]
b958f85c: folds
7155dca: folds
Hero: folds
4a0e451f: folds
15a0f224: raises $0.2 to $0.3
9f10f7db: folds
Uncalled bet ($0.2) returned to 15a0f224
*** SHOWDOWN ***
15a0f224 collected $0.2 from pot
*** SUMMARY ***
Total pot $0.2 | Rake $0 | Jackpot $0 | Bingo $0 | Fortune $0 | Tax $0
Seat 1: 4a0e451f (button) folded before Flop (didn't bet)
Seat 2: 15a0f224 (small blind) collected ($0.2)
Seat 3: 9f10f7db (big blind) folded before Flop
Seat 4: b958f85c folded before Flop (didn't bet)
Seat 5: 7155dca folded before Flop (didn't bet)
Seat 6: Hero folded before Flop (didn't bet)


Poker Hand #RC2774762641: Hold'em No Limit ($0.05/$0.1) - 2024/08/05 13:02:05
Table 'RushAndCash21397901' 6-max Seat #1 is the button
Seat 1: ac8f8a49 ($23.46 in chips)
Seat 2: 7dbfe892 ($10.05 in chips)
Seat 3: 26f11e2a ($10.17 in chips)
Seat 4: Hero ($15.3 in chips)
Seat 5: ee289422 ($11.41 in chips)
Seat 6: 3d571954 ($28.33 in chips)
7dbfe892: posts small blind $0.05
26f11e2a: posts big blind $0.1
*** HOLE CARDS ***
Dealt to ac8f8a49 
Dealt to 7dbfe892 
Dealt to 26f11e2a 
Dealt to Hero [Qh 3h]
Dealt to ee289422 
Dealt to 3d571954 
Hero: folds
ee289422: raises $0.1 to $0.2
3d571954: raises $0.45 to $0.65
ac8f8a49: folds
7dbfe892: folds
26f11e2a: folds
ee289422: calls $0.45
*** FLOP *** [7c Kd Ts]
ee289422: checks
3d571954: bets $0.35
ee289422: folds
Uncalled bet ($0.35) returned to 3d571954
*** SHOWDOWN ***
3d571954 collected $1.38 from pot
*** SUMMARY ***
Total pot $1.45 | Rake $0.07 | Jackpot $0 | Bingo $0 | Fortune $0 | Tax $0
Board [7c Kd Ts]
Seat 1: ac8f8a49 (button) folded before Flop (didn't bet)
Seat 2: 7dbfe892 (small blind) folded before Flop
Seat 3: 26f11e2a (big blind) folded before Flop
Seat 4: Hero folded before Flop (didn't bet)
Seat 5: ee289422 folded on the Flop
Seat 6: 3d571954 won ($1.38)


Poker Hand #RC2774762579: Hold'em No Limit ($0.05/$0.1) - 2024/08/05 13:01:56
Table 'RushAndCash21397839' 6-max Seat #1 is the button
Seat 1: Hero ($15.3 in chips)
Seat 2: 1894db5f ($10 in chips)
Seat 3: 8c673202 ($9.33 in chips)
Seat 4: 75677bc1 ($10.48 in chips)
Seat 5: 9e8e5ab ($24.12 in chips)
Seat 6: a6ec6733 ($17.97 in chips)
1894db5f: posts small blind $0.05
8c673202: posts big blind $0.1
*** HOLE CARDS ***
Dealt to Hero [9d 2h]
Dealt to 1894db5f 
Dealt to 8c673202 
Dealt to 75677bc1 
Dealt to 9e8e5ab 
Dealt to a6ec6733 
75677bc1: raises $0.15 to $0.25
9e8e5ab: folds
a6ec6733: raises $0.55 to $0.8
Hero: folds
1894db5f: folds
8c673202: folds
75677bc1: folds
Uncalled bet ($0.55) returned to a6ec6733
*** SHOWDOWN ***
a6ec6733 collected $0.62 from pot
*** SUMMARY ***
Total pot $0.65 | Rake $0.03 | Jackpot $0 | Bingo $0 | Fortune $0 | Tax $0
Seat 1: Hero (button) folded before Flop (didn't bet)
Seat 2: 1894db5f (small blind) folded before Flop
Seat 3: 8c673202 (big blind) folded before Flop
Seat 4: 75677bc1 folded before Flop
Seat 5: 9e8e5ab folded before Flop (didn't bet)
Seat 6: a6ec6733 collected ($0.62)


Poker Hand #RC2774762554: Hold'em No Limit ($0.05/$0.1) - 2024/08/05 13:01:53
Table 'RushAndCash21397814' 6-max Seat #1 is the button
Seat 1: 9f10f7db ($46.74 in chips)
Seat 2: 35f19e9f ($28.27 in chips)
Seat 3: 569beaa5 ($7.9 in chips)
Seat 4: 95e28b9 ($10.1 in chips)
Seat 5: ea29259a ($10 in chips)
Seat 6: Hero ($15.3 in chips)
35f19e9f: posts small blind $0.05
569beaa5: posts big blind $0.1
*** HOLE CARDS ***
Dealt to 9f10f7db 
Dealt to 35f19e9f 
Dealt to 569beaa5 
Dealt to 95e28b9 
Dealt to ea29259a 
Dealt to Hero [9h 7c]
95e28b9: folds
ea29259a: raises $0.1 to $0.2
Hero: folds
9f10f7db: folds
35f19e9f: raises $0.85 to $1.05
569beaa5: folds
ea29259a: folds
Uncalled bet ($0.85) returned to 35f19e9f
*** SHOWDOWN ***
35f19e9f collected $0.48 from pot
*** SUMMARY ***
Total pot $0.5 | Rake $0.02 | Jackpot $0 | Bingo $0 | Fortune $0 | Tax $0
Seat 1: 9f10f7db (button) folded before Flop (didn't bet)
Seat 2: 35f19e9f (small blind) collected ($0.48)
Seat 3: 569beaa5 (big blind) folded before Flop
Seat 4: 95e28b9 folded before Flop (didn't bet)
Seat 5: ea29259a folded before Flop
Seat 6: Hero folded before Flop (didn't bet)


Poker Hand #RC2774762529: Hold'em No Limit ($0.05/$0.1) - 2024/08/05 13:01:50
Table 'RushAndCash21397789' 6-max Seat #1 is the button
Seat 1: 71817254 ($14.54 in chips)
Seat 2: 3e022ff9 ($16.16 in chips)
Seat 3: e155962f ($30.42 in chips)
Seat 4: 569beaa5 ($7.9 in chips)
Seat 5: 35f19e9f ($28.27 in chips)
Seat 6: Hero ($15.3 in chips)
3e022ff9: posts small blind $0.05
e155962f: posts big blind $0.1
*** HOLE CARDS ***
Dealt to 71817254 
Dealt to 3e022ff9 
Dealt to e155962f 
Dealt to 569beaa5 
Dealt to 35f19e9f 
Dealt to Hero [8h 5c]
569beaa5: folds
35f19e9f: folds
Hero: folds
71817254: folds
3e022ff9: raises $0.2 to $0.3
e155962f: folds
Uncalled bet ($0.2) returned to 3e022ff9
*** SHOWDOWN ***
3e022ff9 collected $0.2 from pot
*** SUMMARY ***
Total pot $0.2 | Rake $0 | Jackpot $0 | Bingo $0 | Fortune $0 | Tax $0
Seat 1: 71817254 (button) folded before Flop (didn't bet)
Seat 2: 3e022ff9 (small blind) collected ($0.2)
Seat 3: e155962f (big blind) folded before Flop
Seat 4: 569beaa5 folded before Flop (didn't bet)
Seat 5: 35f19e9f folded before Flop (didn't bet)
Seat 6: Hero folded before Flop (didn't bet)


Poker Hand #RC2774762503: Hold'em No Limit ($0.05/$0.1) - 2024/08/05 13:01:46
Table 'RushAndCash21397763' 6-max Seat #1 is the button
Seat 1: a3338cf7 ($28.89 in chips)
Seat 2: Hero ($15.35 in chips)
Seat 3: 6bf92f56 ($17.18 in chips)
Seat 4: 738a8979 ($10.02 in chips)
Seat 5: ccf1d75c ($14.42 in chips)
Seat 6: 2c7a529f ($16.78 in chips)
Hero: posts small blind $0.05
6bf92f56: posts big blind $0.1
*** HOLE CARDS ***
Dealt to a3338cf7 
Dealt to Hero [Qh 2c]
Dealt to 6bf92f56 
Dealt to 738a8979 
Dealt to ccf1d75c 
Dealt to 2c7a529f 
738a8979: raises $0.1 to $0.2
ccf1d75c: folds
2c7a529f: folds
a3338cf7: raises $0.5 to $0.7
Hero: folds
6bf92f56: folds
738a8979: raises $1.15 to $1.85
a3338cf7: calls $1.15
*** FLOP *** [Jd 4c 4s]
738a8979: checks
a3338cf7: checks
*** TURN *** [Jd 4c 4s] [5d]
738a8979: checks
a3338cf7: bets $0.35
738a8979: calls $0.35
*** RIVER *** [Jd 4c 4s 5d] [As]
738a8979: bets $7.82 and is all-in
a3338cf7: calls $7.82
738a8979: shows [Ac Ad] (Aces Full over Fours)
a3338cf7: shows [Ah Kh] (Pair of Aces and Pair of Fours)
*** SHOWDOWN ***
738a8979 collected $19.74 from pot
*** SUMMARY ***
Total pot $20.19 | Rake $0.3 | Jackpot $0.15 | Bingo $0 | Fortune $0 | Tax $0
Board [Jd 4c 4s 5d As]
Seat 1: a3338cf7 (button) showed [Ah Kh] and lost with Pair of Aces and Pair of Fours
Seat 2: Hero (small blind) folded before Flop
Seat 3: 6bf92f56 (big blind) folded before Flop
Seat 4: 738a8979 showed [Ac Ad] and won ($19.74) with Aces Full over Fours
Seat 5: ccf1d75c folded before Flop (didn't bet)
Seat 6: 2c7a529f folded before Flop (didn't bet)


Poker Hand #RC2774762421: Hold'em No Limit ($0.05/$0.1) - 2024/08/05 13:01:35
Table 'RushAndCash21397681' 6-max Seat #1 is the button
Seat 1: 612316dc ($10 in chips)
Seat 2: 3e28455c ($10 in chips)
Seat 3: Hero ($15.45 in chips)
Seat 4: 6f93ebc9 ($18.66 in chips)
Seat 5: 9c60b231 ($11.74 in chips)
Seat 6: 5ae164e3 ($15.32 in chips)
3e28455c: posts small blind $0.05
Hero: posts big blind $0.1
*** HOLE CARDS ***
Dealt to 612316dc 
Dealt to 3e28455c 
Dealt to Hero [5d 2d]
Dealt to 6f93ebc9 
Dealt to 9c60b231 
Dealt to 5ae164e3 
6f93ebc9: folds
9c60b231: folds
5ae164e3: folds
612316dc: raises $0.1 to $0.2
3e28455c: calls $0.15
Hero: folds
*** FLOP *** [3d 8s Js]
3e28455c: checks
612316dc: bets $0.25
3e28455c: calls $0.25
*** TURN *** [3d 8s Js] [Jd]
3e28455c: checks
612316dc: bets $0.75
3e28455c: folds
Uncalled bet ($0.75) returned to 612316dc
*** SHOWDOWN ***
612316dc collected $0.94 from pot
*** SUMMARY ***
Total pot $1 | Rake $0.06 | Jackpot $0 | Bingo $0 | Fortune $0 | Tax $0
Board [3d 8s Js Jd]
Seat 1: 612316dc (button) won ($0.94)
Seat 2: 3e28455c (small blind) folded on the Turn
Seat 3: Hero (big blind) folded before Flop
Seat 4: 6f93ebc9 folded before Flop (didn't bet)
Seat 5: 9c60b231 folded before Flop (didn't bet)
Seat 6: 5ae164e3 folded before Flop (didn't bet)


Poker Hand #RC2774762383: Hold'em No Limit ($0.05/$0.1) - 2024/08/05 13:01:30
Table 'RushAndCash21397643' 6-max Seat #1 is the button
Seat 1: 3c894328 ($11.04 in chips)
Seat 2: dd79782c ($10.05 in chips)
Seat 3: Hero ($15.55 in chips)
Seat 4: e8ec4f2b ($18.85 in chips)
Seat 5: 1e49f39 ($10.23 in chips)
Seat 6: 30be881a ($10.1 in chips)
dd79782c: posts small blind $0.05
Hero: posts big blind $0.1
*** HOLE CARDS ***
Dealt to 3c894328 
Dealt to dd79782c 
Dealt to Hero [Ac 2d]
Dealt to e8ec4f2b 
Dealt to 1e49f39 
Dealt to 30be881a 
e8ec4f2b: folds
1e49f39: folds
30be881a: folds
3c894328: raises $0.1 to $0.2
dd79782c: folds
Hero: folds
Uncalled bet ($0.1) returned to 3c894328
*** SHOWDOWN ***
3c894328 collected $0.25 from pot
*** SUMMARY ***
Total pot $0.25 | Rake $0 | Jackpot $0 | Bingo $0 | Fortune $0 | Tax $0
Seat 1: 3c894328 (button) collected ($0.25)
Seat 2: dd79782c (small blind) folded before Flop
Seat 3: Hero (big blind) folded before Flop
Seat 4: e8ec4f2b folded before Flop (didn't bet)
Seat 5: 1e49f39 folded before Flop (didn't bet)
Seat 6: 30be881a folded before Flop (didn't bet)


Poker Hand #RC2774762260: Hold'em No Limit ($0.05/$0.1) - 2024/08/05 13:01:13
Table 'RushAndCash21397520' 6-max Seat #1 is the button
Seat 1: 2511a681 ($9.16 in chips)
Seat 2: e33eca0 ($10.1 in chips)
Seat 3: 3eab91b4 ($15.57 in chips)
Seat 4: 3b80ebf4 ($10.09 in chips)
Seat 5: d103f66a ($12.23 in chips)
Seat 6: Hero ($15.55 in chips)
e33eca0: posts small blind $0.05
3eab91b4: posts big blind $0.1
*** HOLE CARDS ***
Dealt to 2511a681 
Dealt to e33eca0 
Dealt to 3eab91b4 
Dealt to 3b80ebf4 
Dealt to d103f66a 
Dealt to Hero [Th 8s]
3b80ebf4: folds
d103f66a: folds
Hero: folds
2511a681: folds
e33eca0: folds
Uncalled bet ($0.05) returned to 3eab91b4
*** SHOWDOWN ***
3eab91b4 collected $0.1 from pot
*** SUMMARY ***
Total pot $0.1 | Rake $0 | Jackpot $0 | Bingo $0 | Fortune $0 | Tax $0
Seat 1: 2511a681 (button) folded before Flop (didn't bet)
Seat 2: e33eca0 (small blind) folded before Flop
Seat 3: 3eab91b4 (big blind) collected ($0.1)
Seat 4: 3b80ebf4 folded before Flop (didn't bet)
Seat 5: d103f66a folded before Flop (didn't bet)
Seat 6: Hero folded before Flop (didn't bet)


Poker Hand #RC2774761845: Hold'em No Limit ($0.05/$0.1) - 2024/08/05 13:00:16
Table 'RushAndCash21397105' 6-max Seat #1 is the button
Seat 1: Hero ($15.28 in chips)
Seat 2: 427a6303 ($10.28 in chips)
Seat 3: 49aca122 ($10.47 in chips)
Seat 4: c0c61c6e ($13.51 in chips)
Seat 5: e9213cfe ($18.62 in chips)
Seat 6: 55744bec ($14.69 in chips)
427a6303: posts small blind $0.05
49aca122: posts big blind $0.1
*** HOLE CARDS ***
Dealt to Hero [Kc Th]
Dealt to 427a6303 
Dealt to 49aca122 
Dealt to c0c61c6e 
Dealt to e9213cfe 
Dealt to 55744bec 
c0c61c6e: folds
e9213cfe: folds
55744bec: folds
Hero: raises $0.14 to $0.24
427a6303: folds
49aca122: calls $0.14
*** FLOP *** [5d 3s 4s]
49aca122: checks
Hero: checks
*** TURN *** [5d 3s 4s] [Ah]
49aca122: checks
Hero: bets $0.35
49aca122: folds
Uncalled bet ($0.35) returned to Hero
*** SHOWDOWN ***
Hero collected $0.51 from pot
*** SUMMARY ***
Total pot $0.53 | Rake $0.02 | Jackpot $0 | Bingo $0 | Fortune $0 | Tax $0
Board [5d 3s 4s Ah]
Seat 1: Hero (button) won ($0.51)
Seat 2: 427a6303 (small blind) folded before Flop
Seat 3: 49aca122 (big blind) folded on the Turn
Seat 4: c0c61c6e folded before Flop (didn't bet)
Seat 5: e9213cfe folded before Flop (didn't bet)
Seat 6: 55744bec folded before Flop (didn't bet)


Poker Hand #RC2774761801: Hold'em No Limit ($0.05/$0.1) - 2024/08/05 13:00:09
Table 'RushAndCash21397061' 6-max Seat #1 is the button
Seat 1: 605962a ($10 in chips)
Seat 2: ac74022f ($10 in chips)
Seat 3: Hero ($15.38 in chips)
Seat 4: 7add3569 ($10.85 in chips)
Seat 5: 41bcebfb ($10.28 in chips)
Seat 6: 65ec36f8 ($18.84 in chips)
ac74022f: posts small blind $0.05
Hero: posts big blind $0.1
*** HOLE CARDS ***
Dealt to 605962a 
Dealt to ac74022f 
Dealt to Hero [Jd 3c]
Dealt to 7add3569 
Dealt to 41bcebfb 
Dealt to 65ec36f8 
7add3569: folds
41bcebfb: raises $0.15 to $0.25
65ec36f8: raises $0.45 to $0.7
605962a: folds
ac74022f: folds
Hero: folds
41bcebfb: raises $1.8 to $2.5
65ec36f8: calls $1.8
*** FLOP *** [Td 4c 3s]
41bcebfb: bets $1.7
65ec36f8: folds
Uncalled bet ($1.7) returned to 41bcebfb
*** SHOWDOWN ***
41bcebfb collected $4.75 from pot
*** SUMMARY ***
Total pot $5.15 | Rake $0.25 | Jackpot $0.15 | Bingo $0 | Fortune $0 | Tax $0
Board [Td 4c 3s]
Seat 1: 605962a (button) folded before Flop (didn't bet)
Seat 2: ac74022f (small blind) folded before Flop
Seat 3: Hero (big blind) folded before Flop
Seat 4: 7add3569 folded before Flop (didn't bet)
Seat 5: 41bcebfb won ($4.75)
Seat 6: 65ec36f8 folded on the Flop


Poker Hand #RC2774761752: Hold'em No Limit ($0.05/$0.1) - 2024/08/05 13:00:03
Table 'RushAndCash21397012' 6-max Seat #1 is the button
Seat 1: 1f9d7383 ($10 in chips)
Seat 2: Hero ($15.43 in chips)
Seat 3: a3ac6854 ($9.18 in chips)
Seat 4: d2df06cf ($12.66 in chips)
Seat 5: 1e2d72f ($10.1 in chips)
Seat 6: 9f9a72c7 ($13.91 in chips)
Hero: posts small blind $0.05
a3ac6854: posts big blind $0.1
*** HOLE CARDS ***
Dealt to 1f9d7383 
Dealt to Hero [4s 6h]
Dealt to a3ac6854 
Dealt to d2df06cf 
Dealt to 1e2d72f 
Dealt to 9f9a72c7 
d2df06cf: folds
1e2d72f: folds
9f9a72c7: folds
1f9d7383: raises $0.14 to $0.24
Hero: folds
a3ac6854: folds
Uncalled bet ($0.14) returned to 1f9d7383
*** SHOWDOWN ***
1f9d7383 collected $0.25 from pot
*** SUMMARY ***
Total pot $0.25 | Rake $0 | Jackpot $0 | Bingo $0 | Fortune $0 | Tax $0
Seat 1: 1f9d7383 (button) collected ($0.25)
Seat 2: Hero (small blind) folded before Flop
Seat 3: a3ac6854 (big blind) folded before Flop
Seat 4: d2df06cf folded before Flop (didn't bet)
Seat 5: 1e2d72f folded before Flop (didn't bet)
Seat 6: 9f9a72c7 folded before Flop (didn't bet)


Poker Hand #RC2774761721: Hold'em No Limit ($0.05/$0.1) - 2024/08/05 12:59:59
Table 'RushAndCash21396981' 6-max Seat #1 is the button
Seat 1: 1b7b7a16 ($10.15 in chips)
Seat 2: 6ff89eee ($9.27 in chips)
Seat 3: dd79782c ($10.1 in chips)
Seat 4: Hero ($15.43 in chips)
Seat 5: 1f9d7383 ($10 in chips)
Seat 6: 5175fa54 ($10.14 in chips)
6ff89eee: posts small blind $0.05
dd79782c: posts big blind $0.1
*** HOLE CARDS ***
Dealt to 1b7b7a16 
Dealt to 6ff89eee 
Dealt to dd79782c 
Dealt to Hero [Kc 3d]
Dealt to 1f9d7383 
Dealt to 5175fa54 
Hero: folds
1f9d7383: folds
5175fa54: folds
1b7b7a16: raises $0.15 to $0.25
6ff89eee: calls $0.2
dd79782c: calls $0.15
*** FLOP *** [Ac 6h 6d]
6ff89eee: checks
dd79782c: checks
1b7b7a16: checks
*** TURN *** [Ac 6h 6d] [4d]
6ff89eee: checks
dd79782c: checks
1b7b7a16: bets $0.75
6ff89eee: folds
dd79782c: folds
Uncalled bet ($0.75) returned to 1b7b7a16
*** SHOWDOWN ***
1b7b7a16 collected $0.72 from pot
*** SUMMARY ***
Total pot $0.75 | Rake $0.03 | Jackpot $0 | Bingo $0 | Fortune $0 | Tax $0
Board [Ac 6h 6d 4d]
Seat 1: 1b7b7a16 (button) won ($0.72)
Seat 2: 6ff89eee (small blind) folded on the Turn
Seat 3: dd79782c (big blind) folded on the Turn
Seat 4: Hero folded before Flop (didn't bet)
Seat 5: 1f9d7383 folded before Flop (didn't bet)
Seat 6: 5175fa54 folded before Flop (didn't bet)


Poker Hand #RC2774761696: Hold'em No Limit ($0.05/$0.1) - 2024/08/05 12:59:55
Table 'RushAndCash21396956' 6-max Seat #1 is the button
Seat 1: 92e556de ($36.96 in chips)
Seat 2: efeafe15 ($10 in chips)
Seat 3: 551f3ecb ($10.25 in chips)
Seat 4: 2c6662d4 ($9.06 in chips)
Seat 5: 73acb92a ($10 in chips)
Seat 6: Hero ($15.43 in chips)
efeafe15: posts small blind $0.05
551f3ecb: posts big blind $0.1
*** HOLE CARDS ***
Dealt to 92e556de 
Dealt to efeafe15 
Dealt to 551f3ecb 
Dealt to 2c6662d4 
Dealt to 73acb92a 
Dealt to Hero [3h Jd]
2c6662d4: folds
73acb92a: folds
Hero: folds
92e556de: raises $0.15 to $0.25
efeafe15: folds
551f3ecb: folds
Uncalled bet ($0.15) returned to 92e556de
*** SHOWDOWN ***
92e556de collected $0.25 from pot
*** SUMMARY ***
Total pot $0.25 | Rake $0 | Jackpot $0 | Bingo $0 | Fortune $0 | Tax $0
Seat 1: 92e556de (button) collected ($0.25)
Seat 2: efeafe15 (small blind) folded before Flop
Seat 3: 551f3ecb (big blind) folded before Flop
Seat 4: 2c6662d4 folded before Flop (didn't bet)
Seat 5: 73acb92a folded before Flop (didn't bet)
Seat 6: Hero folded before Flop (didn't bet)


Poker Hand #RC2774761674: Hold'em No Limit ($0.05/$0.1) - 2024/08/05 12:59:52
Table 'RushAndCash21396934' 6-max Seat #1 is the button
Seat 1: Hero ($15.43 in chips)
Seat 2: 1dd4d438 ($10.18 in chips)
Seat 3: a289ba4e ($11.76 in chips)
Seat 4: 1b7b7a16 ($10.15 in chips)
Seat 5: a4aad96a ($13.14 in chips)
Seat 6: 551f3ecb ($10.25 in chips)
1dd4d438: posts small blind $0.05
a289ba4e: posts big blind $0.1
*** HOLE CARDS ***
Dealt to Hero [Kd 2s]
Dealt to 1dd4d438 
Dealt to a289ba4e 
Dealt to 1b7b7a16 
Dealt to a4aad96a 
Dealt to 551f3ecb 
1b7b7a16: folds
a4aad96a: folds
551f3ecb: folds
Hero: folds
1dd4d438: raises $0.1 to $0.2
a289ba4e: raises $0.5 to $0.7
1dd4d438: folds
Uncalled bet ($0.5) returned to a289ba4e
*** SHOWDOWN ***
a289ba4e collected $0.38 from pot
*** SUMMARY ***
Total pot $0.4 | Rake $0.02 | Jackpot $0 | Bingo $0 | Fortune $0 | Tax $0
Seat 1: Hero (button) folded before Flop (didn't bet)
Seat 2: 1dd4d438 (small blind) folded before Flop
Seat 3: a289ba4e (big blind) collected ($0.38)
Seat 4: 1b7b7a16 folded before Flop (didn't bet)
Seat 5: a4aad96a folded before Flop (didn't bet)
Seat 6: 551f3ecb folded before Flop (didn't bet)


Poker Hand #RC2774761630: Hold'em No Limit ($0.05/$0.1) - 2024/08/05 12:59:46
Table 'RushAndCash21396890' 6-max Seat #1 is the button
Seat 1: 7155dca ($19.2 in chips)
Seat 2: 4186ebe3 ($19.78 in chips)
Seat 3: 1dd4d438 ($10.28 in chips)
Seat 4: dbffffb3 ($21.85 in chips)
Seat 5: Hero ($15.43 in chips)
Seat 6: 3c64da5 ($10.53 in chips)
4186ebe3: posts small blind $0.05
1dd4d438: posts big blind $0.1
*** HOLE CARDS ***
Dealt to 7155dca 
Dealt to 4186ebe3 
Dealt to 1dd4d438 
Dealt to dbffffb3 
Dealt to Hero [7h Jh]
Dealt to 3c64da5 
dbffffb3: folds
Hero: folds
3c64da5: raises $0.15 to $0.25
7155dca: folds
4186ebe3: raises $0.85 to $1.1
1dd4d438: folds
3c64da5: raises $1.73 to $2.83
4186ebe3: folds
Uncalled bet ($1.73) returned to 3c64da5
*** SHOWDOWN ***
3c64da5 collected $2.17 from pot
*** SUMMARY ***
Total pot $2.3 | Rake $0.13 | Jackpot $0 | Bingo $0 | Fortune $0 | Tax $0
Seat 1: 7155dca (button) folded before Flop (didn't bet)
Seat 2: 4186ebe3 (small blind) folded before Flop
Seat 3: 1dd4d438 (big blind) folded before Flop
Seat 4: dbffffb3 folded before Flop (didn't bet)
Seat 5: Hero folded before Flop (didn't bet)
Seat 6: 3c64da5 collected ($2.17)


Poker Hand #RC2774761604: Hold'em No Limit ($0.05/$0.1) - 2024/08/05 12:59:43
Table 'RushAndCash21396864' 6-max Seat #1 is the button
Seat 1: 1aa5206a ($42.88 in chips)
Seat 2: 5e6c1851 ($13.59 in chips)
Seat 3: 231bec14 ($10.36 in chips)
Seat 4: 3c6efb05 ($17.13 in chips)
Seat 5: Hero ($15.43 in chips)
Seat 6: c43c25b0 ($24.25 in chips)
5e6c1851: posts small blind $0.05
231bec14: posts big blind $0.1
*** HOLE CARDS ***
Dealt to 1aa5206a 
Dealt to 5e6c1851 
Dealt to 231bec14 
Dealt to 3c6efb05 
Dealt to Hero [3h Qc]
Dealt to c43c25b0 
3c6efb05: folds
Hero: folds
c43c25b0: folds
1aa5206a: folds
5e6c1851: raises $0.2 to $0.3
231bec14: folds
Uncalled bet ($0.2) returned to 5e6c1851
*** SHOWDOWN ***
5e6c1851 collected $0.2 from pot
*** SUMMARY ***
Total pot $0.2 | Rake $0 | Jackpot $0 | Bingo $0 | Fortune $0 | Tax $0
Seat 1: 1aa5206a (button) folded before Flop (didn't bet)
Seat 2: 5e6c1851 (small blind) collected ($0.2)
Seat 3: 231bec14 (big blind) folded before Flop
Seat 4: 3c6efb05 folded before Flop (didn't bet)
Seat 5: Hero folded before Flop (didn't bet)
Seat 6: c43c25b0 folded before Flop (didn't bet)


Poker Hand #RC2774761513: Hold'em No Limit ($0.05/$0.1) - 2024/08/05 12:59:31
Table 'RushAndCash21396773' 6-max Seat #1 is the button
Seat 1: 836bfd7 ($10.27 in chips)
Seat 2: fce56742 ($13.29 in chips)
Seat 3: ebf21aa ($15.19 in chips)
Seat 4: da1ba5d7 ($10.57 in chips)
Seat 5: 42383f95 ($11.96 in chips)
Seat 6: Hero ($15.43 in chips)
fce56742: posts small blind $0.05
ebf21aa: posts big blind $0.1
*** HOLE CARDS ***
Dealt to 836bfd7 
Dealt to fce56742 
Dealt to ebf21aa 
Dealt to da1ba5d7 
Dealt to 42383f95 
Dealt to Hero [Jd Qc]
da1ba5d7: folds
42383f95: raises $0.15 to $0.25
Hero: folds
836bfd7: folds
fce56742: folds
ebf21aa: calls $0.15
*** FLOP *** [6d 7s 2c]
ebf21aa: checks
42383f95: bets $0.14
ebf21aa: raises $0.35 to $0.49
42383f95: calls $0.35
*** TURN *** [6d 7s 2c] [2h]
ebf21aa: checks
42383f95: bets $1.15
ebf21aa: folds
Uncalled bet ($1.15) returned to 42383f95
*** SHOWDOWN ***
42383f95 collected $1.46 from pot
*** SUMMARY ***
Total pot $1.53 | Rake $0.07 | Jackpot $0 | Bingo $0 | Fortune $0 | Tax $0
Board [6d 7s 2c 2h]
Seat 1: 836bfd7 (button) folded before Flop (didn't bet)
Seat 2: fce56742 (small blind) folded before Flop
Seat 3: ebf21aa (big blind) folded on the Turn
Seat 4: da1ba5d7 folded before Flop (didn't bet)
Seat 5: 42383f95 won ($1.46)
Seat 6: Hero folded before Flop (didn't bet)


Poker Hand #RC2774761472: Hold'em No Limit ($0.05/$0.1) - 2024/08/05 12:59:26
Table 'RushAndCash21396732' 6-max Seat #1 is the button
Seat 1: 2c243e42 ($10.38 in chips)
Seat 2: 53bf8907 ($16.08 in chips)
Seat 3: Hero ($15.53 in chips)
Seat 4: eaa5e890 ($12.49 in chips)
Seat 5: e9b8904b ($17.2 in chips)
Seat 6: e9213cfe ($19.81 in chips)
53bf8907: posts small blind $0.05
Hero: posts big blind $0.1
*** HOLE CARDS ***
Dealt to 2c243e42 
Dealt to 53bf8907 
Dealt to Hero [Kc 4s]
Dealt to eaa5e890 
Dealt to e9b8904b 
Dealt to e9213cfe 
eaa5e890: folds
e9b8904b: folds
e9213cfe: folds
2c243e42: folds
53bf8907: raises $0.2 to $0.3
Hero: folds
Uncalled bet ($0.2) returned to 53bf8907
*** SHOWDOWN ***
53bf8907 collected $0.2 from pot
*** SUMMARY ***
Total pot $0.2 | Rake $0 | Jackpot $0 | Bingo $0 | Fortune $0 | Tax $0
Seat 1: 2c243e42 (button) folded before Flop (didn't bet)
Seat 2: 53bf8907 (small blind) collected ($0.2)
Seat 3: Hero (big blind) folded before Flop
Seat 4: eaa5e890 folded before Flop (didn't bet)
Seat 5: e9b8904b folded before Flop (didn't bet)
Seat 6: e9213cfe folded before Flop (didn't bet)


Poker Hand #RC2774761372: Hold'em No Limit ($0.05/$0.1) - 2024/08/05 12:59:13
Table 'RushAndCash21396632' 6-max Seat #1 is the button
Seat 1: a4066c25 ($14.54 in chips)
Seat 2: Hero ($15.58 in chips)
Seat 3: b123c7a2 ($10 in chips)
Seat 4: 875951ec ($13.38 in chips)
Seat 5: ee46ea07 ($13.69 in chips)
Seat 6: df3fc675 ($10.15 in chips)
Hero: posts small blind $0.05
b123c7a2: posts big blind $0.1
*** HOLE CARDS ***
Dealt to a4066c25 
Dealt to Hero [8c As]
Dealt to b123c7a2 
Dealt to 875951ec 
Dealt to ee46ea07 
Dealt to df3fc675 
875951ec: raises $0.1 to $0.2
ee46ea07: folds
df3fc675: folds
a4066c25: folds
Hero: folds
b123c7a2: folds
Uncalled bet ($0.1) returned to 875951ec
*** SHOWDOWN ***
875951ec collected $0.25 from pot
*** SUMMARY ***
Total pot $0.25 | Rake $0 | Jackpot $0 | Bingo $0 | Fortune $0 | Tax $0
Seat 1: a4066c25 (button) folded before Flop (didn't bet)
Seat 2: Hero (small blind) folded before Flop
Seat 3: b123c7a2 (big blind) folded before Flop
Seat 4: 875951ec collected ($0.25)
Seat 5: ee46ea07 folded before Flop (didn't bet)
Seat 6: df3fc675 folded before Flop (didn't bet)


Poker Hand #RC2774761348: Hold'em No Limit ($0.05/$0.1) - 2024/08/05 12:59:09
Table 'RushAndCash21396608' 6-max Seat #1 is the button
Seat 1: 257ad3a6 ($16.15 in chips)
Seat 2: 364902ff ($21.36 in chips)
Seat 3: 3433f4a8 ($11.99 in chips)
Seat 4: Hero ($15.58 in chips)
Seat 5: bb387656 ($18.25 in chips)
Seat 6: 4f612bdf ($11.45 in chips)
364902ff: posts small blind $0.05
3433f4a8: posts big blind $0.1
*** HOLE CARDS ***
Dealt to 257ad3a6 
Dealt to 364902ff 
Dealt to 3433f4a8 
Dealt to Hero [Ks 4s]
Dealt to bb387656 
Dealt to 4f612bdf 
Hero: folds
bb387656: folds
4f612bdf: raises $0.15 to $0.25
257ad3a6: folds
364902ff: folds
3433f4a8: folds
Uncalled bet ($0.15) returned to 4f612bdf
*** SHOWDOWN ***
4f612bdf collected $0.25 from pot
*** SUMMARY ***
Total pot $0.25 | Rake $0 | Jackpot $0 | Bingo $0 | Fortune $0 | Tax $0
Seat 1: 257ad3a6 (button) folded before Flop (didn't bet)
Seat 2: 364902ff (small blind) folded before Flop
Seat 3: 3433f4a8 (big blind) folded before Flop
Seat 4: Hero folded before Flop (didn't bet)
Seat 5: bb387656 folded before Flop (didn't bet)
Seat 6: 4f612bdf collected ($0.25)


Poker Hand #RC2774761323: Hold'em No Limit ($0.05/$0.1) - 2024/08/05 12:59:06
Table 'RushAndCash21396583' 6-max Seat #1 is the button
Seat 1: 738a8979 ($10.37 in chips)
Seat 2: 76b2da90 ($11.85 in chips)
Seat 3: eed55452 ($10.53 in chips)
Seat 4: Hero ($15.58 in chips)
Seat 5: 1420c485 ($8.97 in chips)
Seat 6: a5c40612 ($10.37 in chips)
76b2da90: posts small blind $0.05
eed55452: posts big blind $0.1
*** HOLE CARDS ***
Dealt to 738a8979 
Dealt to 76b2da90 
Dealt to eed55452 
Dealt to Hero [Jh 3d]
Dealt to 1420c485 
Dealt to a5c40612 
Hero: folds
1420c485: folds
a5c40612: folds
738a8979: folds
76b2da90: raises $0.1 to $0.2
eed55452: folds
Uncalled bet ($0.1) returned to 76b2da90
*** SHOWDOWN ***
76b2da90 collected $0.2 from pot
*** SUMMARY ***
Total pot $0.2 | Rake $0 | Jackpot $0 | Bingo $0 | Fortune $0 | Tax $0
Seat 1: 738a8979 (button) folded before Flop (didn't bet)
Seat 2: 76b2da90 (small blind) collected ($0.2)
Seat 3: eed55452 (big blind) folded before Flop
Seat 4: Hero folded before Flop (didn't bet)
Seat 5: 1420c485 folded before Flop (didn't bet)
Seat 6: a5c40612 folded before Flop (didn't bet)


Poker Hand #RC2774761286: Hold'em No Limit ($0.05/$0.1) - 2024/08/05 12:59:01
Table 'RushAndCash21396546' 6-max Seat #1 is the button
Seat 1: 7db0f170 ($8.69 in chips)
Seat 2: 1dd4d438 ($10.18 in chips)
Seat 3: 3b80ebf4 ($10.49 in chips)
Seat 4: Hero ($15.58 in chips)
Seat 5: 18e5d625 ($10 in chips)
Seat 6: de5848f9 ($9.36 in chips)
1dd4d438: posts small blind $0.05
3b80ebf4: posts big blind $0.1
*** HOLE CARDS ***
Dealt to 7db0f170 
Dealt to 1dd4d438 
Dealt to 3b80ebf4 
Dealt to Hero [9s 3s]
Dealt to 18e5d625 
Dealt to de5848f9 
Hero: folds
18e5d625: folds
de5848f9: folds
7db0f170: folds
1dd4d438: raises $0.2 to $0.3
3b80ebf4: folds
Uncalled bet ($0.2) returned to 1dd4d438
*** SHOWDOWN ***
1dd4d438 collected $0.2 from pot
*** SUMMARY ***
Total pot $0.2 | Rake $0 | Jackpot $0 | Bingo $0 | Fortune $0 | Tax $0
Seat 1: 7db0f170 (button) folded before Flop (didn't bet)
Seat 2: 1dd4d438 (small blind) collected ($0.2)
Seat 3: 3b80ebf4 (big blind) folded before Flop
Seat 4: Hero folded before Flop (didn't bet)
Seat 5: 18e5d625 folded before Flop (didn't bet)
Seat 6: de5848f9 folded before Flop (didn't bet)


Poker Hand #RC2774761236: Hold'em No Limit ($0.05/$0.1) - 2024/08/05 12:58:55
Table 'RushAndCash21396496' 6-max Seat #1 is the button
Seat 1: Hero ($15.58 in chips)
Seat 2: 7435ecb7 ($14.57 in chips)
Seat 3: 5de8cc3f ($18.44 in chips)
Seat 4: 7add3569 ($11.05 in chips)
Seat 5: 136b30cf ($22.9 in chips)
Seat 6: b123c7a2 ($9.85 in chips)
7435ecb7: posts small blind $0.05
5de8cc3f: posts big blind $0.1
*** HOLE CARDS ***
Dealt to Hero [9d Qc]
Dealt to 7435ecb7 
Dealt to 5de8cc3f 
Dealt to 7add3569 
Dealt to 136b30cf 
Dealt to b123c7a2 
7add3569: folds
136b30cf: raises $0.2 to $0.3
b123c7a2: folds
Hero: folds
7435ecb7: folds
5de8cc3f: folds
Uncalled bet ($0.2) returned to 136b30cf
*** SHOWDOWN ***
136b30cf collected $0.25 from pot
*** SUMMARY ***
Total pot $0.25 | Rake $0 | Jackpot $0 | Bingo $0 | Fortune $0 | Tax $0
Seat 1: Hero (button) folded before Flop (didn't bet)
Seat 2: 7435ecb7 (small blind) folded before Flop
Seat 3: 5de8cc3f (big blind) folded before Flop
Seat 4: 7add3569 folded before Flop (didn't bet)
Seat 5: 136b30cf collected ($0.25)
Seat 6: b123c7a2 folded before Flop (didn't bet)


Poker Hand #RC2774761171: Hold'em No Limit ($0.05/$0.1) - 2024/08/05 12:58:46
Table 'RushAndCash21396431' 6-max Seat #1 is the button
Seat 1: Hero ($15.58 in chips)
Seat 2: 42322d75 ($37.71 in chips)
Seat 3: 9acf1c1f ($16.07 in chips)
Seat 4: 4a28754c ($11.37 in chips)
Seat 5: 7096d81 ($10.78 in chips)
Seat 6: 2c243e42 ($10.2 in chips)
42322d75: posts small blind $0.05
9acf1c1f: posts big blind $0.1
*** HOLE CARDS ***
Dealt to Hero [2c 3c]
Dealt to 42322d75 
Dealt to 9acf1c1f 
Dealt to 4a28754c 
Dealt to 7096d81 
Dealt to 2c243e42 
4a28754c: raises $0.1 to $0.2
7096d81: raises $0.42 to $0.62
2c243e42: folds
Hero: folds
42322d75: folds
9acf1c1f: folds
4a28754c: folds
Uncalled bet ($0.42) returned to 7096d81
*** SHOWDOWN ***
7096d81 collected $0.53 from pot
*** SUMMARY ***
Total pot $0.55 | Rake $0.02 | Jackpot $0 | Bingo $0 | Fortune $0 | Tax $0
Seat 1: Hero (button) folded before Flop (didn't bet)
Seat 2: 42322d75 (small blind) folded before Flop
Seat 3: 9acf1c1f (big blind) folded before Flop
Seat 4: 4a28754c folded before Flop
Seat 5: 7096d81 collected ($0.53)
Seat 6: 2c243e42 folded before Flop (didn't bet)


Poker Hand #RC2774761145: Hold'em No Limit ($0.05/$0.1) - 2024/08/05 12:58:43
Table 'RushAndCash21396405' 6-max Seat #1 is the button
Seat 1: 427a6303 ($11.12 in chips)
Seat 2: f058296c ($10.18 in chips)
Seat 3: 7435ecb7 ($14.67 in chips)
Seat 4: Hero ($15.58 in chips)
Seat 5: 73c8d5ef ($26.59 in chips)
Seat 6: 8510f657 ($10.55 in chips)
f058296c: posts small blind $0.05
7435ecb7: posts big blind $0.1
*** HOLE CARDS ***
Dealt to 427a6303 
Dealt to f058296c 
Dealt to 7435ecb7 
Dealt to Hero [As 3s]
Dealt to 73c8d5ef 
Dealt to 8510f657 
Hero: folds
73c8d5ef: raises $0.1 to $0.2
8510f657: folds
427a6303: folds
f058296c: calls $0.15
7435ecb7: folds
*** FLOP *** [8d 9c Qc]
f058296c: checks
73c8d5ef: bets $0.28
f058296c: raises $0.78 to $1.06
73c8d5ef: folds
Uncalled bet ($0.78) returned to f058296c
*** SHOWDOWN ***
f058296c collected $1.01 from pot
*** SUMMARY ***
Total pot $1.06 | Rake $0.05 | Jackpot $0 | Bingo $0 | Fortune $0 | Tax $0
Board [8d 9c Qc]
Seat 1: 427a6303 (button) folded before Flop (didn't bet)
Seat 2: f058296c (small blind) won ($1.01)
Seat 3: 7435ecb7 (big blind) folded before Flop
Seat 4: Hero folded before Flop (didn't bet)
Seat 5: 73c8d5ef folded on the Flop
Seat 6: 8510f657 folded before Flop (didn't bet)


Poker Hand #RC2774761111: Hold'em No Limit ($0.05/$0.1) - 2024/08/05 12:58:38
Table 'RushAndCash21396371' 6-max Seat #1 is the button
Seat 1: 1e125cc0 ($10.29 in chips)
Seat 2: Hero ($15.63 in chips)
Seat 3: 3dac9132 ($10.2 in chips)
Seat 4: 7c729b47 ($10.06 in chips)
Seat 5: 1f7acbae ($10 in chips)
Seat 6: bc9b23d3 ($10 in chips)
Hero: posts small blind $0.05
3dac9132: posts big blind $0.1
*** HOLE CARDS ***
Dealt to 1e125cc0 
Dealt to Hero [5d 2h]
Dealt to 3dac9132 
Dealt to 7c729b47 
Dealt to 1f7acbae 
Dealt to bc9b23d3 
7c729b47: raises $0.1 to $0.2
1f7acbae: folds
bc9b23d3: folds
1e125cc0: folds
Hero: folds
3dac9132: calls $0.1
*** FLOP *** [Js 4s 3d]
3dac9132: checks
7c729b47: bets $0.45
3dac9132: folds
Uncalled bet ($0.45) returned to 7c729b47
*** SHOWDOWN ***
7c729b47 collected $0.43 from pot
*** SUMMARY ***
Total pot $0.45 | Rake $0.02 | Jackpot $0 | Bingo $0 | Fortune $0 | Tax $0
Board [Js 4s 3d]
Seat 1: 1e125cc0 (button) folded before Flop (didn't bet)
Seat 2: Hero (small blind) folded before Flop
Seat 3: 3dac9132 (big blind) folded on the Flop
Seat 4: 7c729b47 won ($0.43)
Seat 5: 1f7acbae folded before Flop (didn't bet)
Seat 6: bc9b23d3 folded before Flop (didn't bet)


Poker Hand #RC2774761074: Hold'em No Limit ($0.05/$0.1) - 2024/08/05 12:58:33
Table 'RushAndCash21396334' 6-max Seat #1 is the button
Seat 1: ba4cd173 ($18.87 in chips)
Seat 2: d1679aaf ($6.29 in chips)
Seat 3: Hero ($15.73 in chips)
Seat 4: 9957f83a ($16.25 in chips)
Seat 5: 605962a ($11.8 in chips)
Seat 6: 1f9d7383 ($10.25 in chips)
d1679aaf: posts small blind $0.05
Hero: posts big blind $0.1
*** HOLE CARDS ***
Dealt to ba4cd173 
Dealt to d1679aaf 
Dealt to Hero [5d 2s]
Dealt to 9957f83a 
Dealt to 605962a 
Dealt to 1f9d7383 
9957f83a: folds
605962a: folds
1f9d7383: folds
ba4cd173: raises $0.1 to $0.2
d1679aaf: calls $0.15
Hero: folds
*** FLOP *** [7c 3s 4d]
d1679aaf: checks
ba4cd173: checks
*** TURN *** [7c 3s 4d] [As]
d1679aaf: bets $0.17
ba4cd173: folds
Uncalled bet ($0.17) returned to d1679aaf
*** SHOWDOWN ***
d1679aaf collected $0.48 from pot
*** SUMMARY ***
Total pot $0.5 | Rake $0.02 | Jackpot $0 | Bingo $0 | Fortune $0 | Tax $0
Board [7c 3s 4d As]
Seat 1: ba4cd173 (button) folded on the Turn
Seat 2: d1679aaf (small blind) won ($0.48)
Seat 3: Hero (big blind) folded before Flop
Seat 4: 9957f83a folded before Flop (didn't bet)
Seat 5: 605962a folded before Flop (didn't bet)
Seat 6: 1f9d7383 folded before Flop (didn't bet)


Poker Hand #RC2774761047: Hold'em No Limit ($0.05/$0.1) - 2024/08/05 12:58:30
Table 'RushAndCash21396307' 6-max Seat #1 is the button
Seat 1: b36579fb ($10 in chips)
Seat 2: 98e2d761 ($27.39 in chips)
Seat 3: e25d0386 ($10.13 in chips)
Seat 4: Hero ($15.73 in chips)
Seat 5: 42383f95 ($12.06 in chips)
Seat 6: ab950b3c ($43.15 in chips)
98e2d761: posts small blind $0.05
e25d0386: posts big blind $0.1
*** HOLE CARDS ***
Dealt to b36579fb 
Dealt to 98e2d761 
Dealt to e25d0386 
Dealt to Hero [Js Tc]
Dealt to 42383f95 
Dealt to ab950b3c 
Hero: folds
42383f95: folds
ab950b3c: raises $0.12 to $0.22
b36579fb: folds
98e2d761: raises $0.87 to $1.09
e25d0386: folds
ab950b3c: raises $2.41 to $3.5
98e2d761: folds
Uncalled bet ($2.41) returned to ab950b3c
*** SHOWDOWN ***
ab950b3c collected $2.17 from pot
*** SUMMARY ***
Total pot $2.28 | Rake $0.11 | Jackpot $0 | Bingo $0 | Fortune $0 | Tax $0
Seat 1: b36579fb (button) folded before Flop (didn't bet)
Seat 2: 98e2d761 (small blind) folded before Flop
Seat 3: e25d0386 (big blind) folded before Flop
Seat 4: Hero folded before Flop (didn't bet)
Seat 5: 42383f95 folded before Flop (didn't bet)
Seat 6: ab950b3c collected ($2.17)


Poker Hand #RC2774761026: Hold'em No Limit ($0.05/$0.1) - 2024/08/05 12:58:27
Table 'RushAndCash21396286' 6-max Seat #1 is the button
Seat 1: Hero ($15.73 in chips)
Seat 2: ba4cd173 ($18.92 in chips)
Seat 3: 2da240f5 ($21.85 in chips)
Seat 4: daab20d3 ($11.37 in chips)
Seat 5: 42383f95 ($12.06 in chips)
Seat 6: 90dbb409 ($13.49 in chips)
ba4cd173: posts small blind $0.05
2da240f5: posts big blind $0.1
*** HOLE CARDS ***
Dealt to Hero [Ah Jd]
Dealt to ba4cd173 
Dealt to 2da240f5 
Dealt to daab20d3 
Dealt to 42383f95 
Dealt to 90dbb409 
daab20d3: folds
42383f95: folds
90dbb409: folds
Hero: folds
ba4cd173: folds
Uncalled bet ($0.05) returned to 2da240f5
*** SHOWDOWN ***
2da240f5 collected $0.1 from pot
*** SUMMARY ***
Total pot $0.1 | Rake $0 | Jackpot $0 | Bingo $0 | Fortune $0 | Tax $0
Seat 1: Hero (button) folded before Flop (didn't bet)
Seat 2: ba4cd173 (small blind) folded before Flop
Seat 3: 2da240f5 (big blind) collected ($0.1)
Seat 4: daab20d3 folded before Flop (didn't bet)
Seat 5: 42383f95 folded before Flop (didn't bet)
Seat 6: 90dbb409 folded before Flop (didn't bet)


Poker Hand #RC2774761005: Hold'em No Limit ($0.05/$0.1) - 2024/08/05 12:58:24
Table 'RushAndCash21396265' 6-max Seat #1 is the button
Seat 1: 8ec92d94 ($10 in chips)
Seat 2: 231bec14 ($8.99 in chips)
Seat 3: Hero ($15.83 in chips)
Seat 4: 33d4b5ad ($12.58 in chips)
Seat 5: 851fefb5 ($11.83 in chips)
Seat 6: df9a22ce ($6.26 in chips)
231bec14: posts small blind $0.05
Hero: posts big blind $0.1
*** HOLE CARDS ***
Dealt to 8ec92d94 
Dealt to 231bec14 
Dealt to Hero [2s 3h]
Dealt to 33d4b5ad 
Dealt to 851fefb5 
Dealt to df9a22ce 
33d4b5ad: folds
851fefb5: folds
df9a22ce: folds
8ec92d94: folds
231bec14: calls $0.05
Hero: checks
*** FLOP *** [6h Js Jd]
231bec14: checks
Hero: checks
*** TURN *** [6h Js Jd] [Ks]
231bec14: checks
Hero: checks
*** RIVER *** [6h Js Jd Ks] [Qh]
231bec14: bets $0.1
Hero: folds
Uncalled bet ($0.1) returned to 231bec14
*** SHOWDOWN ***
231bec14 collected $0.19 from pot
*** SUMMARY ***
Total pot $0.2 | Rake $0.01 | Jackpot $0 | Bingo $0 | Fortune $0 | Tax $0
Board [6h Js Jd Ks Qh]
Seat 1: 8ec92d94 (button) folded before Flop (didn't bet)
Seat 2: 231bec14 (small blind) won ($0.19)
Seat 3: Hero (big blind) folded on the River
Seat 4: 33d4b5ad folded before Flop (didn't bet)
Seat 5: 851fefb5 folded before Flop (didn't bet)
Seat 6: df9a22ce folded before Flop (didn't bet)


Poker Hand #RC2774760985: Hold'em No Limit ($0.05/$0.1) - 2024/08/05 12:58:20
Table 'RushAndCash21396245' 6-max Seat #1 is the button
Seat 1: cc7203b4 ($11.04 in chips)
Seat 2: Hero ($15.88 in chips)
Seat 3: a18ebac8 ($10 in chips)
Seat 4: 36bbdb6d ($4.22 in chips)
Seat 5: b65d2a12 ($23.93 in chips)
Seat 6: d0a5f098 ($11.03 in chips)
Hero: posts small blind $0.05
a18ebac8: posts big blind $0.1
*** HOLE CARDS ***
Dealt to cc7203b4 
Dealt to Hero [2h Jc]
Dealt to a18ebac8 
Dealt to 36bbdb6d 
Dealt to b65d2a12 
Dealt to d0a5f098 
36bbdb6d: raises $0.1 to $0.2
b65d2a12: folds
d0a5f098: calls $0.2
cc7203b4: folds
Hero: folds
a18ebac8: folds
*** FLOP *** [9d Tc Kh]
36bbdb6d: checks
d0a5f098: bets $0.19
36bbdb6d: calls $0.19
*** TURN *** [9d Tc Kh] [6d]
36bbdb6d: checks
d0a5f098: bets $1.17
36bbdb6d: folds
Uncalled bet ($1.17) returned to d0a5f098
*** SHOWDOWN ***
d0a5f098 collected $0.89 from pot
*** SUMMARY ***
Total pot $0.93 | Rake $0.04 | Jackpot $0 | Bingo $0 | Fortune $0 | Tax $0
Board [9d Tc Kh 6d]
Seat 1: cc7203b4 (button) folded before Flop (didn't bet)
Seat 2: Hero (small blind) folded before Flop
Seat 3: a18ebac8 (big blind) folded before Flop
Seat 4: 36bbdb6d folded on the Turn
Seat 5: b65d2a12 folded before Flop (didn't bet)
Seat 6: d0a5f098 won ($0.89)


Poker Hand #RC2774760916: Hold'em No Limit ($0.05/$0.1) - 2024/08/05 12:58:11
Table 'RushAndCash21396176' 6-max Seat #1 is the button
Seat 1: d227cdbd ($10.46 in chips)
Seat 2: 938dc1b0 ($10.61 in chips)
Seat 3: 3ccb1fbe ($11.12 in chips)
Seat 4: 42f6ae09 ($15.07 in chips)
Seat 5: 43be4122 ($18.36 in chips)
Seat 6: Hero ($15.88 in chips)
938dc1b0: posts small blind $0.05
3ccb1fbe: posts big blind $0.1
*** HOLE CARDS ***
Dealt to d227cdbd 
Dealt to 938dc1b0 
Dealt to 3ccb1fbe 
Dealt to 42f6ae09 
Dealt to 43be4122 
Dealt to Hero [8s Js]
42f6ae09: folds
43be4122: calls $0.1
Hero: folds
d227cdbd: folds
938dc1b0: calls $0.05
3ccb1fbe: checks
*** FLOP *** [Ks 9s 5d]
938dc1b0: checks
3ccb1fbe: checks
43be4122: checks
*** TURN *** [Ks 9s 5d] [Qh]
938dc1b0: bets $0.15
3ccb1fbe: folds
43be4122: folds
Uncalled bet ($0.15) returned to 938dc1b0
*** SHOWDOWN ***
938dc1b0 collected $0.29 from pot
*** SUMMARY ***
Total pot $0.3 | Rake $0.01 | Jackpot $0 | Bingo $0 | Fortune $0 | Tax $0
Board [Ks 9s 5d Qh]
Seat 1: d227cdbd (button) folded before Flop (didn't bet)
Seat 2: 938dc1b0 (small blind) won ($0.29)
Seat 3: 3ccb1fbe (big blind) folded on the Turn
Seat 4: 42f6ae09 folded before Flop (didn't bet)
Seat 5: 43be4122 folded on the Turn
Seat 6: Hero folded before Flop (didn't bet)


Poker Hand #RC2774760807: Hold'em No Limit ($0.05/$0.1) - 2024/08/05 12:57:57
Table 'RushAndCash21396067' 6-max Seat #1 is the button
Seat 1: 7ef3e576 ($12.74 in chips)
Seat 2: Hero ($15.93 in chips)
Seat 3: 7166ca79 ($8.3 in chips)
Seat 4: 527de330 ($12.71 in chips)
Seat 5: b65d2a12 ($23.83 in chips)
Seat 6: ba4cd173 ($18.92 in chips)
Hero: posts small blind $0.05
7166ca79: posts big blind $0.1
*** HOLE CARDS ***
Dealt to 7ef3e576 
Dealt to Hero [Js 5s]
Dealt to 7166ca79 
Dealt to 527de330 
Dealt to b65d2a12 
Dealt to ba4cd173 
527de330: folds
b65d2a12: raises $0.1 to $0.2
ba4cd173: folds
7ef3e576: folds
Hero: folds
7166ca79: folds
Uncalled bet ($0.1) returned to b65d2a12
*** SHOWDOWN ***
b65d2a12 collected $0.25 from pot
*** SUMMARY ***
Total pot $0.25 | Rake $0 | Jackpot $0 | Bingo $0 | Fortune $0 | Tax $0
Seat 1: 7ef3e576 (button) folded before Flop (didn't bet)
Seat 2: Hero (small blind) folded before Flop
Seat 3: 7166ca79 (big blind) folded before Flop
Seat 4: 527de330 folded before Flop (didn't bet)
Seat 5: b65d2a12 collected ($0.25)
Seat 6: ba4cd173 folded before Flop (didn't bet)


Poker Hand #RC2774760781: Hold'em No Limit ($0.05/$0.1) - 2024/08/05 12:57:53
Table 'RushAndCash21396041' 6-max Seat #1 is the button
Seat 1: 9b012cde ($58.82 in chips)
Seat 2: b958f85c ($7.81 in chips)
Seat 3: Hero ($16.03 in chips)
Seat 4: 35351de3 ($19.13 in chips)
Seat 5: f058296c ($10.33 in chips)
Seat 6: c5a0235a ($10.85 in chips)
b958f85c: posts small blind $0.05
Hero: posts big blind $0.1
*** HOLE CARDS ***
Dealt to 9b012cde 
Dealt to b958f85c 
Dealt to Hero [3c 8h]
Dealt to 35351de3 
Dealt to f058296c 
Dealt to c5a0235a 
35351de3: folds
f058296c: folds
c5a0235a: folds
9b012cde: raises $0.1 to $0.2
b958f85c: raises $0.75 to $0.95
Hero: folds
9b012cde: folds
Uncalled bet ($0.75) returned to b958f85c
*** SHOWDOWN ***
b958f85c collected $0.48 from pot
*** SUMMARY ***
Total pot $0.5 | Rake $0.02 | Jackpot $0 | Bingo $0 | Fortune $0 | Tax $0
Seat 1: 9b012cde (button) folded before Flop
Seat 2: b958f85c (small blind) collected ($0.48)
Seat 3: Hero (big blind) folded before Flop
Seat 4: 35351de3 folded before Flop (didn't bet)
Seat 5: f058296c folded before Flop (didn't bet)
Seat 6: c5a0235a folded before Flop (didn't bet)


Poker Hand #RC2774760754: Hold'em No Limit ($0.05/$0.1) - 2024/08/05 12:57:49
Table 'RushAndCash21396014' 6-max Seat #1 is the button
Seat 1: 36112634 ($14.89 in chips)
Seat 2: 5c68fa9e ($10 in chips)
Seat 3: 5d265da3 ($33.58 in chips)
Seat 4: 5ec6e508 ($32.23 in chips)
Seat 5: 6dbe20b7 ($11.2 in chips)
Seat 6: Hero ($16.03 in chips)
5c68fa9e: posts small blind $0.05
5d265da3: posts big blind $0.1
*** HOLE CARDS ***
Dealt to 36112634 
Dealt to 5c68fa9e 
Dealt to 5d265da3 
Dealt to 5ec6e508 
Dealt to 6dbe20b7 
Dealt to Hero [8h 9c]
5ec6e508: folds
6dbe20b7: folds
Hero: folds
36112634: folds
5c68fa9e: raises $0.2 to $0.3
5d265da3: folds
Uncalled bet ($0.2) returned to 5c68fa9e
*** SHOWDOWN ***
5c68fa9e collected $0.2 from pot
*** SUMMARY ***
Total pot $0.2 | Rake $0 | Jackpot $0 | Bingo $0 | Fortune $0 | Tax $0
Seat 1: 36112634 (button) folded before Flop (didn't bet)
Seat 2: 5c68fa9e (small blind) collected ($0.2)
Seat 3: 5d265da3 (big blind) folded before Flop
Seat 4: 5ec6e508 folded before Flop (didn't bet)
Seat 5: 6dbe20b7 folded before Flop (didn't bet)
Seat 6: Hero folded before Flop (didn't bet)


Poker Hand #RC2774760641: Hold'em No Limit ($0.05/$0.1) - 2024/08/05 12:57:34
Table 'RushAndCash21395901' 6-max Seat #1 is the button
Seat 1: Hero ($15.88 in chips)
Seat 2: 9e4260ad ($10 in chips)
Seat 3: 71e51e91 ($15.41 in chips)
Seat 4: 71ea0773 ($7.99 in chips)
Seat 5: 5e4a2802 ($10.74 in chips)
Seat 6: 565a62db ($6.75 in chips)
9e4260ad: posts small blind $0.05
71e51e91: posts big blind $0.1
*** HOLE CARDS ***
Dealt to Hero [Jc Kd]
Dealt to 9e4260ad 
Dealt to 71e51e91 
Dealt to 71ea0773 
Dealt to 5e4a2802 
Dealt to 565a62db 
71ea0773: folds
5e4a2802: folds
565a62db: folds
Hero: raises $0.14 to $0.24
9e4260ad: folds
71e51e91: folds
Uncalled bet ($0.14) returned to Hero
*** SHOWDOWN ***
Hero collected $0.25 from pot
*** SUMMARY ***
Total pot $0.25 | Rake $0 | Jackpot $0 | Bingo $0 | Fortune $0 | Tax $0
Seat 1: Hero (button) collected ($0.25)
Seat 2: 9e4260ad (small blind) folded before Flop
Seat 3: 71e51e91 (big blind) folded before Flop
Seat 4: 71ea0773 folded before Flop (didn't bet)
Seat 5: 5e4a2802 folded before Flop (didn't bet)
Seat 6: 565a62db folded before Flop (didn't bet)


Poker Hand #RC2774760517: Hold'em No Limit ($0.05/$0.1) - 2024/08/05 12:57:18
Table 'RushAndCash21395777' 6-max Seat #1 is the button
Seat 1: 71817254 ($23.43 in chips)
Seat 2: 86739a14 ($11.66 in chips)
Seat 3: 1ab91021 ($10 in chips)
Seat 4: 6e6756d9 ($16.53 in chips)
Seat 5: e5b05063 ($17.09 in chips)
Seat 6: Hero ($15.73 in chips)
86739a14: posts small blind $0.05
1ab91021: posts big blind $0.1
*** HOLE CARDS ***
Dealt to 71817254 
Dealt to 86739a14 
Dealt to 1ab91021 
Dealt to 6e6756d9 
Dealt to e5b05063 
Dealt to Hero [7s 9s]
6e6756d9: folds
e5b05063: folds
Hero: raises $0.14 to $0.24
71817254: folds
86739a14: folds
1ab91021: folds
Uncalled bet ($0.14) returned to Hero
*** SHOWDOWN ***
Hero collected $0.25 from pot
*** SUMMARY ***
Total pot $0.25 | Rake $0 | Jackpot $0 | Bingo $0 | Fortune $0 | Tax $0
Seat 1: 71817254 (button) folded before Flop (didn't bet)
Seat 2: 86739a14 (small blind) folded before Flop
Seat 3: 1ab91021 (big blind) folded before Flop
Seat 4: 6e6756d9 folded before Flop (didn't bet)
Seat 5: e5b05063 folded before Flop (didn't bet)
Seat 6: Hero collected ($0.25)


Poker Hand #RC2774760486: Hold'em No Limit ($0.05/$0.1) - 2024/08/05 12:57:14
Table 'RushAndCash21395746' 6-max Seat #1 is the button
Seat 1: 748321a5 ($11.04 in chips)
Seat 2: e0b14086 ($10 in chips)
Seat 3: 64703012 ($16.98 in chips)
Seat 4: Hero ($15.73 in chips)
Seat 5: d56932f5 ($11.29 in chips)
Seat 6: 2c602ac2 ($9.47 in chips)
e0b14086: posts small blind $0.05
64703012: posts big blind $0.1
*** HOLE CARDS ***
Dealt to 748321a5 
Dealt to e0b14086 
Dealt to 64703012 
Dealt to Hero [Td 9h]
Dealt to d56932f5 
Dealt to 2c602ac2 
Hero: folds
d56932f5: folds
2c602ac2: folds
748321a5: raises $0.15 to $0.25
e0b14086: folds
64703012: calls $0.15
*** FLOP *** [Ts 5c Js]
64703012: checks
748321a5: bets $0.7
64703012: folds
Uncalled bet ($0.7) returned to 748321a5
*** SHOWDOWN ***
748321a5 collected $0.53 from pot
*** SUMMARY ***
Total pot $0.55 | Rake $0.02 | Jackpot $0 | Bingo $0 | Fortune $0 | Tax $0
Board [Ts 5c Js]
Seat 1: 748321a5 (button) won ($0.53)
Seat 2: e0b14086 (small blind) folded before Flop
Seat 3: 64703012 (big blind) folded on the Flop
Seat 4: Hero folded before Flop (didn't bet)
Seat 5: d56932f5 folded before Flop (didn't bet)
Seat 6: 2c602ac2 folded before Flop (didn't bet)


Poker Hand #RC2774760460: Hold'em No Limit ($0.05/$0.1) - 2024/08/05 12:57:11
Table 'RushAndCash21395720' 6-max Seat #1 is the button
Seat 1: 772edc7a ($25.73 in chips)
Seat 2: 7cf707b9 ($6.59 in chips)
Seat 3: f058296c ($10.06 in chips)
Seat 4: 7096d81 ($10.41 in chips)
Seat 5: 62ef8cc4 ($23.29 in chips)
Seat 6: Hero ($15.73 in chips)
7cf707b9: posts small blind $0.05
f058296c: posts big blind $0.1
*** HOLE CARDS ***
Dealt to 772edc7a 
Dealt to 7cf707b9 
Dealt to f058296c 
Dealt to 7096d81 
Dealt to 62ef8cc4 
Dealt to Hero [8h 3d]
7096d81: raises $0.1 to $0.2
62ef8cc4: folds
Hero: folds
772edc7a: folds
7cf707b9: folds
f058296c: folds
Uncalled bet ($0.1) returned to 7096d81
*** SHOWDOWN ***
7096d81 collected $0.25 from pot
*** SUMMARY ***
Total pot $0.25 | Rake $0 | Jackpot $0 | Bingo $0 | Fortune $0 | Tax $0
Seat 1: 772edc7a (button) folded before Flop (didn't bet)
Seat 2: 7cf707b9 (small blind) folded before Flop
Seat 3: f058296c (big blind) folded before Flop
Seat 4: 7096d81 collected ($0.25)
Seat 5: 62ef8cc4 folded before Flop (didn't bet)
Seat 6: Hero folded before Flop (didn't bet)


Poker Hand #RC2774760380: Hold'em No Limit ($0.05/$0.1) - 2024/08/05 12:57:01
Table 'RushAndCash21395640' 6-max Seat #1 is the button
Seat 1: bc9b23d3 ($10 in chips)
Seat 2: 24b8b991 ($12.07 in chips)
Seat 3: aff0d641 ($5.46 in chips)
Seat 4: d0a5f098 ($11.18 in chips)
Seat 5: Hero ($15.73 in chips)
Seat 6: af94ba84 ($10.42 in chips)
24b8b991: posts small blind $0.05
aff0d641: posts big blind $0.1
*** HOLE CARDS ***
Dealt to bc9b23d3 
Dealt to 24b8b991 
Dealt to aff0d641 
Dealt to d0a5f098 
Dealt to Hero [Qh 7h]
Dealt to af94ba84 
d0a5f098: folds
Hero: folds
af94ba84: raises $0.15 to $0.25
bc9b23d3: calls $0.25
24b8b991: folds
aff0d641: folds
*** FLOP *** [Ad Jc 6h]
af94ba84: bets $0.22
bc9b23d3: folds
Uncalled bet ($0.22) returned to af94ba84
*** SHOWDOWN ***
af94ba84 collected $0.62 from pot
*** SUMMARY ***
Total pot $0.65 | Rake $0.03 | Jackpot $0 | Bingo $0 | Fortune $0 | Tax $0
Board [Ad Jc 6h]
Seat 1: bc9b23d3 (button) folded on the Flop
Seat 2: 24b8b991 (small blind) folded before Flop
Seat 3: aff0d641 (big blind) folded before Flop
Seat 4: d0a5f098 folded before Flop (didn't bet)
Seat 5: Hero folded before Flop (didn't bet)
Seat 6: af94ba84 won ($0.62)


Poker Hand #RC2774760317: Hold'em No Limit ($0.05/$0.1) - 2024/08/05 12:56:54
Table 'RushAndCash21395577' 6-max Seat #1 is the button
Seat 1: 3dac9132 ($10 in chips)
Seat 2: Hero ($15.78 in chips)
Seat 3: 8e07bc08 ($12.37 in chips)
Seat 4: e33eca0 ($13.08 in chips)
Seat 5: 3ccb1fbe ($10.18 in chips)
Seat 6: 18f9e66e ($12.03 in chips)
Hero: posts small blind $0.05
8e07bc08: posts big blind $0.1
*** HOLE CARDS ***
Dealt to 3dac9132 
Dealt to Hero [4h 3s]
Dealt to 8e07bc08 
Dealt to e33eca0 
Dealt to 3ccb1fbe 
Dealt to 18f9e66e 
e33eca0: folds
3ccb1fbe: folds
18f9e66e: folds
3dac9132: raises $0.15 to $0.25
Hero: folds
8e07bc08: folds
Uncalled bet ($0.15) returned to 3dac9132
*** SHOWDOWN ***
3dac9132 collected $0.25 from pot
*** SUMMARY ***
Total pot $0.25 | Rake $0 | Jackpot $0 | Bingo $0 | Fortune $0 | Tax $0
Seat 1: 3dac9132 (button) collected ($0.25)
Seat 2: Hero (small blind) folded before Flop
Seat 3: 8e07bc08 (big blind) folded before Flop
Seat 4: e33eca0 folded before Flop (didn't bet)
Seat 5: 3ccb1fbe folded before Flop (didn't bet)
Seat 6: 18f9e66e folded before Flop (didn't bet)


Poker Hand #RC2774760275: Hold'em No Limit ($0.05/$0.1) - 2024/08/05 12:56:49
Table 'RushAndCash21395535' 6-max Seat #1 is the button
Seat 1: 25f61eac ($11.71 in chips)
Seat 2: 353f0f03 ($10.54 in chips)
Seat 3: Hero ($15.88 in chips)
Seat 4: c7552f9 ($9.39 in chips)
Seat 5: 1fea36ef ($19.68 in chips)
Seat 6: 2c7a529f ($16.83 in chips)
353f0f03: posts small blind $0.05
Hero: posts big blind $0.1
*** HOLE CARDS ***
Dealt to 25f61eac 
Dealt to 353f0f03 
Dealt to Hero [9h 7s]
Dealt to c7552f9 
Dealt to 1fea36ef 
Dealt to 2c7a529f 
c7552f9: folds
1fea36ef: raises $0.15 to $0.25
2c7a529f: folds
25f61eac: folds
353f0f03: folds
Hero: folds
Uncalled bet ($0.15) returned to 1fea36ef
*** SHOWDOWN ***
1fea36ef collected $0.25 from pot
*** SUMMARY ***
Total pot $0.25 | Rake $0 | Jackpot $0 | Bingo $0 | Fortune $0 | Tax $0
Seat 1: 25f61eac (button) folded before Flop (didn't bet)
Seat 2: 353f0f03 (small blind) folded before Flop
Seat 3: Hero (big blind) folded before Flop
Seat 4: c7552f9 folded before Flop (didn't bet)
Seat 5: 1fea36ef collected ($0.25)
Seat 6: 2c7a529f folded before Flop (didn't bet)


Poker Hand #RC2774760213: Hold'em No Limit ($0.05/$0.1) - 2024/08/05 12:56:42
Table 'RushAndCash21395473' 6-max Seat #1 is the button
Seat 1: 1f9d7383 ($10 in chips)
Seat 2: fb600294 ($15.86 in chips)
Seat 3: cc7203b4 ($11.6 in chips)
Seat 4: 2511a681 ($12.93 in chips)
Seat 5: Hero ($15.88 in chips)
Seat 6: a6f61f6e ($21.58 in chips)
fb600294: posts small blind $0.05
cc7203b4: posts big blind $0.1
*** HOLE CARDS ***
Dealt to 1f9d7383 
Dealt to fb600294 
Dealt to cc7203b4 
Dealt to 2511a681 
Dealt to Hero [Ah 7h]
Dealt to a6f61f6e 
2511a681: raises $0.1 to $0.2
Hero: folds
a6f61f6e: folds
1f9d7383: folds
fb600294: folds
cc7203b4: folds
Uncalled bet ($0.1) returned to 2511a681
*** SHOWDOWN ***
2511a681 collected $0.25 from pot
*** SUMMARY ***
Total pot $0.25 | Rake $0 | Jackpot $0 | Bingo $0 | Fortune $0 | Tax $0
Seat 1: 1f9d7383 (button) folded before Flop (didn't bet)
Seat 2: fb600294 (small blind) folded before Flop
Seat 3: cc7203b4 (big blind) folded before Flop
Seat 4: 2511a681 collected ($0.25)
Seat 5: Hero folded before Flop (didn't bet)
Seat 6: a6f61f6e folded before Flop (didn't bet)


Poker Hand #RC2774760176: Hold'em No Limit ($0.05/$0.1) - 2024/08/05 12:56:36
Table 'RushAndCash21395436' 6-max Seat #1 is the button
Seat 1: Hero ($15.88 in chips)
Seat 2: 4186ebe3 ($20.57 in chips)
Seat 3: f758d044 ($11.5 in chips)
Seat 4: 86739a14 ($11.24 in chips)
Seat 5: 3a00dd55 ($13.15 in chips)
Seat 6: 4aaba1a4 ($4.11 in chips)
4186ebe3: posts small blind $0.05
f758d044: posts big blind $0.1
*** HOLE CARDS ***
Dealt to Hero [6s 2h]
Dealt to 4186ebe3 
Dealt to f758d044 
Dealt to 86739a14 
Dealt to 3a00dd55 
Dealt to 4aaba1a4 
86739a14: folds
3a00dd55: folds
4aaba1a4: folds
Hero: folds
4186ebe3: folds
Uncalled bet ($0.05) returned to f758d044
*** SHOWDOWN ***
f758d044 collected $0.1 from pot
*** SUMMARY ***
Total pot $0.1 | Rake $0 | Jackpot $0 | Bingo $0 | Fortune $0 | Tax $0
Seat 1: Hero (button) folded before Flop (didn't bet)
Seat 2: 4186ebe3 (small blind) folded before Flop
Seat 3: f758d044 (big blind) collected ($0.1)
Seat 4: 86739a14 folded before Flop (didn't bet)
Seat 5: 3a00dd55 folded before Flop (didn't bet)
Seat 6: 4aaba1a4 folded before Flop (didn't bet)


Poker Hand #RC2774760106: Hold'em No Limit ($0.05/$0.1) - 2024/08/05 12:56:27
Table 'RushAndCash21395366' 6-max Seat #1 is the button
Seat 1: d56932f5 ($11.29 in chips)
Seat 2: Hero ($15.93 in chips)
Seat 3: cbe44fcb ($11.98 in chips)
Seat 4: d9358ce0 ($10.66 in chips)
Seat 5: 3681db75 ($10.15 in chips)
Seat 6: 73acb92a ($10.2 in chips)
Hero: posts small blind $0.05
cbe44fcb: posts big blind $0.1
*** HOLE CARDS ***
Dealt to d56932f5 
Dealt to Hero [6d Tc]
Dealt to cbe44fcb 
Dealt to d9358ce0 
Dealt to 3681db75 
Dealt to 73acb92a 
d9358ce0: folds
3681db75: raises $0.11 to $0.21
73acb92a: folds
d56932f5: folds
Hero: folds
cbe44fcb: folds
Uncalled bet ($0.11) returned to 3681db75
*** SHOWDOWN ***
3681db75 collected $0.25 from pot
*** SUMMARY ***
Total pot $0.25 | Rake $0 | Jackpot $0 | Bingo $0 | Fortune $0 | Tax $0
Seat 1: d56932f5 (button) folded before Flop (didn't bet)
Seat 2: Hero (small blind) folded before Flop
Seat 3: cbe44fcb (big blind) folded before Flop
Seat 4: d9358ce0 folded before Flop (didn't bet)
Seat 5: 3681db75 collected ($0.25)
Seat 6: 73acb92a folded before Flop (didn't bet)


Poker Hand #RC2774760075: Hold'em No Limit ($0.05/$0.1) - 2024/08/05 12:56:22
Table 'RushAndCash21395335' 6-max Seat #1 is the button
Seat 1: 75031704 ($10 in chips)
Seat 2: 85f74e7a ($15.9 in chips)
Seat 3: 7096d81 ($10 in chips)
Seat 4: Hero ($15.93 in chips)
Seat 5: fbea8788 ($10.2 in chips)
Seat 6: 75c4d76c ($10 in chips)
85f74e7a: posts small blind $0.05
7096d81: posts big blind $0.1
*** HOLE CARDS ***
Dealt to 75031704 
Dealt to 85f74e7a 
Dealt to 7096d81 
Dealt to Hero [Ah 2h]
Dealt to fbea8788 
Dealt to 75c4d76c 
Hero: folds
fbea8788: folds
75c4d76c: folds
75031704: folds
85f74e7a: folds
Uncalled bet ($0.05) returned to 7096d81
*** SHOWDOWN ***
7096d81 collected $0.1 from pot
*** SUMMARY ***
Total pot $0.1 | Rake $0 | Jackpot $0 | Bingo $0 | Fortune $0 | Tax $0
Seat 1: 75031704 (button) folded before Flop (didn't bet)
Seat 2: 85f74e7a (small blind) folded before Flop
Seat 3: 7096d81 (big blind) collected ($0.1)
Seat 4: Hero folded before Flop (didn't bet)
Seat 5: fbea8788 folded before Flop (didn't bet)
Seat 6: 75c4d76c folded before Flop (didn't bet)


Poker Hand #RC2774760026: Hold'em No Limit ($0.05/$0.1) - 2024/08/05 12:56:15
Table 'RushAndCash21395286' 6-max Seat #1 is the button
Seat 1: 7721c598 ($10 in chips)
Seat 2: 20c154a7 ($31.74 in chips)
Seat 3: Hero ($16.03 in chips)
Seat 4: 5de8cc3f ($18.99 in chips)
Seat 5: 4a344507 ($22.55 in chips)
Seat 6: 5ac754b0 ($13.9 in chips)
20c154a7: posts small blind $0.05
Hero: posts big blind $0.1
*** HOLE CARDS ***
Dealt to 7721c598 
Dealt to 20c154a7 
Dealt to Hero [7c 2d]
Dealt to 5de8cc3f 
Dealt to 4a344507 
Dealt to 5ac754b0 
5de8cc3f: folds
4a344507: folds
5ac754b0: folds
7721c598: raises $0.11 to $0.21
20c154a7: folds
Hero: folds
Uncalled bet ($0.11) returned to 7721c598
*** SHOWDOWN ***
7721c598 collected $0.25 from pot
*** SUMMARY ***
Total pot $0.25 | Rake $0 | Jackpot $0 | Bingo $0 | Fortune $0 | Tax $0
Seat 1: 7721c598 (button) collected ($0.25)
Seat 2: 20c154a7 (small blind) folded before Flop
Seat 3: Hero (big blind) folded before Flop
Seat 4: 5de8cc3f folded before Flop (didn't bet)
Seat 5: 4a344507 folded before Flop (didn't bet)
Seat 6: 5ac754b0 folded before Flop (didn't bet)


Poker Hand #RC2774760004: Hold'em No Limit ($0.05/$0.1) - 2024/08/05 12:56:12
Table 'RushAndCash21395264' 6-max Seat #1 is the button
Seat 1: 3c894328 ($10.75 in chips)
Seat 2: 3f8e43ae ($11.54 in chips)
Seat 3: 2f86da7f ($12.13 in chips)
Seat 4: 3c64da5 ($10.38 in chips)
Seat 5: 772edc7a ($25.78 in chips)
Seat 6: Hero ($16.03 in chips)
3f8e43ae: posts small blind $0.05
2f86da7f: posts big blind $0.1
*** HOLE CARDS ***
Dealt to 3c894328 
Dealt to 3f8e43ae 
Dealt to 2f86da7f 
Dealt to 3c64da5 
Dealt to 772edc7a 
Dealt to Hero [Td 6s]
3c64da5: folds
772edc7a: raises $0.15 to $0.25
Hero: folds
3c894328: calls $0.25
3f8e43ae: raises $0.64 to $0.89
2f86da7f: folds
772edc7a: raises $24.89 to $25.78 and is all-in
3c894328: folds
3f8e43ae: calls $10.65 and is all-in
Uncalled bet ($14.24) returned to 772edc7a
772edc7a: shows [Kh As]
3f8e43ae: shows [Kc Ac]
*** FLOP *** [9s 4c Jc]
*** TURN *** [9s 4c Jc] [Jh]
*** RIVER *** [9s 4c Jc Jh] [Jd]
*** SHOWDOWN ***
772edc7a collected $11.49 from pot
3f8e43ae collected $11.39 from pot
*** SUMMARY ***
Total pot $23.43 | Rake $0.4 | Jackpot $0.15 | Bingo $0 | Fortune $0 | Tax $0
Board [9s 4c Jc Jh Jd]
Seat 1: 3c894328 (button) folded before Flop
Seat 2: 3f8e43ae (small blind) showed [Kc Ac] and won ($11.39) with Three Jacks
Seat 3: 2f86da7f (big blind) folded before Flop
Seat 4: 3c64da5 folded before Flop (didn't bet)
Seat 5: 772edc7a showed [Kh As] and won ($11.49) with Three Jacks
Seat 6: Hero folded before Flop (didn't bet)


Poker Hand #RC2774759807: Hold'em No Limit ($0.05/$0.1) - 2024/08/05 12:55:47
Table 'RushAndCash21395067' 6-max Seat #1 is the button
Seat 1: 772edc7a ($25.42 in chips)
Seat 2: 4511ef0c ($9.05 in chips)
Seat 3: 54dd54fc ($10.38 in chips)
Seat 4: 35351de3 ($10.24 in chips)
Seat 5: a325d18 ($18.96 in chips)
Seat 6: Hero ($16.27 in chips)
4511ef0c: posts small blind $0.05
54dd54fc: posts big blind $0.1
*** HOLE CARDS ***
Dealt to 772edc7a 
Dealt to 4511ef0c 
Dealt to 54dd54fc 
Dealt to 35351de3 
Dealt to a325d18 
Dealt to Hero [Tc Qh]
35351de3: folds
a325d18: folds
Hero: raises $0.14 to $0.24
772edc7a: raises $0.48 to $0.72
4511ef0c: folds
54dd54fc: folds
Hero: folds
Uncalled bet ($0.48) returned to 772edc7a
*** SHOWDOWN ***
772edc7a collected $0.6 from pot
*** SUMMARY ***
Total pot $0.63 | Rake $0.03 | Jackpot $0 | Bingo $0 | Fortune $0 | Tax $0
Seat 1: 772edc7a (button) collected ($0.6)
Seat 2: 4511ef0c (small blind) folded before Flop
Seat 3: 54dd54fc (big blind) folded before Flop
Seat 4: 35351de3 folded before Flop (didn't bet)
Seat 5: a325d18 folded before Flop (didn't bet)
Seat 6: Hero folded before Flop


Poker Hand #RC2774759779: Hold'em No Limit ($0.05/$0.1) - 2024/08/05 12:55:43
Table 'RushAndCash21395039' 6-max Seat #1 is the button
Seat 1: 6fe2e6b3 ($13.49 in chips)
Seat 2: 1728dde1 ($11.55 in chips)
Seat 3: c4a3c113 ($10.57 in chips)
Seat 4: a7a2c00e ($7.1 in chips)
Seat 5: f1e457c3 ($13.82 in chips)
Seat 6: Hero ($16.27 in chips)
1728dde1: posts small blind $0.05
c4a3c113: posts big blind $0.1
*** HOLE CARDS ***
Dealt to 6fe2e6b3 
Dealt to 1728dde1 
Dealt to c4a3c113 
Dealt to a7a2c00e 
Dealt to f1e457c3 
Dealt to Hero [Kh 7c]
a7a2c00e: folds
f1e457c3: folds
Hero: folds
6fe2e6b3: raises $0.13 to $0.23
1728dde1: folds
c4a3c113: folds
Uncalled bet ($0.13) returned to 6fe2e6b3
*** SHOWDOWN ***
6fe2e6b3 collected $0.25 from pot
*** SUMMARY ***
Total pot $0.25 | Rake $0 | Jackpot $0 | Bingo $0 | Fortune $0 | Tax $0
Seat 1: 6fe2e6b3 (button) collected ($0.25)
Seat 2: 1728dde1 (small blind) folded before Flop
Seat 3: c4a3c113 (big blind) folded before Flop
Seat 4: a7a2c00e folded before Flop (didn't bet)
Seat 5: f1e457c3 folded before Flop (didn't bet)
Seat 6: Hero folded before Flop (didn't bet)


Poker Hand #RC2774759733: Hold'em No Limit ($0.05/$0.1) - 2024/08/05 12:55:37
Table 'RushAndCash21394993' 6-max Seat #1 is the button
Seat 1: Hero ($16.12 in chips)
Seat 2: 42f6ae09 ($15.59 in chips)
Seat 3: 2da240f5 ($20.82 in chips)
Seat 4: 25cc1eb4 ($11.81 in chips)
Seat 5: dd79782c ($10 in chips)
Seat 6: 5ac754b0 ($13.9 in chips)
42f6ae09: posts small blind $0.05
2da240f5: posts big blind $0.1
*** HOLE CARDS ***
Dealt to Hero [9h 2h]
Dealt to 42f6ae09 
Dealt to 2da240f5 
Dealt to 25cc1eb4 
Dealt to dd79782c 
Dealt to 5ac754b0 
25cc1eb4: folds
dd79782c: raises $0.1 to $0.2
5ac754b0: folds
Hero: folds
42f6ae09: folds
2da240f5: calls $0.1
*** FLOP *** [2s Js 5h]
2da240f5: checks
dd79782c: bets $0.15
2da240f5: calls $0.15
*** TURN *** [2s Js 5h] [4d]
2da240f5: checks
dd79782c: checks
*** RIVER *** [2s Js 5h 4d] [Jc]
2da240f5: bets $20.47 and is all-in
dd79782c: folds
Uncalled bet ($20.47) returned to 2da240f5
*** SHOWDOWN ***
2da240f5 collected $0.72 from pot
*** SUMMARY ***
Total pot $0.75 | Rake $0.03 | Jackpot $0 | Bingo $0 | Fortune $0 | Tax $0
Board [2s Js 5h 4d Jc]
Seat 1: Hero (button) folded before Flop (didn't bet)
Seat 2: 42f6ae09 (small blind) folded before Flop
Seat 3: 2da240f5 (big blind) won ($0.72)
Seat 4: 25cc1eb4 folded before Flop (didn't bet)
Seat 5: dd79782c folded on the River
Seat 6: 5ac754b0 folded before Flop (didn't bet)


Poker Hand #RC2774759704: Hold'em No Limit ($0.05/$0.1) - 2024/08/05 12:55:33
Table 'RushAndCash21394964' 6-max Seat #1 is the button
Seat 1: d9358ce0 ($10.66 in chips)
Seat 2: 2da240f5 ($20.87 in chips)
Seat 3: d1679aaf ($5.78 in chips)
Seat 4: Hero ($16.12 in chips)
Seat 5: 356b0e4 ($21.14 in chips)
Seat 6: fa28edbf ($10.31 in chips)
2da240f5: posts small blind $0.05
d1679aaf: posts big blind $0.1
*** HOLE CARDS ***
Dealt to d9358ce0 
Dealt to 2da240f5 
Dealt to d1679aaf 
Dealt to Hero [3s 6h]
Dealt to 356b0e4 
Dealt to fa28edbf 
Hero: folds
356b0e4: folds
fa28edbf: raises $0.15 to $0.25
d9358ce0: folds
2da240f5: folds
d1679aaf: calls $0.15
*** FLOP *** [As Ad Tc]
d1679aaf: bets $0.19
fa28edbf: calls $0.19
*** TURN *** [As Ad Tc] [Qh]
d1679aaf: checks
fa28edbf: checks
*** RIVER *** [As Ad Tc Qh] [Kc]
d1679aaf: checks
fa28edbf: bets $0.6
d1679aaf: calls $0.6
fa28edbf: shows [Js Jc] (Aces-High Straight)
d1679aaf: shows [Td Jd] (Aces-High Straight)
*** SHOWDOWN ***
d1679aaf collected $1.02 from pot
fa28edbf collected $1.01 from pot
*** SUMMARY ***
Total pot $2.13 | Rake $0.1 | Jackpot $0 | Bingo $0 | Fortune $0 | Tax $0
Board [As Ad Tc Qh Kc]
Seat 1: d9358ce0 (button) folded before Flop (didn't bet)
Seat 2: 2da240f5 (small blind) folded before Flop
Seat 3: d1679aaf (big blind) showed [Td Jd] and won ($1.02) with Aces-High Straight
Seat 4: Hero folded before Flop (didn't bet)
Seat 5: 356b0e4 folded before Flop (didn't bet)
Seat 6: fa28edbf showed [Js Jc] and won ($1.01) with Aces-High Straight


Poker Hand #RC2774759679: Hold'em No Limit ($0.05/$0.1) - 2024/08/05 12:55:30
Table 'RushAndCash21394939' 6-max Seat #1 is the button
Seat 1: 6b7afbbe ($31.71 in chips)
Seat 2: b1e24fdc ($9.18 in chips)
Seat 3: 3dac9132 ($10 in chips)
Seat 4: 85f74e7a ($16.22 in chips)
Seat 5: Hero ($16.12 in chips)
Seat 6: e1732ab1 ($12.8 in chips)
b1e24fdc: posts small blind $0.05
3dac9132: posts big blind $0.1
*** HOLE CARDS ***
Dealt to 6b7afbbe 
Dealt to b1e24fdc 
Dealt to 3dac9132 
Dealt to 85f74e7a 
Dealt to Hero [8s 9d]
Dealt to e1732ab1 
85f74e7a: folds
Hero: folds
e1732ab1: folds
6b7afbbe: folds
b1e24fdc: folds
Uncalled bet ($0.05) returned to 3dac9132
*** SHOWDOWN ***
3dac9132 collected $0.1 from pot
*** SUMMARY ***
Total pot $0.1 | Rake $0 | Jackpot $0 | Bingo $0 | Fortune $0 | Tax $0
Seat 1: 6b7afbbe (button) folded before Flop (didn't bet)
Seat 2: b1e24fdc (small blind) folded before Flop
Seat 3: 3dac9132 (big blind) collected ($0.1)
Seat 4: 85f74e7a folded before Flop (didn't bet)
Seat 5: Hero folded before Flop (didn't bet)
Seat 6: e1732ab1 folded before Flop (didn't bet)


Poker Hand #RC2774759657: Hold'em No Limit ($0.05/$0.1) - 2024/08/05 12:55:26
Table 'RushAndCash21394917' 6-max Seat #1 is the button
Seat 1: dcbb121b ($10.38 in chips)
Seat 2: e61eeea8 ($9.51 in chips)
Seat 3: Hero ($16.22 in chips)
Seat 4: 67cee464 ($14.82 in chips)
Seat 5: eace9db7 ($15.14 in chips)
Seat 6: c519f7aa ($11.75 in chips)
e61eeea8: posts small blind $0.05
Hero: posts big blind $0.1
*** HOLE CARDS ***
Dealt to dcbb121b 
Dealt to e61eeea8 
Dealt to Hero [3c Ah]
Dealt to 67cee464 
Dealt to eace9db7 
Dealt to c519f7aa 
67cee464: folds
eace9db7: folds
c519f7aa: folds
dcbb121b: folds
e61eeea8: folds
Uncalled bet ($0.05) returned to Hero
*** SHOWDOWN ***
Hero collected $0.1 from pot
*** SUMMARY ***
Total pot $0.1 | Rake $0 | Jackpot $0 | Bingo $0 | Fortune $0 | Tax $0
Seat 1: dcbb121b (button) folded before Flop (didn't bet)
Seat 2: e61eeea8 (small blind) folded before Flop
Seat 3: Hero (big blind) collected ($0.1)
Seat 4: 67cee464 folded before Flop (didn't bet)
Seat 5: eace9db7 folded before Flop (didn't bet)
Seat 6: c519f7aa folded before Flop (didn't bet)


Poker Hand #RC2774759633: Hold'em No Limit ($0.05/$0.1) - 2024/08/05 12:55:23
Table 'RushAndCash21394893' 6-max Seat #1 is the button
Seat 1: 3c64da5 ($10.21 in chips)
Seat 2: Hero ($16.27 in chips)
Seat 3: d1802282 ($11.07 in chips)
Seat 4: 70b1c1f1 ($13.65 in chips)
Seat 5: b8cbe754 ($31.02 in chips)
Seat 6: 8be257d4 ($10 in chips)
Hero: posts small blind $0.05
d1802282: posts big blind $0.1
*** HOLE CARDS ***
Dealt to 3c64da5 
Dealt to Hero [6d 3h]
Dealt to d1802282 
Dealt to 70b1c1f1 
Dealt to b8cbe754 
Dealt to 8be257d4 
70b1c1f1: folds
b8cbe754: folds
8be257d4: folds
3c64da5: raises $0.15 to $0.25
Hero: folds
d1802282: calls $0.15
*** FLOP *** [Qh 2d 8d]
d1802282: checks
3c64da5: checks
*** TURN *** [Qh 2d 8d] [2h]
d1802282: checks
3c64da5: checks
*** RIVER *** [Qh 2d 8d 2h] [8h]
d1802282: checks
3c64da5: bets $0.42
d1802282: folds
Uncalled bet ($0.42) returned to 3c64da5
*** SHOWDOWN ***
3c64da5 collected $0.52 from pot
*** SUMMARY ***
Total pot $0.55 | Rake $0.03 | Jackpot $0 | Bingo $0 | Fortune $0 | Tax $0
Board [Qh 2d 8d 2h 8h]
Seat 1: 3c64da5 (button) won ($0.52)
Seat 2: Hero (small blind) folded before Flop
Seat 3: d1802282 (big blind) folded on the River
Seat 4: 70b1c1f1 folded before Flop (didn't bet)
Seat 5: b8cbe754 folded before Flop (didn't bet)
Seat 6: 8be257d4 folded before Flop (didn't bet)


Poker Hand #RC2774759493: Hold'em No Limit ($0.05/$0.1) - 2024/08/05 12:55:04
Table 'RushAndCash21394753' 6-max Seat #1 is the button
Seat 1: Hero ($15.93 in chips)
Seat 2: 9594a28c ($19.18 in chips)
Seat 3: 3921ed80 ($10.3 in chips)
Seat 4: 1dc8e473 ($18.88 in chips)
Seat 5: e21f5f10 ($14.05 in chips)
Seat 6: a4261460 ($11.24 in chips)
9594a28c: posts small blind $0.05
3921ed80: posts big blind $0.1
*** HOLE CARDS ***
Dealt to Hero [9c 9d]
Dealt to 9594a28c 
Dealt to 3921ed80 
Dealt to 1dc8e473 
Dealt to e21f5f10 
Dealt to a4261460 
1dc8e473: folds
e21f5f10: folds
a4261460: raises $0.12 to $0.22
Hero: raises $0.48 to $0.7
9594a28c: folds
3921ed80: folds
a4261460: folds
Uncalled bet ($0.48) returned to Hero
*** SHOWDOWN ***
Hero collected $0.56 from pot
*** SUMMARY ***
Total pot $0.59 | Rake $0.03 | Jackpot $0 | Bingo $0 | Fortune $0 | Tax $0
Seat 1: Hero (button) collected ($0.56)
Seat 2: 9594a28c (small blind) folded before Flop
Seat 3: 3921ed80 (big blind) folded before Flop
Seat 4: 1dc8e473 folded before Flop (didn't bet)
Seat 5: e21f5f10 folded before Flop (didn't bet)
Seat 6: a4261460 folded before Flop


Poker Hand #RC2774759460: Hold'em No Limit ($0.05/$0.1) - 2024/08/05 12:54:59
Table 'RushAndCash21394720' 6-max Seat #1 is the button
Seat 1: b74de1f2 ($14.92 in chips)
Seat 2: 7096d81 ($10.14 in chips)
Seat 3: 1b93dbd9 ($23.11 in chips)
Seat 4: 5e4a2802 ($11.34 in chips)
Seat 5: Hero ($15.93 in chips)
Seat 6: 68fe2fd0 ($14.09 in chips)
7096d81: posts small blind $0.05
1b93dbd9: posts big blind $0.1
*** HOLE CARDS ***
Dealt to b74de1f2 
Dealt to 7096d81 
Dealt to 1b93dbd9 
Dealt to 5e4a2802 
Dealt to Hero [4h 3h]
Dealt to 68fe2fd0 
5e4a2802: folds
Hero: folds
68fe2fd0: raises $0.11 to $0.21
b74de1f2: folds
7096d81: folds
1b93dbd9: folds
Uncalled bet ($0.11) returned to 68fe2fd0
*** SHOWDOWN ***
68fe2fd0 collected $0.25 from pot
*** SUMMARY ***
Total pot $0.25 | Rake $0 | Jackpot $0 | Bingo $0 | Fortune $0 | Tax $0
Seat 1: b74de1f2 (button) folded before Flop (didn't bet)
Seat 2: 7096d81 (small blind) folded before Flop
Seat 3: 1b93dbd9 (big blind) folded before Flop
Seat 4: 5e4a2802 folded before Flop (didn't bet)
Seat 5: Hero folded before Flop (didn't bet)
Seat 6: 68fe2fd0 collected ($0.25)


Poker Hand #RC2774759414: Hold'em No Limit ($0.05/$0.1) - 2024/08/05 12:54:53
Table 'RushAndCash21394674' 6-max Seat #1 is the button
Seat 1: Hero ($15.93 in chips)
Seat 2: 3d337591 ($12.46 in chips)
Seat 3: 661faef ($15.88 in chips)
Seat 4: 95186f86 ($5.63 in chips)
Seat 5: ec0a46be ($10.23 in chips)
Seat 6: 8617f6d1 ($8.55 in chips)
3d337591: posts small blind $0.05
661faef: posts big blind $0.1
*** HOLE CARDS ***
Dealt to Hero [9s 3h]
Dealt to 3d337591 
Dealt to 661faef 
Dealt to 95186f86 
Dealt to ec0a46be 
Dealt to 8617f6d1 
95186f86: folds
ec0a46be: folds
8617f6d1: raises $0.13 to $0.23
Hero: folds
3d337591: folds
661faef: folds
Uncalled bet ($0.13) returned to 8617f6d1
*** SHOWDOWN ***
8617f6d1 collected $0.25 from pot
*** SUMMARY ***
Total pot $0.25 | Rake $0 | Jackpot $0 | Bingo $0 | Fortune $0 | Tax $0
Seat 1: Hero (button) folded before Flop (didn't bet)
Seat 2: 3d337591 (small blind) folded before Flop
Seat 3: 661faef (big blind) folded before Flop
Seat 4: 95186f86 folded before Flop (didn't bet)
Seat 5: ec0a46be folded before Flop (didn't bet)
Seat 6: 8617f6d1 collected ($0.25)


Poker Hand #RC2774759305: Hold'em No Limit ($0.05/$0.1) - 2024/08/05 12:54:40
Table 'RushAndCash21394565' 6-max Seat #1 is the button
Seat 1: 3c6efb05 ($10.53 in chips)
Seat 2: 551f3ecb ($10 in chips)
Seat 3: 750f4df2 ($10 in chips)
Seat 4: f192758 ($10 in chips)
Seat 5: d32124f6 ($3.57 in chips)
Seat 6: Hero ($15.93 in chips)
551f3ecb: posts small blind $0.05
750f4df2: posts big blind $0.1
*** HOLE CARDS ***
Dealt to 3c6efb05 
Dealt to 551f3ecb 
Dealt to 750f4df2 
Dealt to f192758 
Dealt to d32124f6 
Dealt to Hero [6s 6c]
f192758: raises $0.19 to $0.29
d32124f6: folds
Hero: folds
3c6efb05: folds
551f3ecb: folds
750f4df2: folds
Uncalled bet ($0.19) returned to f192758
*** SHOWDOWN ***
f192758 collected $0.25 from pot
*** SUMMARY ***
Total pot $0.25 | Rake $0 | Jackpot $0 | Bingo $0 | Fortune $0 | Tax $0
Seat 1: 3c6efb05 (button) folded before Flop (didn't bet)
Seat 2: 551f3ecb (small blind) folded before Flop
Seat 3: 750f4df2 (big blind) folded before Flop
Seat 4: f192758 collected ($0.25)
Seat 5: d32124f6 folded before Flop (didn't bet)
Seat 6: Hero folded before Flop (didn't bet)


Poker Hand #RC2774759173: Hold'em No Limit ($0.05/$0.1) - 2024/08/05 12:54:22
Table 'RushAndCash21394433' 6-max Seat #1 is the button
Seat 1: 3f4fcbd0 ($10.05 in chips)
Seat 2: Hero ($15.98 in chips)
Seat 3: 23be08af ($15.4 in chips)
Seat 4: d28d30e4 ($19.54 in chips)
Seat 5: 9cec7f3b ($21.83 in chips)
Seat 6: cb7bab68 ($9.72 in chips)
Hero: posts small blind $0.05
23be08af: posts big blind $0.1
*** HOLE CARDS ***
Dealt to 3f4fcbd0 
Dealt to Hero [Kd Jh]
Dealt to 23be08af 
Dealt to d28d30e4 
Dealt to 9cec7f3b 
Dealt to cb7bab68 
d28d30e4: folds
9cec7f3b: folds
cb7bab68: raises $0.2 to $0.3
3f4fcbd0: raises $0.8 to $1.1
Hero: folds
23be08af: folds
cb7bab68: folds
Uncalled bet ($0.8) returned to 3f4fcbd0
*** SHOWDOWN ***
3f4fcbd0 collected $0.72 from pot
*** SUMMARY ***
Total pot $0.75 | Rake $0.03 | Jackpot $0 | Bingo $0 | Fortune $0 | Tax $0
Seat 1: 3f4fcbd0 (button) collected ($0.72)
Seat 2: Hero (small blind) folded before Flop
Seat 3: 23be08af (big blind) folded before Flop
Seat 4: d28d30e4 folded before Flop (didn't bet)
Seat 5: 9cec7f3b folded before Flop (didn't bet)
Seat 6: cb7bab68 folded before Flop


Poker Hand #RC2774759138: Hold'em No Limit ($0.05/$0.1) - 2024/08/05 12:54:19
Table 'RushAndCash21394398' 6-max Seat #1 is the button
Seat 1: 50d5b4b0 ($29.59 in chips)
Seat 2: d8f7e6d7 ($11.81 in chips)
Seat 3: Hero ($16.08 in chips)
Seat 4: 2654fa91 ($10.03 in chips)
Seat 5: 6e22e07 ($18.7 in chips)
Seat 6: af94ba84 ($10 in chips)
d8f7e6d7: posts small blind $0.05
Hero: posts big blind $0.1
*** HOLE CARDS ***
Dealt to 50d5b4b0 
Dealt to d8f7e6d7 
Dealt to Hero [Ah 2d]
Dealt to 2654fa91 
Dealt to 6e22e07 
Dealt to af94ba84 
2654fa91: folds
6e22e07: folds
af94ba84: folds
50d5b4b0: folds
d8f7e6d7: raises $0.2 to $0.3
Hero: folds
Uncalled bet ($0.2) returned to d8f7e6d7
*** SHOWDOWN ***
d8f7e6d7 collected $0.2 from pot
*** SUMMARY ***
Total pot $0.2 | Rake $0 | Jackpot $0 | Bingo $0 | Fortune $0 | Tax $0
Seat 1: 50d5b4b0 (button) folded before Flop (didn't bet)
Seat 2: d8f7e6d7 (small blind) collected ($0.2)
Seat 3: Hero (big blind) folded before Flop
Seat 4: 2654fa91 folded before Flop (didn't bet)
Seat 5: 6e22e07 folded before Flop (didn't bet)
Seat 6: af94ba84 folded before Flop (didn't bet)


Poker Hand #RC2774759110: Hold'em No Limit ($0.05/$0.1) - 2024/08/05 12:54:15
Table 'RushAndCash21394370' 6-max Seat #1 is the button
Seat 1: c20c6f3d ($11.14 in chips)
Seat 2: 98e2d761 ($17.57 in chips)
Seat 3: d6ede69b ($12.01 in chips)
Seat 4: a89d1258 ($7.12 in chips)
Seat 5: Hero ($16.08 in chips)
Seat 6: 2672cac2 ($12.25 in chips)
98e2d761: posts small blind $0.05
d6ede69b: posts big blind $0.1
*** HOLE CARDS ***
Dealt to c20c6f3d 
Dealt to 98e2d761 
Dealt to d6ede69b 
Dealt to a89d1258 
Dealt to Hero [9s 2h]
Dealt to 2672cac2 
a89d1258: folds
Hero: folds
2672cac2: folds
c20c6f3d: folds
98e2d761: folds
Uncalled bet ($0.05) returned to d6ede69b
*** SHOWDOWN ***
d6ede69b collected $0.1 from pot
*** SUMMARY ***
Total pot $0.1 | Rake $0 | Jackpot $0 | Bingo $0 | Fortune $0 | Tax $0
Seat 1: c20c6f3d (button) folded before Flop (didn't bet)
Seat 2: 98e2d761 (small blind) folded before Flop
Seat 3: d6ede69b (big blind) collected ($0.1)
Seat 4: a89d1258 folded before Flop (didn't bet)
Seat 5: Hero folded before Flop (didn't bet)
Seat 6: 2672cac2 folded before Flop (didn't bet)


Poker Hand #RC2774759070: Hold'em No Limit ($0.05/$0.1) - 2024/08/05 12:54:10
Table 'RushAndCash21394330' 6-max Seat #1 is the button
Seat 1: 41727a67 ($11.31 in chips)
Seat 2: 2aeffca9 ($10.5 in chips)
Seat 3: eaa5e890 ($13.17 in chips)
Seat 4: 8ec92d94 ($10.83 in chips)
Seat 5: Hero ($16.08 in chips)
Seat 6: 8b8c29f1 ($29.25 in chips)
2aeffca9: posts small blind $0.05
eaa5e890: posts big blind $0.1
*** HOLE CARDS ***
Dealt to 41727a67 
Dealt to 2aeffca9 
Dealt to eaa5e890 
Dealt to 8ec92d94 
Dealt to Hero [8s 2h]
Dealt to 8b8c29f1 
8ec92d94: folds
Hero: folds
8b8c29f1: folds
41727a67: raises $0.1 to $0.2
2aeffca9: folds
eaa5e890: calls $0.1
*** FLOP *** [Ac 4s 3d]
eaa5e890: checks
41727a67: bets $0.15
eaa5e890: folds
Uncalled bet ($0.15) returned to 41727a67
*** SHOWDOWN ***
41727a67 collected $0.43 from pot
*** SUMMARY ***
Total pot $0.45 | Rake $0.02 | Jackpot $0 | Bingo $0 | Fortune $0 | Tax $0
Board [Ac 4s 3d]
Seat 1: 41727a67 (button) won ($0.43)
Seat 2: 2aeffca9 (small blind) folded before Flop
Seat 3: eaa5e890 (big blind) folded on the Flop
Seat 4: 8ec92d94 folded before Flop (didn't bet)
Seat 5: Hero folded before Flop (didn't bet)
Seat 6: 8b8c29f1 folded before Flop (didn't bet)


Poker Hand #RC2774759031: Hold'em No Limit ($0.05/$0.1) - 2024/08/05 12:54:05
Table 'RushAndCash21394291' 6-max Seat #1 is the button
Seat 1: f9b9586e ($18.4 in chips)
Seat 2: Hero ($16.13 in chips)
Seat 3: ddc6e4ca ($10.1 in chips)
Seat 4: 1ab91021 ($10.99 in chips)
Seat 5: c681138f ($10.28 in chips)
Seat 6: a89d1258 ($7.12 in chips)
Hero: posts small blind $0.05
ddc6e4ca: posts big blind $0.1
*** HOLE CARDS ***
Dealt to f9b9586e 
Dealt to Hero [5c 7d]
Dealt to ddc6e4ca 
Dealt to 1ab91021 
Dealt to c681138f 
Dealt to a89d1258 
1ab91021: raises $0.15 to $0.25
c681138f: folds
a89d1258: folds
f9b9586e: folds
Hero: folds
ddc6e4ca: calls $0.15
*** FLOP *** [Ts 3h 6h]
ddc6e4ca: checks
1ab91021: bets $0.19
ddc6e4ca: calls $0.19
*** TURN *** [Ts 3h 6h] [Tc]
ddc6e4ca: checks
1ab91021: checks
*** RIVER *** [Ts 3h 6h Tc] [Qc]
ddc6e4ca: checks
1ab91021: checks
ddc6e4ca: shows [5h Kh] (Pair of Tens)
1ab91021: shows [Ah 8h] (Pair of Tens)
*** SHOWDOWN ***
1ab91021 collected $0.89 from pot
*** SUMMARY ***
Total pot $0.93 | Rake $0.04 | Jackpot $0 | Bingo $0 | Fortune $0 | Tax $0
Board [Ts 3h 6h Tc Qc]
Seat 1: f9b9586e (button) folded before Flop (didn't bet)
Seat 2: Hero (small blind) folded before Flop
Seat 3: ddc6e4ca (big blind) showed [5h Kh] and lost with Pair of Tens
Seat 4: 1ab91021 showed [Ah 8h] and won ($0.89) with Pair of Tens
Seat 5: c681138f folded before Flop (didn't bet)
Seat 6: a89d1258 folded before Flop (didn't bet)


Poker Hand #RC2774759002: Hold'em No Limit ($0.05/$0.1) - 2024/08/05 12:54:01
Table 'RushAndCash21394262' 6-max Seat #1 is the button
Seat 1: bc9b23d3 ($10.48 in chips)
Seat 2: 3e8da1e7 ($10.05 in chips)
Seat 3: 3b80ebf4 ($10.18 in chips)
Seat 4: Hero ($16.13 in chips)
Seat 5: 904b4948 ($10 in chips)
Seat 6: 71e51e91 ($16.28 in chips)
3e8da1e7: posts small blind $0.05
3b80ebf4: posts big blind $0.1
*** HOLE CARDS ***
Dealt to bc9b23d3 
Dealt to 3e8da1e7 
Dealt to 3b80ebf4 
Dealt to Hero [4s Kh]
Dealt to 904b4948 
Dealt to 71e51e91 
Hero: folds
904b4948: folds
71e51e91: raises $0.14 to $0.24
bc9b23d3: calls $0.24
3e8da1e7: raises $1.16 to $1.4
3b80ebf4: calls $1.3
71e51e91: folds
bc9b23d3: folds
*** FLOP *** [8h Jd Jh]
3e8da1e7: bets $1.09
3b80ebf4: calls $1.09
*** TURN *** [8h Jd Jh] [6d]
3e8da1e7: bets $3.01
3b80ebf4: folds
Uncalled bet ($3.01) returned to 3e8da1e7
*** SHOWDOWN ***
3e8da1e7 collected $5.05 from pot
*** SUMMARY ***
Total pot $5.46 | Rake $0.26 | Jackpot $0.15 | Bingo $0 | Fortune $0 | Tax $0
Board [8h Jd Jh 6d]
Seat 1: bc9b23d3 (button) folded before Flop
Seat 2: 3e8da1e7 (small blind) won ($5.05)
Seat 3: 3b80ebf4 (big blind) folded on the Turn
Seat 4: Hero folded before Flop (didn't bet)
Seat 5: 904b4948 folded before Flop (didn't bet)
Seat 6: 71e51e91 folded before Flop


Poker Hand #RC2774758974: Hold'em No Limit ($0.05/$0.1) - 2024/08/05 12:53:58
Table 'RushAndCash21394234' 6-max Seat #1 is the button
Seat 1: eb6782a7 ($10.29 in chips)
Seat 2: 319443e2 ($10.44 in chips)
Seat 3: 9e4d794f ($13.05 in chips)
Seat 4: f6196e9b ($9.36 in chips)
Seat 5: Hero ($16.13 in chips)
Seat 6: d88fba59 ($12.55 in chips)
319443e2: posts small blind $0.05
9e4d794f: posts big blind $0.1
*** HOLE CARDS ***
Dealt to eb6782a7 
Dealt to 319443e2 
Dealt to 9e4d794f 
Dealt to f6196e9b 
Dealt to Hero [5d Ts]
Dealt to d88fba59 
f6196e9b: folds
Hero: folds
d88fba59: raises $0.11 to $0.21
eb6782a7: folds
319443e2: folds
9e4d794f: folds
Uncalled bet ($0.11) returned to d88fba59
*** SHOWDOWN ***
d88fba59 collected $0.25 from pot
*** SUMMARY ***
Total pot $0.25 | Rake $0 | Jackpot $0 | Bingo $0 | Fortune $0 | Tax $0
Seat 1: eb6782a7 (button) folded before Flop (didn't bet)
Seat 2: 319443e2 (small blind) folded before Flop
Seat 3: 9e4d794f (big blind) folded before Flop
Seat 4: f6196e9b folded before Flop (didn't bet)
Seat 5: Hero folded before Flop (didn't bet)
Seat 6: d88fba59 collected ($0.25)


Poker Hand #RC2774758954: Hold'em No Limit ($0.05/$0.1) - 2024/08/05 12:53:55
Table 'RushAndCash21394214' 6-max Seat #1 is the button
Seat 1: 2e20dc8d ($10 in chips)
Seat 2: 5927ec1b ($5.03 in chips)
Seat 3: 2da240f5 ($18.1 in chips)
Seat 4: Hero ($16.13 in chips)
Seat 5: 75677bc1 ($10.26 in chips)
Seat 6: 8ec92d94 ($10.98 in chips)
5927ec1b: posts small blind $0.05
2da240f5: posts big blind $0.1
*** HOLE CARDS ***
Dealt to 2e20dc8d 
Dealt to 5927ec1b 
Dealt to 2da240f5 
Dealt to Hero [As 5d]
Dealt to 75677bc1 
Dealt to 8ec92d94 
Hero: folds
75677bc1: folds
8ec92d94: folds
2e20dc8d: folds
5927ec1b: folds
Uncalled bet ($0.05) returned to 2da240f5
*** SHOWDOWN ***
2da240f5 collected $0.1 from pot
*** SUMMARY ***
Total pot $0.1 | Rake $0 | Jackpot $0 | Bingo $0 | Fortune $0 | Tax $0
Seat 1: 2e20dc8d (button) folded before Flop (didn't bet)
Seat 2: 5927ec1b (small blind) folded before Flop
Seat 3: 2da240f5 (big blind) collected ($0.1)
Seat 4: Hero folded before Flop (didn't bet)
Seat 5: 75677bc1 folded before Flop (didn't bet)
Seat 6: 8ec92d94 folded before Flop (didn't bet)


Poker Hand #RC2774758836: Hold'em No Limit ($0.05/$0.1) - 2024/08/05 12:53:41
Table 'RushAndCash21394096' 6-max Seat #1 is the button
Seat 1: 35351de3 ($10.89 in chips)
Seat 2: 8af1362 ($21.57 in chips)
Seat 3: Hero ($16.23 in chips)
Seat 4: 1b1f16d3 ($13.22 in chips)
Seat 5: 75c4d76c ($6.23 in chips)
Seat 6: 772edc7a ($25.07 in chips)
8af1362: posts small blind $0.05
Hero: posts big blind $0.1
*** HOLE CARDS ***
Dealt to 35351de3 
Dealt to 8af1362 
Dealt to Hero [Td Ks]
Dealt to 1b1f16d3 
Dealt to 75c4d76c 
Dealt to 772edc7a 
1b1f16d3: folds
75c4d76c: raises $0.1 to $0.2
772edc7a: raises $0.47 to $0.67
35351de3: folds
8af1362: folds
Hero: folds
75c4d76c: calls $0.47
*** FLOP *** [Tc 4h 2s]
75c4d76c: checks
772edc7a: bets $0.75
75c4d76c: folds
Uncalled bet ($0.75) returned to 772edc7a
*** SHOWDOWN ***
772edc7a collected $1.42 from pot
*** SUMMARY ***
Total pot $1.49 | Rake $0.07 | Jackpot $0 | Bingo $0 | Fortune $0 | Tax $0
Board [Tc 4h 2s]
Seat 1: 35351de3 (button) folded before Flop (didn't bet)
Seat 2: 8af1362 (small blind) folded before Flop
Seat 3: Hero (big blind) folded before Flop
Seat 4: 1b1f16d3 folded before Flop (didn't bet)
Seat 5: 75c4d76c folded on the Flop
Seat 6: 772edc7a won ($1.42)


Poker Hand #RC2774758801: Hold'em No Limit ($0.05/$0.1) - 2024/08/05 12:53:37
Table 'RushAndCash21394061' 6-max Seat #1 is the button
Seat 1: d50247d2 ($13.06 in chips)
Seat 2: d9f4049e ($13.09 in chips)
Seat 3: 7ed5d525 ($10.65 in chips)
Seat 4: a70018e ($7.64 in chips)
Seat 5: Hero ($16.23 in chips)
Seat 6: 15e8bc52 ($11.14 in chips)
d9f4049e: posts small blind $0.05
7ed5d525: posts big blind $0.1
*** HOLE CARDS ***
Dealt to d50247d2 
Dealt to d9f4049e 
Dealt to 7ed5d525 
Dealt to a70018e 
Dealt to Hero [5c Jc]
Dealt to 15e8bc52 
a70018e: raises $0.1 to $0.2
Hero: folds
15e8bc52: folds
d50247d2: folds
d9f4049e: folds
7ed5d525: folds
Uncalled bet ($0.1) returned to a70018e
*** SHOWDOWN ***
a70018e collected $0.25 from pot
*** SUMMARY ***
Total pot $0.25 | Rake $0 | Jackpot $0 | Bingo $0 | Fortune $0 | Tax $0
Seat 1: d50247d2 (button) folded before Flop (didn't bet)
Seat 2: d9f4049e (small blind) folded before Flop
Seat 3: 7ed5d525 (big blind) folded before Flop
Seat 4: a70018e collected ($0.25)
Seat 5: Hero folded before Flop (didn't bet)
Seat 6: 15e8bc52 folded before Flop (didn't bet)


Poker Hand #RC2774758608: Hold'em No Limit ($0.05/$0.1) - 2024/08/05 12:53:12
Table 'RushAndCash21393868' 6-max Seat #1 is the button
Seat 1: Hero ($16.47 in chips)
Seat 2: ac8f8a49 ($17.4 in chips)
Seat 3: d9f4049e ($12.82 in chips)
Seat 4: 63c60428 ($3.65 in chips)
Seat 5: 61614a4a ($9.75 in chips)
Seat 6: 660c8e53 ($9.73 in chips)
ac8f8a49: posts small blind $0.05
d9f4049e: posts big blind $0.1
*** HOLE CARDS ***
Dealt to Hero [9h Kc]
Dealt to ac8f8a49 
Dealt to d9f4049e 
Dealt to 63c60428 
Dealt to 61614a4a 
Dealt to 660c8e53 
63c60428: folds
61614a4a: folds
660c8e53: folds
Hero: raises $0.14 to $0.24
ac8f8a49: folds
d9f4049e: raises $0.56 to $0.8
Hero: folds
Uncalled bet ($0.56) returned to d9f4049e
*** SHOWDOWN ***
d9f4049e collected $0.51 from pot
*** SUMMARY ***
Total pot $0.53 | Rake $0.02 | Jackpot $0 | Bingo $0 | Fortune $0 | Tax $0
Seat 1: Hero (button) folded before Flop
Seat 2: ac8f8a49 (small blind) folded before Flop
Seat 3: d9f4049e (big blind) collected ($0.51)
Seat 4: 63c60428 folded before Flop (didn't bet)
Seat 5: 61614a4a folded before Flop (didn't bet)
Seat 6: 660c8e53 folded before Flop (didn't bet)


Poker Hand #RC2774758121: Hold'em No Limit ($0.05/$0.1) - 2024/08/05 12:52:11
Table 'RushAndCash21393381' 6-max Seat #1 is the button
Seat 1: f38291df ($6.64 in chips)
Seat 2: bb387656 ($14.8 in chips)
Seat 3: b5697b78 ($20.36 in chips)
Seat 4: 77dc05e8 ($24.04 in chips)
Seat 5: 63c60428 ($5.45 in chips)
Seat 6: Hero ($14.85 in chips)
bb387656: posts small blind $0.05
b5697b78: posts big blind $0.1
*** HOLE CARDS ***
Dealt to f38291df 
Dealt to bb387656 
Dealt to b5697b78 
Dealt to 77dc05e8 
Dealt to 63c60428 
Dealt to Hero [Ac Kc]
77dc05e8: folds
63c60428: raises $0.2 to $0.3
Hero: raises $0.6 to $0.9
f38291df: folds
bb387656: folds
b5697b78: folds
63c60428: calls $0.6
*** FLOP *** [Jc Td Kh]
63c60428: checks
Hero: bets $0.9
63c60428: calls $0.9
*** TURN *** [Jc Td Kh] [As]
63c60428: checks
Hero: checks
*** RIVER *** [Jc Td Kh As] [6d]
63c60428: checks
Hero: checks
63c60428: shows [7s Ks] (Pair of Kings)
Hero: shows [Ac Kc] (Pair of Aces and Pair of Kings)
*** SHOWDOWN ***
Hero collected $3.42 from pot
*** SUMMARY ***
Total pot $3.75 | Rake $0.18 | Jackpot $0.15 | Bingo $0 | Fortune $0 | Tax $0
Board [Jc Td Kh As 6d]
Seat 1: f38291df (button) folded before Flop (didn't bet)
Seat 2: bb387656 (small blind) folded before Flop
Seat 3: b5697b78 (big blind) folded before Flop
Seat 4: 77dc05e8 folded before Flop (didn't bet)
Seat 5: 63c60428 showed [7s Ks] and lost with Pair of Kings
Seat 6: Hero showed [Ac Kc] and won ($3.42) with Pair of Aces and Pair of Kings


Poker Hand #RC2774758094: Hold'em No Limit ($0.05/$0.1) - 2024/08/05 12:52:08
Table 'RushAndCash21393354' 6-max Seat #1 is the button
Seat 1: fa28edbf ($10.1 in chips)
Seat 2: 886683ba ($10.53 in chips)
Seat 3: 1728dde1 ($12.29 in chips)
Seat 4: 7096d81 ($10.15 in chips)
Seat 5: eb6782a7 ($10.79 in chips)
Seat 6: Hero ($14.85 in chips)
886683ba: posts small blind $0.05
1728dde1: posts big blind $0.1
*** HOLE CARDS ***
Dealt to fa28edbf 
Dealt to 886683ba 
Dealt to 1728dde1 
Dealt to 7096d81 
Dealt to eb6782a7 
Dealt to Hero [7c 9s]
7096d81: raises $0.1 to $0.2
eb6782a7: folds
Hero: folds
fa28edbf: folds
886683ba: folds
1728dde1: folds
Uncalled bet ($0.1) returned to 7096d81
*** SHOWDOWN ***
7096d81 collected $0.25 from pot
*** SUMMARY ***
Total pot $0.25 | Rake $0 | Jackpot $0 | Bingo $0 | Fortune $0 | Tax $0
Seat 1: fa28edbf (button) folded before Flop (didn't bet)
Seat 2: 886683ba (small blind) folded before Flop
Seat 3: 1728dde1 (big blind) folded before Flop
Seat 4: 7096d81 collected ($0.25)
Seat 5: eb6782a7 folded before Flop (didn't bet)
Seat 6: Hero folded before Flop (didn't bet)


Poker Hand #RC2774758015: Hold'em No Limit ($0.05/$0.1) - 2024/08/05 12:51:58
Table 'RushAndCash21393275' 6-max Seat #1 is the button
Seat 1: ef76fdc ($22.33 in chips)
Seat 2: Hero ($14.9 in chips)
Seat 3: 62ef8cc4 ($21.12 in chips)
Seat 4: 71817254 ($22.98 in chips)
Seat 5: 633d8c4e ($12.66 in chips)
Seat 6: 644022ea ($27.11 in chips)
Hero: posts small blind $0.05
62ef8cc4: posts big blind $0.1
*** HOLE CARDS ***
Dealt to ef76fdc 
Dealt to Hero [Ks Qh]
Dealt to 62ef8cc4 
Dealt to 71817254 
Dealt to 633d8c4e 
Dealt to 644022ea 
71817254: raises $0.1 to $0.2
633d8c4e: folds
644022ea: raises $0.4 to $0.6
ef76fdc: folds
Hero: folds
62ef8cc4: folds
71817254: folds
Uncalled bet ($0.4) returned to 644022ea
*** SHOWDOWN ***
644022ea collected $0.53 from pot
*** SUMMARY ***
Total pot $0.55 | Rake $0.02 | Jackpot $0 | Bingo $0 | Fortune $0 | Tax $0
Seat 1: ef76fdc (button) folded before Flop (didn't bet)
Seat 2: Hero (small blind) folded before Flop
Seat 3: 62ef8cc4 (big blind) folded before Flop
Seat 4: 71817254 folded before Flop
Seat 5: 633d8c4e folded before Flop (didn't bet)
Seat 6: 644022ea collected ($0.53)


Poker Hand #RC2774757923: Hold'em No Limit ($0.05/$0.1) - 2024/08/05 12:51:46
Table 'RushAndCash21393183' 6-max Seat #1 is the button
Seat 1: Hero ($14.75 in chips)
Seat 2: 25a4b4f ($23.36 in chips)
Seat 3: 9c40ca74 ($9.09 in chips)
Seat 4: 2b6fca08 ($10.15 in chips)
Seat 5: e3c74d7a ($18.32 in chips)
Seat 6: cb9c1345 ($10.3 in chips)
25a4b4f: posts small blind $0.05
9c40ca74: posts big blind $0.1
*** HOLE CARDS ***
Dealt to Hero [5c As]
Dealt to 25a4b4f 
Dealt to 9c40ca74 
Dealt to 2b6fca08 
Dealt to e3c74d7a 
Dealt to cb9c1345 
2b6fca08: folds
e3c74d7a: folds
cb9c1345: folds
Hero: raises $0.14 to $0.24
25a4b4f: folds
9c40ca74: folds
Uncalled bet ($0.14) returned to Hero
*** SHOWDOWN ***
Hero collected $0.25 from pot
*** SUMMARY ***
Total pot $0.25 | Rake $0 | Jackpot $0 | Bingo $0 | Fortune $0 | Tax $0
Seat 1: Hero (button) collected ($0.25)
Seat 2: 25a4b4f (small blind) folded before Flop
Seat 3: 9c40ca74 (big blind) folded before Flop
Seat 4: 2b6fca08 folded before Flop (didn't bet)
Seat 5: e3c74d7a folded before Flop (didn't bet)
Seat 6: cb9c1345 folded before Flop (didn't bet)


Poker Hand #RC2774757877: Hold'em No Limit ($0.05/$0.1) - 2024/08/05 12:51:40
Table 'RushAndCash21393137' 6-max Seat #1 is the button
Seat 1: Hero ($14.75 in chips)
Seat 2: 569e38b ($10.52 in chips)
Seat 3: ba50e138 ($10.34 in chips)
Seat 4: 9957f83a ($17.6 in chips)
Seat 5: c95979f4 ($10.3 in chips)
Seat 6: 75c4d76c ($6.85 in chips)
569e38b: posts small blind $0.05
ba50e138: posts big blind $0.1
*** HOLE CARDS ***
Dealt to Hero [8c 2c]
Dealt to 569e38b 
Dealt to ba50e138 
Dealt to 9957f83a 
Dealt to c95979f4 
Dealt to 75c4d76c 
9957f83a: raises $0.1 to $0.2
c95979f4: folds
75c4d76c: folds
Hero: folds
569e38b: folds
ba50e138: calls $0.1
*** FLOP *** [2h 8d Jc]
ba50e138: checks
9957f83a: bets $0.15
ba50e138: raises $0.5 to $0.65
9957f83a: folds
Uncalled bet ($0.5) returned to ba50e138
*** SHOWDOWN ***
ba50e138 collected $0.72 from pot
*** SUMMARY ***
Total pot $0.75 | Rake $0.03 | Jackpot $0 | Bingo $0 | Fortune $0 | Tax $0
Board [2h 8d Jc]
Seat 1: Hero (button) folded before Flop (didn't bet)
Seat 2: 569e38b (small blind) folded before Flop
Seat 3: ba50e138 (big blind) won ($0.72)
Seat 4: 9957f83a folded on the Flop
Seat 5: c95979f4 folded before Flop (didn't bet)
Seat 6: 75c4d76c folded before Flop (didn't bet)


Poker Hand #RC2774757848: Hold'em No Limit ($0.05/$0.1) - 2024/08/05 12:51:37
Table 'RushAndCash21393108' 6-max Seat #1 is the button
Seat 1: 33f4cde8 ($15.01 in chips)
Seat 2: a58a0072 ($34.21 in chips)
Seat 3: 1f029720 ($14.54 in chips)
Seat 4: e33eca0 ($10.22 in chips)
Seat 5: 65ec36f8 ($13.97 in chips)
Seat 6: Hero ($14.75 in chips)
a58a0072: posts small blind $0.05
1f029720: posts big blind $0.1
*** HOLE CARDS ***
Dealt to 33f4cde8 
Dealt to a58a0072 
Dealt to 1f029720 
Dealt to e33eca0 
Dealt to 65ec36f8 
Dealt to Hero [2c 9d]
e33eca0: folds
65ec36f8: folds
Hero: folds
33f4cde8: folds
a58a0072: folds
Uncalled bet ($0.05) returned to 1f029720
*** SHOWDOWN ***
1f029720 collected $0.1 from pot
*** SUMMARY ***
Total pot $0.1 | Rake $0 | Jackpot $0 | Bingo $0 | Fortune $0 | Tax $0
Seat 1: 33f4cde8 (button) folded before Flop (didn't bet)
Seat 2: a58a0072 (small blind) folded before Flop
Seat 3: 1f029720 (big blind) collected ($0.1)
Seat 4: e33eca0 folded before Flop (didn't bet)
Seat 5: 65ec36f8 folded before Flop (didn't bet)
Seat 6: Hero folded before Flop (didn't bet)


Poker Hand #RC2774757719: Hold'em No Limit ($0.05/$0.1) - 2024/08/05 12:51:20
Table 'RushAndCash21392979' 6-max Seat #1 is the button
Seat 1: 75677bc1 ($10 in chips)
Seat 2: 9886bba4 ($11.93 in chips)
Seat 3: Hero ($14.7 in chips)
Seat 4: 94218f2 ($11.35 in chips)
Seat 5: bb387656 ($14.7 in chips)
Seat 6: bf7b9b78 ($10.04 in chips)
9886bba4: posts small blind $0.05
Hero: posts big blind $0.1
*** HOLE CARDS ***
Dealt to 75677bc1 
Dealt to 9886bba4 
Dealt to Hero [9h Kd]
Dealt to 94218f2 
Dealt to bb387656 
Dealt to bf7b9b78 
94218f2: folds
bb387656: folds
bf7b9b78: folds
75677bc1: folds
9886bba4: folds
Uncalled bet ($0.05) returned to Hero
*** SHOWDOWN ***
Hero collected $0.1 from pot
*** SUMMARY ***
Total pot $0.1 | Rake $0 | Jackpot $0 | Bingo $0 | Fortune $0 | Tax $0
Seat 1: 75677bc1 (button) folded before Flop (didn't bet)
Seat 2: 9886bba4 (small blind) folded before Flop
Seat 3: Hero (big blind) collected ($0.1)
Seat 4: 94218f2 folded before Flop (didn't bet)
Seat 5: bb387656 folded before Flop (didn't bet)
Seat 6: bf7b9b78 folded before Flop (didn't bet)


Poker Hand #RC2774757651: Hold'em No Limit ($0.05/$0.1) - 2024/08/05 12:51:12
Table 'RushAndCash21392911' 6-max Seat #1 is the button
Seat 1: dddad481 ($12.05 in chips)
Seat 2: Hero ($14.75 in chips)
Seat 3: 6ab7886b ($6.5 in chips)
Seat 4: 62ef8cc4 ($20.18 in chips)
Seat 5: 565a62db ($7.73 in chips)
Seat 6: d88fba59 ($11.26 in chips)
Hero: posts small blind $0.05
6ab7886b: posts big blind $0.1
*** HOLE CARDS ***
Dealt to dddad481 
Dealt to Hero [Qd 3h]
Dealt to 6ab7886b 
Dealt to 62ef8cc4 
Dealt to 565a62db 
Dealt to d88fba59 
62ef8cc4: raises $0.1 to $0.2
565a62db: folds
d88fba59: calls $0.2
dddad481: folds
Hero: folds
6ab7886b: calls $0.1
*** FLOP *** [5d Kh Jh]
6ab7886b: bets $0.22
62ef8cc4: calls $0.22
d88fba59: folds
*** TURN *** [5d Kh Jh] [Js]
6ab7886b: bets $0.36
62ef8cc4: calls $0.36
*** RIVER *** [5d Kh Jh Js] [Ac]
6ab7886b: checks
62ef8cc4: checks
6ab7886b: shows [7h 8h] (Pair of Jacks)
62ef8cc4: shows [Tc Kc] (Pair of Kings and Pair of Jacks)
*** SHOWDOWN ***
62ef8cc4 collected $1.72 from pot
*** SUMMARY ***
Total pot $1.81 | Rake $0.09 | Jackpot $0 | Bingo $0 | Fortune $0 | Tax $0
Board [5d Kh Jh Js Ac]
Seat 1: dddad481 (button) folded before Flop (didn't bet)
Seat 2: Hero (small blind) folded before Flop
Seat 3: 6ab7886b (big blind) showed [7h 8h] and lost with Pair of Jacks
Seat 4: 62ef8cc4 showed [Tc Kc] and won ($1.72) with Pair of Kings and Pair of Jacks
Seat 5: 565a62db folded before Flop (didn't bet)
Seat 6: d88fba59 folded on the Flop


Poker Hand #RC2774757288: Hold'em No Limit ($0.05/$0.1) - 2024/08/05 12:50:27
Table 'RushAndCash21392548' 6-max Seat #1 is the button
Seat 1: 2ec87d42 ($10.23 in chips)
Seat 2: f217c6c1 ($16.76 in chips)
Seat 3: Hero ($13.94 in chips)
Seat 4: c802bf76 ($10.62 in chips)
Seat 5: a7a2c00e ($8.3 in chips)
Seat 6: 71ea0773 ($7.66 in chips)
f217c6c1: posts small blind $0.05
Hero: posts big blind $0.1
*** HOLE CARDS ***
Dealt to 2ec87d42 
Dealt to f217c6c1 
Dealt to Hero [Tc Ad]
Dealt to c802bf76 
Dealt to a7a2c00e 
Dealt to 71ea0773 
c802bf76: folds
a7a2c00e: folds
71ea0773: folds
2ec87d42: folds
f217c6c1: raises $0.2 to $0.3
Hero: raises $0.6 to $0.9
f217c6c1: calls $0.6
*** FLOP *** [Qc 5h 5d]
f217c6c1: checks
Hero: bets $0.9
f217c6c1: folds
Uncalled bet ($0.9) returned to Hero
*** SHOWDOWN ***
Hero collected $1.71 from pot
*** SUMMARY ***
Total pot $1.8 | Rake $0.09 | Jackpot $0 | Bingo $0 | Fortune $0 | Tax $0
Board [Qc 5h 5d]
Seat 1: 2ec87d42 (button) folded before Flop (didn't bet)
Seat 2: f217c6c1 (small blind) folded on the Flop
Seat 3: Hero (big blind) won ($1.71)
Seat 4: c802bf76 folded before Flop (didn't bet)
Seat 5: a7a2c00e folded before Flop (didn't bet)
Seat 6: 71ea0773 folded before Flop (didn't bet)


Poker Hand #RC2774757246: Hold'em No Limit ($0.05/$0.1) - 2024/08/05 12:50:22
Table 'RushAndCash21392506' 6-max Seat #1 is the button
Seat 1: 356b0e4 ($22.97 in chips)
Seat 2: 55744bec ($28.71 in chips)
Seat 3: 661faef ($16.03 in chips)
Seat 4: 8f7c02cf ($13.01 in chips)
Seat 5: 7add3569 ($11.2 in chips)
Seat 6: Hero ($13.94 in chips)
55744bec: posts small blind $0.05
661faef: posts big blind $0.1
*** HOLE CARDS ***
Dealt to 356b0e4 
Dealt to 55744bec 
Dealt to 661faef 
Dealt to 8f7c02cf 
Dealt to 7add3569 
Dealt to Hero [Ad 4h]
8f7c02cf: folds
7add3569: folds
Hero: folds
356b0e4: folds
55744bec: folds
Uncalled bet ($0.05) returned to 661faef
*** SHOWDOWN ***
661faef collected $0.1 from pot
*** SUMMARY ***
Total pot $0.1 | Rake $0 | Jackpot $0 | Bingo $0 | Fortune $0 | Tax $0
Seat 1: 356b0e4 (button) folded before Flop (didn't bet)
Seat 2: 55744bec (small blind) folded before Flop
Seat 3: 661faef (big blind) collected ($0.1)
Seat 4: 8f7c02cf folded before Flop (didn't bet)
Seat 5: 7add3569 folded before Flop (didn't bet)
Seat 6: Hero folded before Flop (didn't bet)


Poker Hand #RC2774757200: Hold'em No Limit ($0.05/$0.1) - 2024/08/05 12:50:17
Table 'RushAndCash21392460' 6-max Seat #1 is the button
Seat 1: f27cb3e6 ($4.95 in chips)
Seat 2: 18f9e66e ($10.94 in chips)
Seat 3: 1f7acbae ($10 in chips)
Seat 4: 1e2d72f ($10.27 in chips)
Seat 5: 98e2d761 ($19.82 in chips)
Seat 6: Hero ($13.94 in chips)
18f9e66e: posts small blind $0.05
1f7acbae: posts big blind $0.1
*** HOLE CARDS ***
Dealt to f27cb3e6 
Dealt to 18f9e66e 
Dealt to 1f7acbae 
Dealt to 1e2d72f 
Dealt to 98e2d761 
Dealt to Hero [8d Th]
1e2d72f: raises $0.1 to $0.2
98e2d761: folds
Hero: folds
f27cb3e6: folds
18f9e66e: folds
1f7acbae: folds
Uncalled bet ($0.1) returned to 1e2d72f
*** SHOWDOWN ***
1e2d72f collected $0.25 from pot
*** SUMMARY ***
Total pot $0.25 | Rake $0 | Jackpot $0 | Bingo $0 | Fortune $0 | Tax $0
Seat 1: f27cb3e6 (button) folded before Flop (didn't bet)
Seat 2: 18f9e66e (small blind) folded before Flop
Seat 3: 1f7acbae (big blind) folded before Flop
Seat 4: 1e2d72f collected ($0.25)
Seat 5: 98e2d761 folded before Flop (didn't bet)
Seat 6: Hero folded before Flop (didn't bet)


Poker Hand #RC2774757156: Hold'em No Limit ($0.05/$0.1) - 2024/08/05 12:50:12
Table 'RushAndCash21392416' 6-max Seat #1 is the button
Seat 1: 41727a67 ($10 in chips)
Seat 2: 8617f6d1 ($7.35 in chips)
Seat 3: fdb7f034 ($26.81 in chips)
Seat 4: 1c7dcb28 ($10 in chips)
Seat 5: Hero ($13.94 in chips)
Seat 6: b86e03ef ($12.25 in chips)
8617f6d1: posts small blind $0.05
fdb7f034: posts big blind $0.1
*** HOLE CARDS ***
Dealt to 41727a67 
Dealt to 8617f6d1 
Dealt to fdb7f034 
Dealt to 1c7dcb28 
Dealt to Hero [5c 6s]
Dealt to b86e03ef 
1c7dcb28: folds
Hero: folds
b86e03ef: folds
41727a67: folds
8617f6d1: folds
Uncalled bet ($0.05) returned to fdb7f034
*** SHOWDOWN ***
fdb7f034 collected $0.1 from pot
*** SUMMARY ***
Total pot $0.1 | Rake $0 | Jackpot $0 | Bingo $0 | Fortune $0 | Tax $0
Seat 1: 41727a67 (button) folded before Flop (didn't bet)
Seat 2: 8617f6d1 (small blind) folded before Flop
Seat 3: fdb7f034 (big blind) collected ($0.1)
Seat 4: 1c7dcb28 folded before Flop (didn't bet)
Seat 5: Hero folded before Flop (didn't bet)
Seat 6: b86e03ef folded before Flop (didn't bet)


Poker Hand #RC2774757060: Hold'em No Limit ($0.05/$0.1) - 2024/08/05 12:50:01
Table 'RushAndCash21392320' 6-max Seat #1 is the button
Seat 1: Hero ($13.94 in chips)
Seat 2: 64703012 ($19.2 in chips)
Seat 3: 45ff06d5 ($10.16 in chips)
Seat 4: 9594a28c ($17.4 in chips)
Seat 5: 785352ba ($11.77 in chips)
Seat 6: c4a9d3f3 ($10.54 in chips)
Cash Drop to Pot : total $1 
64703012: posts small blind $0.05
45ff06d5: posts big blind $0.1
*** HOLE CARDS ***
Dealt to Hero [4c 8d]
Dealt to 64703012 
Dealt to 45ff06d5 
Dealt to 9594a28c 
Dealt to 785352ba 
Dealt to c4a9d3f3 
9594a28c: raises $0.1 to $0.2
785352ba: folds
c4a9d3f3: folds
Hero: folds
64703012: folds
45ff06d5: raises $0.73 to $0.93
9594a28c: calls $0.73
*** FLOP *** [6h Kc Qh]
45ff06d5: checks
9594a28c: bets $2.19
45ff06d5: folds
Uncalled bet ($2.19) returned to 9594a28c
*** SHOWDOWN ***
9594a28c collected $2.77 from pot
*** SUMMARY ***
Total pot $2.91 | Rake $0.14 | Jackpot $0 | Bingo $0 | Fortune $0 | Tax $0
Board [6h Kc Qh]
Seat 1: Hero (button) folded before Flop (didn't bet)
Seat 2: 64703012 (small blind) folded before Flop
Seat 3: 45ff06d5 (big blind) folded on the Flop
Seat 4: 9594a28c won ($2.77)
Seat 5: 785352ba folded before Flop (didn't bet)
Seat 6: c4a9d3f3 folded before Flop (didn't bet)


Poker Hand #RC2774756355: Hold'em No Limit ($0.05/$0.1) - 2024/08/05 12:48:34
Table 'RushAndCash21391615' 6-max Seat #1 is the button
Seat 1: c4a3c113 ($9.85 in chips)
Seat 2: 35193f50 ($10.73 in chips)
Seat 3: Hero ($13.3 in chips)
Seat 4: 605962a ($15.28 in chips)
Seat 5: 45ff06d5 ($10.81 in chips)
Seat 6: d28d30e4 ($20.03 in chips)
35193f50: posts small blind $0.05
Hero: posts big blind $0.1
*** HOLE CARDS ***
Dealt to c4a3c113 
Dealt to 35193f50 
Dealt to Hero [8d 8s]
Dealt to 605962a 
Dealt to 45ff06d5 
Dealt to d28d30e4 
605962a: folds
45ff06d5: raises $0.1 to $0.2
d28d30e4: folds
c4a3c113: folds
35193f50: folds
Hero: calls $0.1
*** FLOP *** [9c 9h 7d]
Hero: checks
45ff06d5: checks
*** TURN *** [9c 9h 7d] [6s]
Hero: checks
45ff06d5: checks
*** RIVER *** [9c 9h 7d 6s] [7h]
Hero: checks
45ff06d5: bets $0.45
Hero: calls $0.45
45ff06d5: shows [3d Qd] (Pair of Nines and Pair of Sevens)
Hero: shows [8d 8s] (Pair of Nines and Pair of Eights)
*** SHOWDOWN ***
Hero collected $1.29 from pot
*** SUMMARY ***
Total pot $1.35 | Rake $0.06 | Jackpot $0 | Bingo $0 | Fortune $0 | Tax $0
Board [9c 9h 7d 6s 7h]
Seat 1: c4a3c113 (button) folded before Flop (didn't bet)
Seat 2: 35193f50 (small blind) folded before Flop
Seat 3: Hero (big blind) showed [8d 8s] and won ($1.29) with Pair of Nines and Pair of Eights
Seat 4: 605962a folded before Flop (didn't bet)
Seat 5: 45ff06d5 showed [3d Qd] and lost with Pair of Nines and Pair of Sevens
Seat 6: d28d30e4 folded before Flop (didn't bet)


Poker Hand #RC2774756276: Hold'em No Limit ($0.05/$0.1) - 2024/08/05 12:48:25
Table 'RushAndCash21391536' 6-max Seat #1 is the button
Seat 1: 44f3fd7e ($4.93 in chips)
Seat 2: c9df336 ($10 in chips)
Seat 3: a289ba4e ($11.15 in chips)
Seat 4: f3b4cb31 ($15.76 in chips)
Seat 5: ceb12113 ($10.15 in chips)
Seat 6: Hero ($13.3 in chips)
c9df336: posts small blind $0.05
a289ba4e: posts big blind $0.1
*** HOLE CARDS ***
Dealt to 44f3fd7e 
Dealt to c9df336 
Dealt to a289ba4e 
Dealt to f3b4cb31 
Dealt to ceb12113 
Dealt to Hero [Ac 7c]
f3b4cb31: folds
ceb12113: raises $0.1 to $0.2
Hero: folds
44f3fd7e: calls $0.2
c9df336: folds
a289ba4e: folds
*** FLOP *** [2d 5s Qc]
ceb12113: bets $0.17
44f3fd7e: calls $0.17
*** TURN *** [2d 5s Qc] [4s]
ceb12113: checks
44f3fd7e: bets $0.71
ceb12113: folds
Uncalled bet ($0.71) returned to 44f3fd7e
*** SHOWDOWN ***
44f3fd7e collected $0.85 from pot
*** SUMMARY ***
Total pot $0.89 | Rake $0.04 | Jackpot $0 | Bingo $0 | Fortune $0 | Tax $0
Board [2d 5s Qc 4s]
Seat 1: 44f3fd7e (button) won ($0.85)
Seat 2: c9df336 (small blind) folded before Flop
Seat 3: a289ba4e (big blind) folded before Flop
Seat 4: f3b4cb31 folded before Flop (didn't bet)
Seat 5: ceb12113 folded on the Turn
Seat 6: Hero folded before Flop (didn't bet)


Poker Hand #RC2774756169: Hold'em No Limit ($0.05/$0.1) - 2024/08/05 12:48:13
Table 'RushAndCash21391429' 6-max Seat #1 is the button
Seat 1: d88fba59 ($11.34 in chips)
Seat 2: Hero ($13.35 in chips)
Seat 3: 75031704 ($11.26 in chips)
Seat 4: 20bf403f ($11.1 in chips)
Seat 5: 29ecec ($13.71 in chips)
Seat 6: a0b1108f ($8.13 in chips)
Hero: posts small blind $0.05
75031704: posts big blind $0.1
*** HOLE CARDS ***
Dealt to d88fba59 
Dealt to Hero [Th 8s]
Dealt to 75031704 
Dealt to 20bf403f 
Dealt to 29ecec 
Dealt to a0b1108f 
20bf403f: folds
29ecec: raises $0.15 to $0.25
a0b1108f: folds
d88fba59: folds
Hero: folds
75031704: calls $0.15
*** FLOP *** [Kd 5d As]
75031704: checks
29ecec: bets $0.19
75031704: calls $0.19
*** TURN *** [Kd 5d As] [Js]
75031704: checks
29ecec: checks
*** RIVER *** [Kd 5d As Js] [Tc]
75031704: checks
29ecec: bets $0.93
75031704: folds
Uncalled bet ($0.93) returned to 29ecec
*** SHOWDOWN ***
29ecec collected $0.89 from pot
*** SUMMARY ***
Total pot $0.93 | Rake $0.04 | Jackpot $0 | Bingo $0 | Fortune $0 | Tax $0
Board [Kd 5d As Js Tc]
Seat 1: d88fba59 (button) folded before Flop (didn't bet)
Seat 2: Hero (small blind) folded before Flop
Seat 3: 75031704 (big blind) folded on the River
Seat 4: 20bf403f folded before Flop (didn't bet)
Seat 5: 29ecec won ($0.89)
Seat 6: a0b1108f folded before Flop (didn't bet)


Poker Hand #RC2774755974: Hold'em No Limit ($0.05/$0.1) - 2024/08/05 12:47:49
Table 'RushAndCash21391234' 6-max Seat #1 is the button
Seat 1: 42322d75 ($34.09 in chips)
Seat 2: 559cea23 ($13.02 in chips)
Seat 3: 220b27f4 ($10 in chips)
Seat 4: Hero ($13.55 in chips)
Seat 5: 43be4122 ($9.42 in chips)
Seat 6: 75031704 ($10.93 in chips)
559cea23: posts small blind $0.05
220b27f4: posts big blind $0.1
*** HOLE CARDS ***
Dealt to 42322d75 
Dealt to 559cea23 
Dealt to 220b27f4 
Dealt to Hero [Ad Qh]
Dealt to 43be4122 
Dealt to 75031704 
Hero: raises $0.1 to $0.2
43be4122: folds
75031704: raises $0.75 to $0.95
42322d75: folds
559cea23: folds
220b27f4: folds
Hero: folds
Uncalled bet ($0.75) returned to 75031704
*** SHOWDOWN ***
75031704 collected $0.53 from pot
*** SUMMARY ***
Total pot $0.55 | Rake $0.02 | Jackpot $0 | Bingo $0 | Fortune $0 | Tax $0
Seat 1: 42322d75 (button) folded before Flop (didn't bet)
Seat 2: 559cea23 (small blind) folded before Flop
Seat 3: 220b27f4 (big blind) folded before Flop
Seat 4: Hero folded before Flop
Seat 5: 43be4122 folded before Flop (didn't bet)
Seat 6: 75031704 collected ($0.53)


Poker Hand #RC2774755943: Hold'em No Limit ($0.05/$0.1) - 2024/08/05 12:47:45
Table 'RushAndCash21391203' 6-max Seat #1 is the button
Seat 1: 64abc031 ($10.64 in chips)
Seat 2: 42322d75 ($34.14 in chips)
Seat 3: 559cea23 ($13.12 in chips)
Seat 4: 70126d5c ($20.16 in chips)
Seat 5: 67e8d437 ($13.25 in chips)
Seat 6: Hero ($13.55 in chips)
42322d75: posts small blind $0.05
559cea23: posts big blind $0.1
*** HOLE CARDS ***
Dealt to 64abc031 
Dealt to 42322d75 
Dealt to 559cea23 
Dealt to 70126d5c 
Dealt to 67e8d437 
Dealt to Hero [8c As]
70126d5c: folds
67e8d437: folds
Hero: folds
64abc031: folds
42322d75: folds
Uncalled bet ($0.05) returned to 559cea23
*** SHOWDOWN ***
559cea23 collected $0.1 from pot
*** SUMMARY ***
Total pot $0.1 | Rake $0 | Jackpot $0 | Bingo $0 | Fortune $0 | Tax $0
Seat 1: 64abc031 (button) folded before Flop (didn't bet)
Seat 2: 42322d75 (small blind) folded before Flop
Seat 3: 559cea23 (big blind) collected ($0.1)
Seat 4: 70126d5c folded before Flop (didn't bet)
Seat 5: 67e8d437 folded before Flop (didn't bet)
Seat 6: Hero folded before Flop (didn't bet)


Poker Hand #RC2774755915: Hold'em No Limit ($0.05/$0.1) - 2024/08/05 12:47:42
Table 'RushAndCash21391175' 6-max Seat #1 is the button
Seat 1: b4ab114f ($4.15 in chips)
Seat 2: Hero ($13.6 in chips)
Seat 3: 27c8fc7b ($11.57 in chips)
Seat 4: e5e26648 ($35.96 in chips)
Seat 5: 9e29158a ($10.85 in chips)
Seat 6: 204bd1bb ($10 in chips)
Hero: posts small blind $0.05
27c8fc7b: posts big blind $0.1
*** HOLE CARDS ***
Dealt to b4ab114f 
Dealt to Hero [9h Ks]
Dealt to 27c8fc7b 
Dealt to e5e26648 
Dealt to 9e29158a 
Dealt to 204bd1bb 
e5e26648: raises $0.15 to $0.25
9e29158a: folds
204bd1bb: folds
b4ab114f: calls $0.25
Hero: folds
27c8fc7b: folds
*** FLOP *** [Th 3s Qc]
e5e26648: bets $0.33
b4ab114f: calls $0.33
*** TURN *** [Th 3s Qc] [9s]
e5e26648: bets $0.99
b4ab114f: raises $1.21 to $2.2
e5e26648: raises $7.43 to $9.63
b4ab114f: calls $1.37 and is all-in
Uncalled bet ($6.06) returned to e5e26648
e5e26648: shows [Kd Jc] (Kings-High Straight)
b4ab114f: shows [As Js] (Ace-High)
*** RIVER *** [Th 3s Qc 9s] [5c]
*** SHOWDOWN ***
e5e26648 collected $8 from pot
*** SUMMARY ***
Total pot $8.45 | Rake $0.3 | Jackpot $0.15 | Bingo $0 | Fortune $0 | Tax $0
Board [Th 3s Qc 9s 5c]
Seat 1: b4ab114f (button) showed [As Js] and lost with Ace-High
Seat 2: Hero (small blind) folded before Flop
Seat 3: 27c8fc7b (big blind) folded before Flop
Seat 4: e5e26648 showed [Kd Jc] and won ($8) with Kings-High Straight
Seat 5: 9e29158a folded before Flop (didn't bet)
Seat 6: 204bd1bb folded before Flop (didn't bet)


Poker Hand #RC2774755745: Hold'em No Limit ($0.05/$0.1) - 2024/08/05 12:47:18
Table 'RushAndCash21391005' 6-max Seat #1 is the button
Seat 1: Hero ($13.23 in chips)
Seat 2: 13b99118 ($19.53 in chips)
Seat 3: 94da05b1 ($15.86 in chips)
Seat 4: f6dba5f1 ($15.03 in chips)
Seat 5: c4a3c113 ($10.23 in chips)
Seat 6: e5e26648 ($36.21 in chips)
13b99118: posts small blind $0.05
94da05b1: posts big blind $0.1
*** HOLE CARDS ***
Dealt to Hero [Td Th]
Dealt to 13b99118 
Dealt to 94da05b1 
Dealt to f6dba5f1 
Dealt to c4a3c113 
Dealt to e5e26648 
f6dba5f1: folds
c4a3c113: folds
e5e26648: raises $0.15 to $0.25
Hero: raises $0.55 to $0.8
13b99118: folds
94da05b1: folds
e5e26648: folds
Uncalled bet ($0.55) returned to Hero
*** SHOWDOWN ***
Hero collected $0.62 from pot
*** SUMMARY ***
Total pot $0.65 | Rake $0.03 | Jackpot $0 | Bingo $0 | Fortune $0 | Tax $0
Seat 1: Hero (button) collected ($0.62)
Seat 2: 13b99118 (small blind) folded before Flop
Seat 3: 94da05b1 (big blind) folded before Flop
Seat 4: f6dba5f1 folded before Flop (didn't bet)
Seat 5: c4a3c113 folded before Flop (didn't bet)
Seat 6: e5e26648 folded before Flop


Poker Hand #RC2774755705: Hold'em No Limit ($0.05/$0.1) - 2024/08/05 12:47:13
Table 'RushAndCash21390965' 6-max Seat #1 is the button
Seat 1: 3ace4cc9 ($12.77 in chips)
Seat 2: ac724a39 ($8.34 in chips)
Seat 3: d1802282 ($10 in chips)
Seat 4: 8be257d4 ($10 in chips)
Seat 5: bdef84f6 ($11.43 in chips)
Seat 6: Hero ($13.23 in chips)
ac724a39: posts small blind $0.05
d1802282: posts big blind $0.1
*** HOLE CARDS ***
Dealt to 3ace4cc9 
Dealt to ac724a39 
Dealt to d1802282 
Dealt to 8be257d4 
Dealt to bdef84f6 
Dealt to Hero [3s 8s]
8be257d4: folds
bdef84f6: folds
Hero: folds
3ace4cc9: folds
ac724a39: folds
Uncalled bet ($0.05) returned to d1802282
*** SHOWDOWN ***
d1802282 collected $0.1 from pot
*** SUMMARY ***
Total pot $0.1 | Rake $0 | Jackpot $0 | Bingo $0 | Fortune $0 | Tax $0
Seat 1: 3ace4cc9 (button) folded before Flop (didn't bet)
Seat 2: ac724a39 (small blind) folded before Flop
Seat 3: d1802282 (big blind) collected ($0.1)
Seat 4: 8be257d4 folded before Flop (didn't bet)
Seat 5: bdef84f6 folded before Flop (didn't bet)
Seat 6: Hero folded before Flop (didn't bet)


Poker Hand #RC2774755508: Hold'em No Limit ($0.05/$0.1) - 2024/08/05 12:46:48
Table 'RushAndCash21390768' 6-max Seat #1 is the button
Seat 1: 58694b26 ($1.26 in chips)
Seat 2: 55744bec ($28.54 in chips)
Seat 3: Hero ($13.33 in chips)
Seat 4: 1b1f16d3 ($16.11 in chips)
Seat 5: 4573cbdf ($10.25 in chips)
Seat 6: fb88a35b ($9.7 in chips)
55744bec: posts small blind $0.05
Hero: posts big blind $0.1
*** HOLE CARDS ***
Dealt to 58694b26 
Dealt to 55744bec 
Dealt to Hero [8c As]
Dealt to 1b1f16d3 
Dealt to 4573cbdf 
Dealt to fb88a35b 
1b1f16d3: folds
4573cbdf: raises $0.12 to $0.22
fb88a35b: folds
58694b26: folds
55744bec: folds
Hero: folds
Uncalled bet ($0.12) returned to 4573cbdf
*** SHOWDOWN ***
4573cbdf collected $0.25 from pot
*** SUMMARY ***
Total pot $0.25 | Rake $0 | Jackpot $0 | Bingo $0 | Fortune $0 | Tax $0
Seat 1: 58694b26 (button) folded before Flop (didn't bet)
Seat 2: 55744bec (small blind) folded before Flop
Seat 3: Hero (big blind) folded before Flop
Seat 4: 1b1f16d3 folded before Flop (didn't bet)
Seat 5: 4573cbdf collected ($0.25)
Seat 6: fb88a35b folded before Flop (didn't bet)


Poker Hand #RC2774755466: Hold'em No Limit ($0.05/$0.1) - 2024/08/05 12:46:42
Table 'RushAndCash21390726' 6-max Seat #1 is the button
Seat 1: b4219453 ($10.35 in chips)
Seat 2: 47357586 ($10 in chips)
Seat 3: 64703012 ($20.61 in chips)
Seat 4: 9957f83a ($17.9 in chips)
Seat 5: Hero ($13.33 in chips)
Seat 6: d50247d2 ($15.99 in chips)
47357586: posts small blind $0.05
64703012: posts big blind $0.1
*** HOLE CARDS ***
Dealt to b4219453 
Dealt to 47357586 
Dealt to 64703012 
Dealt to 9957f83a 
Dealt to Hero [6c 5h]
Dealt to d50247d2 
9957f83a: folds
Hero: folds
d50247d2: folds
b4219453: raises $0.1 to $0.2
47357586: folds
64703012: folds
Uncalled bet ($0.1) returned to b4219453
*** SHOWDOWN ***
b4219453 collected $0.25 from pot
*** SUMMARY ***
Total pot $0.25 | Rake $0 | Jackpot $0 | Bingo $0 | Fortune $0 | Tax $0
Seat 1: b4219453 (button) collected ($0.25)
Seat 2: 47357586 (small blind) folded before Flop
Seat 3: 64703012 (big blind) folded before Flop
Seat 4: 9957f83a folded before Flop (didn't bet)
Seat 5: Hero folded before Flop (didn't bet)
Seat 6: d50247d2 folded before Flop (didn't bet)


Poker Hand #RC2774754954: Hold'em No Limit ($0.05/$0.1) - 2024/08/05 12:45:36
Table 'RushAndCash21390214' 6-max Seat #1 is the button
Seat 1: f8e4d6fa ($16.31 in chips)
Seat 2: 9f10f7db ($35.13 in chips)
Seat 3: d50247d2 ($15.21 in chips)
Seat 4: Hero ($13.98 in chips)
Seat 5: bf7b9b78 ($10.51 in chips)
Seat 6: 9fe4665f ($10 in chips)
9f10f7db: posts small blind $0.05
d50247d2: posts big blind $0.1
*** HOLE CARDS ***
Dealt to f8e4d6fa 
Dealt to 9f10f7db 
Dealt to d50247d2 
Dealt to Hero [Qc Js]
Dealt to bf7b9b78 
Dealt to 9fe4665f 
Hero: raises $0.1 to $0.2
bf7b9b78: folds
9fe4665f: folds
f8e4d6fa: folds
9f10f7db: calls $0.15
d50247d2: calls $0.1
*** FLOP *** [Ac 9d Jc]
9f10f7db: checks
d50247d2: checks
Hero: checks
*** TURN *** [Ac 9d Jc] [7c]
9f10f7db: checks
d50247d2: bets $0.45
Hero: calls $0.45
9f10f7db: folds
*** RIVER *** [Ac 9d Jc 7c] [4d]
d50247d2: bets $1.13
Hero: folds
Uncalled bet ($1.13) returned to d50247d2
*** SHOWDOWN ***
d50247d2 collected $1.43 from pot
*** SUMMARY ***
Total pot $1.5 | Rake $0.07 | Jackpot $0 | Bingo $0 | Fortune $0 | Tax $0
Board [Ac 9d Jc 7c 4d]
Seat 1: f8e4d6fa (button) folded before Flop (didn't bet)
Seat 2: 9f10f7db (small blind) folded on the Turn
Seat 3: d50247d2 (big blind) won ($1.43)
Seat 4: Hero folded on the River
Seat 5: bf7b9b78 folded before Flop (didn't bet)
Seat 6: 9fe4665f folded before Flop (didn't bet)


Poker Hand #RC2774754902: Hold'em No Limit ($0.05/$0.1) - 2024/08/05 12:45:29
Table 'RushAndCash21390162' 6-max Seat #1 is the button
Seat 1: c06aa921 ($11.1 in chips)
Seat 2: a42a4e96 ($13.12 in chips)
Seat 3: eb6782a7 ($10 in chips)
Seat 4: d28d30e4 ($20.56 in chips)
Seat 5: 3ace4cc9 ($13.67 in chips)
Seat 6: Hero ($13.98 in chips)
a42a4e96: posts small blind $0.05
eb6782a7: posts big blind $0.1
*** HOLE CARDS ***
Dealt to c06aa921 
Dealt to a42a4e96 
Dealt to eb6782a7 
Dealt to d28d30e4 
Dealt to 3ace4cc9 
Dealt to Hero [Kh 3d]
d28d30e4: raises $0.1 to $0.2
3ace4cc9: folds
Hero: folds
c06aa921: folds
a42a4e96: folds
eb6782a7: folds
Uncalled bet ($0.1) returned to d28d30e4
*** SHOWDOWN ***
d28d30e4 collected $0.25 from pot
*** SUMMARY ***
Total pot $0.25 | Rake $0 | Jackpot $0 | Bingo $0 | Fortune $0 | Tax $0
Seat 1: c06aa921 (button) folded before Flop (didn't bet)
Seat 2: a42a4e96 (small blind) folded before Flop
Seat 3: eb6782a7 (big blind) folded before Flop
Seat 4: d28d30e4 collected ($0.25)
Seat 5: 3ace4cc9 folded before Flop (didn't bet)
Seat 6: Hero folded before Flop (didn't bet)


Poker Hand #RC2774754869: Hold'em No Limit ($0.05/$0.1) - 2024/08/05 12:45:25
Table 'RushAndCash21390129' 6-max Seat #1 is the button
Seat 1: 48897338 ($10.99 in chips)
Seat 2: 204bd1bb ($10 in chips)
Seat 3: 77599916 ($24.83 in chips)
Seat 4: Hero ($13.98 in chips)
Seat 5: 9fe4665f ($10 in chips)
Seat 6: b4219453 ($10.2 in chips)
204bd1bb: posts small blind $0.05
77599916: posts big blind $0.1
*** HOLE CARDS ***
Dealt to 48897338 
Dealt to 204bd1bb 
Dealt to 77599916 
Dealt to Hero [8c Ts]
Dealt to 9fe4665f 
Dealt to b4219453 
Hero: folds
9fe4665f: folds
b4219453: folds
48897338: folds
204bd1bb: folds
Uncalled bet ($0.05) returned to 77599916
*** SHOWDOWN ***
77599916 collected $0.1 from pot
*** SUMMARY ***
Total pot $0.1 | Rake $0 | Jackpot $0 | Bingo $0 | Fortune $0 | Tax $0
Seat 1: 48897338 (button) folded before Flop (didn't bet)
Seat 2: 204bd1bb (small blind) folded before Flop
Seat 3: 77599916 (big blind) collected ($0.1)
Seat 4: Hero folded before Flop (didn't bet)
Seat 5: 9fe4665f folded before Flop (didn't bet)
Seat 6: b4219453 folded before Flop (didn't bet)


Poker Hand #RC2774754840: Hold'em No Limit ($0.05/$0.1) - 2024/08/05 12:45:21
Table 'RushAndCash21390100' 6-max Seat #1 is the button
Seat 1: 3b0c26fe ($21.59 in chips)
Seat 2: 414e3269 ($27.53 in chips)
Seat 3: Hero ($14.08 in chips)
Seat 4: 90577903 ($6.37 in chips)
Seat 5: 68fe2fd0 ($14.64 in chips)
Seat 6: ddc6e4ca ($10.09 in chips)
414e3269: posts small blind $0.05
Hero: posts big blind $0.1
*** HOLE CARDS ***
Dealt to 3b0c26fe 
Dealt to 414e3269 
Dealt to Hero [2s 7d]
Dealt to 90577903 
Dealt to 68fe2fd0 
Dealt to ddc6e4ca 
90577903: folds
68fe2fd0: raises $0.11 to $0.21
ddc6e4ca: folds
3b0c26fe: folds
414e3269: folds
Hero: folds
Uncalled bet ($0.11) returned to 68fe2fd0
*** SHOWDOWN ***
68fe2fd0 collected $0.25 from pot
*** SUMMARY ***
Total pot $0.25 | Rake $0 | Jackpot $0 | Bingo $0 | Fortune $0 | Tax $0
Seat 1: 3b0c26fe (button) folded before Flop (didn't bet)
Seat 2: 414e3269 (small blind) folded before Flop
Seat 3: Hero (big blind) folded before Flop
Seat 4: 90577903 folded before Flop (didn't bet)
Seat 5: 68fe2fd0 collected ($0.25)
Seat 6: ddc6e4ca folded before Flop (didn't bet)


Poker Hand #RC2774754810: Hold'em No Limit ($0.05/$0.1) - 2024/08/05 12:45:17
Table 'RushAndCash21390070' 6-max Seat #1 is the button
Seat 1: 3d571954 ($27.62 in chips)
Seat 2: 54b93839 ($8.92 in chips)
Seat 3: 68fe2fd0 ($14.74 in chips)
Seat 4: Hero ($14.08 in chips)
Seat 5: 90577903 ($6.37 in chips)
Seat 6: b5aebb10 ($10 in chips)
54b93839: posts small blind $0.05
68fe2fd0: posts big blind $0.1
*** HOLE CARDS ***
Dealt to 3d571954 
Dealt to 54b93839 
Dealt to 68fe2fd0 
Dealt to Hero [3d Jh]
Dealt to 90577903 
Dealt to b5aebb10 
Hero: folds
90577903: folds
b5aebb10: raises $0.12 to $0.22
3d571954: folds
54b93839: folds
68fe2fd0: folds
Uncalled bet ($0.12) returned to b5aebb10
*** SHOWDOWN ***
b5aebb10 collected $0.25 from pot
*** SUMMARY ***
Total pot $0.25 | Rake $0 | Jackpot $0 | Bingo $0 | Fortune $0 | Tax $0
Seat 1: 3d571954 (button) folded before Flop (didn't bet)
Seat 2: 54b93839 (small blind) folded before Flop
Seat 3: 68fe2fd0 (big blind) folded before Flop
Seat 4: Hero folded before Flop (didn't bet)
Seat 5: 90577903 folded before Flop (didn't bet)
Seat 6: b5aebb10 collected ($0.25)


Poker Hand #RC2774754785: Hold'em No Limit ($0.05/$0.1) - 2024/08/05 12:45:14
Table 'RushAndCash21390045' 6-max Seat #1 is the button
Seat 1: 68fe2fd0 ($14.74 in chips)
Seat 2: Hero ($14.13 in chips)
Seat 3: 511bf05 ($11.82 in chips)
Seat 4: 8f0b47a3 ($19.32 in chips)
Seat 5: b4219453 ($10.2 in chips)
Seat 6: 4a28754c ($11.14 in chips)
Hero: posts small blind $0.05
511bf05: posts big blind $0.1
*** HOLE CARDS ***
Dealt to 68fe2fd0 
Dealt to Hero [Ac 2h]
Dealt to 511bf05 
Dealt to 8f0b47a3 
Dealt to b4219453 
Dealt to 4a28754c 
8f0b47a3: folds
b4219453: folds
4a28754c: folds
68fe2fd0: folds
Hero: folds
Uncalled bet ($0.05) returned to 511bf05
*** SHOWDOWN ***
511bf05 collected $0.1 from pot
*** SUMMARY ***
Total pot $0.1 | Rake $0 | Jackpot $0 | Bingo $0 | Fortune $0 | Tax $0
Seat 1: 68fe2fd0 (button) folded before Flop (didn't bet)
Seat 2: Hero (small blind) folded before Flop
Seat 3: 511bf05 (big blind) collected ($0.1)
Seat 4: 8f0b47a3 folded before Flop (didn't bet)
Seat 5: b4219453 folded before Flop (didn't bet)
Seat 6: 4a28754c folded before Flop (didn't bet)


Poker Hand #RC2774754751: Hold'em No Limit ($0.05/$0.1) - 2024/08/05 12:45:09
Table 'RushAndCash21390011' 6-max Seat #1 is the button
Seat 1: 25a4b4f ($23.59 in chips)
Seat 2: 13b99118 ($18.86 in chips)
Seat 3: 3da388d0 ($11.78 in chips)
Seat 4: 15e4e6a4 ($7.61 in chips)
Seat 5: Hero ($14.13 in chips)
Seat 6: c12d5fe8 ($10.63 in chips)
13b99118: posts small blind $0.05
3da388d0: posts big blind $0.1
*** HOLE CARDS ***
Dealt to 25a4b4f 
Dealt to 13b99118 
Dealt to 3da388d0 
Dealt to 15e4e6a4 
Dealt to Hero [Th 7s]
Dealt to c12d5fe8 
15e4e6a4: folds
Hero: folds
c12d5fe8: raises $0.15 to $0.25
25a4b4f: folds
13b99118: folds
3da388d0: folds
Uncalled bet ($0.15) returned to c12d5fe8
*** SHOWDOWN ***
c12d5fe8 collected $0.25 from pot
*** SUMMARY ***
Total pot $0.25 | Rake $0 | Jackpot $0 | Bingo $0 | Fortune $0 | Tax $0
Seat 1: 25a4b4f (button) folded before Flop (didn't bet)
Seat 2: 13b99118 (small blind) folded before Flop
Seat 3: 3da388d0 (big blind) folded before Flop
Seat 4: 15e4e6a4 folded before Flop (didn't bet)
Seat 5: Hero folded before Flop (didn't bet)
Seat 6: c12d5fe8 collected ($0.25)


Poker Hand #RC2774724722: Hold'em No Limit ($0.05/$0.1) - 2024/08/05 12:45:06
Table 'RushAndCash21389982' 6-max Seat #1 is the button
Seat 1: d5f9901 ($8.21 in chips)
Seat 2: e9b8904b ($12.58 in chips)
Seat 3: 90577903 ($6.47 in chips)
Seat 4: d81f4718 ($4.88 in chips)
Seat 5: d4cb0a8 ($10.11 in chips)
Seat 6: Hero ($14.13 in chips)
e9b8904b: posts small blind $0.05
90577903: posts big blind $0.1
*** HOLE CARDS ***
Dealt to d5f9901 
Dealt to e9b8904b 
Dealt to 90577903 
Dealt to d81f4718 
Dealt to d4cb0a8 
Dealt to Hero [4d Kc]
d81f4718: raises $0.1 to $0.2
d4cb0a8: folds
Hero: folds
d5f9901: folds
e9b8904b: folds
90577903: folds
Uncalled bet ($0.1) returned to d81f4718
*** SHOWDOWN ***
d81f4718 collected $0.25 from pot
*** SUMMARY ***
Total pot $0.25 | Rake $0 | Jackpot $0 | Bingo $0 | Fortune $0 | Tax $0
Seat 1: d5f9901 (button) folded before Flop (didn't bet)
Seat 2: e9b8904b (small blind) folded before Flop
Seat 3: 90577903 (big blind) folded before Flop
Seat 4: d81f4718 collected ($0.25)
Seat 5: d4cb0a8 folded before Flop (didn't bet)
Seat 6: Hero folded before Flop (didn't bet)


Poker Hand #RC2774724683: Hold'em No Limit ($0.05/$0.1) - 2024/08/05 12:45:02
Table 'RushAndCash21389943' 6-max Seat #1 is the button
Seat 1: Hero ($14.13 in chips)
Seat 2: ec0a46be ($10 in chips)
Seat 3: 2672cac2 ($10 in chips)
Seat 4: e1174674 ($10.3 in chips)
Seat 5: bae62c2a ($31.34 in chips)
Seat 6: f19312af ($7.33 in chips)
ec0a46be: posts small blind $0.05
2672cac2: posts big blind $0.1
*** HOLE CARDS ***
Dealt to Hero [4d 3c]
Dealt to ec0a46be 
Dealt to 2672cac2 
Dealt to e1174674 
Dealt to bae62c2a 
Dealt to f19312af 
e1174674: folds
bae62c2a: folds
f19312af: raises $0.15 to $0.25
Hero: folds
ec0a46be: folds
2672cac2: folds
Uncalled bet ($0.15) returned to f19312af
*** SHOWDOWN ***
f19312af collected $0.25 from pot
*** SUMMARY ***
Total pot $0.25 | Rake $0 | Jackpot $0 | Bingo $0 | Fortune $0 | Tax $0
Seat 1: Hero (button) folded before Flop (didn't bet)
Seat 2: ec0a46be (small blind) folded before Flop
Seat 3: 2672cac2 (big blind) folded before Flop
Seat 4: e1174674 folded before Flop (didn't bet)
Seat 5: bae62c2a folded before Flop (didn't bet)
Seat 6: f19312af collected ($0.25)


Poker Hand #RC2774724650: Hold'em No Limit ($0.05/$0.1) - 2024/08/05 12:44:58
Table 'RushAndCash21389910' 6-max Seat #1 is the button
Seat 1: Hero ($14.13 in chips)
Seat 2: 565a62db ($7.23 in chips)
Seat 3: 938dc1b0 ($10.95 in chips)
Seat 4: 204bd1bb ($10 in chips)
Seat 5: 71e51e91 ($11.04 in chips)
Seat 6: eca0bbe7 ($6.22 in chips)
565a62db: posts small blind $0.05
938dc1b0: posts big blind $0.1
*** HOLE CARDS ***
Dealt to Hero [3d Jh]
Dealt to 565a62db 
Dealt to 938dc1b0 
Dealt to 204bd1bb 
Dealt to 71e51e91 
Dealt to eca0bbe7 
204bd1bb: folds
71e51e91: folds
eca0bbe7: folds
Hero: folds
565a62db: folds
Uncalled bet ($0.05) returned to 938dc1b0
*** SHOWDOWN ***
938dc1b0 collected $0.1 from pot
*** SUMMARY ***
Total pot $0.1 | Rake $0 | Jackpot $0 | Bingo $0 | Fortune $0 | Tax $0
Seat 1: Hero (button) folded before Flop (didn't bet)
Seat 2: 565a62db (small blind) folded before Flop
Seat 3: 938dc1b0 (big blind) collected ($0.1)
Seat 4: 204bd1bb folded before Flop (didn't bet)
Seat 5: 71e51e91 folded before Flop (didn't bet)
Seat 6: eca0bbe7 folded before Flop (didn't bet)


Poker Hand #RC2774724625: Hold'em No Limit ($0.05/$0.1) - 2024/08/05 12:44:54
Table 'RushAndCash21389885' 6-max Seat #1 is the button
Seat 1: abf167f9 ($11.61 in chips)
Seat 2: Hero ($14.18 in chips)
Seat 3: f63f5ec8 ($14.06 in chips)
Seat 4: 4a5029c2 ($14.27 in chips)
Seat 5: 76b2da90 ($10 in chips)
Seat 6: eb6782a7 ($10 in chips)
Hero: posts small blind $0.05
f63f5ec8: posts big blind $0.1
*** HOLE CARDS ***
Dealt to abf167f9 
Dealt to Hero [Jd 3h]
Dealt to f63f5ec8 
Dealt to 4a5029c2 
Dealt to 76b2da90 
Dealt to eb6782a7 
4a5029c2: folds
76b2da90: folds
eb6782a7: raises $0.1 to $0.2
abf167f9: folds
Hero: folds
f63f5ec8: calls $0.1
*** FLOP *** [7s Ac 6s]
f63f5ec8: checks
eb6782a7: checks
*** TURN *** [7s Ac 6s] [Qs]
f63f5ec8: bets $0.2
eb6782a7: folds
Uncalled bet ($0.2) returned to f63f5ec8
*** SHOWDOWN ***
f63f5ec8 collected $0.43 from pot
*** SUMMARY ***
Total pot $0.45 | Rake $0.02 | Jackpot $0 | Bingo $0 | Fortune $0 | Tax $0
Board [7s Ac 6s Qs]
Seat 1: abf167f9 (button) folded before Flop (didn't bet)
Seat 2: Hero (small blind) folded before Flop
Seat 3: f63f5ec8 (big blind) won ($0.43)
Seat 4: 4a5029c2 folded before Flop (didn't bet)
Seat 5: 76b2da90 folded before Flop (didn't bet)
Seat 6: eb6782a7 folded on the Turn


Poker Hand #RC2774724554: Hold'em No Limit ($0.05/$0.1) - 2024/08/05 12:44:45
Table 'RushAndCash21389814' 6-max Seat #1 is the button
Seat 1: bdb1e82b ($10.24 in chips)
Seat 2: b962f844 ($10.03 in chips)
Seat 3: Hero ($14.28 in chips)
Seat 4: a568b35d ($13.11 in chips)
Seat 5: f3b4cb31 ($15.32 in chips)
Seat 6: af94ba84 ($10.2 in chips)
b962f844: posts small blind $0.05
Hero: posts big blind $0.1
*** HOLE CARDS ***
Dealt to bdb1e82b 
Dealt to b962f844 
Dealt to Hero [Kd Td]
Dealt to a568b35d 
Dealt to f3b4cb31 
Dealt to af94ba84 
a568b35d: folds
f3b4cb31: raises $0.1 to $0.2
af94ba84: raises $0.42 to $0.62
bdb1e82b: folds
b962f844: folds
Hero: folds
f3b4cb31: folds
Uncalled bet ($0.42) returned to af94ba84
*** SHOWDOWN ***
af94ba84 collected $0.53 from pot
*** SUMMARY ***
Total pot $0.55 | Rake $0.02 | Jackpot $0 | Bingo $0 | Fortune $0 | Tax $0
Seat 1: bdb1e82b (button) folded before Flop (didn't bet)
Seat 2: b962f844 (small blind) folded before Flop
Seat 3: Hero (big blind) folded before Flop
Seat 4: a568b35d folded before Flop (didn't bet)
Seat 5: f3b4cb31 folded before Flop
Seat 6: af94ba84 collected ($0.53)


Poker Hand #RC2774724490: Hold'em No Limit ($0.05/$0.1) - 2024/08/05 12:44:37
Table 'RushAndCash21389750' 6-max Seat #1 is the button
Seat 1: 4f612bdf ($11.65 in chips)
Seat 2: 480cefc6 ($8.53 in chips)
Seat 3: adac1045 ($10 in chips)
Seat 4: 3b0c26fe ($22.39 in chips)
Seat 5: a219470f ($10.9 in chips)
Seat 6: Hero ($14.28 in chips)
480cefc6: posts small blind $0.05
adac1045: posts big blind $0.1
*** HOLE CARDS ***
Dealt to 4f612bdf 
Dealt to 480cefc6 
Dealt to adac1045 
Dealt to 3b0c26fe 
Dealt to a219470f 
Dealt to Hero [Tc 2c]
3b0c26fe: raises $0.1 to $0.2
a219470f: raises $0.42 to $0.62
Hero: folds
4f612bdf: folds
480cefc6: folds
adac1045: folds
3b0c26fe: folds
Uncalled bet ($0.42) returned to a219470f
*** SHOWDOWN ***
a219470f collected $0.53 from pot
*** SUMMARY ***
Total pot $0.55 | Rake $0.02 | Jackpot $0 | Bingo $0 | Fortune $0 | Tax $0
Seat 1: 4f612bdf (button) folded before Flop (didn't bet)
Seat 2: 480cefc6 (small blind) folded before Flop
Seat 3: adac1045 (big blind) folded before Flop
Seat 4: 3b0c26fe folded before Flop
Seat 5: a219470f collected ($0.53)
Seat 6: Hero folded before Flop (didn't bet)


Poker Hand #RC2774724453: Hold'em No Limit ($0.05/$0.1) - 2024/08/05 12:44:32
Table 'RushAndCash21389713' 6-max Seat #1 is the button
Seat 1: Hero ($14.28 in chips)
Seat 2: 7ad4649d ($10.69 in chips)
Seat 3: 468f433f ($26.72 in chips)
Seat 4: 50d5b4b0 ($29.47 in chips)
Seat 5: c87cabee ($10 in chips)
Seat 6: 17c07c2e ($10.91 in chips)
7ad4649d: posts small blind $0.05
468f433f: posts big blind $0.1
*** HOLE CARDS ***
Dealt to Hero [3c 9h]
Dealt to 7ad4649d 
Dealt to 468f433f 
Dealt to 50d5b4b0 
Dealt to c87cabee 
Dealt to 17c07c2e 
50d5b4b0: folds
c87cabee: folds
17c07c2e: folds
Hero: folds
7ad4649d: folds
Uncalled bet ($0.05) returned to 468f433f
*** SHOWDOWN ***
468f433f collected $0.1 from pot
*** SUMMARY ***
Total pot $0.1 | Rake $0 | Jackpot $0 | Bingo $0 | Fortune $0 | Tax $0
Seat 1: Hero (button) folded before Flop (didn't bet)
Seat 2: 7ad4649d (small blind) folded before Flop
Seat 3: 468f433f (big blind) collected ($0.1)
Seat 4: 50d5b4b0 folded before Flop (didn't bet)
Seat 5: c87cabee folded before Flop (didn't bet)
Seat 6: 17c07c2e folded before Flop (didn't bet)


Poker Hand #RC2774724421: Hold'em No Limit ($0.05/$0.1) - 2024/08/05 12:44:28
Table 'RushAndCash21389681' 6-max Seat #1 is the button
Seat 1: f8c2e6a9 ($16.63 in chips)
Seat 2: Hero ($14.33 in chips)
Seat 3: c2e4cef2 ($10.21 in chips)
Seat 4: 9f4d5e0 ($9.37 in chips)
Seat 5: eaa5e890 ($10 in chips)
Seat 6: 90577903 ($6.1 in chips)
Hero: posts small blind $0.05
c2e4cef2: posts big blind $0.1
*** HOLE CARDS ***
Dealt to f8c2e6a9 
Dealt to Hero [7c 8d]
Dealt to c2e4cef2 
Dealt to 9f4d5e0 
Dealt to eaa5e890 
Dealt to 90577903 
9f4d5e0: raises $0.1 to $0.2
eaa5e890: folds
90577903: folds
f8c2e6a9: raises $0.52 to $0.72
Hero: folds
c2e4cef2: folds
9f4d5e0: calls $0.52
*** FLOP *** [3h 6h Ah]
9f4d5e0: checks
f8c2e6a9: checks
*** TURN *** [3h 6h Ah] [9s]
9f4d5e0: bets $0.9
f8c2e6a9: calls $0.9
*** RIVER *** [3h 6h Ah 9s] [Ts]
9f4d5e0: bets $1.9
f8c2e6a9: calls $1.9
9f4d5e0: shows [2c 2h] (Pair of Twos)
f8c2e6a9: shows [Jc Ad] (Pair of Aces)
*** SHOWDOWN ***
f8c2e6a9 collected $6.74 from pot
*** SUMMARY ***
Total pot $7.19 | Rake $0.3 | Jackpot $0.15 | Bingo $0 | Fortune $0 | Tax $0
Board [3h 6h Ah 9s Ts]
Seat 1: f8c2e6a9 (button) showed [Jc Ad] and won ($6.74) with Pair of Aces
Seat 2: Hero (small blind) folded before Flop
Seat 3: c2e4cef2 (big blind) folded before Flop
Seat 4: 9f4d5e0 showed [2c 2h] and lost with Pair of Twos
Seat 5: eaa5e890 folded before Flop (didn't bet)
Seat 6: 90577903 folded before Flop (didn't bet)


Poker Hand #RC2774724365: Hold'em No Limit ($0.05/$0.1) - 2024/08/05 12:44:21
Table 'RushAndCash21389625' 6-max Seat #1 is the button
Seat 1: 70286d44 ($10.87 in chips)
Seat 2: 1b7463f4 ($11.36 in chips)
Seat 3: Hero ($14.43 in chips)
Seat 4: 95eab614 ($13.17 in chips)
Seat 5: 519d5b9b ($10.76 in chips)
Seat 6: a2057744 ($26.54 in chips)
1b7463f4: posts small blind $0.05
Hero: posts big blind $0.1
*** HOLE CARDS ***
Dealt to 70286d44 
Dealt to 1b7463f4 
Dealt to Hero [8d 6s]
Dealt to 95eab614 
Dealt to 519d5b9b 
Dealt to a2057744 
95eab614: folds
519d5b9b: folds
a2057744: folds
70286d44: folds
1b7463f4: raises $0.1 to $0.2
Hero: folds
Uncalled bet ($0.1) returned to 1b7463f4
*** SHOWDOWN ***
1b7463f4 collected $0.2 from pot
*** SUMMARY ***
Total pot $0.2 | Rake $0 | Jackpot $0 | Bingo $0 | Fortune $0 | Tax $0
Seat 1: 70286d44 (button) folded before Flop (didn't bet)
Seat 2: 1b7463f4 (small blind) collected ($0.2)
Seat 3: Hero (big blind) folded before Flop
Seat 4: 95eab614 folded before Flop (didn't bet)
Seat 5: 519d5b9b folded before Flop (didn't bet)
Seat 6: a2057744 folded before Flop (didn't bet)


Poker Hand #RC2774724326: Hold'em No Limit ($0.05/$0.1) - 2024/08/05 12:44:17
Table 'RushAndCash21389586' 6-max Seat #1 is the button
Seat 1: bf9c2355 ($10.15 in chips)
Seat 2: 3fe53689 ($11.94 in chips)
Seat 3: a70018e ($7 in chips)
Seat 4: Hero ($14.43 in chips)
Seat 5: 8a3c0da8 ($21.36 in chips)
Seat 6: 1fee764 ($10.35 in chips)
3fe53689: posts small blind $0.05
a70018e: posts big blind $0.1
*** HOLE CARDS ***
Dealt to bf9c2355 
Dealt to 3fe53689 
Dealt to a70018e 
Dealt to Hero [3d Ac]
Dealt to 8a3c0da8 
Dealt to 1fee764 
Hero: folds
8a3c0da8: folds
1fee764: raises $0.13 to $0.23
bf9c2355: folds
3fe53689: calls $0.18
a70018e: folds
*** FLOP *** [Ad Qd 7c]
3fe53689: checks
1fee764: bets $0.19
3fe53689: folds
Uncalled bet ($0.19) returned to 1fee764
*** SHOWDOWN ***
1fee764 collected $0.54 from pot
*** SUMMARY ***
Total pot $0.56 | Rake $0.02 | Jackpot $0 | Bingo $0 | Fortune $0 | Tax $0
Board [Ad Qd 7c]
Seat 1: bf9c2355 (button) folded before Flop (didn't bet)
Seat 2: 3fe53689 (small blind) folded on the Flop
Seat 3: a70018e (big blind) folded before Flop
Seat 4: Hero folded before Flop (didn't bet)
Seat 5: 8a3c0da8 folded before Flop (didn't bet)
Seat 6: 1fee764 won ($0.54)


Poker Hand #RC2774724296: Hold'em No Limit ($0.05/$0.1) - 2024/08/05 12:44:14
Table 'RushAndCash21389556' 6-max Seat #1 is the button
Seat 1: 7db9a084 ($12.71 in chips)
Seat 2: bd1d5d64 ($10.38 in chips)
Seat 3: 64bea18e ($25.07 in chips)
Seat 4: Hero ($14.43 in chips)
Seat 5: 5d265da3 ($11.79 in chips)
Seat 6: d434bc61 ($10.81 in chips)
bd1d5d64: posts small blind $0.05
64bea18e: posts big blind $0.1
*** HOLE CARDS ***
Dealt to 7db9a084 
Dealt to bd1d5d64 
Dealt to 64bea18e 
Dealt to Hero [6c 8s]
Dealt to 5d265da3 
Dealt to d434bc61 
Hero: folds
5d265da3: folds
d434bc61: folds
7db9a084: folds
bd1d5d64: raises $0.2 to $0.3
64bea18e: folds
Uncalled bet ($0.2) returned to bd1d5d64
*** SHOWDOWN ***
bd1d5d64 collected $0.2 from pot
*** SUMMARY ***
Total pot $0.2 | Rake $0 | Jackpot $0 | Bingo $0 | Fortune $0 | Tax $0
Seat 1: 7db9a084 (button) folded before Flop (didn't bet)
Seat 2: bd1d5d64 (small blind) collected ($0.2)
Seat 3: 64bea18e (big blind) folded before Flop
Seat 4: Hero folded before Flop (didn't bet)
Seat 5: 5d265da3 folded before Flop (didn't bet)
Seat 6: d434bc61 folded before Flop (didn't bet)


Poker Hand #RC2774724257: Hold'em No Limit ($0.05/$0.1) - 2024/08/05 12:44:09
Table 'RushAndCash21389517' 6-max Seat #1 is the button
Seat 1: ec0a46be ($10 in chips)
Seat 2: f8c2e6a9 ($16.78 in chips)
Seat 3: 6dda4c72 ($10.1 in chips)
Seat 4: Hero ($14.43 in chips)
Seat 5: c727157d ($11.75 in chips)
Seat 6: b958f85c ($10.05 in chips)
f8c2e6a9: posts small blind $0.05
6dda4c72: posts big blind $0.1
*** HOLE CARDS ***
Dealt to ec0a46be 
Dealt to f8c2e6a9 
Dealt to 6dda4c72 
Dealt to Hero [5s Kd]
Dealt to c727157d 
Dealt to b958f85c 
Hero: folds
c727157d: folds
b958f85c: folds
ec0a46be: folds
f8c2e6a9: folds
Uncalled bet ($0.05) returned to 6dda4c72
*** SHOWDOWN ***
6dda4c72 collected $0.1 from pot
*** SUMMARY ***
Total pot $0.1 | Rake $0 | Jackpot $0 | Bingo $0 | Fortune $0 | Tax $0
Seat 1: ec0a46be (button) folded before Flop (didn't bet)
Seat 2: f8c2e6a9 (small blind) folded before Flop
Seat 3: 6dda4c72 (big blind) collected ($0.1)
Seat 4: Hero folded before Flop (didn't bet)
Seat 5: c727157d folded before Flop (didn't bet)
Seat 6: b958f85c folded before Flop (didn't bet)


Poker Hand #RC2774724228: Hold'em No Limit ($0.05/$0.1) - 2024/08/05 12:44:06
Table 'RushAndCash21389488' 6-max Seat #1 is the button
Seat 1: 8f7c02cf ($10 in chips)
Seat 2: a219470f ($11.15 in chips)
Seat 3: cc95bb99 ($10 in chips)
Seat 4: 116388f6 ($13.52 in chips)
Seat 5: 25a4b4f ($22.21 in chips)
Seat 6: Hero ($14.43 in chips)
a219470f: posts small blind $0.05
cc95bb99: posts big blind $0.1
*** HOLE CARDS ***
Dealt to 8f7c02cf 
Dealt to a219470f 
Dealt to cc95bb99 
Dealt to 116388f6 
Dealt to 25a4b4f 
Dealt to Hero [9s 6s]
116388f6: raises $0.1 to $0.2
25a4b4f: folds
Hero: folds
8f7c02cf: folds
a219470f: folds
cc95bb99: folds
Uncalled bet ($0.1) returned to 116388f6
*** SHOWDOWN ***
116388f6 collected $0.25 from pot
*** SUMMARY ***
Total pot $0.25 | Rake $0 | Jackpot $0 | Bingo $0 | Fortune $0 | Tax $0
Seat 1: 8f7c02cf (button) folded before Flop (didn't bet)
Seat 2: a219470f (small blind) folded before Flop
Seat 3: cc95bb99 (big blind) folded before Flop
Seat 4: 116388f6 collected ($0.25)
Seat 5: 25a4b4f folded before Flop (didn't bet)
Seat 6: Hero folded before Flop (didn't bet)


Poker Hand #RC2774724145: Hold'em No Limit ($0.05/$0.1) - 2024/08/05 12:43:56
Table 'RushAndCash21389405' 6-max Seat #1 is the button
Seat 1: 8666fbab ($10.41 in chips)
Seat 2: 21f8b6f6 ($10.05 in chips)
Seat 3: Hero ($14.53 in chips)
Seat 4: 7c95236a ($12.4 in chips)
Seat 5: 88072c5 ($10.61 in chips)
Seat 6: d56932f5 ($10 in chips)
21f8b6f6: posts small blind $0.05
Hero: posts big blind $0.1
*** HOLE CARDS ***
Dealt to 8666fbab 
Dealt to 21f8b6f6 
Dealt to Hero [6c 4d]
Dealt to 7c95236a 
Dealt to 88072c5 
Dealt to d56932f5 
7c95236a: folds
88072c5: folds
d56932f5: folds
8666fbab: folds
21f8b6f6: raises $0.1 to $0.2
Hero: folds
Uncalled bet ($0.1) returned to 21f8b6f6
*** SHOWDOWN ***
21f8b6f6 collected $0.2 from pot
*** SUMMARY ***
Total pot $0.2 | Rake $0 | Jackpot $0 | Bingo $0 | Fortune $0 | Tax $0
Seat 1: 8666fbab (button) folded before Flop (didn't bet)
Seat 2: 21f8b6f6 (small blind) collected ($0.2)
Seat 3: Hero (big blind) folded before Flop
Seat 4: 7c95236a folded before Flop (didn't bet)
Seat 5: 88072c5 folded before Flop (didn't bet)
Seat 6: d56932f5 folded before Flop (didn't bet)


Poker Hand #RC2774724092: Hold'em No Limit ($0.05/$0.1) - 2024/08/05 12:43:49
Table 'RushAndCash21389352' 6-max Seat #1 is the button
Seat 1: e3d464d3 ($12 in chips)
Seat 2: 5c68fa9e ($10.2 in chips)
Seat 3: a70018e ($6.95 in chips)
Seat 4: c2e4cef2 ($10.36 in chips)
Seat 5: Hero ($14.53 in chips)
Seat 6: 9b012cde ($52.6 in chips)
5c68fa9e: posts small blind $0.05
a70018e: posts big blind $0.1
*** HOLE CARDS ***
Dealt to e3d464d3 
Dealt to 5c68fa9e 
Dealt to a70018e 
Dealt to c2e4cef2 
Dealt to Hero [3h 9h]
Dealt to 9b012cde 
c2e4cef2: folds
Hero: folds
9b012cde: folds
e3d464d3: folds
5c68fa9e: folds
Uncalled bet ($0.05) returned to a70018e
*** SHOWDOWN ***
a70018e collected $0.1 from pot
*** SUMMARY ***
Total pot $0.1 | Rake $0 | Jackpot $0 | Bingo $0 | Fortune $0 | Tax $0
Seat 1: e3d464d3 (button) folded before Flop (didn't bet)
Seat 2: 5c68fa9e (small blind) folded before Flop
Seat 3: a70018e (big blind) collected ($0.1)
Seat 4: c2e4cef2 folded before Flop (didn't bet)
Seat 5: Hero folded before Flop (didn't bet)
Seat 6: 9b012cde folded before Flop (didn't bet)


Poker Hand #RC2774723769: Hold'em No Limit ($0.05/$0.1) - 2024/08/05 12:43:07
Table 'RushAndCash21389029' 6-max Seat #1 is the button
Seat 1: c2e4cef2 ($9.36 in chips)
Seat 2: Hero ($15.53 in chips)
Seat 3: 5d265da3 ($11.89 in chips)
Seat 4: c26e4bee ($10.35 in chips)
Seat 5: a58a0072 ($42.42 in chips)
Seat 6: 6e30e639 ($12.27 in chips)
Hero: posts small blind $0.05
5d265da3: posts big blind $0.1
*** HOLE CARDS ***
Dealt to c2e4cef2 
Dealt to Hero [Qd Kd]
Dealt to 5d265da3 
Dealt to c26e4bee 
Dealt to a58a0072 
Dealt to 6e30e639 
c26e4bee: folds
a58a0072: folds
6e30e639: folds
c2e4cef2: raises $0.1 to $0.2
Hero: raises $0.8 to $1
5d265da3: folds
c2e4cef2: calls $0.8
*** FLOP *** [9h 8s 5h]
Hero: checks
c2e4cef2: bets $1.05
Hero: folds
Uncalled bet ($1.05) returned to c2e4cef2
*** SHOWDOWN ***
c2e4cef2 collected $2 from pot
*** SUMMARY ***
Total pot $2.1 | Rake $0.1 | Jackpot $0 | Bingo $0 | Fortune $0 | Tax $0
Board [9h 8s 5h]
Seat 1: c2e4cef2 (button) won ($2)
Seat 2: Hero (small blind) folded on the Flop
Seat 3: 5d265da3 (big blind) folded before Flop
Seat 4: c26e4bee folded before Flop (didn't bet)
Seat 5: a58a0072 folded before Flop (didn't bet)
Seat 6: 6e30e639 folded before Flop (didn't bet)


Poker Hand #RC2774723731: Hold'em No Limit ($0.05/$0.1) - 2024/08/05 12:43:02
Table 'RushAndCash21388991' 6-max Seat #1 is the button
Seat 1: 4573cbdf ($10 in chips)
Seat 2: 3dc8fdf7 ($7.69 in chips)
Seat 3: 480cefc6 ($8.4 in chips)
Seat 4: Hero ($15.53 in chips)
Seat 5: b10aee13 ($10.71 in chips)
Seat 6: 35351de3 ($12.58 in chips)
3dc8fdf7: posts small blind $0.05
480cefc6: posts big blind $0.1
*** HOLE CARDS ***
Dealt to 4573cbdf 
Dealt to 3dc8fdf7 
Dealt to 480cefc6 
Dealt to Hero [7s 2d]
Dealt to b10aee13 
Dealt to 35351de3 
Hero: folds
b10aee13: folds
35351de3: raises $0.1 to $0.2
4573cbdf: folds
3dc8fdf7: folds
480cefc6: folds
Uncalled bet ($0.1) returned to 35351de3
*** SHOWDOWN ***
35351de3 collected $0.25 from pot
*** SUMMARY ***
Total pot $0.25 | Rake $0 | Jackpot $0 | Bingo $0 | Fortune $0 | Tax $0
Seat 1: 4573cbdf (button) folded before Flop (didn't bet)
Seat 2: 3dc8fdf7 (small blind) folded before Flop
Seat 3: 480cefc6 (big blind) folded before Flop
Seat 4: Hero folded before Flop (didn't bet)
Seat 5: b10aee13 folded before Flop (didn't bet)
Seat 6: 35351de3 collected ($0.25)


Poker Hand #RC2774723685: Hold'em No Limit ($0.05/$0.1) - 2024/08/05 12:42:57
Table 'RushAndCash21388945' 6-max Seat #1 is the button
Seat 1: Hero ($15.53 in chips)
Seat 2: 9acf1c1f ($10 in chips)
Seat 3: 42322d75 ($29.18 in chips)
Seat 4: ba50e138 ($10.58 in chips)
Seat 5: 75031704 ($10.15 in chips)
Seat 6: ca1a6df2 ($10.1 in chips)
9acf1c1f: posts small blind $0.05
42322d75: posts big blind $0.1
*** HOLE CARDS ***
Dealt to Hero [8d Jc]
Dealt to 9acf1c1f 
Dealt to 42322d75 
Dealt to ba50e138 
Dealt to 75031704 
Dealt to ca1a6df2 
ba50e138: raises $0.1 to $0.2
75031704: folds
ca1a6df2: folds
Hero: folds
9acf1c1f: folds
42322d75: folds
Uncalled bet ($0.1) returned to ba50e138
*** SHOWDOWN ***
ba50e138 collected $0.25 from pot
*** SUMMARY ***
Total pot $0.25 | Rake $0 | Jackpot $0 | Bingo $0 | Fortune $0 | Tax $0
Seat 1: Hero (button) folded before Flop (didn't bet)
Seat 2: 9acf1c1f (small blind) folded before Flop
Seat 3: 42322d75 (big blind) folded before Flop
Seat 4: ba50e138 collected ($0.25)
Seat 5: 75031704 folded before Flop (didn't bet)
Seat 6: ca1a6df2 folded before Flop (didn't bet)


Poker Hand #RC2774723629: Hold'em No Limit ($0.05/$0.1) - 2024/08/05 12:42:50
Table 'RushAndCash21388889' 6-max Seat #1 is the button
Seat 1: 64a291c5 ($21.37 in chips)
Seat 2: a26e0263 ($10 in chips)
Seat 3: 99d264c4 ($11.6 in chips)
Seat 4: dc92c56 ($47.93 in chips)
Seat 5: a42a4e96 ($8.92 in chips)
Seat 6: Hero ($15.53 in chips)
a26e0263: posts small blind $0.05
99d264c4: posts big blind $0.1
*** HOLE CARDS ***
Dealt to 64a291c5 
Dealt to a26e0263 
Dealt to 99d264c4 
Dealt to dc92c56 
Dealt to a42a4e96 
Dealt to Hero [4d 7h]
dc92c56: folds
a42a4e96: folds
Hero: folds
64a291c5: raises $0.2 to $0.3
a26e0263: folds
99d264c4: folds
Uncalled bet ($0.2) returned to 64a291c5
*** SHOWDOWN ***
64a291c5 collected $0.25 from pot
*** SUMMARY ***
Total pot $0.25 | Rake $0 | Jackpot $0 | Bingo $0 | Fortune $0 | Tax $0
Seat 1: 64a291c5 (button) collected ($0.25)
Seat 2: a26e0263 (small blind) folded before Flop
Seat 3: 99d264c4 (big blind) folded before Flop
Seat 4: dc92c56 folded before Flop (didn't bet)
Seat 5: a42a4e96 folded before Flop (didn't bet)
Seat 6: Hero folded before Flop (didn't bet)


Poker Hand #RC2774723553: Hold'em No Limit ($0.05/$0.1) - 2024/08/05 12:42:41
Table 'RushAndCash21388813' 6-max Seat #1 is the button
Seat 1: ab1f8e20 ($6.53 in chips)
Seat 2: Hero ($15.58 in chips)
Seat 3: b86e03ef ($12.88 in chips)
Seat 4: d26f83cb ($10.76 in chips)
Seat 5: 43be4122 ($8.94 in chips)
Seat 6: 42f6ae09 ($11.85 in chips)
Hero: posts small blind $0.05
b86e03ef: posts big blind $0.1
*** HOLE CARDS ***
Dealt to ab1f8e20 
Dealt to Hero [Ac 6s]
Dealt to b86e03ef 
Dealt to d26f83cb 
Dealt to 43be4122 
Dealt to 42f6ae09 
d26f83cb: folds
43be4122: folds
42f6ae09: folds
ab1f8e20: raises $0.1 to $0.2
Hero: folds
b86e03ef: folds
Uncalled bet ($0.1) returned to ab1f8e20
*** SHOWDOWN ***
ab1f8e20 collected $0.25 from pot
*** SUMMARY ***
Total pot $0.25 | Rake $0 | Jackpot $0 | Bingo $0 | Fortune $0 | Tax $0
Seat 1: ab1f8e20 (button) collected ($0.25)
Seat 2: Hero (small blind) folded before Flop
Seat 3: b86e03ef (big blind) folded before Flop
Seat 4: d26f83cb folded before Flop (didn't bet)
Seat 5: 43be4122 folded before Flop (didn't bet)
Seat 6: 42f6ae09 folded before Flop (didn't bet)


Poker Hand #RC2774723422: Hold'em No Limit ($0.05/$0.1) - 2024/08/05 12:42:24
Table 'RushAndCash21388682' 6-max Seat #1 is the button
Seat 1: Hero ($15.43 in chips)
Seat 2: 3236a7df ($9.13 in chips)
Seat 3: 81dc9567 ($8.29 in chips)
Seat 4: f735ed75 ($12.66 in chips)
Seat 5: 9e260c68 ($10 in chips)
Seat 6: e9b8904b ($13.24 in chips)
3236a7df: posts small blind $0.05
81dc9567: posts big blind $0.1
*** HOLE CARDS ***
Dealt to Hero [9h Qh]
Dealt to 3236a7df 
Dealt to 81dc9567 
Dealt to f735ed75 
Dealt to 9e260c68 
Dealt to e9b8904b 
f735ed75: folds
9e260c68: folds
e9b8904b: folds
Hero: raises $0.14 to $0.24
3236a7df: folds
81dc9567: folds
Uncalled bet ($0.14) returned to Hero
*** SHOWDOWN ***
Hero collected $0.25 from pot
*** SUMMARY ***
Total pot $0.25 | Rake $0 | Jackpot $0 | Bingo $0 | Fortune $0 | Tax $0
Seat 1: Hero (button) collected ($0.25)
Seat 2: 3236a7df (small blind) folded before Flop
Seat 3: 81dc9567 (big blind) folded before Flop
Seat 4: f735ed75 folded before Flop (didn't bet)
Seat 5: 9e260c68 folded before Flop (didn't bet)
Seat 6: e9b8904b folded before Flop (didn't bet)


Poker Hand #RC2774723379: Hold'em No Limit ($0.05/$0.1) - 2024/08/05 12:42:18
Table 'RushAndCash21388639' 6-max Seat #1 is the button
Seat 1: eb6782a7 ($10 in chips)
Seat 2: 8f2b3fe6 ($10.69 in chips)
Seat 3: Hero ($15.53 in chips)
Seat 4: 20bf403f ($7.77 in chips)
Seat 5: e1174674 ($10 in chips)
Seat 6: 961076e2 ($10.1 in chips)
8f2b3fe6: posts small blind $0.05
Hero: posts big blind $0.1
*** HOLE CARDS ***
Dealt to eb6782a7 
Dealt to 8f2b3fe6 
Dealt to Hero [4h Kd]
Dealt to 20bf403f 
Dealt to e1174674 
Dealt to 961076e2 
20bf403f: folds
e1174674: folds
961076e2: folds
eb6782a7: folds
8f2b3fe6: raises $0.17 to $0.27
Hero: folds
Uncalled bet ($0.17) returned to 8f2b3fe6
*** SHOWDOWN ***
8f2b3fe6 collected $0.2 from pot
*** SUMMARY ***
Total pot $0.2 | Rake $0 | Jackpot $0 | Bingo $0 | Fortune $0 | Tax $0
Seat 1: eb6782a7 (button) folded before Flop (didn't bet)
Seat 2: 8f2b3fe6 (small blind) collected ($0.2)
Seat 3: Hero (big blind) folded before Flop
Seat 4: 20bf403f folded before Flop (didn't bet)
Seat 5: e1174674 folded before Flop (didn't bet)
Seat 6: 961076e2 folded before Flop (didn't bet)


Poker Hand #RC2774723305: Hold'em No Limit ($0.05/$0.1) - 2024/08/05 12:42:09
Table 'RushAndCash21388565' 6-max Seat #1 is the button
Seat 1: c9a2f192 ($19.14 in chips)
Seat 2: Hero ($15.58 in chips)
Seat 3: f8ded6e2 ($30.81 in chips)
Seat 4: 9a46da17 ($12.88 in chips)
Seat 5: 38ec9e55 ($12.43 in chips)
Seat 6: 8d51c9b1 ($33.71 in chips)
Hero: posts small blind $0.05
f8ded6e2: posts big blind $0.1
*** HOLE CARDS ***
Dealt to c9a2f192 
Dealt to Hero [Ts 4s]
Dealt to f8ded6e2 
Dealt to 9a46da17 
Dealt to 38ec9e55 
Dealt to 8d51c9b1 
9a46da17: folds
38ec9e55: folds
8d51c9b1: folds
c9a2f192: folds
Hero: folds
Uncalled bet ($0.05) returned to f8ded6e2
*** SHOWDOWN ***
f8ded6e2 collected $0.1 from pot
*** SUMMARY ***
Total pot $0.1 | Rake $0 | Jackpot $0 | Bingo $0 | Fortune $0 | Tax $0
Seat 1: c9a2f192 (button) folded before Flop (didn't bet)
Seat 2: Hero (small blind) folded before Flop
Seat 3: f8ded6e2 (big blind) collected ($0.1)
Seat 4: 9a46da17 folded before Flop (didn't bet)
Seat 5: 38ec9e55 folded before Flop (didn't bet)
Seat 6: 8d51c9b1 folded before Flop (didn't bet)


Poker Hand #RC2774723026: Hold'em No Limit ($0.05/$0.1) - 2024/08/05 12:41:33
Table 'RushAndCash21388286' 6-max Seat #1 is the button
Seat 1: da1ba5d7 ($10.22 in chips)
Seat 2: 2434749b ($10.71 in chips)
Seat 3: c9a2f192 ($18.91 in chips)
Seat 4: 42ea9e42 ($31.66 in chips)
Seat 5: Hero ($15.78 in chips)
Seat 6: c4584975 ($11.7 in chips)
2434749b: posts small blind $0.05
c9a2f192: posts big blind $0.1
*** HOLE CARDS ***
Dealt to da1ba5d7 
Dealt to 2434749b 
Dealt to c9a2f192 
Dealt to 42ea9e42 
Dealt to Hero [Ks 7s]
Dealt to c4584975 
42ea9e42: folds
Hero: raises $0.1 to $0.2
c4584975: folds
da1ba5d7: folds
2434749b: folds
c9a2f192: calls $0.1
*** FLOP *** [Qc 2s 8d]
c9a2f192: checks
Hero: checks
*** TURN *** [Qc 2s 8d] [6h]
c9a2f192: bets $0.3
Hero: folds
Uncalled bet ($0.3) returned to c9a2f192
*** SHOWDOWN ***
c9a2f192 collected $0.43 from pot
*** SUMMARY ***
Total pot $0.45 | Rake $0.02 | Jackpot $0 | Bingo $0 | Fortune $0 | Tax $0
Board [Qc 2s 8d 6h]
Seat 1: da1ba5d7 (button) folded before Flop (didn't bet)
Seat 2: 2434749b (small blind) folded before Flop
Seat 3: c9a2f192 (big blind) won ($0.43)
Seat 4: 42ea9e42 folded before Flop (didn't bet)
Seat 5: Hero folded on the Turn
Seat 6: c4584975 folded before Flop (didn't bet)


Poker Hand #RC2774722993: Hold'em No Limit ($0.05/$0.1) - 2024/08/05 12:41:30
Table 'RushAndCash21388253' 6-max Seat #1 is the button
Seat 1: 6b7afbbe ($30.95 in chips)
Seat 2: 1e2d72f ($10 in chips)
Seat 3: f8303f3b ($12.14 in chips)
Seat 4: Hero ($15.78 in chips)
Seat 5: 9886bba4 ($10.35 in chips)
Seat 6: ddc6e4ca ($10.34 in chips)
1e2d72f: posts small blind $0.05
f8303f3b: posts big blind $0.1
*** HOLE CARDS ***
Dealt to 6b7afbbe 
Dealt to 1e2d72f 
Dealt to f8303f3b 
Dealt to Hero [8d 2s]
Dealt to 9886bba4 
Dealt to ddc6e4ca 
Hero: folds
9886bba4: folds
ddc6e4ca: folds
6b7afbbe: folds
1e2d72f: folds
Uncalled bet ($0.05) returned to f8303f3b
*** SHOWDOWN ***
f8303f3b collected $0.1 from pot
*** SUMMARY ***
Total pot $0.1 | Rake $0 | Jackpot $0 | Bingo $0 | Fortune $0 | Tax $0
Seat 1: 6b7afbbe (button) folded before Flop (didn't bet)
Seat 2: 1e2d72f (small blind) folded before Flop
Seat 3: f8303f3b (big blind) collected ($0.1)
Seat 4: Hero folded before Flop (didn't bet)
Seat 5: 9886bba4 folded before Flop (didn't bet)
Seat 6: ddc6e4ca folded before Flop (didn't bet)


Poker Hand #RC2774722412: Hold'em No Limit ($0.05/$0.1) - 2024/08/05 12:40:15
Table 'RushAndCash21387672' 6-max Seat #1 is the button
Seat 1: d85d1b8e ($22.1 in chips)
Seat 2: 633d8c4e ($12.29 in chips)
Seat 3: dc92c56 ($49.48 in chips)
Seat 4: 7950b0f3 ($17.43 in chips)
Seat 5: 6ff7870c ($12.36 in chips)
Seat 6: Hero ($13.07 in chips)
633d8c4e: posts small blind $0.05
dc92c56: posts big blind $0.1
*** HOLE CARDS ***
Dealt to d85d1b8e 
Dealt to 633d8c4e 
Dealt to dc92c56 
Dealt to 7950b0f3 
Dealt to 6ff7870c 
Dealt to Hero [Qh As]
7950b0f3: folds
6ff7870c: folds
Hero: raises $0.14 to $0.24
d85d1b8e: folds
633d8c4e: raises $0.58 to $0.82
dc92c56: folds
Hero: calls $0.58
*** FLOP *** [3d Kc Ts]
633d8c4e: checks
Hero: bets $1
633d8c4e: calls $1
*** TURN *** [3d Kc Ts] [Ks]
633d8c4e: checks
Hero: bets $1.24
633d8c4e: calls $1.24
*** RIVER *** [3d Kc Ts Ks] [5s]
633d8c4e: checks
Hero: bets $10.01 and is all-in
633d8c4e: folds
Uncalled bet ($10.01) returned to Hero
*** SHOWDOWN ***
Hero collected $5.77 from pot
*** SUMMARY ***
Total pot $6.22 | Rake $0.3 | Jackpot $0.15 | Bingo $0 | Fortune $0 | Tax $0
Board [3d Kc Ts Ks 5s]
Seat 1: d85d1b8e (button) folded before Flop (didn't bet)
Seat 2: 633d8c4e (small blind) folded on the River
Seat 3: dc92c56 (big blind) folded before Flop
Seat 4: 7950b0f3 folded before Flop (didn't bet)
Seat 5: 6ff7870c folded before Flop (didn't bet)
Seat 6: Hero won ($5.77)


Poker Hand #RC2774722339: Hold'em No Limit ($0.05/$0.1) - 2024/08/05 12:40:06
Table 'RushAndCash21387599' 6-max Seat #1 is the button
Seat 1: 2c7a529f ($10 in chips)
Seat 2: 4dd54c14 ($10.47 in chips)
Seat 3: Hero ($13.17 in chips)
Seat 4: bec0764 ($16.04 in chips)
Seat 5: 658e122b ($20.42 in chips)
Seat 6: 64326c84 ($11.12 in chips)
4dd54c14: posts small blind $0.05
Hero: posts big blind $0.1
*** HOLE CARDS ***
Dealt to 2c7a529f 
Dealt to 4dd54c14 
Dealt to Hero [Ks 2c]
Dealt to bec0764 
Dealt to 658e122b 
Dealt to 64326c84 
bec0764: folds
658e122b: folds
64326c84: folds
2c7a529f: raises $0.12 to $0.22
4dd54c14: folds
Hero: folds
Uncalled bet ($0.12) returned to 2c7a529f
*** SHOWDOWN ***
2c7a529f collected $0.25 from pot
*** SUMMARY ***
Total pot $0.25 | Rake $0 | Jackpot $0 | Bingo $0 | Fortune $0 | Tax $0
Seat 1: 2c7a529f (button) collected ($0.25)
Seat 2: 4dd54c14 (small blind) folded before Flop
Seat 3: Hero (big blind) folded before Flop
Seat 4: bec0764 folded before Flop (didn't bet)
Seat 5: 658e122b folded before Flop (didn't bet)
Seat 6: 64326c84 folded before Flop (didn't bet)


Poker Hand #RC2774722304: Hold'em No Limit ($0.05/$0.1) - 2024/08/05 12:40:02
Table 'RushAndCash21387564' 6-max Seat #1 is the button
Seat 1: 9b9d8b69 ($20.09 in chips)
Seat 2: 9dc9ad21 ($10 in chips)
Seat 3: e59c72d0 ($18.95 in chips)
Seat 4: 7155dca ($11.07 in chips)
Seat 5: 8617f6d1 ($9.58 in chips)
Seat 6: Hero ($13.17 in chips)
9dc9ad21: posts small blind $0.05
e59c72d0: posts big blind $0.1
*** HOLE CARDS ***
Dealt to 9b9d8b69 
Dealt to 9dc9ad21 
Dealt to e59c72d0 
Dealt to 7155dca 
Dealt to 8617f6d1 
Dealt to Hero [9h 4s]
7155dca: folds
8617f6d1: folds
Hero: folds
9b9d8b69: folds
9dc9ad21: raises $0.2 to $0.3
e59c72d0: raises $0.6 to $0.9
9dc9ad21: raises $1.35 to $2.25
e59c72d0: folds
Uncalled bet ($1.35) returned to 9dc9ad21
*** SHOWDOWN ***
9dc9ad21 collected $1.7 from pot
*** SUMMARY ***
Total pot $1.8 | Rake $0.1 | Jackpot $0 | Bingo $0 | Fortune $0 | Tax $0
Seat 1: 9b9d8b69 (button) folded before Flop (didn't bet)
Seat 2: 9dc9ad21 (small blind) collected ($1.7)
Seat 3: e59c72d0 (big blind) folded before Flop
Seat 4: 7155dca folded before Flop (didn't bet)
Seat 5: 8617f6d1 folded before Flop (didn't bet)
Seat 6: Hero folded before Flop (didn't bet)


Poker Hand #RC2774722271: Hold'em No Limit ($0.05/$0.1) - 2024/08/05 12:39:58
Table 'RushAndCash21387531' 6-max Seat #1 is the button
Seat 1: Hero ($13.17 in chips)
Seat 2: 6ab7886b ($7.43 in chips)
Seat 3: be6b5098 ($13.23 in chips)
Seat 4: eed55452 ($12.69 in chips)
Seat 5: 938dc1b0 ($10.27 in chips)
Seat 6: 7155dca ($11.07 in chips)
6ab7886b: posts small blind $0.05
be6b5098: posts big blind $0.1
*** HOLE CARDS ***
Dealt to Hero [Tc 2h]
Dealt to 6ab7886b 
Dealt to be6b5098 
Dealt to eed55452 
Dealt to 938dc1b0 
Dealt to 7155dca 
eed55452: folds
938dc1b0: folds
7155dca: folds
Hero: folds
6ab7886b: raises $0.1 to $0.2
be6b5098: folds
Uncalled bet ($0.1) returned to 6ab7886b
*** SHOWDOWN ***
6ab7886b collected $0.2 from pot
*** SUMMARY ***
Total pot $0.2 | Rake $0 | Jackpot $0 | Bingo $0 | Fortune $0 | Tax $0
Seat 1: Hero (button) folded before Flop (didn't bet)
Seat 2: 6ab7886b (small blind) collected ($0.2)
Seat 3: be6b5098 (big blind) folded before Flop
Seat 4: eed55452 folded before Flop (didn't bet)
Seat 5: 938dc1b0 folded before Flop (didn't bet)
Seat 6: 7155dca folded before Flop (didn't bet)


Poker Hand #RC2774722243: Hold'em No Limit ($0.05/$0.1) - 2024/08/05 12:39:54
Table 'RushAndCash21387503' 6-max Seat #1 is the button
Seat 1: 3888f290 ($10.82 in chips)
Seat 2: a58a0072 ($42.19 in chips)
Seat 3: f38291df ($5.82 in chips)
Seat 4: Hero ($13.17 in chips)
Seat 5: 5ec6e508 ($19.72 in chips)
Seat 6: c2a98b86 ($9.65 in chips)
a58a0072: posts small blind $0.05
f38291df: posts big blind $0.1
*** HOLE CARDS ***
Dealt to 3888f290 
Dealt to a58a0072 
Dealt to f38291df 
Dealt to Hero [5d 5c]
Dealt to 5ec6e508 
Dealt to c2a98b86 
Hero: folds
5ec6e508: folds
c2a98b86: folds
3888f290: folds
a58a0072: raises $0.2 to $0.3
f38291df: folds
Uncalled bet ($0.2) returned to a58a0072
*** SHOWDOWN ***
a58a0072 collected $0.2 from pot
*** SUMMARY ***
Total pot $0.2 | Rake $0 | Jackpot $0 | Bingo $0 | Fortune $0 | Tax $0
Seat 1: 3888f290 (button) folded before Flop (didn't bet)
Seat 2: a58a0072 (small blind) collected ($0.2)
Seat 3: f38291df (big blind) folded before Flop
Seat 4: Hero folded before Flop (didn't bet)
Seat 5: 5ec6e508 folded before Flop (didn't bet)
Seat 6: c2a98b86 folded before Flop (didn't bet)


Poker Hand #RC2774722032: Hold'em No Limit ($0.05/$0.1) - 2024/08/05 12:39:29
Table 'RushAndCash21387292' 6-max Seat #1 is the button
Seat 1: d0b9c0d3 ($30.13 in chips)
Seat 2: 5ec6e508 ($19.62 in chips)
Seat 3: fb600294 ($16.32 in chips)
Seat 4: 8c410251 ($10.83 in chips)
Seat 5: 69dbfdca ($10 in chips)
Seat 6: Hero ($12.84 in chips)
5ec6e508: posts small blind $0.05
fb600294: posts big blind $0.1
*** HOLE CARDS ***
Dealt to d0b9c0d3 
Dealt to 5ec6e508 
Dealt to fb600294 
Dealt to 8c410251 
Dealt to 69dbfdca 
Dealt to Hero [Kh Js]
8c410251: folds
69dbfdca: raises $0.1 to $0.2
Hero: raises $0.47 to $0.67
d0b9c0d3: folds
5ec6e508: folds
fb600294: folds
69dbfdca: folds
Uncalled bet ($0.47) returned to Hero
*** SHOWDOWN ***
Hero collected $0.53 from pot
*** SUMMARY ***
Total pot $0.55 | Rake $0.02 | Jackpot $0 | Bingo $0 | Fortune $0 | Tax $0
Seat 1: d0b9c0d3 (button) folded before Flop (didn't bet)
Seat 2: 5ec6e508 (small blind) folded before Flop
Seat 3: fb600294 (big blind) folded before Flop
Seat 4: 8c410251 folded before Flop (didn't bet)
Seat 5: 69dbfdca folded before Flop
Seat 6: Hero collected ($0.53)


Poker Hand #RC2774721881: Hold'em No Limit ($0.05/$0.1) - 2024/08/05 12:39:10
Table 'RushAndCash21387141' 6-max Seat #1 is the button
Seat 1: e33eca0 ($10 in chips)
Seat 2: 7707f5cb ($10.68 in chips)
Seat 3: Hero ($12.61 in chips)
Seat 4: fb600294 ($16.32 in chips)
Seat 5: 5c0ade4d ($10.97 in chips)
Seat 6: fbe6dd7e ($10.57 in chips)
7707f5cb: posts small blind $0.05
Hero: posts big blind $0.1
*** HOLE CARDS ***
Dealt to e33eca0 
Dealt to 7707f5cb 
Dealt to Hero [Qc Qh]
Dealt to fb600294 
Dealt to 5c0ade4d 
Dealt to fbe6dd7e 
fb600294: folds
5c0ade4d: folds
fbe6dd7e: folds
e33eca0: raises $0.1 to $0.2
7707f5cb: folds
Hero: raises $0.7 to $0.9
e33eca0: folds
Uncalled bet ($0.7) returned to Hero
*** SHOWDOWN ***
Hero collected $0.43 from pot
*** SUMMARY ***
Total pot $0.45 | Rake $0.02 | Jackpot $0 | Bingo $0 | Fortune $0 | Tax $0
Seat 1: e33eca0 (button) folded before Flop
Seat 2: 7707f5cb (small blind) folded before Flop
Seat 3: Hero (big blind) collected ($0.43)
Seat 4: fb600294 folded before Flop (didn't bet)
Seat 5: 5c0ade4d folded before Flop (didn't bet)
Seat 6: fbe6dd7e folded before Flop (didn't bet)


Poker Hand #RC2774721844: Hold'em No Limit ($0.05/$0.1) - 2024/08/05 12:39:04
Table 'RushAndCash21387104' 6-max Seat #1 is the button
Seat 1: 8f7c02cf ($10.33 in chips)
Seat 2: 62ef8cc4 ($15.72 in chips)
Seat 3: 36112634 ($10.51 in chips)
Seat 4: Hero ($12.61 in chips)
Seat 5: 605962a ($10.05 in chips)
Seat 6: 3c0a97c0 ($11.02 in chips)
62ef8cc4: posts small blind $0.05
36112634: posts big blind $0.1
*** HOLE CARDS ***
Dealt to 8f7c02cf 
Dealt to 62ef8cc4 
Dealt to 36112634 
Dealt to Hero [5h Jh]
Dealt to 605962a 
Dealt to 3c0a97c0 
Hero: folds
605962a: folds
3c0a97c0: raises $0.1 to $0.2
8f7c02cf: raises $0.4 to $0.6
62ef8cc4: folds
36112634: folds
3c0a97c0: calls $0.4
*** FLOP *** [Td 7s 4d]
3c0a97c0: bets $0.45
8f7c02cf: folds
Uncalled bet ($0.45) returned to 3c0a97c0
*** SHOWDOWN ***
3c0a97c0 collected $1.29 from pot
*** SUMMARY ***
Total pot $1.35 | Rake $0.06 | Jackpot $0 | Bingo $0 | Fortune $0 | Tax $0
Board [Td 7s 4d]
Seat 1: 8f7c02cf (button) folded on the Flop
Seat 2: 62ef8cc4 (small blind) folded before Flop
Seat 3: 36112634 (big blind) folded before Flop
Seat 4: Hero folded before Flop (didn't bet)
Seat 5: 605962a folded before Flop (didn't bet)
Seat 6: 3c0a97c0 won ($1.29)


Poker Hand #RC2774721746: Hold'em No Limit ($0.05/$0.1) - 2024/08/05 12:38:51
Table 'RushAndCash21387006' 6-max Seat #1 is the button
Seat 1: f63f5ec8 ($14.21 in chips)
Seat 2: Hero ($12.66 in chips)
Seat 3: 3ced2fed ($9.78 in chips)
Seat 4: 75031704 ($10 in chips)
Seat 5: 204bd1bb ($11.39 in chips)
Seat 6: a3db2d38 ($10.25 in chips)
Hero: posts small blind $0.05
3ced2fed: posts big blind $0.1
*** HOLE CARDS ***
Dealt to f63f5ec8 
Dealt to Hero [4d Qd]
Dealt to 3ced2fed 
Dealt to 75031704 
Dealt to 204bd1bb 
Dealt to a3db2d38 
75031704: folds
204bd1bb: folds
a3db2d38: raises $0.2 to $0.3
f63f5ec8: folds
Hero: folds
3ced2fed: folds
Uncalled bet ($0.2) returned to a3db2d38
*** SHOWDOWN ***
a3db2d38 collected $0.25 from pot
*** SUMMARY ***
Total pot $0.25 | Rake $0 | Jackpot $0 | Bingo $0 | Fortune $0 | Tax $0
Seat 1: f63f5ec8 (button) folded before Flop (didn't bet)
Seat 2: Hero (small blind) folded before Flop
Seat 3: 3ced2fed (big blind) folded before Flop
Seat 4: 75031704 folded before Flop (didn't bet)
Seat 5: 204bd1bb folded before Flop (didn't bet)
Seat 6: a3db2d38 collected ($0.25)


Poker Hand #RC2774721684: Hold'em No Limit ($0.05/$0.1) - 2024/08/05 12:38:43
Table 'RushAndCash21386944' 6-max Seat #1 is the button
Seat 1: Hero ($12.66 in chips)
Seat 2: 7ace1cc0 ($17.91 in chips)
Seat 3: b74de1f2 ($10 in chips)
Seat 4: da3d9584 ($12.96 in chips)
Seat 5: 8a3c0da8 ($21.81 in chips)
Seat 6: c519f7aa ($12.85 in chips)
7ace1cc0: posts small blind $0.05
b74de1f2: posts big blind $0.1
*** HOLE CARDS ***
Dealt to Hero [4s 9h]
Dealt to 7ace1cc0 
Dealt to b74de1f2 
Dealt to da3d9584 
Dealt to 8a3c0da8 
Dealt to c519f7aa 
da3d9584: folds
8a3c0da8: folds
c519f7aa: folds
Hero: folds
7ace1cc0: folds
Uncalled bet ($0.05) returned to b74de1f2
*** SHOWDOWN ***
b74de1f2 collected $0.1 from pot
*** SUMMARY ***
Total pot $0.1 | Rake $0 | Jackpot $0 | Bingo $0 | Fortune $0 | Tax $0
Seat 1: Hero (button) folded before Flop (didn't bet)
Seat 2: 7ace1cc0 (small blind) folded before Flop
Seat 3: b74de1f2 (big blind) collected ($0.1)
Seat 4: da3d9584 folded before Flop (didn't bet)
Seat 5: 8a3c0da8 folded before Flop (didn't bet)
Seat 6: c519f7aa folded before Flop (didn't bet)


Poker Hand #RC2774721656: Hold'em No Limit ($0.05/$0.1) - 2024/08/05 12:38:39
Table 'RushAndCash21386916' 6-max Seat #1 is the button
Seat 1: 63c60428 ($6.94 in chips)
Seat 2: 13355c12 ($23.19 in chips)
Seat 3: 116388f6 ($14.04 in chips)
Seat 4: ad44b18a ($16.69 in chips)
Seat 5: Hero ($12.66 in chips)
Seat 6: 1f7acbae ($10.21 in chips)
13355c12: posts small blind $0.05
116388f6: posts big blind $0.1
*** HOLE CARDS ***
Dealt to 63c60428 
Dealt to 13355c12 
Dealt to 116388f6 
Dealt to ad44b18a 
Dealt to Hero [Ts 8d]
Dealt to 1f7acbae 
ad44b18a: folds
Hero: folds
1f7acbae: folds
63c60428: raises $0.2 to $0.3
13355c12: folds
116388f6: calls $0.2
*** FLOP *** [Qc 2h Ks]
116388f6: checks
63c60428: checks
*** TURN *** [Qc 2h Ks] [3h]
116388f6: checks
63c60428: checks
*** RIVER *** [Qc 2h Ks 3h] [Qh]
116388f6: checks
63c60428: bets $0.65
116388f6: folds
Uncalled bet ($0.65) returned to 63c60428
*** SHOWDOWN ***
63c60428 collected $0.62 from pot
*** SUMMARY ***
Total pot $0.65 | Rake $0.03 | Jackpot $0 | Bingo $0 | Fortune $0 | Tax $0
Board [Qc 2h Ks 3h Qh]
Seat 1: 63c60428 (button) won ($0.62)
Seat 2: 13355c12 (small blind) folded before Flop
Seat 3: 116388f6 (big blind) folded on the River
Seat 4: ad44b18a folded before Flop (didn't bet)
Seat 5: Hero folded before Flop (didn't bet)
Seat 6: 1f7acbae folded before Flop (didn't bet)


Poker Hand #RC2774721603: Hold'em No Limit ($0.05/$0.1) - 2024/08/05 12:38:32
Table 'RushAndCash21386863' 6-max Seat #1 is the button
Seat 1: ec055f5c ($10.47 in chips)
Seat 2: 3216df9a ($10.14 in chips)
Seat 3: b86e03ef ($14.97 in chips)
Seat 4: 6eb639d3 ($5.5 in chips)
Seat 5: Hero ($12.66 in chips)
Seat 6: e33eca0 ($10 in chips)
3216df9a: posts small blind $0.05
b86e03ef: posts big blind $0.1
*** HOLE CARDS ***
Dealt to ec055f5c 
Dealt to 3216df9a 
Dealt to b86e03ef 
Dealt to 6eb639d3 
Dealt to Hero [8d Kd]
Dealt to e33eca0 
6eb639d3: folds
Hero: folds
e33eca0: folds
ec055f5c: folds
3216df9a: raises $0.15 to $0.25
b86e03ef: folds
Uncalled bet ($0.15) returned to 3216df9a
*** SHOWDOWN ***
3216df9a collected $0.2 from pot
*** SUMMARY ***
Total pot $0.2 | Rake $0 | Jackpot $0 | Bingo $0 | Fortune $0 | Tax $0
Seat 1: ec055f5c (button) folded before Flop (didn't bet)
Seat 2: 3216df9a (small blind) collected ($0.2)
Seat 3: b86e03ef (big blind) folded before Flop
Seat 4: 6eb639d3 folded before Flop (didn't bet)
Seat 5: Hero folded before Flop (didn't bet)
Seat 6: e33eca0 folded before Flop (didn't bet)


Poker Hand #RC2774721492: Hold'em No Limit ($0.05/$0.1) - 2024/08/05 12:38:17
Table 'RushAndCash21386752' 6-max Seat #1 is the button
Seat 1: Hero ($12.66 in chips)
Seat 2: 76e5e7b9 ($10.21 in chips)
Seat 3: 9b0d7628 ($10 in chips)
Seat 4: 49189a4 ($13.09 in chips)
Seat 5: b10aee13 ($11.13 in chips)
Seat 6: 94218f2 ($10.97 in chips)
76e5e7b9: posts small blind $0.05
9b0d7628: posts big blind $0.1
*** HOLE CARDS ***
Dealt to Hero [7c Ad]
Dealt to 76e5e7b9 
Dealt to 9b0d7628 
Dealt to 49189a4 
Dealt to b10aee13 
Dealt to 94218f2 
49189a4: folds
b10aee13: raises $0.15 to $0.25
94218f2: folds
Hero: folds
76e5e7b9: folds
9b0d7628: folds
Uncalled bet ($0.15) returned to b10aee13
*** SHOWDOWN ***
b10aee13 collected $0.25 from pot
*** SUMMARY ***
Total pot $0.25 | Rake $0 | Jackpot $0 | Bingo $0 | Fortune $0 | Tax $0
Seat 1: Hero (button) folded before Flop (didn't bet)
Seat 2: 76e5e7b9 (small blind) folded before Flop
Seat 3: 9b0d7628 (big blind) folded before Flop
Seat 4: 49189a4 folded before Flop (didn't bet)
Seat 5: b10aee13 collected ($0.25)
Seat 6: 94218f2 folded before Flop (didn't bet)


Poker Hand #RC2774721068: Hold'em No Limit ($0.05/$0.1) - 2024/08/05 12:37:25
Table 'RushAndCash21386328' 6-max Seat #1 is the button
Seat 1: 41727a67 ($11.07 in chips)
Seat 2: 2f6e7bb0 ($24.09 in chips)
Seat 3: Hero ($12.61 in chips)
Seat 4: 42ea9e42 ($31.93 in chips)
Seat 5: 98610389 ($10.82 in chips)
Seat 6: 3ced2fed ($10.08 in chips)
2f6e7bb0: posts small blind $0.05
Hero: posts big blind $0.1
*** HOLE CARDS ***
Dealt to 41727a67 
Dealt to 2f6e7bb0 
Dealt to Hero [Kd 6h]
Dealt to 42ea9e42 
Dealt to 98610389 
Dealt to 3ced2fed 
42ea9e42: folds
98610389: folds
3ced2fed: folds
41727a67: folds
2f6e7bb0: folds
Uncalled bet ($0.05) returned to Hero
*** SHOWDOWN ***
Hero collected $0.1 from pot
*** SUMMARY ***
Total pot $0.1 | Rake $0 | Jackpot $0 | Bingo $0 | Fortune $0 | Tax $0
Seat 1: 41727a67 (button) folded before Flop (didn't bet)
Seat 2: 2f6e7bb0 (small blind) folded before Flop
Seat 3: Hero (big blind) collected ($0.1)
Seat 4: 42ea9e42 folded before Flop (didn't bet)
Seat 5: 98610389 folded before Flop (didn't bet)
Seat 6: 3ced2fed folded before Flop (didn't bet)


Poker Hand #RC2774721003: Hold'em No Limit ($0.05/$0.1) - 2024/08/05 12:37:17
Table 'RushAndCash21386263' 6-max Seat #1 is the button
Seat 1: 772edc7a ($13.1 in chips)
Seat 2: Hero ($12.66 in chips)
Seat 3: 2511a681 ($9.96 in chips)
Seat 4: 414e3269 ($22.07 in chips)
Seat 5: 34a541ff ($18.09 in chips)
Seat 6: 519d5b9b ($10.26 in chips)
Hero: posts small blind $0.05
2511a681: posts big blind $0.1
*** HOLE CARDS ***
Dealt to 772edc7a 
Dealt to Hero [5h Jc]
Dealt to 2511a681 
Dealt to 414e3269 
Dealt to 34a541ff 
Dealt to 519d5b9b 
414e3269: folds
34a541ff: folds
519d5b9b: folds
772edc7a: folds
Hero: folds
Uncalled bet ($0.05) returned to 2511a681
*** SHOWDOWN ***
2511a681 collected $0.1 from pot
*** SUMMARY ***
Total pot $0.1 | Rake $0 | Jackpot $0 | Bingo $0 | Fortune $0 | Tax $0
Seat 1: 772edc7a (button) folded before Flop (didn't bet)
Seat 2: Hero (small blind) folded before Flop
Seat 3: 2511a681 (big blind) collected ($0.1)
Seat 4: 414e3269 folded before Flop (didn't bet)
Seat 5: 34a541ff folded before Flop (didn't bet)
Seat 6: 519d5b9b folded before Flop (didn't bet)


Poker Hand #RC2774720962: Hold'em No Limit ($0.05/$0.1) - 2024/08/05 12:37:13
Table 'RushAndCash21386222' 6-max Seat #1 is the button
Seat 1: ab7c1e6 ($17.27 in chips)
Seat 2: b1e85d3c ($11.9 in chips)
Seat 3: 70126d5c ($21.36 in chips)
Seat 4: Hero ($12.66 in chips)
Seat 5: 3457986d ($10.33 in chips)
Seat 6: adb0200e ($8.76 in chips)
b1e85d3c: posts small blind $0.05
70126d5c: posts big blind $0.1
*** HOLE CARDS ***
Dealt to ab7c1e6 
Dealt to b1e85d3c 
Dealt to 70126d5c 
Dealt to Hero [3d 9c]
Dealt to 3457986d 
Dealt to adb0200e 
Hero: folds
3457986d: folds
adb0200e: folds
ab7c1e6: folds
b1e85d3c: folds
Uncalled bet ($0.05) returned to 70126d5c
*** SHOWDOWN ***
70126d5c collected $0.1 from pot
*** SUMMARY ***
Total pot $0.1 | Rake $0 | Jackpot $0 | Bingo $0 | Fortune $0 | Tax $0
Seat 1: ab7c1e6 (button) folded before Flop (didn't bet)
Seat 2: b1e85d3c (small blind) folded before Flop
Seat 3: 70126d5c (big blind) collected ($0.1)
Seat 4: Hero folded before Flop (didn't bet)
Seat 5: 3457986d folded before Flop (didn't bet)
Seat 6: adb0200e folded before Flop (didn't bet)


Poker Hand #RC2774720927: Hold'em No Limit ($0.05/$0.1) - 2024/08/05 12:37:08
Table 'RushAndCash21386187' 6-max Seat #1 is the button
Seat 1: 929b4246 ($19.15 in chips)
Seat 2: d26f83cb ($10 in chips)
Seat 3: a4aad96a ($10.89 in chips)
Seat 4: Hero ($12.66 in chips)
Seat 5: 8b8c29f1 ($16.71 in chips)
Seat 6: 644022ea ($22.52 in chips)
d26f83cb: posts small blind $0.05
a4aad96a: posts big blind $0.1
*** HOLE CARDS ***
Dealt to 929b4246 
Dealt to d26f83cb 
Dealt to a4aad96a 
Dealt to Hero [Kh 7h]
Dealt to 8b8c29f1 
Dealt to 644022ea 
Hero: folds
8b8c29f1: folds
644022ea: raises $0.15 to $0.25
929b4246: raises $0.5 to $0.75
d26f83cb: folds
a4aad96a: folds
644022ea: raises $1.6 to $2.35
929b4246: folds
Uncalled bet ($1.6) returned to 644022ea
*** SHOWDOWN ***
644022ea collected $1.57 from pot
*** SUMMARY ***
Total pot $1.65 | Rake $0.08 | Jackpot $0 | Bingo $0 | Fortune $0 | Tax $0
Seat 1: 929b4246 (button) folded before Flop
Seat 2: d26f83cb (small blind) folded before Flop
Seat 3: a4aad96a (big blind) folded before Flop
Seat 4: Hero folded before Flop (didn't bet)
Seat 5: 8b8c29f1 folded before Flop (didn't bet)
Seat 6: 644022ea collected ($1.57)


Poker Hand #RC2774720899: Hold'em No Limit ($0.05/$0.1) - 2024/08/05 12:37:04
Table 'RushAndCash21386159' 6-max Seat #1 is the button
Seat 1: 52f12e3a ($10 in chips)
Seat 2: 7be4d738 ($17.14 in chips)
Seat 3: d434bc61 ($10 in chips)
Seat 4: Hero ($12.66 in chips)
Seat 5: e5e26648 ($44.82 in chips)
Seat 6: c55d ($4.15 in chips)
7be4d738: posts small blind $0.05
d434bc61: posts big blind $0.1
*** HOLE CARDS ***
Dealt to 52f12e3a 
Dealt to 7be4d738 
Dealt to d434bc61 
Dealt to Hero [8d 9s]
Dealt to e5e26648 
Dealt to c55d 
Hero: folds
e5e26648: folds
c55d: calls $0.1
52f12e3a: folds
7be4d738: folds
d434bc61: checks
*** FLOP *** [6s 8s 2c]
d434bc61: checks
c55d: checks
*** TURN *** [6s 8s 2c] [Kh]
d434bc61: checks
c55d: bets $0.13
d434bc61: calls $0.13
*** RIVER *** [6s 8s 2c Kh] [7h]
d434bc61: checks
c55d: checks
d434bc61: shows [7s 7c] (Three Sevens)
c55d: shows [5h Ac] (Ace-High)
*** SHOWDOWN ***
d434bc61 collected $0.49 from pot
*** SUMMARY ***
Total pot $0.51 | Rake $0.02 | Jackpot $0 | Bingo $0 | Fortune $0 | Tax $0
Board [6s 8s 2c Kh 7h]
Seat 1: 52f12e3a (button) folded before Flop (didn't bet)
Seat 2: 7be4d738 (small blind) folded before Flop
Seat 3: d434bc61 (big blind) showed [7s 7c] and won ($0.49) with Three Sevens
Seat 4: Hero folded before Flop (didn't bet)
Seat 5: e5e26648 folded before Flop (didn't bet)
Seat 6: c55d showed [5h Ac] and lost with Ace-High


Poker Hand #RC2774720876: Hold'em No Limit ($0.05/$0.1) - 2024/08/05 12:37:00
Table 'RushAndCash21386136' 6-max Seat #1 is the button
Seat 1: f136f614 ($10.77 in chips)
Seat 2: c4584975 ($12.37 in chips)
Seat 3: 1add7ce4 ($7.96 in chips)
Seat 4: c55d ($4.15 in chips)
Seat 5: bdd584ee ($10.55 in chips)
Seat 6: Hero ($12.66 in chips)
c4584975: posts small blind $0.05
1add7ce4: posts big blind $0.1
*** HOLE CARDS ***
Dealt to f136f614 
Dealt to c4584975 
Dealt to 1add7ce4 
Dealt to c55d 
Dealt to bdd584ee 
Dealt to Hero [8c Ks]
c55d: folds
bdd584ee: folds
Hero: folds
f136f614: raises $0.12 to $0.22
c4584975: folds
1add7ce4: calls $0.12
*** FLOP *** [Kc 6h 4h]
1add7ce4: checks
f136f614: bets $0.2
1add7ce4: raises $0.89 to $1.09
f136f614: folds
Uncalled bet ($0.89) returned to 1add7ce4
*** SHOWDOWN ***
1add7ce4 collected $0.85 from pot
*** SUMMARY ***
Total pot $0.89 | Rake $0.04 | Jackpot $0 | Bingo $0 | Fortune $0 | Tax $0
Board [Kc 6h 4h]
Seat 1: f136f614 (button) folded on the Flop
Seat 2: c4584975 (small blind) folded before Flop
Seat 3: 1add7ce4 (big blind) won ($0.85)
Seat 4: c55d folded before Flop (didn't bet)
Seat 5: bdd584ee folded before Flop (didn't bet)
Seat 6: Hero folded before Flop (didn't bet)


Poker Hand #RC2774720794: Hold'em No Limit ($0.05/$0.1) - 2024/08/05 12:36:50
Table 'RushAndCash21386054' 6-max Seat #1 is the button
Seat 1: 1894db5f ($12.83 in chips)
Seat 2: a41a5c6e ($10.57 in chips)
Seat 3: Hero ($12.61 in chips)
Seat 4: 3fe53689 ($11.03 in chips)
Seat 5: 7448bb3b ($10 in chips)
Seat 6: 5ec6e508 ($20.37 in chips)
a41a5c6e: posts small blind $0.05
Hero: posts big blind $0.1
*** HOLE CARDS ***
Dealt to 1894db5f 
Dealt to a41a5c6e 
Dealt to Hero [3s 4h]
Dealt to 3fe53689 
Dealt to 7448bb3b 
Dealt to 5ec6e508 
3fe53689: folds
7448bb3b: folds
5ec6e508: folds
1894db5f: folds
a41a5c6e: folds
Uncalled bet ($0.05) returned to Hero
*** SHOWDOWN ***
Hero collected $0.1 from pot
*** SUMMARY ***
Total pot $0.1 | Rake $0 | Jackpot $0 | Bingo $0 | Fortune $0 | Tax $0
Seat 1: 1894db5f (button) folded before Flop (didn't bet)
Seat 2: a41a5c6e (small blind) folded before Flop
Seat 3: Hero (big blind) collected ($0.1)
Seat 4: 3fe53689 folded before Flop (didn't bet)
Seat 5: 7448bb3b folded before Flop (didn't bet)
Seat 6: 5ec6e508 folded before Flop (didn't bet)


Poker Hand #RC2774720533: Hold'em No Limit ($0.05/$0.1) - 2024/08/05 12:36:17
Table 'RushAndCash21385793' 6-max Seat #1 is the button
Seat 1: Hero ($12.34 in chips)
Seat 2: 9f9a72c7 ($10.4 in chips)
Seat 3: 5ec6e508 ($20.61 in chips)
Seat 4: c4093c4a ($11.26 in chips)
Seat 5: 7c95236a ($10.32 in chips)
Seat 6: 605962a ($11.04 in chips)
9f9a72c7: posts small blind $0.05
5ec6e508: posts big blind $0.1
*** HOLE CARDS ***
Dealt to Hero [Ad 8h]
Dealt to 9f9a72c7 
Dealt to 5ec6e508 
Dealt to c4093c4a 
Dealt to 7c95236a 
Dealt to 605962a 
c4093c4a: folds
7c95236a: folds
605962a: folds
Hero: raises $0.14 to $0.24
9f9a72c7: folds
5ec6e508: calls $0.14
*** FLOP *** [2d 9d 2s]
5ec6e508: checks
Hero: bets $0.35
5ec6e508: folds
Uncalled bet ($0.35) returned to Hero
*** SHOWDOWN ***
Hero collected $0.51 from pot
*** SUMMARY ***
Total pot $0.53 | Rake $0.02 | Jackpot $0 | Bingo $0 | Fortune $0 | Tax $0
Board [2d 9d 2s]
Seat 1: Hero (button) won ($0.51)
Seat 2: 9f9a72c7 (small blind) folded before Flop
Seat 3: 5ec6e508 (big blind) folded on the Flop
Seat 4: c4093c4a folded before Flop (didn't bet)
Seat 5: 7c95236a folded before Flop (didn't bet)
Seat 6: 605962a folded before Flop (didn't bet)


Poker Hand #RC2774720508: Hold'em No Limit ($0.05/$0.1) - 2024/08/05 12:36:14
Table 'RushAndCash21385768' 6-max Seat #1 is the button
Seat 1: d28d30e4 ($18.45 in chips)
Seat 2: Hero ($12.39 in chips)
Seat 3: 3d571954 ($29.56 in chips)
Seat 4: e5b05063 ($20.82 in chips)
Seat 5: fc60fbbc ($10.15 in chips)
Seat 6: bdf3b4bd ($7.22 in chips)
Hero: posts small blind $0.05
3d571954: posts big blind $0.1
*** HOLE CARDS ***
Dealt to d28d30e4 
Dealt to Hero [3d 6h]
Dealt to 3d571954 
Dealt to e5b05063 
Dealt to fc60fbbc 
Dealt to bdf3b4bd 
e5b05063: raises $0.1 to $0.2
fc60fbbc: folds
bdf3b4bd: folds
d28d30e4: folds
Hero: folds
3d571954: folds
Uncalled bet ($0.1) returned to e5b05063
*** SHOWDOWN ***
e5b05063 collected $0.25 from pot
*** SUMMARY ***
Total pot $0.25 | Rake $0 | Jackpot $0 | Bingo $0 | Fortune $0 | Tax $0
Seat 1: d28d30e4 (button) folded before Flop (didn't bet)
Seat 2: Hero (small blind) folded before Flop
Seat 3: 3d571954 (big blind) folded before Flop
Seat 4: e5b05063 collected ($0.25)
Seat 5: fc60fbbc folded before Flop (didn't bet)
Seat 6: bdf3b4bd folded before Flop (didn't bet)


Poker Hand #RC2774720480: Hold'em No Limit ($0.05/$0.1) - 2024/08/05 12:36:11
Table 'RushAndCash21385740' 6-max Seat #1 is the button
Seat 1: 847778db ($10 in chips)
Seat 2: 750f4df2 ($12.28 in chips)
Seat 3: 7435ecb7 ($10.88 in chips)
Seat 4: bdf3b4bd ($7.22 in chips)
Seat 5: Hero ($12.39 in chips)
Seat 6: 3b0c26fe ($11.23 in chips)
750f4df2: posts small blind $0.05
7435ecb7: posts big blind $0.1
*** HOLE CARDS ***
Dealt to 847778db 
Dealt to 750f4df2 
Dealt to 7435ecb7 
Dealt to bdf3b4bd 
Dealt to Hero [8s 9c]
Dealt to 3b0c26fe 
bdf3b4bd: folds
Hero: folds
3b0c26fe: folds
847778db: folds
750f4df2: raises $0.12 to $0.22
7435ecb7: calls $0.12
*** FLOP *** [3h Qh 7s]
750f4df2: checks
7435ecb7: checks
*** TURN *** [3h Qh 7s] [4h]
750f4df2: bets $0.22
7435ecb7: folds
Uncalled bet ($0.22) returned to 750f4df2
*** SHOWDOWN ***
750f4df2 collected $0.42 from pot
*** SUMMARY ***
Total pot $0.44 | Rake $0.02 | Jackpot $0 | Bingo $0 | Fortune $0 | Tax $0
Board [3h Qh 7s 4h]
Seat 1: 847778db (button) folded before Flop (didn't bet)
Seat 2: 750f4df2 (small blind) won ($0.42)
Seat 3: 7435ecb7 (big blind) folded on the Turn
Seat 4: bdf3b4bd folded before Flop (didn't bet)
Seat 5: Hero folded before Flop (didn't bet)
Seat 6: 3b0c26fe folded before Flop (didn't bet)


Poker Hand #RC2774720436: Hold'em No Limit ($0.05/$0.1) - 2024/08/05 12:36:05
Table 'RushAndCash21385696' 6-max Seat #1 is the button
Seat 1: dc92c56 ($49.88 in chips)
Seat 2: 5ec6e508 ($20.66 in chips)
Seat 3: 42322d75 ($28.37 in chips)
Seat 4: 8cedb71e ($10.94 in chips)
Seat 5: Hero ($12.39 in chips)
Seat 6: 6c735362 ($8.87 in chips)
5ec6e508: posts small blind $0.05
42322d75: posts big blind $0.1
*** HOLE CARDS ***
Dealt to dc92c56 
Dealt to 5ec6e508 
Dealt to 42322d75 
Dealt to 8cedb71e 
Dealt to Hero [4s 4d]
Dealt to 6c735362 
8cedb71e: folds
Hero: folds
6c735362: raises $0.2 to $0.3
dc92c56: folds
5ec6e508: folds
42322d75: folds
Uncalled bet ($0.2) returned to 6c735362
*** SHOWDOWN ***
6c735362 collected $0.25 from pot
*** SUMMARY ***
Total pot $0.25 | Rake $0 | Jackpot $0 | Bingo $0 | Fortune $0 | Tax $0
Seat 1: dc92c56 (button) folded before Flop (didn't bet)
Seat 2: 5ec6e508 (small blind) folded before Flop
Seat 3: 42322d75 (big blind) folded before Flop
Seat 4: 8cedb71e folded before Flop (didn't bet)
Seat 5: Hero folded before Flop (didn't bet)
Seat 6: 6c735362 collected ($0.25)


Poker Hand #RC2774720409: Hold'em No Limit ($0.05/$0.1) - 2024/08/05 12:36:02
Table 'RushAndCash21385669' 6-max Seat #1 is the button
Seat 1: 6def5588 ($17.04 in chips)
Seat 2: Hero ($12.44 in chips)
Seat 3: da1ba5d7 ($11.64 in chips)
Seat 4: 38ec9e55 ($9.81 in chips)
Seat 5: 118773cf ($5.41 in chips)
Seat 6: d3015cb3 ($10.98 in chips)
Hero: posts small blind $0.05
da1ba5d7: posts big blind $0.1
*** HOLE CARDS ***
Dealt to 6def5588 
Dealt to Hero [5c Jd]
Dealt to da1ba5d7 
Dealt to 38ec9e55 
Dealt to 118773cf 
Dealt to d3015cb3 
38ec9e55: folds
118773cf: folds
d3015cb3: folds
6def5588: folds
Hero: folds
Uncalled bet ($0.05) returned to da1ba5d7
*** SHOWDOWN ***
da1ba5d7 collected $0.1 from pot
*** SUMMARY ***
Total pot $0.1 | Rake $0 | Jackpot $0 | Bingo $0 | Fortune $0 | Tax $0
Seat 1: 6def5588 (button) folded before Flop (didn't bet)
Seat 2: Hero (small blind) folded before Flop
Seat 3: da1ba5d7 (big blind) collected ($0.1)
Seat 4: 38ec9e55 folded before Flop (didn't bet)
Seat 5: 118773cf folded before Flop (didn't bet)
Seat 6: d3015cb3 folded before Flop (didn't bet)


Poker Hand #RC2774720381: Hold'em No Limit ($0.05/$0.1) - 2024/08/05 12:35:58
Table 'RushAndCash21385641' 6-max Seat #1 is the button
Seat 1: 84999102 ($7.19 in chips)
Seat 2: 96300ea7 ($9.88 in chips)
Seat 3: 67ddcdcd ($17.3 in chips)
Seat 4: 6def5588 ($17.04 in chips)
Seat 5: Hero ($12.44 in chips)
Seat 6: 78664b40 ($20.83 in chips)
96300ea7: posts small blind $0.05
67ddcdcd: posts big blind $0.1
*** HOLE CARDS ***
Dealt to 84999102 
Dealt to 96300ea7 
Dealt to 67ddcdcd 
Dealt to 6def5588 
Dealt to Hero [Qh 9d]
Dealt to 78664b40 
6def5588: folds
Hero: folds
78664b40: folds
84999102: raises $0.1 to $0.2
96300ea7: folds
67ddcdcd: calls $0.1
*** FLOP *** [Ad 8d 9c]
67ddcdcd: checks
84999102: checks
*** TURN *** [Ad 8d 9c] [Kd]
67ddcdcd: bets $0.57
84999102: folds
Uncalled bet ($0.57) returned to 67ddcdcd
*** SHOWDOWN ***
67ddcdcd collected $0.43 from pot
*** SUMMARY ***
Total pot $0.45 | Rake $0.02 | Jackpot $0 | Bingo $0 | Fortune $0 | Tax $0
Board [Ad 8d 9c Kd]
Seat 1: 84999102 (button) folded on the Turn
Seat 2: 96300ea7 (small blind) folded before Flop
Seat 3: 67ddcdcd (big blind) won ($0.43)
Seat 4: 6def5588 folded before Flop (didn't bet)
Seat 5: Hero folded before Flop (didn't bet)
Seat 6: 78664b40 folded before Flop (didn't bet)


Poker Hand #RC2774720340: Hold'em No Limit ($0.05/$0.1) - 2024/08/05 12:35:53
Table 'RushAndCash21385600' 6-max Seat #1 is the button
Seat 1: ae76a8f6 ($10.69 in chips)
Seat 2: e25d0386 ($10.38 in chips)
Seat 3: Hero ($12.54 in chips)
Seat 4: 8d51c9b1 ($34.75 in chips)
Seat 5: f8e4d6fa ($17.3 in chips)
Seat 6: 689a4315 ($10.48 in chips)
e25d0386: posts small blind $0.05
Hero: posts big blind $0.1
*** HOLE CARDS ***
Dealt to ae76a8f6 
Dealt to e25d0386 
Dealt to Hero [Jd 9h]
Dealt to 8d51c9b1 
Dealt to f8e4d6fa 
Dealt to 689a4315 
8d51c9b1: raises $0.1 to $0.2
f8e4d6fa: raises $0.52 to $0.72
689a4315: folds
ae76a8f6: folds
e25d0386: folds
Hero: folds
8d51c9b1: folds
Uncalled bet ($0.52) returned to f8e4d6fa
*** SHOWDOWN ***
f8e4d6fa collected $0.53 from pot
*** SUMMARY ***
Total pot $0.55 | Rake $0.02 | Jackpot $0 | Bingo $0 | Fortune $0 | Tax $0
Seat 1: ae76a8f6 (button) folded before Flop (didn't bet)
Seat 2: e25d0386 (small blind) folded before Flop
Seat 3: Hero (big blind) folded before Flop
Seat 4: 8d51c9b1 folded before Flop
Seat 5: f8e4d6fa collected ($0.53)
Seat 6: 689a4315 folded before Flop (didn't bet)


Poker Hand #RC2774720288: Hold'em No Limit ($0.05/$0.1) - 2024/08/05 12:35:46
Table 'RushAndCash21385548' 6-max Seat #1 is the button
Seat 1: Hero ($12.54 in chips)
Seat 2: 3846630c ($9.9 in chips)
Seat 3: bc31de8a ($11.06 in chips)
Seat 4: fb4632c7 ($13.63 in chips)
Seat 5: ae76a8f6 ($10.69 in chips)
Seat 6: cd4be1e5 ($25.91 in chips)
3846630c: posts small blind $0.05
bc31de8a: posts big blind $0.1
*** HOLE CARDS ***
Dealt to Hero [5h 6h]
Dealt to 3846630c 
Dealt to bc31de8a 
Dealt to fb4632c7 
Dealt to ae76a8f6 
Dealt to cd4be1e5 
fb4632c7: folds
ae76a8f6: folds
cd4be1e5: folds
Hero: folds
3846630c: folds
Uncalled bet ($0.05) returned to bc31de8a
*** SHOWDOWN ***
bc31de8a collected $0.1 from pot
*** SUMMARY ***
Total pot $0.1 | Rake $0 | Jackpot $0 | Bingo $0 | Fortune $0 | Tax $0
Seat 1: Hero (button) folded before Flop (didn't bet)
Seat 2: 3846630c (small blind) folded before Flop
Seat 3: bc31de8a (big blind) collected ($0.1)
Seat 4: fb4632c7 folded before Flop (didn't bet)
Seat 5: ae76a8f6 folded before Flop (didn't bet)
Seat 6: cd4be1e5 folded before Flop (didn't bet)


Poker Hand #RC2774720249: Hold'em No Limit ($0.05/$0.1) - 2024/08/05 12:35:41
Table 'RushAndCash21385509' 6-max Seat #1 is the button
Seat 1: a70018e ($4.35 in chips)
Seat 2: 118b2939 ($10.67 in chips)
Seat 3: 47f607d ($12.37 in chips)
Seat 4: 1f7acbae ($10.19 in chips)
Seat 5: Hero ($12.54 in chips)
Seat 6: fbe6dd7e ($10.63 in chips)
118b2939: posts small blind $0.05
47f607d: posts big blind $0.1
*** HOLE CARDS ***
Dealt to a70018e 
Dealt to 118b2939 
Dealt to 47f607d 
Dealt to 1f7acbae 
Dealt to Hero [Jh 9s]
Dealt to fbe6dd7e 
1f7acbae: folds
Hero: folds
fbe6dd7e: folds
a70018e: folds
118b2939: raises $0.15 to $0.25
47f607d: raises $0.68 to $0.93
118b2939: folds
Uncalled bet ($0.68) returned to 47f607d
*** SHOWDOWN ***
47f607d collected $0.48 from pot
*** SUMMARY ***
Total pot $0.5 | Rake $0.02 | Jackpot $0 | Bingo $0 | Fortune $0 | Tax $0
Seat 1: a70018e (button) folded before Flop (didn't bet)
Seat 2: 118b2939 (small blind) folded before Flop
Seat 3: 47f607d (big blind) collected ($0.48)
Seat 4: 1f7acbae folded before Flop (didn't bet)
Seat 5: Hero folded before Flop (didn't bet)
Seat 6: fbe6dd7e folded before Flop (didn't bet)


Poker Hand #RC2774720160: Hold'em No Limit ($0.05/$0.1) - 2024/08/05 12:35:30
Table 'RushAndCash21385420' 6-max Seat #1 is the button
Seat 1: 5a2ff57f ($10.05 in chips)
Seat 2: 64a291c5 ($22.53 in chips)
Seat 3: 87d59ce6 ($11.44 in chips)
Seat 4: Hero ($12.39 in chips)
Seat 5: 34f8bad ($34.44 in chips)
Seat 6: 82a8f9c ($17.52 in chips)
64a291c5: posts small blind $0.05
87d59ce6: posts big blind $0.1
*** HOLE CARDS ***
Dealt to 5a2ff57f 
Dealt to 64a291c5 
Dealt to 87d59ce6 
Dealt to Hero [Kc Kh]
Dealt to 34f8bad 
Dealt to 82a8f9c 
Hero: raises $0.1 to $0.2
34f8bad: folds
82a8f9c: folds
5a2ff57f: folds
64a291c5: folds
87d59ce6: folds
Uncalled bet ($0.1) returned to Hero
*** SHOWDOWN ***
Hero collected $0.25 from pot
*** SUMMARY ***
Total pot $0.25 | Rake $0 | Jackpot $0 | Bingo $0 | Fortune $0 | Tax $0
Seat 1: 5a2ff57f (button) folded before Flop (didn't bet)
Seat 2: 64a291c5 (small blind) folded before Flop
Seat 3: 87d59ce6 (big blind) folded before Flop
Seat 4: Hero collected ($0.25)
Seat 5: 34f8bad folded before Flop (didn't bet)
Seat 6: 82a8f9c folded before Flop (didn't bet)


Poker Hand #RC2774720132: Hold'em No Limit ($0.05/$0.1) - 2024/08/05 12:35:26
Table 'RushAndCash21385392' 6-max Seat #1 is the button
Seat 1: 7c891321 ($16.19 in chips)
Seat 2: 99d264c4 ($10.1 in chips)
Seat 3: 71e51e91 ($10.64 in chips)
Seat 4: Hero ($12.39 in chips)
Seat 5: e5e26648 ($43.85 in chips)
Seat 6: 35f19e9f ($10.28 in chips)
99d264c4: posts small blind $0.05
71e51e91: posts big blind $0.1
*** HOLE CARDS ***
Dealt to 7c891321 
Dealt to 99d264c4 
Dealt to 71e51e91 
Dealt to Hero [3s 8d]
Dealt to e5e26648 
Dealt to 35f19e9f 
Hero: folds
e5e26648: raises $0.15 to $0.25
35f19e9f: folds
7c891321: folds
99d264c4: folds
71e51e91: folds
Uncalled bet ($0.15) returned to e5e26648
*** SHOWDOWN ***
e5e26648 collected $0.25 from pot
*** SUMMARY ***
Total pot $0.25 | Rake $0 | Jackpot $0 | Bingo $0 | Fortune $0 | Tax $0
Seat 1: 7c891321 (button) folded before Flop (didn't bet)
Seat 2: 99d264c4 (small blind) folded before Flop
Seat 3: 71e51e91 (big blind) folded before Flop
Seat 4: Hero folded before Flop (didn't bet)
Seat 5: e5e26648 collected ($0.25)
Seat 6: 35f19e9f folded before Flop (didn't bet)


Poker Hand #RC2774720107: Hold'em No Limit ($0.05/$0.1) - 2024/08/05 12:35:23
Table 'RushAndCash21385367' 6-max Seat #1 is the button
Seat 1: Hero ($12.39 in chips)
Seat 2: 21675255 ($25.32 in chips)
Seat 3: 6def5588 ($16.4 in chips)
Seat 4: c1047659 ($15.99 in chips)
Seat 5: 62e3d632 ($10 in chips)
Seat 6: d3ade9fc ($24.36 in chips)
21675255: posts small blind $0.05
6def5588: posts big blind $0.1
*** HOLE CARDS ***
Dealt to Hero [4s 2h]
Dealt to 21675255 
Dealt to 6def5588 
Dealt to c1047659 
Dealt to 62e3d632 
Dealt to d3ade9fc 
c1047659: folds
62e3d632: folds
d3ade9fc: raises $0.1 to $0.2
Hero: folds
21675255: folds
6def5588: folds
Uncalled bet ($0.1) returned to d3ade9fc
*** SHOWDOWN ***
d3ade9fc collected $0.25 from pot
*** SUMMARY ***
Total pot $0.25 | Rake $0 | Jackpot $0 | Bingo $0 | Fortune $0 | Tax $0
Seat 1: Hero (button) folded before Flop (didn't bet)
Seat 2: 21675255 (small blind) folded before Flop
Seat 3: 6def5588 (big blind) folded before Flop
Seat 4: c1047659 folded before Flop (didn't bet)
Seat 5: 62e3d632 folded before Flop (didn't bet)
Seat 6: d3ade9fc collected ($0.25)


Poker Hand #RC2774720019: Hold'em No Limit ($0.05/$0.1) - 2024/08/05 12:35:12
Table 'RushAndCash21385279' 6-max Seat #1 is the button
Seat 1: 24b8b991 ($8.19 in chips)
Seat 2: Hero ($12.44 in chips)
Seat 3: 80fa0469 ($11.13 in chips)
Seat 4: 7c891321 ($16.19 in chips)
Seat 5: cbd807c5 ($15.21 in chips)
Seat 6: 57b870a9 ($10.6 in chips)
Hero: posts small blind $0.05
80fa0469: posts big blind $0.1
*** HOLE CARDS ***
Dealt to 24b8b991 
Dealt to Hero [7h Jh]
Dealt to 80fa0469 
Dealt to 7c891321 
Dealt to cbd807c5 
Dealt to 57b870a9 
7c891321: folds
cbd807c5: raises $0.15 to $0.25
57b870a9: folds
24b8b991: folds
Hero: folds
80fa0469: calls $0.15
*** FLOP *** [2s 4c 5d]
80fa0469: checks
cbd807c5: bets $0.2
80fa0469: folds
Uncalled bet ($0.2) returned to cbd807c5
*** SHOWDOWN ***
cbd807c5 collected $0.53 from pot
*** SUMMARY ***
Total pot $0.55 | Rake $0.02 | Jackpot $0 | Bingo $0 | Fortune $0 | Tax $0
Board [2s 4c 5d]
Seat 1: 24b8b991 (button) folded before Flop (didn't bet)
Seat 2: Hero (small blind) folded before Flop
Seat 3: 80fa0469 (big blind) folded on the Flop
Seat 4: 7c891321 folded before Flop (didn't bet)
Seat 5: cbd807c5 won ($0.53)
Seat 6: 57b870a9 folded before Flop (didn't bet)


Poker Hand #RC2774719973: Hold'em No Limit ($0.05/$0.1) - 2024/08/05 12:35:07
Table 'RushAndCash21385233' 6-max Seat #1 is the button
Seat 1: 76b2da90 ($11.88 in chips)
Seat 2: 63c60428 ($6.69 in chips)
Seat 3: Hero ($12.54 in chips)
Seat 4: 5d265da3 ($10 in chips)
Seat 5: 9d82a043 ($7.89 in chips)
Seat 6: 9b026fca ($13.15 in chips)
63c60428: posts small blind $0.05
Hero: posts big blind $0.1
*** HOLE CARDS ***
Dealt to 76b2da90 
Dealt to 63c60428 
Dealt to Hero [Ad 7s]
Dealt to 5d265da3 
Dealt to 9d82a043 
Dealt to 9b026fca 
5d265da3: folds
9d82a043: folds
9b026fca: raises $0.15 to $0.25
76b2da90: folds
63c60428: folds
Hero: folds
Uncalled bet ($0.15) returned to 9b026fca
*** SHOWDOWN ***
9b026fca collected $0.25 from pot
*** SUMMARY ***
Total pot $0.25 | Rake $0 | Jackpot $0 | Bingo $0 | Fortune $0 | Tax $0
Seat 1: 76b2da90 (button) folded before Flop (didn't bet)
Seat 2: 63c60428 (small blind) folded before Flop
Seat 3: Hero (big blind) folded before Flop
Seat 4: 5d265da3 folded before Flop (didn't bet)
Seat 5: 9d82a043 folded before Flop (didn't bet)
Seat 6: 9b026fca collected ($0.25)


Poker Hand #RC2774719922: Hold'em No Limit ($0.05/$0.1) - 2024/08/05 12:35:00
Table 'RushAndCash21385182' 6-max Seat #1 is the button
Seat 1: b958f85c ($10.67 in chips)
Seat 2: 6c735362 ($9.12 in chips)
Seat 3: cbf26d60 ($20.33 in chips)
Seat 4: Hero ($12.54 in chips)
Seat 5: 98056f4c ($10.28 in chips)
Seat 6: 3fe53689 ($11.33 in chips)
6c735362: posts small blind $0.05
cbf26d60: posts big blind $0.1
*** HOLE CARDS ***
Dealt to b958f85c 
Dealt to 6c735362 
Dealt to cbf26d60 
Dealt to Hero [Kh Td]
Dealt to 98056f4c 
Dealt to 3fe53689 
Hero: folds
98056f4c: folds
3fe53689: folds
b958f85c: raises $0.13 to $0.23
6c735362: folds
cbf26d60: raises $0.67 to $0.9
b958f85c: raises $1.63 to $2.53
cbf26d60: calls $1.63
*** FLOP *** [6c 7d 3d]
cbf26d60: checks
b958f85c: bets $1.13
cbf26d60: calls $1.13
*** TURN *** [6c 7d 3d] [2c]
cbf26d60: checks
b958f85c: bets $7.01 and is all-in
cbf26d60: calls $7.01
b958f85c: shows [Kd Ad] (Ace-High)
cbf26d60: shows [Ac Kc] (Ace-High)
*** RIVER *** [6c 7d 3d 2c] [2h]
*** SHOWDOWN ***
cbf26d60 collected $10.47 from pot
b958f85c collected $10.47 from pot
*** SUMMARY ***
Total pot $21.39 | Rake $0.3 | Jackpot $0.15 | Bingo $0 | Fortune $0 | Tax $0
Board [6c 7d 3d 2c 2h]
Seat 1: b958f85c (button) showed [Kd Ad] and won ($10.47) with Pair of Twos
Seat 2: 6c735362 (small blind) folded before Flop
Seat 3: cbf26d60 (big blind) showed [Ac Kc] and won ($10.47) with Pair of Twos
Seat 4: Hero folded before Flop (didn't bet)
Seat 5: 98056f4c folded before Flop (didn't bet)
Seat 6: 3fe53689 folded before Flop (didn't bet)


Poker Hand #RC2774719773: Hold'em No Limit ($0.05/$0.1) - 2024/08/05 12:34:43
Table 'RushAndCash21385033' 6-max Seat #1 is the button
Seat 1: 439eb5aa ($4.07 in chips)
Seat 2: e25d0386 ($10 in chips)
Seat 3: d68693bc ($10.95 in chips)
Seat 4: e33eca0 ($10.72 in chips)
Seat 5: Hero ($12.21 in chips)
Seat 6: 27ac90be ($31.99 in chips)
e25d0386: posts small blind $0.05
d68693bc: posts big blind $0.1
*** HOLE CARDS ***
Dealt to 439eb5aa 
Dealt to e25d0386 
Dealt to d68693bc 
Dealt to e33eca0 
Dealt to Hero [Qs As]
Dealt to 27ac90be 
e33eca0: raises $0.1 to $0.2
Hero: raises $0.4 to $0.6
27ac90be: folds
439eb5aa: folds
e25d0386: folds
d68693bc: folds
e33eca0: folds
Uncalled bet ($0.4) returned to Hero
*** SHOWDOWN ***
Hero collected $0.53 from pot
*** SUMMARY ***
Total pot $0.55 | Rake $0.02 | Jackpot $0 | Bingo $0 | Fortune $0 | Tax $0
Seat 1: 439eb5aa (button) folded before Flop (didn't bet)
Seat 2: e25d0386 (small blind) folded before Flop
Seat 3: d68693bc (big blind) folded before Flop
Seat 4: e33eca0 folded before Flop
Seat 5: Hero collected ($0.53)
Seat 6: 27ac90be folded before Flop (didn't bet)


Poker Hand #RC2774719737: Hold'em No Limit ($0.05/$0.1) - 2024/08/05 12:34:38
Table 'RushAndCash21384997' 6-max Seat #1 is the button
Seat 1: ed41ea81 ($11.41 in chips)
Seat 2: f43bbc07 ($10.79 in chips)
Seat 3: 7f874253 ($15.5 in chips)
Seat 4: f6dba5f1 ($16.32 in chips)
Seat 5: Hero ($12.21 in chips)
Seat 6: e49005b6 ($10.1 in chips)
f43bbc07: posts small blind $0.05
7f874253: posts big blind $0.1
*** HOLE CARDS ***
Dealt to ed41ea81 
Dealt to f43bbc07 
Dealt to 7f874253 
Dealt to f6dba5f1 
Dealt to Hero [5s Ad]
Dealt to e49005b6 
f6dba5f1: folds
Hero: folds
e49005b6: folds
ed41ea81: folds
f43bbc07: folds
Uncalled bet ($0.05) returned to 7f874253
*** SHOWDOWN ***
7f874253 collected $0.1 from pot
*** SUMMARY ***
Total pot $0.1 | Rake $0 | Jackpot $0 | Bingo $0 | Fortune $0 | Tax $0
Seat 1: ed41ea81 (button) folded before Flop (didn't bet)
Seat 2: f43bbc07 (small blind) folded before Flop
Seat 3: 7f874253 (big blind) collected ($0.1)
Seat 4: f6dba5f1 folded before Flop (didn't bet)
Seat 5: Hero folded before Flop (didn't bet)
Seat 6: e49005b6 folded before Flop (didn't bet)


Poker Hand #RC2774719641: Hold'em No Limit ($0.05/$0.1) - 2024/08/05 12:34:25
Table 'RushAndCash21384901' 6-max Seat #1 is the button
Seat 1: e56eab42 ($15.59 in chips)
Seat 2: Hero ($12.26 in chips)
Seat 3: 27c7b1c ($12.96 in chips)
Seat 4: 527de330 ($18.92 in chips)
Seat 5: 2087d64 ($10.08 in chips)
Seat 6: 630edda2 ($4.91 in chips)
Hero: posts small blind $0.05
27c7b1c: posts big blind $0.1
*** HOLE CARDS ***
Dealt to e56eab42 
Dealt to Hero [8s Ts]
Dealt to 27c7b1c 
Dealt to 527de330 
Dealt to 2087d64 
Dealt to 630edda2 
527de330: folds
2087d64: folds
630edda2: raises $0.13 to $0.23
e56eab42: folds
Hero: folds
27c7b1c: folds
Uncalled bet ($0.13) returned to 630edda2
*** SHOWDOWN ***
630edda2 collected $0.25 from pot
*** SUMMARY ***
Total pot $0.25 | Rake $0 | Jackpot $0 | Bingo $0 | Fortune $0 | Tax $0
Seat 1: e56eab42 (button) folded before Flop (didn't bet)
Seat 2: Hero (small blind) folded before Flop
Seat 3: 27c7b1c (big blind) folded before Flop
Seat 4: 527de330 folded before Flop (didn't bet)
Seat 5: 2087d64 folded before Flop (didn't bet)
Seat 6: 630edda2 collected ($0.25)


Poker Hand #RC2774719542: Hold'em No Limit ($0.05/$0.1) - 2024/08/05 12:34:13
Table 'RushAndCash21384802' 6-max Seat #1 is the button
Seat 1: 9886bba4 ($11.19 in chips)
Seat 2: eca0bbe7 ($3.66 in chips)
Seat 3: Hero ($12.36 in chips)
Seat 4: 220b27f4 ($17.16 in chips)
Seat 5: 64703012 ($14.4 in chips)
Seat 6: 98610389 ($10.36 in chips)
eca0bbe7: posts small blind $0.05
Hero: posts big blind $0.1
*** HOLE CARDS ***
Dealt to 9886bba4 
Dealt to eca0bbe7 
Dealt to Hero [Jc 9s]
Dealt to 220b27f4 
Dealt to 64703012 
Dealt to 98610389 
220b27f4: folds
64703012: folds
98610389: folds
9886bba4: raises $0.16 to $0.26
eca0bbe7: folds
Hero: folds
Uncalled bet ($0.16) returned to 9886bba4
*** SHOWDOWN ***
9886bba4 collected $0.25 from pot
*** SUMMARY ***
Total pot $0.25 | Rake $0 | Jackpot $0 | Bingo $0 | Fortune $0 | Tax $0
Seat 1: 9886bba4 (button) collected ($0.25)
Seat 2: eca0bbe7 (small blind) folded before Flop
Seat 3: Hero (big blind) folded before Flop
Seat 4: 220b27f4 folded before Flop (didn't bet)
Seat 5: 64703012 folded before Flop (didn't bet)
Seat 6: 98610389 folded before Flop (didn't bet)


Poker Hand #RC2774719513: Hold'em No Limit ($0.05/$0.1) - 2024/08/05 12:34:09
Table 'RushAndCash21384773' 6-max Seat #1 is the button
Seat 1: a568b35d ($10.59 in chips)
Seat 2: 8f370fad ($11.54 in chips)
Seat 3: 77599916 ($23.9 in chips)
Seat 4: Hero ($12.36 in chips)
Seat 5: 35351de3 ($10.65 in chips)
Seat 6: f058296c ($8.25 in chips)
8f370fad: posts small blind $0.05
77599916: posts big blind $0.1
*** HOLE CARDS ***
Dealt to a568b35d 
Dealt to 8f370fad 
Dealt to 77599916 
Dealt to Hero [5c 6s]
Dealt to 35351de3 
Dealt to f058296c 
Hero: folds
35351de3: folds
f058296c: folds
a568b35d: raises $0.12 to $0.22
8f370fad: folds
77599916: folds
Uncalled bet ($0.12) returned to a568b35d
*** SHOWDOWN ***
a568b35d collected $0.25 from pot
*** SUMMARY ***
Total pot $0.25 | Rake $0 | Jackpot $0 | Bingo $0 | Fortune $0 | Tax $0
Seat 1: a568b35d (button) collected ($0.25)
Seat 2: 8f370fad (small blind) folded before Flop
Seat 3: 77599916 (big blind) folded before Flop
Seat 4: Hero folded before Flop (didn't bet)
Seat 5: 35351de3 folded before Flop (didn't bet)
Seat 6: f058296c folded before Flop (didn't bet)


Poker Hand #RC2774719486: Hold'em No Limit ($0.05/$0.1) - 2024/08/05 12:34:06
Table 'RushAndCash21384746' 6-max Seat #1 is the button
Seat 1: Hero ($12.36 in chips)
Seat 2: 4f612bdf ($10 in chips)
Seat 3: 3d571954 ($28.67 in chips)
Seat 4: 90577903 ($10 in chips)
Seat 5: 6e30e639 ($12.49 in chips)
Seat 6: 8f370fad ($11.54 in chips)
4f612bdf: posts small blind $0.05
3d571954: posts big blind $0.1
*** HOLE CARDS ***
Dealt to Hero [6d 8c]
Dealt to 4f612bdf 
Dealt to 3d571954 
Dealt to 90577903 
Dealt to 6e30e639 
Dealt to 8f370fad 
90577903: folds
6e30e639: folds
8f370fad: folds
Hero: folds
4f612bdf: raises $0.2 to $0.3
3d571954: calls $0.2
*** FLOP *** [9c Kc Jc]
4f612bdf: bets $0.2
3d571954: calls $0.2
*** TURN *** [9c Kc Jc] [6h]
4f612bdf: checks
3d571954: checks
*** RIVER *** [9c Kc Jc 6h] [Js]
4f612bdf: checks
3d571954: checks
4f612bdf: shows [2h 2s] (Pair of Jacks and Pair of Twos)
3d571954: shows [6c 7d] (Pair of Jacks and Pair of Sixes)
*** SHOWDOWN ***
3d571954 collected $0.95 from pot
*** SUMMARY ***
Total pot $1 | Rake $0.05 | Jackpot $0 | Bingo $0 | Fortune $0 | Tax $0
Board [9c Kc Jc 6h Js]
Seat 1: Hero (button) folded before Flop (didn't bet)
Seat 2: 4f612bdf (small blind) showed [2h 2s] and lost with Pair of Jacks and Pair of Twos
Seat 3: 3d571954 (big blind) showed [6c 7d] and won ($0.95) with Pair of Jacks and Pair of Sixes
Seat 4: 90577903 folded before Flop (didn't bet)
Seat 5: 6e30e639 folded before Flop (didn't bet)
Seat 6: 8f370fad folded before Flop (didn't bet)


Poker Hand #RC2774719461: Hold'em No Limit ($0.05/$0.1) - 2024/08/05 12:34:03
Table 'RushAndCash21384721' 6-max Seat #1 is the button
Seat 1: ec055f5c ($10.28 in chips)
Seat 2: 36112634 ($11.49 in chips)
Seat 3: 3f3545f ($10.74 in chips)
Seat 4: Hero ($12.36 in chips)
Seat 5: d88fba59 ($10.4 in chips)
Seat 6: b30e0cdc ($15.54 in chips)
36112634: posts small blind $0.05
3f3545f: posts big blind $0.1
*** HOLE CARDS ***
Dealt to ec055f5c 
Dealt to 36112634 
Dealt to 3f3545f 
Dealt to Hero [9d Ts]
Dealt to d88fba59 
Dealt to b30e0cdc 
Hero: folds
d88fba59: raises $0.1 to $0.2
b30e0cdc: folds
ec055f5c: folds
36112634: folds
3f3545f: folds
Uncalled bet ($0.1) returned to d88fba59
*** SHOWDOWN ***
d88fba59 collected $0.25 from pot
*** SUMMARY ***
Total pot $0.25 | Rake $0 | Jackpot $0 | Bingo $0 | Fortune $0 | Tax $0
Seat 1: ec055f5c (button) folded before Flop (didn't bet)
Seat 2: 36112634 (small blind) folded before Flop
Seat 3: 3f3545f (big blind) folded before Flop
Seat 4: Hero folded before Flop (didn't bet)
Seat 5: d88fba59 collected ($0.25)
Seat 6: b30e0cdc folded before Flop (didn't bet)


Poker Hand #RC2774719432: Hold'em No Limit ($0.05/$0.1) - 2024/08/05 12:33:59
Table 'RushAndCash21384692' 6-max Seat #1 is the button
Seat 1: bdadd860 ($23.2 in chips)
Seat 2: Hero ($12.41 in chips)
Seat 3: 7892dac4 ($20.6 in chips)
Seat 4: 2ec87d42 ($10 in chips)
Seat 5: 3d337591 ($15.09 in chips)
Seat 6: 3f3545f ($10.74 in chips)
Hero: posts small blind $0.05
7892dac4: posts big blind $0.1
*** HOLE CARDS ***
Dealt to bdadd860 
Dealt to Hero [8h 3d]
Dealt to 7892dac4 
Dealt to 2ec87d42 
Dealt to 3d337591 
Dealt to 3f3545f 
2ec87d42: folds
3d337591: folds
3f3545f: folds
bdadd860: folds
Hero: folds
Uncalled bet ($0.05) returned to 7892dac4
*** SHOWDOWN ***
7892dac4 collected $0.1 from pot
*** SUMMARY ***
Total pot $0.1 | Rake $0 | Jackpot $0 | Bingo $0 | Fortune $0 | Tax $0
Seat 1: bdadd860 (button) folded before Flop (didn't bet)
Seat 2: Hero (small blind) folded before Flop
Seat 3: 7892dac4 (big blind) collected ($0.1)
Seat 4: 2ec87d42 folded before Flop (didn't bet)
Seat 5: 3d337591 folded before Flop (didn't bet)
Seat 6: 3f3545f folded before Flop (didn't bet)


Poker Hand #RC2774719146: Hold'em No Limit ($0.05/$0.1) - 2024/08/05 12:33:21
Table 'RushAndCash21384406' 6-max Seat #1 is the button
Seat 1: Hero ($12.37 in chips)
Seat 2: 9d82a043 ($7.9 in chips)
Seat 3: 833c8c91 ($18.93 in chips)
Seat 4: 99e13528 ($10.15 in chips)
Seat 5: b10aee13 ($11.5 in chips)
Seat 6: 1f7acbae ($10 in chips)
9d82a043: posts small blind $0.05
833c8c91: posts big blind $0.1
*** HOLE CARDS ***
Dealt to Hero [5d 5h]
Dealt to 9d82a043 
Dealt to 833c8c91 
Dealt to 99e13528 
Dealt to b10aee13 
Dealt to 1f7acbae 
99e13528: folds
b10aee13: folds
1f7acbae: folds
Hero: raises $0.14 to $0.24
9d82a043: calls $0.19
833c8c91: folds
*** FLOP *** [Tc Js 8d]
9d82a043: checks
Hero: checks
*** TURN *** [Tc Js 8d] [3h]
9d82a043: checks
Hero: checks
*** RIVER *** [Tc Js 8d 3h] [6c]
9d82a043: checks
Hero: checks
9d82a043: shows [5s 5c] (Pair of Fives)
Hero: shows [5d 5h] (Pair of Fives)
*** SHOWDOWN ***
9d82a043 collected $0.28 from pot
Hero collected $0.28 from pot
*** SUMMARY ***
Total pot $0.58 | Rake $0.02 | Jackpot $0 | Bingo $0 | Fortune $0 | Tax $0
Board [Tc Js 8d 3h 6c]
Seat 1: Hero (button) showed [5d 5h] and won ($0.28) with Pair of Fives
Seat 2: 9d82a043 (small blind) showed [5s 5c] and won ($0.28) with Pair of Fives
Seat 3: 833c8c91 (big blind) folded before Flop
Seat 4: 99e13528 folded before Flop (didn't bet)
Seat 5: b10aee13 folded before Flop (didn't bet)
Seat 6: 1f7acbae folded before Flop (didn't bet)


Poker Hand #RC2774719078: Hold'em No Limit ($0.05/$0.1) - 2024/08/05 12:33:13
Table 'RushAndCash21384338' 6-max Seat #1 is the button
Seat 1: d0b9c0d3 ($27.95 in chips)
Seat 2: 4186ebe3 ($13.45 in chips)
Seat 3: Hero ($12.32 in chips)
Seat 4: 6783a110 ($11.31 in chips)
Seat 5: f136f614 ($10.26 in chips)
Seat 6: f60c0f24 ($10 in chips)
4186ebe3: posts small blind $0.05
Hero: posts big blind $0.1
*** HOLE CARDS ***
Dealt to d0b9c0d3 
Dealt to 4186ebe3 
Dealt to Hero [Jc 5c]
Dealt to 6783a110 
Dealt to f136f614 
Dealt to f60c0f24 
6783a110: folds
f136f614: folds
f60c0f24: folds
d0b9c0d3: folds
4186ebe3: folds
Uncalled bet ($0.05) returned to Hero
*** SHOWDOWN ***
Hero collected $0.1 from pot
*** SUMMARY ***
Total pot $0.1 | Rake $0 | Jackpot $0 | Bingo $0 | Fortune $0 | Tax $0
Seat 1: d0b9c0d3 (button) folded before Flop (didn't bet)
Seat 2: 4186ebe3 (small blind) folded before Flop
Seat 3: Hero (big blind) collected ($0.1)
Seat 4: 6783a110 folded before Flop (didn't bet)
Seat 5: f136f614 folded before Flop (didn't bet)
Seat 6: f60c0f24 folded before Flop (didn't bet)


Poker Hand #RC2774718932: Hold'em No Limit ($0.05/$0.1) - 2024/08/05 12:32:54
Table 'RushAndCash21384192' 6-max Seat #1 is the button
Seat 1: adb0200e ($10.24 in chips)
Seat 2: b4219453 ($10.88 in chips)
Seat 3: 1fee764 ($11.42 in chips)
Seat 4: 9886bba4 ($11.34 in chips)
Seat 5: f8ded6e2 ($27.21 in chips)
Seat 6: Hero ($12.17 in chips)
b4219453: posts small blind $0.05
1fee764: posts big blind $0.1
*** HOLE CARDS ***
Dealt to adb0200e 
Dealt to b4219453 
Dealt to 1fee764 
Dealt to 9886bba4 
Dealt to f8ded6e2 
Dealt to Hero [Tc Qh]
9886bba4: folds
f8ded6e2: folds
Hero: raises $0.14 to $0.24
adb0200e: folds
b4219453: folds
1fee764: folds
Uncalled bet ($0.14) returned to Hero
*** SHOWDOWN ***
Hero collected $0.25 from pot
*** SUMMARY ***
Total pot $0.25 | Rake $0 | Jackpot $0 | Bingo $0 | Fortune $0 | Tax $0
Seat 1: adb0200e (button) folded before Flop (didn't bet)
Seat 2: b4219453 (small blind) folded before Flop
Seat 3: 1fee764 (big blind) folded before Flop
Seat 4: 9886bba4 folded before Flop (didn't bet)
Seat 5: f8ded6e2 folded before Flop (didn't bet)
Seat 6: Hero collected ($0.25)


Poker Hand #RC2774718551: Hold'em No Limit ($0.05/$0.1) - 2024/08/05 12:32:03
Table 'RushAndCash21383811' 6-max Seat #1 is the button
Seat 1: 59d37d9f ($24.26 in chips)
Seat 2: adb0200e ($10.44 in chips)
Seat 3: 672645ab ($6.54 in chips)
Seat 4: a41a5c6e ($10.25 in chips)
Seat 5: Hero ($11.7 in chips)
Seat 6: f3b4cb31 ($10.18 in chips)
adb0200e: posts small blind $0.05
672645ab: posts big blind $0.1
*** HOLE CARDS ***
Dealt to 59d37d9f 
Dealt to adb0200e 
Dealt to 672645ab 
Dealt to a41a5c6e 
Dealt to Hero [Ts Tc]
Dealt to f3b4cb31 
a41a5c6e: folds
Hero: raises $0.1 to $0.2
f3b4cb31: calls $0.2
59d37d9f: folds
adb0200e: calls $0.15
672645ab: folds
*** FLOP *** [Jc 8h 2d]
adb0200e: checks
Hero: checks
f3b4cb31: checks
*** TURN *** [Jc 8h 2d] [7c]
adb0200e: checks
Hero: bets $0.24
f3b4cb31: folds
adb0200e: folds
Uncalled bet ($0.24) returned to Hero
*** SHOWDOWN ***
Hero collected $0.67 from pot
*** SUMMARY ***
Total pot $0.7 | Rake $0.03 | Jackpot $0 | Bingo $0 | Fortune $0 | Tax $0
Board [Jc 8h 2d 7c]
Seat 1: 59d37d9f (button) folded before Flop (didn't bet)
Seat 2: adb0200e (small blind) folded on the Turn
Seat 3: 672645ab (big blind) folded before Flop
Seat 4: a41a5c6e folded before Flop (didn't bet)
Seat 5: Hero won ($0.67)
Seat 6: f3b4cb31 folded on the Turn


Poker Hand #RC2774718526: Hold'em No Limit ($0.05/$0.1) - 2024/08/05 12:32:00
Table 'RushAndCash21383786' 6-max Seat #1 is the button
Seat 1: d26f83cb ($11.03 in chips)
Seat 2: 8b8c29f1 ($17.57 in chips)
Seat 3: 9f86428c ($10 in chips)
Seat 4: Hero ($11.7 in chips)
Seat 5: cbf26d60 ($14.15 in chips)
Seat 6: 7ace1cc0 ($16.92 in chips)
8b8c29f1: posts small blind $0.05
9f86428c: posts big blind $0.1
*** HOLE CARDS ***
Dealt to d26f83cb 
Dealt to 8b8c29f1 
Dealt to 9f86428c 
Dealt to Hero [8d 5d]
Dealt to cbf26d60 
Dealt to 7ace1cc0 
Hero: folds
cbf26d60: raises $0.15 to $0.25
7ace1cc0: folds
d26f83cb: raises $0.51 to $0.76
8b8c29f1: folds
9f86428c: folds
cbf26d60: raises $1.26 to $2.02
d26f83cb: calls $1.26
*** FLOP *** [7c Td 3s]
cbf26d60: bets $2.1
d26f83cb: folds
Uncalled bet ($2.1) returned to cbf26d60
*** SHOWDOWN ***
cbf26d60 collected $3.84 from pot
*** SUMMARY ***
Total pot $4.19 | Rake $0.2 | Jackpot $0.15 | Bingo $0 | Fortune $0 | Tax $0
Board [7c Td 3s]
Seat 1: d26f83cb (button) folded on the Flop
Seat 2: 8b8c29f1 (small blind) folded before Flop
Seat 3: 9f86428c (big blind) folded before Flop
Seat 4: Hero folded before Flop (didn't bet)
Seat 5: cbf26d60 won ($3.84)
Seat 6: 7ace1cc0 folded before Flop (didn't bet)


Poker Hand #RC2774718237: Hold'em No Limit ($0.05/$0.1) - 2024/08/05 12:31:26
Table 'RushAndCash21383497' 6-max Seat #1 is the button
Seat 1: e39f69b1 ($13.99 in chips)
Seat 2: d26f83cb ($10.71 in chips)
Seat 3: bec0764 ($16.93 in chips)
Seat 4: f8e4d6fa ($16.89 in chips)
Seat 5: fb600294 ($15.51 in chips)
Seat 6: Hero ($11.94 in chips)
d26f83cb: posts small blind $0.05
bec0764: posts big blind $0.1
*** HOLE CARDS ***
Dealt to e39f69b1 
Dealt to d26f83cb 
Dealt to bec0764 
Dealt to f8e4d6fa 
Dealt to fb600294 
Dealt to Hero [Th Qh]
f8e4d6fa: folds
fb600294: folds
Hero: raises $0.14 to $0.24
e39f69b1: folds
d26f83cb: raises $0.86 to $1.1
bec0764: folds
Hero: folds
Uncalled bet ($0.86) returned to d26f83cb
*** SHOWDOWN ***
d26f83cb collected $0.56 from pot
*** SUMMARY ***
Total pot $0.58 | Rake $0.02 | Jackpot $0 | Bingo $0 | Fortune $0 | Tax $0
Seat 1: e39f69b1 (button) folded before Flop (didn't bet)
Seat 2: d26f83cb (small blind) collected ($0.56)
Seat 3: bec0764 (big blind) folded before Flop
Seat 4: f8e4d6fa folded before Flop (didn't bet)
Seat 5: fb600294 folded before Flop (didn't bet)
Seat 6: Hero folded before Flop


Poker Hand #RC2774718154: Hold'em No Limit ($0.05/$0.1) - 2024/08/05 12:31:15
Table 'RushAndCash21383414' 6-max Seat #1 is the button
Seat 1: Hero ($11.79 in chips)
Seat 2: a3338cf7 ($19.15 in chips)
Seat 3: 8cf8d6a1 ($35.89 in chips)
Seat 4: 13a5a153 ($12.94 in chips)
Seat 5: 130045e8 ($12 in chips)
Seat 6: ffcb4e75 ($7.14 in chips)
a3338cf7: posts small blind $0.05
8cf8d6a1: posts big blind $0.1
*** HOLE CARDS ***
Dealt to Hero [Qs Js]
Dealt to a3338cf7 
Dealt to 8cf8d6a1 
Dealt to 13a5a153 
Dealt to 130045e8 
Dealt to ffcb4e75 
13a5a153: folds
130045e8: folds
ffcb4e75: folds
Hero: raises $0.14 to $0.24
a3338cf7: folds
8cf8d6a1: folds
Uncalled bet ($0.14) returned to Hero
*** SHOWDOWN ***
Hero collected $0.25 from pot
*** SUMMARY ***
Total pot $0.25 | Rake $0 | Jackpot $0 | Bingo $0 | Fortune $0 | Tax $0
Seat 1: Hero (button) collected ($0.25)
Seat 2: a3338cf7 (small blind) folded before Flop
Seat 3: 8cf8d6a1 (big blind) folded before Flop
Seat 4: 13a5a153 folded before Flop (didn't bet)
Seat 5: 130045e8 folded before Flop (didn't bet)
Seat 6: ffcb4e75 folded before Flop (didn't bet)


Poker Hand #RC2774718123: Hold'em No Limit ($0.05/$0.1) - 2024/08/05 12:31:11
Table 'RushAndCash21383383' 6-max Seat #1 is the button
Seat 1: 35f19e9f ($10.3 in chips)
Seat 2: Hero ($11.84 in chips)
Seat 3: efe5e7f7 ($10.24 in chips)
Seat 4: 67ddcdcd ($18.32 in chips)
Seat 5: 3f3545f ($10.15 in chips)
Seat 6: b407a400 ($10.47 in chips)
Hero: posts small blind $0.05
efe5e7f7: posts big blind $0.1
*** HOLE CARDS ***
Dealt to 35f19e9f 
Dealt to Hero [4d 8h]
Dealt to efe5e7f7 
Dealt to 67ddcdcd 
Dealt to 3f3545f 
Dealt to b407a400 
67ddcdcd: folds
3f3545f: folds
b407a400: folds
35f19e9f: raises $0.12 to $0.22
Hero: folds
efe5e7f7: folds
Uncalled bet ($0.12) returned to 35f19e9f
*** SHOWDOWN ***
35f19e9f collected $0.25 from pot
*** SUMMARY ***
Total pot $0.25 | Rake $0 | Jackpot $0 | Bingo $0 | Fortune $0 | Tax $0
Seat 1: 35f19e9f (button) collected ($0.25)
Seat 2: Hero (small blind) folded before Flop
Seat 3: efe5e7f7 (big blind) folded before Flop
Seat 4: 67ddcdcd folded before Flop (didn't bet)
Seat 5: 3f3545f folded before Flop (didn't bet)
Seat 6: b407a400 folded before Flop (didn't bet)


Poker Hand #RC2774718080: Hold'em No Limit ($0.05/$0.1) - 2024/08/05 12:31:06
Table 'RushAndCash21383340' 6-max Seat #1 is the button
Seat 1: 35351de3 ($11.07 in chips)
Seat 2: be353c45 ($10 in chips)
Seat 3: Hero ($11.94 in chips)
Seat 4: 3216df9a ($10.51 in chips)
Seat 5: 833c8c91 ($19.38 in chips)
Seat 6: eace9db7 ($12.8 in chips)
be353c45: posts small blind $0.05
Hero: posts big blind $0.1
*** HOLE CARDS ***
Dealt to 35351de3 
Dealt to be353c45 
Dealt to Hero [3s Qh]
Dealt to 3216df9a 
Dealt to 833c8c91 
Dealt to eace9db7 
3216df9a: folds
833c8c91: folds
eace9db7: raises $0.2 to $0.3
35351de3: folds
be353c45: folds
Hero: folds
Uncalled bet ($0.2) returned to eace9db7
*** SHOWDOWN ***
eace9db7 collected $0.25 from pot
*** SUMMARY ***
Total pot $0.25 | Rake $0 | Jackpot $0 | Bingo $0 | Fortune $0 | Tax $0
Seat 1: 35351de3 (button) folded before Flop (didn't bet)
Seat 2: be353c45 (small blind) folded before Flop
Seat 3: Hero (big blind) folded before Flop
Seat 4: 3216df9a folded before Flop (didn't bet)
Seat 5: 833c8c91 folded before Flop (didn't bet)
Seat 6: eace9db7 collected ($0.25)


Poker Hand #RC2774718039: Hold'em No Limit ($0.05/$0.1) - 2024/08/05 12:31:01
Table 'RushAndCash21383299' 6-max Seat #1 is the button
Seat 1: cdc72cef ($13.62 in chips)
Seat 2: 35672bc8 ($11.76 in chips)
Seat 3: 7ace1cc0 ($17.37 in chips)
Seat 4: Hero ($11.94 in chips)
Seat 5: 37d34c03 ($11.28 in chips)
Seat 6: a5c40612 ($11.43 in chips)
35672bc8: posts small blind $0.05
7ace1cc0: posts big blind $0.1
*** HOLE CARDS ***
Dealt to cdc72cef 
Dealt to 35672bc8 
Dealt to 7ace1cc0 
Dealt to Hero [2s 2h]
Dealt to 37d34c03 
Dealt to a5c40612 
Hero: folds
37d34c03: raises $0.14 to $0.24
a5c40612: raises $0.51 to $0.75
cdc72cef: folds
35672bc8: folds
7ace1cc0: folds
37d34c03: folds
Uncalled bet ($0.51) returned to a5c40612
*** SHOWDOWN ***
a5c40612 collected $0.6 from pot
*** SUMMARY ***
Total pot $0.63 | Rake $0.03 | Jackpot $0 | Bingo $0 | Fortune $0 | Tax $0
Seat 1: cdc72cef (button) folded before Flop (didn't bet)
Seat 2: 35672bc8 (small blind) folded before Flop
Seat 3: 7ace1cc0 (big blind) folded before Flop
Seat 4: Hero folded before Flop (didn't bet)
Seat 5: 37d34c03 folded before Flop
Seat 6: a5c40612 collected ($0.6)


Poker Hand #RC2774718010: Hold'em No Limit ($0.05/$0.1) - 2024/08/05 12:30:57
Table 'RushAndCash21383270' 6-max Seat #1 is the button
Seat 1: 2f0a1775 ($13.51 in chips)
Seat 2: 2a3d5d7e ($10 in chips)
Seat 3: cc0546d8 ($16.56 in chips)
Seat 4: 7c891321 ($18.29 in chips)
Seat 5: Hero ($11.94 in chips)
Seat 6: 87d59ce6 ($11.63 in chips)
2a3d5d7e: posts small blind $0.05
cc0546d8: posts big blind $0.1
*** HOLE CARDS ***
Dealt to 2f0a1775 
Dealt to 2a3d5d7e 
Dealt to cc0546d8 
Dealt to 7c891321 
Dealt to Hero [3s 3d]
Dealt to 87d59ce6 
7c891321: folds
Hero: folds
87d59ce6: folds
2f0a1775: raises $0.1 to $0.2
2a3d5d7e: calls $0.15
cc0546d8: calls $0.1
*** FLOP *** [2s Qh 9s]
2a3d5d7e: checks
cc0546d8: checks
2f0a1775: checks
*** TURN *** [2s Qh 9s] [9d]
2a3d5d7e: bets $0.4
cc0546d8: raises $1.2 to $1.6
2f0a1775: folds
2a3d5d7e: folds
Uncalled bet ($1.2) returned to cc0546d8
*** SHOWDOWN ***
cc0546d8 collected $1.33 from pot
*** SUMMARY ***
Total pot $1.4 | Rake $0.07 | Jackpot $0 | Bingo $0 | Fortune $0 | Tax $0
Board [2s Qh 9s 9d]
Seat 1: 2f0a1775 (button) folded on the Turn
Seat 2: 2a3d5d7e (small blind) folded on the Turn
Seat 3: cc0546d8 (big blind) won ($1.33)
Seat 4: 7c891321 folded before Flop (didn't bet)
Seat 5: Hero folded before Flop (didn't bet)
Seat 6: 87d59ce6 folded before Flop (didn't bet)


Poker Hand #RC2774717971: Hold'em No Limit ($0.05/$0.1) - 2024/08/05 12:30:53
Table 'RushAndCash21383231' 6-max Seat #1 is the button
Seat 1: 57a440e2 ($8.72 in chips)
Seat 2: 66e42f9c ($9.86 in chips)
Seat 3: ace4ff6e ($14.05 in chips)
Seat 4: Hero ($11.94 in chips)
Seat 5: 21eb9f5f ($11.45 in chips)
Seat 6: 1fea36ef ($13.68 in chips)
66e42f9c: posts small blind $0.05
ace4ff6e: posts big blind $0.1
*** HOLE CARDS ***
Dealt to 57a440e2 
Dealt to 66e42f9c 
Dealt to ace4ff6e 
Dealt to Hero [7h Tc]
Dealt to 21eb9f5f 
Dealt to 1fea36ef 
Hero: folds
21eb9f5f: folds
1fea36ef: folds
57a440e2: raises $0.1 to $0.2
66e42f9c: folds
ace4ff6e: folds
Uncalled bet ($0.1) returned to 57a440e2
*** SHOWDOWN ***
57a440e2 collected $0.25 from pot
*** SUMMARY ***
Total pot $0.25 | Rake $0 | Jackpot $0 | Bingo $0 | Fortune $0 | Tax $0
Seat 1: 57a440e2 (button) collected ($0.25)
Seat 2: 66e42f9c (small blind) folded before Flop
Seat 3: ace4ff6e (big blind) folded before Flop
Seat 4: Hero folded before Flop (didn't bet)
Seat 5: 21eb9f5f folded before Flop (didn't bet)
Seat 6: 1fea36ef folded before Flop (didn't bet)


Poker Hand #RC2774717888: Hold'em No Limit ($0.05/$0.1) - 2024/08/05 12:30:42
Table 'RushAndCash21383148' 6-max Seat #1 is the button
Seat 1: ef76fdc ($17.13 in chips)
Seat 2: Hero ($11.99 in chips)
Seat 3: 8669e249 ($25.18 in chips)
Seat 4: 4f612bdf ($10 in chips)
Seat 5: f38291df ($5.08 in chips)
Seat 6: f95ea52 ($11.23 in chips)
Hero: posts small blind $0.05
8669e249: posts big blind $0.1
*** HOLE CARDS ***
Dealt to ef76fdc 
Dealt to Hero [Qh Th]
Dealt to 8669e249 
Dealt to 4f612bdf 
Dealt to f38291df 
Dealt to f95ea52 
4f612bdf: folds
f38291df: folds
f95ea52: raises $0.15 to $0.25
ef76fdc: folds
Hero: folds
8669e249: folds
Uncalled bet ($0.15) returned to f95ea52
*** SHOWDOWN ***
f95ea52 collected $0.25 from pot
*** SUMMARY ***
Total pot $0.25 | Rake $0 | Jackpot $0 | Bingo $0 | Fortune $0 | Tax $0
Seat 1: ef76fdc (button) folded before Flop (didn't bet)
Seat 2: Hero (small blind) folded before Flop
Seat 3: 8669e249 (big blind) folded before Flop
Seat 4: 4f612bdf folded before Flop (didn't bet)
Seat 5: f38291df folded before Flop (didn't bet)
Seat 6: f95ea52 collected ($0.25)


Poker Hand #RC2774717863: Hold'em No Limit ($0.05/$0.1) - 2024/08/05 12:30:39
Table 'RushAndCash21383123' 6-max Seat #1 is the button
Seat 1: e9b8904b ($13.39 in chips)
Seat 2: 18e5d625 ($10.56 in chips)
Seat 3: Hero ($12.09 in chips)
Seat 4: 9e4d794f ($10 in chips)
Seat 5: 480cefc6 ($10.5 in chips)
Seat 6: bec0764 ($16.93 in chips)
18e5d625: posts small blind $0.05
Hero: posts big blind $0.1
*** HOLE CARDS ***
Dealt to e9b8904b 
Dealt to 18e5d625 
Dealt to Hero [7d Ts]
Dealt to 9e4d794f 
Dealt to 480cefc6 
Dealt to bec0764 
9e4d794f: folds
480cefc6: raises $0.2 to $0.3
bec0764: folds
e9b8904b: folds
18e5d625: raises $0.7 to $1
Hero: folds
480cefc6: calls $0.7
*** FLOP *** [2h 3c 3d]
18e5d625: bets $1.05
480cefc6: folds
Uncalled bet ($1.05) returned to 18e5d625
*** SHOWDOWN ***
18e5d625 collected $2 from pot
*** SUMMARY ***
Total pot $2.1 | Rake $0.1 | Jackpot $0 | Bingo $0 | Fortune $0 | Tax $0
Board [2h 3c 3d]
Seat 1: e9b8904b (button) folded before Flop (didn't bet)
Seat 2: 18e5d625 (small blind) won ($2)
Seat 3: Hero (big blind) folded before Flop
Seat 4: 9e4d794f folded before Flop (didn't bet)
Seat 5: 480cefc6 folded on the Flop
Seat 6: bec0764 folded before Flop (didn't bet)


Poker Hand #RC2774717823: Hold'em No Limit ($0.05/$0.1) - 2024/08/05 12:30:34
Table 'RushAndCash21383083' 6-max Seat #1 is the button
Seat 1: 118773cf ($5.23 in chips)
Seat 2: 468f433f ($23.98 in chips)
Seat 3: 3da388d0 ($10.25 in chips)
Seat 4: Hero ($12.09 in chips)
Seat 5: 64326c84 ($10.05 in chips)
Seat 6: 77b138d9 ($10.15 in chips)
468f433f: posts small blind $0.05
3da388d0: posts big blind $0.1
*** HOLE CARDS ***
Dealt to 118773cf 
Dealt to 468f433f 
Dealt to 3da388d0 
Dealt to Hero [Ah 6c]
Dealt to 64326c84 
Dealt to 77b138d9 
Hero: folds
64326c84: folds
77b138d9: raises $0.15 to $0.25
118773cf: folds
468f433f: folds
3da388d0: folds
Uncalled bet ($0.15) returned to 77b138d9
*** SHOWDOWN ***
77b138d9 collected $0.25 from pot
*** SUMMARY ***
Total pot $0.25 | Rake $0 | Jackpot $0 | Bingo $0 | Fortune $0 | Tax $0
Seat 1: 118773cf (button) folded before Flop (didn't bet)
Seat 2: 468f433f (small blind) folded before Flop
Seat 3: 3da388d0 (big blind) folded before Flop
Seat 4: Hero folded before Flop (didn't bet)
Seat 5: 64326c84 folded before Flop (didn't bet)
Seat 6: 77b138d9 collected ($0.25)


Poker Hand #RC2774717611: Hold'em No Limit ($0.05/$0.1) - 2024/08/05 12:30:09
Table 'RushAndCash21382871' 6-max Seat #1 is the button
Seat 1: Hero ($11.82 in chips)
Seat 2: 8aacf0e9 ($11.55 in chips)
Seat 3: ef025fda ($10.15 in chips)
Seat 4: 1fee764 ($12.07 in chips)
Seat 5: 8af1362 ($26.23 in chips)
Seat 6: c0c61c6e ($10.14 in chips)
8aacf0e9: posts small blind $0.05
ef025fda: posts big blind $0.1
*** HOLE CARDS ***
Dealt to Hero [6s Ks]
Dealt to 8aacf0e9 
Dealt to ef025fda 
Dealt to 1fee764 
Dealt to 8af1362 
Dealt to c0c61c6e 
1fee764: folds
8af1362: folds
c0c61c6e: folds
Hero: raises $0.14 to $0.24
8aacf0e9: folds
ef025fda: calls $0.14
*** FLOP *** [7h 3s As]
ef025fda: checks
Hero: bets $0.35
ef025fda: folds
Uncalled bet ($0.35) returned to Hero
*** SHOWDOWN ***
Hero collected $0.51 from pot
*** SUMMARY ***
Total pot $0.53 | Rake $0.02 | Jackpot $0 | Bingo $0 | Fortune $0 | Tax $0
Board [7h 3s As]
Seat 1: Hero (button) won ($0.51)
Seat 2: 8aacf0e9 (small blind) folded before Flop
Seat 3: ef025fda (big blind) folded on the Flop
Seat 4: 1fee764 folded before Flop (didn't bet)
Seat 5: 8af1362 folded before Flop (didn't bet)
Seat 6: c0c61c6e folded before Flop (didn't bet)


Poker Hand #RC2774717582: Hold'em No Limit ($0.05/$0.1) - 2024/08/05 12:30:05
Table 'RushAndCash21382842' 6-max Seat #1 is the button
Seat 1: 6b9d4393 ($18.16 in chips)
Seat 2: b8cbe754 ($33.79 in chips)
Seat 3: 860bc69a ($12.43 in chips)
Seat 4: 9b026fca ($10.47 in chips)
Seat 5: Hero ($11.82 in chips)
Seat 6: 64326c84 ($10.03 in chips)
b8cbe754: posts small blind $0.05
860bc69a: posts big blind $0.1
*** HOLE CARDS ***
Dealt to 6b9d4393 
Dealt to b8cbe754 
Dealt to 860bc69a 
Dealt to 9b026fca 
Dealt to Hero [5d Ks]
Dealt to 64326c84 
9b026fca: folds
Hero: folds
64326c84: folds
6b9d4393: folds
b8cbe754: raises $0.1 to $0.2
860bc69a: folds
Uncalled bet ($0.1) returned to b8cbe754
*** SHOWDOWN ***
b8cbe754 collected $0.2 from pot
*** SUMMARY ***
Total pot $0.2 | Rake $0 | Jackpot $0 | Bingo $0 | Fortune $0 | Tax $0
Seat 1: 6b9d4393 (button) folded before Flop (didn't bet)
Seat 2: b8cbe754 (small blind) collected ($0.2)
Seat 3: 860bc69a (big blind) folded before Flop
Seat 4: 9b026fca folded before Flop (didn't bet)
Seat 5: Hero folded before Flop (didn't bet)
Seat 6: 64326c84 folded before Flop (didn't bet)


Poker Hand #RC2774717556: Hold'em No Limit ($0.05/$0.1) - 2024/08/05 12:30:01
Table 'RushAndCash21382816' 6-max Seat #1 is the button
Seat 1: e5b05063 ($17.44 in chips)
Seat 2: b6aff380 ($9.9 in chips)
Seat 3: ece2e771 ($18.34 in chips)
Seat 4: b958f85c ($11.74 in chips)
Seat 5: Hero ($11.82 in chips)
Seat 6: cd4be1e5 ($26.57 in chips)
b6aff380: posts small blind $0.05
ece2e771: posts big blind $0.1
*** HOLE CARDS ***
Dealt to e5b05063 
Dealt to b6aff380 
Dealt to ece2e771 
Dealt to b958f85c 
Dealt to Hero [7d Ac]
Dealt to cd4be1e5 
b958f85c: raises $0.13 to $0.23
Hero: folds
cd4be1e5: folds
e5b05063: folds
b6aff380: folds
ece2e771: folds
Uncalled bet ($0.13) returned to b958f85c
*** SHOWDOWN ***
b958f85c collected $0.25 from pot
*** SUMMARY ***
Total pot $0.25 | Rake $0 | Jackpot $0 | Bingo $0 | Fortune $0 | Tax $0
Seat 1: e5b05063 (button) folded before Flop (didn't bet)
Seat 2: b6aff380 (small blind) folded before Flop
Seat 3: ece2e771 (big blind) folded before Flop
Seat 4: b958f85c collected ($0.25)
Seat 5: Hero folded before Flop (didn't bet)
Seat 6: cd4be1e5 folded before Flop (didn't bet)


Poker Hand #RC2774717502: Hold'em No Limit ($0.05/$0.1) - 2024/08/05 12:29:54
Table 'RushAndCash21382762' 6-max Seat #1 is the button
Seat 1: Hero ($11.82 in chips)
Seat 2: f217c6c1 ($9.17 in chips)
Seat 3: 6f93ebc9 ($11.08 in chips)
Seat 4: ef818b32 ($10.21 in chips)
Seat 5: 59d37d9f ($23.96 in chips)
Seat 6: 37d34c03 ($11.43 in chips)
f217c6c1: posts small blind $0.05
6f93ebc9: posts big blind $0.1
*** HOLE CARDS ***
Dealt to Hero [Jc 6d]
Dealt to f217c6c1 
Dealt to 6f93ebc9 
Dealt to ef818b32 
Dealt to 59d37d9f 
Dealt to 37d34c03 
ef818b32: folds
59d37d9f: folds
37d34c03: folds
Hero: folds
f217c6c1: folds
Uncalled bet ($0.05) returned to 6f93ebc9
*** SHOWDOWN ***
6f93ebc9 collected $0.1 from pot
*** SUMMARY ***
Total pot $0.1 | Rake $0 | Jackpot $0 | Bingo $0 | Fortune $0 | Tax $0
Seat 1: Hero (button) folded before Flop (didn't bet)
Seat 2: f217c6c1 (small blind) folded before Flop
Seat 3: 6f93ebc9 (big blind) collected ($0.1)
Seat 4: ef818b32 folded before Flop (didn't bet)
Seat 5: 59d37d9f folded before Flop (didn't bet)
Seat 6: 37d34c03 folded before Flop (didn't bet)


Poker Hand #RC2774717457: Hold'em No Limit ($0.05/$0.1) - 2024/08/05 12:29:49
Table 'RushAndCash21382717' 6-max Seat #1 is the button
Seat 1: ef025fda ($10 in chips)
Seat 2: Hero ($11.87 in chips)
Seat 3: 55744bec ($16.85 in chips)
Seat 4: b1e85d3c ($11.26 in chips)
Seat 5: 9929eca2 ($11.06 in chips)
Seat 6: 1ea2d9c4 ($10.15 in chips)
Hero: posts small blind $0.05
55744bec: posts big blind $0.1
*** HOLE CARDS ***
Dealt to ef025fda 
Dealt to Hero [Td 6c]
Dealt to 55744bec 
Dealt to b1e85d3c 
Dealt to 9929eca2 
Dealt to 1ea2d9c4 
b1e85d3c: folds
9929eca2: folds
1ea2d9c4: folds
ef025fda: folds
Hero: folds
Uncalled bet ($0.05) returned to 55744bec
*** SHOWDOWN ***
55744bec collected $0.1 from pot
*** SUMMARY ***
Total pot $0.1 | Rake $0 | Jackpot $0 | Bingo $0 | Fortune $0 | Tax $0
Seat 1: ef025fda (button) folded before Flop (didn't bet)
Seat 2: Hero (small blind) folded before Flop
Seat 3: 55744bec (big blind) collected ($0.1)
Seat 4: b1e85d3c folded before Flop (didn't bet)
Seat 5: 9929eca2 folded before Flop (didn't bet)
Seat 6: 1ea2d9c4 folded before Flop (didn't bet)


Poker Hand #RC2774717396: Hold'em No Limit ($0.05/$0.1) - 2024/08/05 12:29:41
Table 'RushAndCash21382656' 6-max Seat #1 is the button
Seat 1: b5c5ce37 ($13.82 in chips)
Seat 2: 7c891321 ($17.7 in chips)
Seat 3: Hero ($11.97 in chips)
Seat 4: a58a0072 ($43.62 in chips)
Seat 5: d50247d2 ($14.79 in chips)
Seat 6: 6b9d4393 ($18.16 in chips)
7c891321: posts small blind $0.05
Hero: posts big blind $0.1
*** HOLE CARDS ***
Dealt to b5c5ce37 
Dealt to 7c891321 
Dealt to Hero [Kc 8h]
Dealt to a58a0072 
Dealt to d50247d2 
Dealt to 6b9d4393 
a58a0072: folds
d50247d2: folds
6b9d4393: folds
b5c5ce37: folds
7c891321: raises $0.1 to $0.2
Hero: folds
Uncalled bet ($0.1) returned to 7c891321
*** SHOWDOWN ***
7c891321 collected $0.2 from pot
*** SUMMARY ***
Total pot $0.2 | Rake $0 | Jackpot $0 | Bingo $0 | Fortune $0 | Tax $0
Seat 1: b5c5ce37 (button) folded before Flop (didn't bet)
Seat 2: 7c891321 (small blind) collected ($0.2)
Seat 3: Hero (big blind) folded before Flop
Seat 4: a58a0072 folded before Flop (didn't bet)
Seat 5: d50247d2 folded before Flop (didn't bet)
Seat 6: 6b9d4393 folded before Flop (didn't bet)


Poker Hand #RC2774717359: Hold'em No Limit ($0.05/$0.1) - 2024/08/05 12:29:36
Table 'RushAndCash21382619' 6-max Seat #1 is the button
Seat 1: 97aa405b ($10.05 in chips)
Seat 2: cde11cbc ($19.89 in chips)
Seat 3: f0aaf0fe ($13.78 in chips)
Seat 4: a6028eea ($10.3 in chips)
Seat 5: 5d265da3 ($10 in chips)
Seat 6: Hero ($11.97 in chips)
cde11cbc: posts small blind $0.05
f0aaf0fe: posts big blind $0.1
*** HOLE CARDS ***
Dealt to 97aa405b 
Dealt to cde11cbc 
Dealt to f0aaf0fe 
Dealt to a6028eea 
Dealt to 5d265da3 
Dealt to Hero [4c Ts]
a6028eea: raises $0.15 to $0.25
5d265da3: raises $0.45 to $0.7
Hero: folds
97aa405b: folds
cde11cbc: folds
f0aaf0fe: calls $0.6
a6028eea: calls $0.45
*** FLOP *** [Kc Qd Kh]
f0aaf0fe: checks
a6028eea: checks
5d265da3: checks
*** TURN *** [Kc Qd Kh] [5s]
f0aaf0fe: bets $1.45
a6028eea: folds
5d265da3: folds
Uncalled bet ($1.45) returned to f0aaf0fe
*** SHOWDOWN ***
f0aaf0fe collected $2.05 from pot
*** SUMMARY ***
Total pot $2.15 | Rake $0.1 | Jackpot $0 | Bingo $0 | Fortune $0 | Tax $0
Board [Kc Qd Kh 5s]
Seat 1: 97aa405b (button) folded before Flop (didn't bet)
Seat 2: cde11cbc (small blind) folded before Flop
Seat 3: f0aaf0fe (big blind) won ($2.05)
Seat 4: a6028eea folded on the Turn
Seat 5: 5d265da3 folded on the Turn
Seat 6: Hero folded before Flop (didn't bet)


Poker Hand #RC2774717336: Hold'em No Limit ($0.05/$0.1) - 2024/08/05 12:29:33
Table 'RushAndCash21382596' 6-max Seat #1 is the button
Seat 1: 3f815a4c ($13.83 in chips)
Seat 2: 8ddd04bb ($10.85 in chips)
Seat 3: 5a4b99ba ($3.42 in chips)
Seat 4: Hero ($11.97 in chips)
Seat 5: 57569970 ($11.17 in chips)
Seat 6: 5ec6e508 ($19.66 in chips)
8ddd04bb: posts small blind $0.05
5a4b99ba: posts big blind $0.1
*** HOLE CARDS ***
Dealt to 3f815a4c 
Dealt to 8ddd04bb 
Dealt to 5a4b99ba 
Dealt to Hero [Ah 6s]
Dealt to 57569970 
Dealt to 5ec6e508 
Hero: folds
57569970: raises $0.12 to $0.22
5ec6e508: folds
3f815a4c: folds
8ddd04bb: folds
5a4b99ba: folds
Uncalled bet ($0.12) returned to 57569970
*** SHOWDOWN ***
57569970 collected $0.25 from pot
*** SUMMARY ***
Total pot $0.25 | Rake $0 | Jackpot $0 | Bingo $0 | Fortune $0 | Tax $0
Seat 1: 3f815a4c (button) folded before Flop (didn't bet)
Seat 2: 8ddd04bb (small blind) folded before Flop
Seat 3: 5a4b99ba (big blind) folded before Flop
Seat 4: Hero folded before Flop (didn't bet)
Seat 5: 57569970 collected ($0.25)
Seat 6: 5ec6e508 folded before Flop (didn't bet)


Poker Hand #RC2774717310: Hold'em No Limit ($0.05/$0.1) - 2024/08/05 12:29:29
Table 'RushAndCash21382570' 6-max Seat #1 is the button
Seat 1: 644022ea ($25.18 in chips)
Seat 2: af18778e ($6.28 in chips)
Seat 3: 98610389 ($10.68 in chips)
Seat 4: dd50519d ($10 in chips)
Seat 5: ebeb4fad ($11.3 in chips)
Seat 6: Hero ($11.97 in chips)
af18778e: posts small blind $0.05
98610389: posts big blind $0.1
*** HOLE CARDS ***
Dealt to 644022ea 
Dealt to af18778e 
Dealt to 98610389 
Dealt to dd50519d 
Dealt to ebeb4fad 
Dealt to Hero [Qd Ts]
dd50519d: folds
ebeb4fad: folds
Hero: folds
644022ea: raises $0.15 to $0.25
af18778e: folds
98610389: calls $0.15
*** FLOP *** [7h 9s Qc]
98610389: checks
644022ea: checks
*** TURN *** [7h 9s Qc] [3c]
98610389: bets $0.42
644022ea: folds
Uncalled bet ($0.42) returned to 98610389
*** SHOWDOWN ***
98610389 collected $0.53 from pot
*** SUMMARY ***
Total pot $0.55 | Rake $0.02 | Jackpot $0 | Bingo $0 | Fortune $0 | Tax $0
Board [7h 9s Qc 3c]
Seat 1: 644022ea (button) folded on the Turn
Seat 2: af18778e (small blind) folded before Flop
Seat 3: 98610389 (big blind) won ($0.53)
Seat 4: dd50519d folded before Flop (didn't bet)
Seat 5: ebeb4fad folded before Flop (didn't bet)
Seat 6: Hero folded before Flop (didn't bet)


Poker Hand #RC2774716940: Hold'em No Limit ($0.05/$0.1) - 2024/08/05 12:28:45
Table 'RushAndCash21382200' 6-max Seat #1 is the button
Seat 1: 64a291c5 ($10.76 in chips)
Seat 2: Hero ($10.79 in chips)
Seat 3: eca0bbe7 ($12.11 in chips)
Seat 4: 6c94eb4f ($5.96 in chips)
Seat 5: 9957f83a ($28 in chips)
Seat 6: c0c61c6e ($10.58 in chips)
Hero: posts small blind $0.05
eca0bbe7: posts big blind $0.1
*** HOLE CARDS ***
Dealt to 64a291c5 
Dealt to Hero [Jh Th]
Dealt to eca0bbe7 
Dealt to 6c94eb4f 
Dealt to 9957f83a 
Dealt to c0c61c6e 
6c94eb4f: folds
9957f83a: folds
c0c61c6e: folds
64a291c5: raises $0.2 to $0.3
Hero: raises $0.9 to $1.2
eca0bbe7: folds
64a291c5: calls $0.9
*** FLOP *** [4s Ts 9s]
Hero: bets $1.1
64a291c5: folds
Uncalled bet ($1.1) returned to Hero
*** SHOWDOWN ***
Hero collected $2.38 from pot
*** SUMMARY ***
Total pot $2.5 | Rake $0.12 | Jackpot $0 | Bingo $0 | Fortune $0 | Tax $0
Board [4s Ts 9s]
Seat 1: 64a291c5 (button) folded on the Flop
Seat 2: Hero (small blind) won ($2.38)
Seat 3: eca0bbe7 (big blind) folded before Flop
Seat 4: 6c94eb4f folded before Flop (didn't bet)
Seat 5: 9957f83a folded before Flop (didn't bet)
Seat 6: c0c61c6e folded before Flop (didn't bet)


Poker Hand #RC2774716906: Hold'em No Limit ($0.05/$0.1) - 2024/08/05 12:28:41
Table 'RushAndCash21382166' 6-max Seat #1 is the button
Seat 1: 9cec7f3b ($10.7 in chips)
Seat 2: 57a440e2 ($8.73 in chips)
Seat 3: Hero ($10.89 in chips)
Seat 4: f60c0f24 ($10.1 in chips)
Seat 5: f8303f3b ($13.57 in chips)
Seat 6: 34f8bad ($37.14 in chips)
57a440e2: posts small blind $0.05
Hero: posts big blind $0.1
*** HOLE CARDS ***
Dealt to 9cec7f3b 
Dealt to 57a440e2 
Dealt to Hero [6s 9h]
Dealt to f60c0f24 
Dealt to f8303f3b 
Dealt to 34f8bad 
f60c0f24: raises $0.1 to $0.2
f8303f3b: folds
34f8bad: folds
9cec7f3b: folds
57a440e2: folds
Hero: folds
Uncalled bet ($0.1) returned to f60c0f24
*** SHOWDOWN ***
f60c0f24 collected $0.25 from pot
*** SUMMARY ***
Total pot $0.25 | Rake $0 | Jackpot $0 | Bingo $0 | Fortune $0 | Tax $0
Seat 1: 9cec7f3b (button) folded before Flop (didn't bet)
Seat 2: 57a440e2 (small blind) folded before Flop
Seat 3: Hero (big blind) folded before Flop
Seat 4: f60c0f24 collected ($0.25)
Seat 5: f8303f3b folded before Flop (didn't bet)
Seat 6: 34f8bad folded before Flop (didn't bet)


Poker Hand #RC2774716863: Hold'em No Limit ($0.05/$0.1) - 2024/08/05 12:28:36
Table 'RushAndCash21382123' 6-max Seat #1 is the button
Seat 1: Hero ($10.89 in chips)
Seat 2: efe5e7f7 ($10.05 in chips)
Seat 3: 785352ba ($13.46 in chips)
Seat 4: 87d59ce6 ($11.8 in chips)
Seat 5: 527de330 ($20.61 in chips)
Seat 6: 93557287 ($26.5 in chips)
efe5e7f7: posts small blind $0.05
785352ba: posts big blind $0.1
*** HOLE CARDS ***
Dealt to Hero [5d Th]
Dealt to efe5e7f7 
Dealt to 785352ba 
Dealt to 87d59ce6 
Dealt to 527de330 
Dealt to 93557287 
87d59ce6: raises $0.1 to $0.2
527de330: folds
93557287: folds
Hero: folds
efe5e7f7: folds
785352ba: folds
Uncalled bet ($0.1) returned to 87d59ce6
*** SHOWDOWN ***
87d59ce6 collected $0.25 from pot
*** SUMMARY ***
Total pot $0.25 | Rake $0 | Jackpot $0 | Bingo $0 | Fortune $0 | Tax $0
Seat 1: Hero (button) folded before Flop (didn't bet)
Seat 2: efe5e7f7 (small blind) folded before Flop
Seat 3: 785352ba (big blind) folded before Flop
Seat 4: 87d59ce6 collected ($0.25)
Seat 5: 527de330 folded before Flop (didn't bet)
Seat 6: 93557287 folded before Flop (didn't bet)


Poker Hand #RC2774716824: Hold'em No Limit ($0.05/$0.1) - 2024/08/05 12:28:31
Table 'RushAndCash21382084' 6-max Seat #1 is the button
Seat 1: 6e30e639 ($15.06 in chips)
Seat 2: 8fe3e66c ($16.9 in chips)
Seat 3: 9eaac162 ($8.04 in chips)
Seat 4: 4b66d271 ($7.39 in chips)
Seat 5: Hero ($10.89 in chips)
Seat 6: e9b8904b ($13.61 in chips)
8fe3e66c: posts small blind $0.05
9eaac162: posts big blind $0.1
*** HOLE CARDS ***
Dealt to 6e30e639 
Dealt to 8fe3e66c 
Dealt to 9eaac162 
Dealt to 4b66d271 
Dealt to Hero [6d 5d]
Dealt to e9b8904b 
4b66d271: raises $0.1 to $0.2
Hero: folds
e9b8904b: folds
6e30e639: folds
8fe3e66c: folds
9eaac162: folds
Uncalled bet ($0.1) returned to 4b66d271
*** SHOWDOWN ***
4b66d271 collected $0.25 from pot
*** SUMMARY ***
Total pot $0.25 | Rake $0 | Jackpot $0 | Bingo $0 | Fortune $0 | Tax $0
Seat 1: 6e30e639 (button) folded before Flop (didn't bet)
Seat 2: 8fe3e66c (small blind) folded before Flop
Seat 3: 9eaac162 (big blind) folded before Flop
Seat 4: 4b66d271 collected ($0.25)
Seat 5: Hero folded before Flop (didn't bet)
Seat 6: e9b8904b folded before Flop (didn't bet)


Poker Hand #RC2774716627: Hold'em No Limit ($0.05/$0.1) - 2024/08/05 12:28:06
Table 'RushAndCash21381887' 6-max Seat #1 is the button
Seat 1: bec7e5d7 ($13.11 in chips)
Seat 2: 6e30e639 ($14.78 in chips)
Seat 3: 1d581932 ($12.24 in chips)
Seat 4: 42f6ae09 ($10.3 in chips)
Seat 5: Hero ($11.09 in chips)
Seat 6: 8e07bc08 ($11.87 in chips)
6e30e639: posts small blind $0.05
1d581932: posts big blind $0.1
*** HOLE CARDS ***
Dealt to bec7e5d7 
Dealt to 6e30e639 
Dealt to 1d581932 
Dealt to 42f6ae09 
Dealt to Hero [Ah 9h]
Dealt to 8e07bc08 
42f6ae09: folds
Hero: raises $0.1 to $0.2
8e07bc08: folds
bec7e5d7: folds
6e30e639: raises $0.6 to $0.8
1d581932: folds
Hero: folds
Uncalled bet ($0.6) returned to 6e30e639
*** SHOWDOWN ***
6e30e639 collected $0.48 from pot
*** SUMMARY ***
Total pot $0.5 | Rake $0.02 | Jackpot $0 | Bingo $0 | Fortune $0 | Tax $0
Seat 1: bec7e5d7 (button) folded before Flop (didn't bet)
Seat 2: 6e30e639 (small blind) collected ($0.48)
Seat 3: 1d581932 (big blind) folded before Flop
Seat 4: 42f6ae09 folded before Flop (didn't bet)
Seat 5: Hero folded before Flop
Seat 6: 8e07bc08 folded before Flop (didn't bet)


Poker Hand #RC2774716572: Hold'em No Limit ($0.05/$0.1) - 2024/08/05 12:27:59
Table 'RushAndCash21381832' 6-max Seat #1 is the button
Seat 1: Hero ($11.09 in chips)
Seat 2: 41727a67 ($10.69 in chips)
Seat 3: ed41ea81 ($10 in chips)
Seat 4: a42a4e96 ($9.95 in chips)
Seat 5: a6f61f6e ($12.59 in chips)
Seat 6: f735ed75 ($9.85 in chips)
41727a67: posts small blind $0.05
ed41ea81: posts big blind $0.1
*** HOLE CARDS ***
Dealt to Hero [Ac 7s]
Dealt to 41727a67 
Dealt to ed41ea81 
Dealt to a42a4e96 
Dealt to a6f61f6e 
Dealt to f735ed75 
a42a4e96: folds
a6f61f6e: folds
f735ed75: folds
Hero: folds
41727a67: raises $0.2 to $0.3
ed41ea81: folds
Uncalled bet ($0.2) returned to 41727a67
*** SHOWDOWN ***
41727a67 collected $0.2 from pot
*** SUMMARY ***
Total pot $0.2 | Rake $0 | Jackpot $0 | Bingo $0 | Fortune $0 | Tax $0
Seat 1: Hero (button) folded before Flop (didn't bet)
Seat 2: 41727a67 (small blind) collected ($0.2)
Seat 3: ed41ea81 (big blind) folded before Flop
Seat 4: a42a4e96 folded before Flop (didn't bet)
Seat 5: a6f61f6e folded before Flop (didn't bet)
Seat 6: f735ed75 folded before Flop (didn't bet)


Poker Hand #RC2774716534: Hold'em No Limit ($0.05/$0.1) - 2024/08/05 12:27:54
Table 'RushAndCash21381794' 6-max Seat #1 is the button
Seat 1: 859322bf ($11.09 in chips)
Seat 2: 6c735362 ($9.64 in chips)
Seat 3: Hero ($11.19 in chips)
Seat 4: 7be4d738 ($15.3 in chips)
Seat 5: f3d5acf6 ($10 in chips)
Seat 6: bec7e5d7 ($13.21 in chips)
6c735362: posts small blind $0.05
Hero: posts big blind $0.1
*** HOLE CARDS ***
Dealt to 859322bf 
Dealt to 6c735362 
Dealt to Hero [3h Ac]
Dealt to 7be4d738 
Dealt to f3d5acf6 
Dealt to bec7e5d7 
7be4d738: folds
f3d5acf6: folds
bec7e5d7: folds
859322bf: folds
6c735362: raises $0.2 to $0.3
Hero: folds
Uncalled bet ($0.2) returned to 6c735362
*** SHOWDOWN ***
6c735362 collected $0.2 from pot
*** SUMMARY ***
Total pot $0.2 | Rake $0 | Jackpot $0 | Bingo $0 | Fortune $0 | Tax $0
Seat 1: 859322bf (button) folded before Flop (didn't bet)
Seat 2: 6c735362 (small blind) collected ($0.2)
Seat 3: Hero (big blind) folded before Flop
Seat 4: 7be4d738 folded before Flop (didn't bet)
Seat 5: f3d5acf6 folded before Flop (didn't bet)
Seat 6: bec7e5d7 folded before Flop (didn't bet)


Poker Hand #RC2774716468: Hold'em No Limit ($0.05/$0.1) - 2024/08/05 12:27:46
Table 'RushAndCash21381728' 6-max Seat #1 is the button
Seat 1: f16ed2df ($13.47 in chips)
Seat 2: Hero ($11.24 in chips)
Seat 3: d04d5157 ($8.74 in chips)
Seat 4: daab20d3 ($23.51 in chips)
Seat 5: 1ea2d9c4 ($10 in chips)
Seat 6: d99f71b9 ($10.23 in chips)
Hero: posts small blind $0.05
d04d5157: posts big blind $0.1
*** HOLE CARDS ***
Dealt to f16ed2df 
Dealt to Hero [3s 8s]
Dealt to d04d5157 
Dealt to daab20d3 
Dealt to 1ea2d9c4 
Dealt to d99f71b9 
daab20d3: folds
1ea2d9c4: raises $0.15 to $0.25
d99f71b9: folds
f16ed2df: folds
Hero: folds
d04d5157: calls $0.15
*** FLOP *** [6h 4s 4h]
d04d5157: checks
1ea2d9c4: checks
*** TURN *** [6h 4s 4h] [4c]
d04d5157: checks
1ea2d9c4: checks
*** RIVER *** [6h 4s 4h 4c] [4d]
d04d5157: checks
1ea2d9c4: bets $0.19
d04d5157: folds
Uncalled bet ($0.19) returned to 1ea2d9c4
*** SHOWDOWN ***
1ea2d9c4 collected $0.53 from pot
*** SUMMARY ***
Total pot $0.55 | Rake $0.02 | Jackpot $0 | Bingo $0 | Fortune $0 | Tax $0
Board [6h 4s 4h 4c 4d]
Seat 1: f16ed2df (button) folded before Flop (didn't bet)
Seat 2: Hero (small blind) folded before Flop
Seat 3: d04d5157 (big blind) folded on the River
Seat 4: daab20d3 folded before Flop (didn't bet)
Seat 5: 1ea2d9c4 won ($0.53)
Seat 6: d99f71b9 folded before Flop (didn't bet)


Poker Hand #RC2774716422: Hold'em No Limit ($0.05/$0.1) - 2024/08/05 12:27:40
Table 'RushAndCash21381682' 6-max Seat #1 is the button
Seat 1: 1c48d2d2 ($14.21 in chips)
Seat 2: 7934dc36 ($19.29 in chips)
Seat 3: 772edc7a ($10 in chips)
Seat 4: Hero ($11.24 in chips)
Seat 5: d85d1b8e ($18.59 in chips)
Seat 6: f8303f3b ($14.2 in chips)
7934dc36: posts small blind $0.05
772edc7a: posts big blind $0.1
*** HOLE CARDS ***
Dealt to 1c48d2d2 
Dealt to 7934dc36 
Dealt to 772edc7a 
Dealt to Hero [2s Kd]
Dealt to d85d1b8e 
Dealt to f8303f3b 
Hero: folds
d85d1b8e: folds
f8303f3b: raises $0.1 to $0.2
1c48d2d2: folds
7934dc36: folds
772edc7a: calls $0.1
*** FLOP *** [9s 2h 7d]
772edc7a: checks
f8303f3b: checks
*** TURN *** [9s 2h 7d] [6d]
772edc7a: bets $0.23
f8303f3b: calls $0.23
*** RIVER *** [9s 2h 7d 6d] [Qh]
772edc7a: checks
f8303f3b: checks
772edc7a: shows [Ad 7c] (Pair of Sevens)
f8303f3b: shows [6h Ah] (Pair of Sixes)
*** SHOWDOWN ***
772edc7a collected $0.87 from pot
*** SUMMARY ***
Total pot $0.91 | Rake $0.04 | Jackpot $0 | Bingo $0 | Fortune $0 | Tax $0
Board [9s 2h 7d 6d Qh]
Seat 1: 1c48d2d2 (button) folded before Flop (didn't bet)
Seat 2: 7934dc36 (small blind) folded before Flop
Seat 3: 772edc7a (big blind) showed [Ad 7c] and won ($0.87) with Pair of Sevens
Seat 4: Hero folded before Flop (didn't bet)
Seat 5: d85d1b8e folded before Flop (didn't bet)
Seat 6: f8303f3b showed [6h Ah] and lost with Pair of Sixes


Poker Hand #RC2774716361: Hold'em No Limit ($0.05/$0.1) - 2024/08/05 12:27:32
Table 'RushAndCash21381621' 6-max Seat #1 is the button
Seat 1: 5e52e81 ($13.76 in chips)
Seat 2: 27c7b1c ($11.17 in chips)
Seat 3: 7b6f167 ($25.79 in chips)
Seat 4: 3d571954 ($30.86 in chips)
Seat 5: 3e43307b ($9.65 in chips)
Seat 6: Hero ($11.24 in chips)
27c7b1c: posts small blind $0.05
7b6f167: posts big blind $0.1
*** HOLE CARDS ***
Dealt to 5e52e81 
Dealt to 27c7b1c 
Dealt to 7b6f167 
Dealt to 3d571954 
Dealt to 3e43307b 
Dealt to Hero [8s 6c]
3d571954: raises $0.1 to $0.2
3e43307b: folds
Hero: folds
5e52e81: folds
27c7b1c: folds
7b6f167: folds
Uncalled bet ($0.1) returned to 3d571954
*** SHOWDOWN ***
3d571954 collected $0.25 from pot
*** SUMMARY ***
Total pot $0.25 | Rake $0 | Jackpot $0 | Bingo $0 | Fortune $0 | Tax $0
Seat 1: 5e52e81 (button) folded before Flop (didn't bet)
Seat 2: 27c7b1c (small blind) folded before Flop
Seat 3: 7b6f167 (big blind) folded before Flop
Seat 4: 3d571954 collected ($0.25)
Seat 5: 3e43307b folded before Flop (didn't bet)
Seat 6: Hero folded before Flop (didn't bet)


Poker Hand #RC2774716329: Hold'em No Limit ($0.05/$0.1) - 2024/08/05 12:27:28
Table 'RushAndCash21381589' 6-max Seat #1 is the button
Seat 1: 7ea29049 ($12.12 in chips)
Seat 2: 8fe3e66c ($17.45 in chips)
Seat 3: 1267cb64 ($10 in chips)
Seat 4: a6f61f6e ($12.64 in chips)
Seat 5: Hero ($11.24 in chips)
Seat 6: 95e28b9 ($9.53 in chips)
8fe3e66c: posts small blind $0.05
1267cb64: posts big blind $0.1
*** HOLE CARDS ***
Dealt to 7ea29049 
Dealt to 8fe3e66c 
Dealt to 1267cb64 
Dealt to a6f61f6e 
Dealt to Hero [4c 4h]
Dealt to 95e28b9 
a6f61f6e: folds
Hero: folds
95e28b9: folds
7ea29049: folds
8fe3e66c: calls $0.05
1267cb64: raises $0.3 to $0.4
8fe3e66c: calls $0.3
*** FLOP *** [4s 7d As]
8fe3e66c: checks
1267cb64: bets $0.27
8fe3e66c: folds
Uncalled bet ($0.27) returned to 1267cb64
*** SHOWDOWN ***
1267cb64 collected $0.76 from pot
*** SUMMARY ***
Total pot $0.8 | Rake $0.04 | Jackpot $0 | Bingo $0 | Fortune $0 | Tax $0
Board [4s 7d As]
Seat 1: 7ea29049 (button) folded before Flop (didn't bet)
Seat 2: 8fe3e66c (small blind) folded on the Flop
Seat 3: 1267cb64 (big blind) won ($0.76)
Seat 4: a6f61f6e folded before Flop (didn't bet)
Seat 5: Hero folded before Flop (didn't bet)
Seat 6: 95e28b9 folded before Flop (didn't bet)


Poker Hand #RC2774716305: Hold'em No Limit ($0.05/$0.1) - 2024/08/05 12:27:25
Table 'RushAndCash21381565' 6-max Seat #1 is the button
Seat 1: b958f85c ($11.26 in chips)
Seat 2: Hero ($11.29 in chips)
Seat 3: a5c40612 ($10 in chips)
Seat 4: dc92c56 ($45.44 in chips)
Seat 5: 9a65e146 ($10 in chips)
Seat 6: 7ea29049 ($12.12 in chips)
Hero: posts small blind $0.05
a5c40612: posts big blind $0.1
*** HOLE CARDS ***
Dealt to b958f85c 
Dealt to Hero [5c 5h]
Dealt to a5c40612 
Dealt to dc92c56 
Dealt to 9a65e146 
Dealt to 7ea29049 
dc92c56: folds
9a65e146: folds
7ea29049: folds
b958f85c: folds
Hero: folds
Uncalled bet ($0.05) returned to a5c40612
*** SHOWDOWN ***
a5c40612 collected $0.1 from pot
*** SUMMARY ***
Total pot $0.1 | Rake $0 | Jackpot $0 | Bingo $0 | Fortune $0 | Tax $0
Seat 1: b958f85c (button) folded before Flop (didn't bet)
Seat 2: Hero (small blind) folded before Flop
Seat 3: a5c40612 (big blind) collected ($0.1)
Seat 4: dc92c56 folded before Flop (didn't bet)
Seat 5: 9a65e146 folded before Flop (didn't bet)
Seat 6: 7ea29049 folded before Flop (didn't bet)


Poker Hand #RC2774716016: Hold'em No Limit ($0.05/$0.1) - 2024/08/05 12:26:50
Table 'RushAndCash21381276' 6-max Seat #1 is the button
Seat 1: e56eab42 ($13.12 in chips)
Seat 2: 85dcaf0 ($9.9 in chips)
Seat 3: 7fa823f4 ($10.15 in chips)
Seat 4: a4aad96a ($10.3 in chips)
Seat 5: 7c7fc1d ($23.01 in chips)
Seat 6: Hero ($11.02 in chips)
85dcaf0: posts small blind $0.05
7fa823f4: posts big blind $0.1
*** HOLE CARDS ***
Dealt to e56eab42 
Dealt to 85dcaf0 
Dealt to 7fa823f4 
Dealt to a4aad96a 
Dealt to 7c7fc1d 
Dealt to Hero [8h 7h]
a4aad96a: folds
7c7fc1d: folds
Hero: raises $0.14 to $0.24
e56eab42: folds
85dcaf0: folds
7fa823f4: calls $0.14
*** FLOP *** [3c 5c Kd]
7fa823f4: checks
Hero: checks
*** TURN *** [3c 5c Kd] [As]
7fa823f4: checks
Hero: bets $0.35
7fa823f4: folds
Uncalled bet ($0.35) returned to Hero
*** SHOWDOWN ***
Hero collected $0.51 from pot
*** SUMMARY ***
Total pot $0.53 | Rake $0.02 | Jackpot $0 | Bingo $0 | Fortune $0 | Tax $0
Board [3c 5c Kd As]
Seat 1: e56eab42 (button) folded before Flop (didn't bet)
Seat 2: 85dcaf0 (small blind) folded before Flop
Seat 3: 7fa823f4 (big blind) folded on the Turn
Seat 4: a4aad96a folded before Flop (didn't bet)
Seat 5: 7c7fc1d folded before Flop (didn't bet)
Seat 6: Hero won ($0.51)


Poker Hand #RC2774715728: Hold'em No Limit ($0.05/$0.1) - 2024/08/05 12:26:14
Table 'RushAndCash21380988' 6-max Seat #1 is the button
Seat 1: c4093c4a ($10.76 in chips)
Seat 2: dbe3cff8 ($17.91 in chips)
Seat 3: Hero ($10.58 in chips)
Seat 4: 847778db ($10 in chips)
Seat 5: 7c7fc1d ($23.44 in chips)
Seat 6: 9b012cde ($49.86 in chips)
dbe3cff8: posts small blind $0.05
Hero: posts big blind $0.1
*** HOLE CARDS ***
Dealt to c4093c4a 
Dealt to dbe3cff8 
Dealt to Hero [Qs 9s]
Dealt to 847778db 
Dealt to 7c7fc1d 
Dealt to 9b012cde 
847778db: folds
7c7fc1d: raises $0.1 to $0.2
9b012cde: folds
c4093c4a: folds
dbe3cff8: folds
Hero: calls $0.1
*** FLOP *** [3h Qd Th]
Hero: checks
7c7fc1d: bets $0.23
Hero: calls $0.23
*** TURN *** [3h Qd Th] [8s]
Hero: checks
7c7fc1d: checks
*** RIVER *** [3h Qd Th 8s] [9d]
Hero: checks
7c7fc1d: checks
Hero: shows [Qs 9s] (Pair of Queens and Pair of Nines)
7c7fc1d: shows [Kh As] (Ace-High)
*** SHOWDOWN ***
Hero collected $0.87 from pot
*** SUMMARY ***
Total pot $0.91 | Rake $0.04 | Jackpot $0 | Bingo $0 | Fortune $0 | Tax $0
Board [3h Qd Th 8s 9d]
Seat 1: c4093c4a (button) folded before Flop (didn't bet)
Seat 2: dbe3cff8 (small blind) folded before Flop
Seat 3: Hero (big blind) showed [Qs 9s] and won ($0.87) with Pair of Queens and Pair of Nines
Seat 4: 847778db folded before Flop (didn't bet)
Seat 5: 7c7fc1d showed [Kh As] and lost with Ace-High
Seat 6: 9b012cde folded before Flop (didn't bet)


Poker Hand #RC2774715702: Hold'em No Limit ($0.05/$0.1) - 2024/08/05 12:26:10
Table 'RushAndCash21380962' 6-max Seat #1 is the button
Seat 1: Hero ($10.58 in chips)
Seat 2: b6411a59 ($10 in chips)
Seat 3: c519f7aa ($19.29 in chips)
Seat 4: 97ee54db ($16.85 in chips)
Seat 5: 550c1762 ($10.74 in chips)
Seat 6: c43c25b0 ($22.18 in chips)
b6411a59: posts small blind $0.05
c519f7aa: posts big blind $0.1
*** HOLE CARDS ***
Dealt to Hero [Jd 4c]
Dealt to b6411a59 
Dealt to c519f7aa 
Dealt to 97ee54db 
Dealt to 550c1762 
Dealt to c43c25b0 
97ee54db: folds
550c1762: raises $0.14 to $0.24
c43c25b0: folds
Hero: folds
b6411a59: folds
c519f7aa: folds
Uncalled bet ($0.14) returned to 550c1762
*** SHOWDOWN ***
550c1762 collected $0.25 from pot
*** SUMMARY ***
Total pot $0.25 | Rake $0 | Jackpot $0 | Bingo $0 | Fortune $0 | Tax $0
Seat 1: Hero (button) folded before Flop (didn't bet)
Seat 2: b6411a59 (small blind) folded before Flop
Seat 3: c519f7aa (big blind) folded before Flop
Seat 4: 97ee54db folded before Flop (didn't bet)
Seat 5: 550c1762 collected ($0.25)
Seat 6: c43c25b0 folded before Flop (didn't bet)


Poker Hand #RC2774715675: Hold'em No Limit ($0.05/$0.1) - 2024/08/05 12:26:07
Table 'RushAndCash21380935' 6-max Seat #1 is the button
Seat 1: a42a4e96 ($14 in chips)
Seat 2: d12dc75 ($10 in chips)
Seat 3: 66b312b5 ($11.54 in chips)
Seat 4: Hero ($10.58 in chips)
Seat 5: 7f9b7218 ($12.36 in chips)
Seat 6: 2a216d35 ($10.15 in chips)
d12dc75: posts small blind $0.05
66b312b5: posts big blind $0.1
*** HOLE CARDS ***
Dealt to a42a4e96 
Dealt to d12dc75 
Dealt to 66b312b5 
Dealt to Hero [3d 3s]
Dealt to 7f9b7218 
Dealt to 2a216d35 
Hero: folds
7f9b7218: folds
2a216d35: raises $0.1 to $0.2
a42a4e96: folds
d12dc75: folds
66b312b5: calls $0.1
*** FLOP *** [2c Qs 2d]
66b312b5: checks
2a216d35: bets $0.15
66b312b5: folds
Uncalled bet ($0.15) returned to 2a216d35
*** SHOWDOWN ***
2a216d35 collected $0.43 from pot
*** SUMMARY ***
Total pot $0.45 | Rake $0.02 | Jackpot $0 | Bingo $0 | Fortune $0 | Tax $0
Board [2c Qs 2d]
Seat 1: a42a4e96 (button) folded before Flop (didn't bet)
Seat 2: d12dc75 (small blind) folded before Flop
Seat 3: 66b312b5 (big blind) folded on the Flop
Seat 4: Hero folded before Flop (didn't bet)
Seat 5: 7f9b7218 folded before Flop (didn't bet)
Seat 6: 2a216d35 won ($0.43)


Poker Hand #RC2774715654: Hold'em No Limit ($0.05/$0.1) - 2024/08/05 12:26:03
Table 'RushAndCash21380914' 6-max Seat #1 is the button
Seat 1: 7155dca ($14.44 in chips)
Seat 2: Hero ($10.63 in chips)
Seat 3: 1aa5206a ($42.89 in chips)
Seat 4: 1dc8e473 ($10.68 in chips)
Seat 5: 68fe2fd0 ($10.82 in chips)
Seat 6: cbe44fcb ($23.31 in chips)
Hero: posts small blind $0.05
1aa5206a: posts big blind $0.1
*** HOLE CARDS ***
Dealt to 7155dca 
Dealt to Hero [5c 3h]
Dealt to 1aa5206a 
Dealt to 1dc8e473 
Dealt to 68fe2fd0 
Dealt to cbe44fcb 
1dc8e473: folds
68fe2fd0: folds
cbe44fcb: folds
7155dca: raises $0.1 to $0.2
Hero: folds
1aa5206a: folds
Uncalled bet ($0.1) returned to 7155dca
*** SHOWDOWN ***
7155dca collected $0.25 from pot
*** SUMMARY ***
Total pot $0.25 | Rake $0 | Jackpot $0 | Bingo $0 | Fortune $0 | Tax $0
Seat 1: 7155dca (button) collected ($0.25)
Seat 2: Hero (small blind) folded before Flop
Seat 3: 1aa5206a (big blind) folded before Flop
Seat 4: 1dc8e473 folded before Flop (didn't bet)
Seat 5: 68fe2fd0 folded before Flop (didn't bet)
Seat 6: cbe44fcb folded before Flop (didn't bet)


Poker Hand #RC2774715562: Hold'em No Limit ($0.05/$0.1) - 2024/08/05 12:25:51
Table 'RushAndCash21380822' 6-max Seat #1 is the button
Seat 1: f6dba5f1 ($17.42 in chips)
Seat 2: 2a216d35 ($10.05 in chips)
Seat 3: 9f10f7db ($23.63 in chips)
Seat 4: 11b42223 ($17.86 in chips)
Seat 5: Hero ($10.48 in chips)
Seat 6: 6c94eb4f ($6.23 in chips)
2a216d35: posts small blind $0.05
9f10f7db: posts big blind $0.1
*** HOLE CARDS ***
Dealt to f6dba5f1 
Dealt to 2a216d35 
Dealt to 9f10f7db 
Dealt to 11b42223 
Dealt to Hero [Qs Qd]
Dealt to 6c94eb4f 
11b42223: folds
Hero: raises $0.1 to $0.2
6c94eb4f: folds
f6dba5f1: folds
2a216d35: folds
9f10f7db: folds
Uncalled bet ($0.1) returned to Hero
*** SHOWDOWN ***
Hero collected $0.25 from pot
*** SUMMARY ***
Total pot $0.25 | Rake $0 | Jackpot $0 | Bingo $0 | Fortune $0 | Tax $0
Seat 1: f6dba5f1 (button) folded before Flop (didn't bet)
Seat 2: 2a216d35 (small blind) folded before Flop
Seat 3: 9f10f7db (big blind) folded before Flop
Seat 4: 11b42223 folded before Flop (didn't bet)
Seat 5: Hero collected ($0.25)
Seat 6: 6c94eb4f folded before Flop (didn't bet)


Poker Hand #RC2774715447: Hold'em No Limit ($0.05/$0.1) - 2024/08/05 12:25:37
Table 'RushAndCash21380707' 6-max Seat #1 is the button
Seat 1: Hero ($10.33 in chips)
Seat 2: e86f9bc3 ($9.9 in chips)
Seat 3: 57569970 ($10 in chips)
Seat 4: e21f5f10 ($10.78 in chips)
Seat 5: 6749b50 ($12.82 in chips)
Seat 6: 116388f6 ($9.68 in chips)
e86f9bc3: posts small blind $0.05
57569970: posts big blind $0.1
*** HOLE CARDS ***
Dealt to Hero [Js Jh]
Dealt to e86f9bc3 
Dealt to 57569970 
Dealt to e21f5f10 
Dealt to 6749b50 
Dealt to 116388f6 
e21f5f10: folds
6749b50: folds
116388f6: folds
Hero: raises $0.14 to $0.24
e86f9bc3: folds
57569970: folds
Uncalled bet ($0.14) returned to Hero
*** SHOWDOWN ***
Hero collected $0.25 from pot
*** SUMMARY ***
Total pot $0.25 | Rake $0 | Jackpot $0 | Bingo $0 | Fortune $0 | Tax $0
Seat 1: Hero (button) collected ($0.25)
Seat 2: e86f9bc3 (small blind) folded before Flop
Seat 3: 57569970 (big blind) folded before Flop
Seat 4: e21f5f10 folded before Flop (didn't bet)
Seat 5: 6749b50 folded before Flop (didn't bet)
Seat 6: 116388f6 folded before Flop (didn't bet)


Poker Hand #RC2774715420: Hold'em No Limit ($0.05/$0.1) - 2024/08/05 12:25:34
Table 'RushAndCash21380680' 6-max Seat #1 is the button
Seat 1: 74428f5 ($12.18 in chips)
Seat 2: 5b89f38d ($10.98 in chips)
Seat 3: a58a0072 ($44.07 in chips)
Seat 4: Hero ($10.18 in chips)
Seat 5: e21f5f10 ($10.78 in chips)
Seat 6: cead1158 ($22.89 in chips)
5b89f38d: posts small blind $0.05
a58a0072: posts big blind $0.1
*** HOLE CARDS ***
Dealt to 74428f5 
Dealt to 5b89f38d 
Dealt to a58a0072 
Dealt to Hero [5d 8h]
Dealt to e21f5f10 
Dealt to cead1158 
Hero: folds
e21f5f10: folds
cead1158: folds
74428f5: folds
5b89f38d: raises $0.12 to $0.22
a58a0072: calls $0.12
*** FLOP *** [Qc 2s 6h]
5b89f38d: checks
a58a0072: checks
*** TURN *** [Qc 2s 6h] [Tc]
5b89f38d: checks
a58a0072: bets $0.15
5b89f38d: folds
Uncalled bet ($0.15) returned to a58a0072
*** SHOWDOWN ***
a58a0072 collected $0.42 from pot
*** SUMMARY ***
Total pot $0.44 | Rake $0.02 | Jackpot $0 | Bingo $0 | Fortune $0 | Tax $0
Board [Qc 2s 6h Tc]
Seat 1: 74428f5 (button) folded before Flop (didn't bet)
Seat 2: 5b89f38d (small blind) folded on the Turn
Seat 3: a58a0072 (big blind) won ($0.42)
Seat 4: Hero folded before Flop (didn't bet)
Seat 5: e21f5f10 folded before Flop (didn't bet)
Seat 6: cead1158 folded before Flop (didn't bet)


Poker Hand #RC2774715397: Hold'em No Limit ($0.05/$0.1) - 2024/08/05 12:25:30
Table 'RushAndCash21380657' 6-max Seat #1 is the button
Seat 1: 68ed0679 ($20.63 in chips)
Seat 2: af18778e ($6.56 in chips)
Seat 3: Hero ($10.28 in chips)
Seat 4: 4a344507 ($10.15 in chips)
Seat 5: 7fa823f4 ($10.15 in chips)
Seat 6: cc0546d8 ($14.36 in chips)
af18778e: posts small blind $0.05
Hero: posts big blind $0.1
*** HOLE CARDS ***
Dealt to 68ed0679 
Dealt to af18778e 
Dealt to Hero [6d 8s]
Dealt to 4a344507 
Dealt to 7fa823f4 
Dealt to cc0546d8 
4a344507: folds
7fa823f4: folds
cc0546d8: folds
68ed0679: folds
af18778e: folds
Uncalled bet ($0.05) returned to Hero
*** SHOWDOWN ***
Hero collected $0.1 from pot
*** SUMMARY ***
Total pot $0.1 | Rake $0 | Jackpot $0 | Bingo $0 | Fortune $0 | Tax $0
Seat 1: 68ed0679 (button) folded before Flop (didn't bet)
Seat 2: af18778e (small blind) folded before Flop
Seat 3: Hero (big blind) collected ($0.1)
Seat 4: 4a344507 folded before Flop (didn't bet)
Seat 5: 7fa823f4 folded before Flop (didn't bet)
Seat 6: cc0546d8 folded before Flop (didn't bet)


Poker Hand #RC2774715362: Hold'em No Limit ($0.05/$0.1) - 2024/08/05 12:25:25
Table 'RushAndCash21380622' 6-max Seat #1 is the button
Seat 1: 2ed44d09 ($14.55 in chips)
Seat 2: 48e2061f ($10.05 in chips)
Seat 3: 6407757e ($10.1 in chips)
Seat 4: 1fee764 ($11.62 in chips)
Seat 5: a219470f ($10.08 in chips)
Seat 6: Hero ($10.28 in chips)
48e2061f: posts small blind $0.05
6407757e: posts big blind $0.1
*** HOLE CARDS ***
Dealt to 2ed44d09 
Dealt to 48e2061f 
Dealt to 6407757e 
Dealt to 1fee764 
Dealt to a219470f 
Dealt to Hero [6c 3h]
1fee764: folds
a219470f: raises $0.1 to $0.2
Hero: folds
2ed44d09: folds
48e2061f: folds
6407757e: folds
Uncalled bet ($0.1) returned to a219470f
*** SHOWDOWN ***
a219470f collected $0.25 from pot
*** SUMMARY ***
Total pot $0.25 | Rake $0 | Jackpot $0 | Bingo $0 | Fortune $0 | Tax $0
Seat 1: 2ed44d09 (button) folded before Flop (didn't bet)
Seat 2: 48e2061f (small blind) folded before Flop
Seat 3: 6407757e (big blind) folded before Flop
Seat 4: 1fee764 folded before Flop (didn't bet)
Seat 5: a219470f collected ($0.25)
Seat 6: Hero folded before Flop (didn't bet)


Poker Hand #RC2774715242: Hold'em No Limit ($0.05/$0.1) - 2024/08/05 12:25:09
Table 'RushAndCash21380502' 6-max Seat #1 is the button
Seat 1: b08ad8b2 ($12.67 in chips)
Seat 2: 7e452864 ($10.82 in chips)
Seat 3: 5580da68 ($10.44 in chips)
Seat 4: f95ea52 ($10 in chips)
Seat 5: 6b7afbbe ($28.07 in chips)
Seat 6: Hero ($10.28 in chips)
7e452864: posts small blind $0.05
5580da68: posts big blind $0.1
*** HOLE CARDS ***
Dealt to b08ad8b2 
Dealt to 7e452864 
Dealt to 5580da68 
Dealt to f95ea52 
Dealt to 6b7afbbe 
Dealt to Hero [Ac 2h]
f95ea52: raises $0.15 to $0.25
6b7afbbe: folds
Hero: folds
b08ad8b2: folds
7e452864: folds
5580da68: folds
Uncalled bet ($0.15) returned to f95ea52
*** SHOWDOWN ***
f95ea52 collected $0.25 from pot
*** SUMMARY ***
Total pot $0.25 | Rake $0 | Jackpot $0 | Bingo $0 | Fortune $0 | Tax $0
Seat 1: b08ad8b2 (button) folded before Flop (didn't bet)
Seat 2: 7e452864 (small blind) folded before Flop
Seat 3: 5580da68 (big blind) folded before Flop
Seat 4: f95ea52 collected ($0.25)
Seat 5: 6b7afbbe folded before Flop (didn't bet)
Seat 6: Hero folded before Flop (didn't bet)


Poker Hand #RC2774715197: Hold'em No Limit ($0.05/$0.1) - 2024/08/05 12:25:04
Table 'RushAndCash21380457' 6-max Seat #1 is the button
Seat 1: 6023b781 ($7.58 in chips)
Seat 2: 6c88db04 ($22.8 in chips)
Seat 3: 7d1c443f ($10 in chips)
Seat 4: 8c035ec7 ($10 in chips)
Seat 5: d3c98539 ($21.31 in chips)
Seat 6: Hero ($10.28 in chips)
6c88db04: posts small blind $0.05
7d1c443f: posts big blind $0.1
*** HOLE CARDS ***
Dealt to 6023b781 
Dealt to 6c88db04 
Dealt to 7d1c443f 
Dealt to 8c035ec7 
Dealt to d3c98539 
Dealt to Hero [6d 2c]
8c035ec7: folds
d3c98539: raises $0.15 to $0.25
Hero: folds
6023b781: calls $0.25
6c88db04: calls $0.2
7d1c443f: folds
*** FLOP *** [As 4d 5h]
6c88db04: checks
d3c98539: bets $0.43
6023b781: folds
6c88db04: folds
Uncalled bet ($0.43) returned to d3c98539
*** SHOWDOWN ***
d3c98539 collected $0.81 from pot
*** SUMMARY ***
Total pot $0.85 | Rake $0.04 | Jackpot $0 | Bingo $0 | Fortune $0 | Tax $0
Board [As 4d 5h]
Seat 1: 6023b781 (button) folded on the Flop
Seat 2: 6c88db04 (small blind) folded on the Flop
Seat 3: 7d1c443f (big blind) folded before Flop
Seat 4: 8c035ec7 folded before Flop (didn't bet)
Seat 5: d3c98539 won ($0.81)
Seat 6: Hero folded before Flop (didn't bet)


Poker Hand #RC2774715172: Hold'em No Limit ($0.05/$0.1) - 2024/08/05 12:25:01
Table 'RushAndCash21380432' 6-max Seat #1 is the button
Seat 1: f38291df ($3.49 in chips)
Seat 2: 8f9bbae2 ($13.87 in chips)
Seat 3: c4333c52 ($12.91 in chips)
Seat 4: Hero ($10.28 in chips)
Seat 5: 5e52e81 ($12.29 in chips)
Seat 6: e8ec4f2b ($10.29 in chips)
8f9bbae2: posts small blind $0.05
c4333c52: posts big blind $0.1
*** HOLE CARDS ***
Dealt to f38291df 
Dealt to 8f9bbae2 
Dealt to c4333c52 
Dealt to Hero [4s Ad]
Dealt to 5e52e81 
Dealt to e8ec4f2b 
Hero: folds
5e52e81: folds
e8ec4f2b: raises $0.14 to $0.24
f38291df: folds
8f9bbae2: folds
c4333c52: calls $0.14
*** FLOP *** [7s Kc Qc]
c4333c52: checks
e8ec4f2b: bets $0.18
c4333c52: folds
Uncalled bet ($0.18) returned to e8ec4f2b
*** SHOWDOWN ***
e8ec4f2b collected $0.51 from pot
*** SUMMARY ***
Total pot $0.53 | Rake $0.02 | Jackpot $0 | Bingo $0 | Fortune $0 | Tax $0
Board [7s Kc Qc]
Seat 1: f38291df (button) folded before Flop (didn't bet)
Seat 2: 8f9bbae2 (small blind) folded before Flop
Seat 3: c4333c52 (big blind) folded on the Flop
Seat 4: Hero folded before Flop (didn't bet)
Seat 5: 5e52e81 folded before Flop (didn't bet)
Seat 6: e8ec4f2b won ($0.51)


Poker Hand #RC2774715148: Hold'em No Limit ($0.05/$0.1) - 2024/08/05 12:24:57
Table 'RushAndCash21380408' 6-max Seat #1 is the button
Seat 1: 150a0f7d ($7.45 in chips)
Seat 2: Hero ($10.33 in chips)
Seat 3: d28d30e4 ($23.84 in chips)
Seat 4: c4333c52 ($12.91 in chips)
Seat 5: c9320cd3 ($10.32 in chips)
Seat 6: 4e4da831 ($9.4 in chips)
Hero: posts small blind $0.05
d28d30e4: posts big blind $0.1
*** HOLE CARDS ***
Dealt to 150a0f7d 
Dealt to Hero [3h 5c]
Dealt to d28d30e4 
Dealt to c4333c52 
Dealt to c9320cd3 
Dealt to 4e4da831 
c4333c52: folds
c9320cd3: folds
4e4da831: folds
150a0f7d: raises $0.15 to $0.25
Hero: folds
d28d30e4: folds
Uncalled bet ($0.15) returned to 150a0f7d
*** SHOWDOWN ***
150a0f7d collected $0.25 from pot
*** SUMMARY ***
Total pot $0.25 | Rake $0 | Jackpot $0 | Bingo $0 | Fortune $0 | Tax $0
Seat 1: 150a0f7d (button) collected ($0.25)
Seat 2: Hero (small blind) folded before Flop
Seat 3: d28d30e4 (big blind) folded before Flop
Seat 4: c4333c52 folded before Flop (didn't bet)
Seat 5: c9320cd3 folded before Flop (didn't bet)
Seat 6: 4e4da831 folded before Flop (didn't bet)


Poker Hand #RC2774715121: Hold'em No Limit ($0.05/$0.1) - 2024/08/05 12:24:54
Table 'RushAndCash21380381' 6-max Seat #1 is the button
Seat 1: 4bd01f63 ($17.04 in chips)
Seat 2: 8ac89c2c ($10.11 in chips)
Seat 3: Hero ($10.43 in chips)
Seat 4: a5c2c2c9 ($6.08 in chips)
Seat 5: 35351de3 ($10.2 in chips)
Seat 6: 1b93dbd9 ($10.28 in chips)
8ac89c2c: posts small blind $0.05
Hero: posts big blind $0.1
*** HOLE CARDS ***
Dealt to 4bd01f63 
Dealt to 8ac89c2c 
Dealt to Hero [5s Kh]
Dealt to a5c2c2c9 
Dealt to 35351de3 
Dealt to 1b93dbd9 
a5c2c2c9: folds
35351de3: folds
1b93dbd9: folds
4bd01f63: folds
8ac89c2c: raises $0.1 to $0.2
Hero: folds
Uncalled bet ($0.1) returned to 8ac89c2c
*** SHOWDOWN ***
8ac89c2c collected $0.2 from pot
*** SUMMARY ***
Total pot $0.2 | Rake $0 | Jackpot $0 | Bingo $0 | Fortune $0 | Tax $0
Seat 1: 4bd01f63 (button) folded before Flop (didn't bet)
Seat 2: 8ac89c2c (small blind) collected ($0.2)
Seat 3: Hero (big blind) folded before Flop
Seat 4: a5c2c2c9 folded before Flop (didn't bet)
Seat 5: 35351de3 folded before Flop (didn't bet)
Seat 6: 1b93dbd9 folded before Flop (didn't bet)


Poker Hand #RC2774715082: Hold'em No Limit ($0.05/$0.1) - 2024/08/05 12:24:49
Table 'RushAndCash21380342' 6-max Seat #1 is the button
Seat 1: 70431863 ($19.6 in chips)
Seat 2: fb4632c7 ($13.62 in chips)
Seat 3: 8f9bbae2 ($13.97 in chips)
Seat 4: 68fe2fd0 ($10.82 in chips)
Seat 5: Hero ($10.43 in chips)
Seat 6: 55102729 ($13.62 in chips)
fb4632c7: posts small blind $0.05
8f9bbae2: posts big blind $0.1
*** HOLE CARDS ***
Dealt to 70431863 
Dealt to fb4632c7 
Dealt to 8f9bbae2 
Dealt to 68fe2fd0 
Dealt to Hero [Tc 3h]
Dealt to 55102729 
68fe2fd0: folds
Hero: folds
55102729: folds
70431863: raises $0.15 to $0.25
fb4632c7: folds
8f9bbae2: folds
Uncalled bet ($0.15) returned to 70431863
*** SHOWDOWN ***
70431863 collected $0.25 from pot
*** SUMMARY ***
Total pot $0.25 | Rake $0 | Jackpot $0 | Bingo $0 | Fortune $0 | Tax $0
Seat 1: 70431863 (button) collected ($0.25)
Seat 2: fb4632c7 (small blind) folded before Flop
Seat 3: 8f9bbae2 (big blind) folded before Flop
Seat 4: 68fe2fd0 folded before Flop (didn't bet)
Seat 5: Hero folded before Flop (didn't bet)
Seat 6: 55102729 folded before Flop (didn't bet)


Poker Hand #RC2774715025: Hold'em No Limit ($0.05/$0.1) - 2024/08/05 12:24:41
Table 'RushAndCash21380285' 6-max Seat #1 is the button
Seat 1: Hero ($10.43 in chips)
Seat 2: a42a4e96 ($13.05 in chips)
Seat 3: a41a5c6e ($10.55 in chips)
Seat 4: 527de330 ($10 in chips)
Seat 5: 90577903 ($10 in chips)
Seat 6: a181a32a ($10 in chips)
a42a4e96: posts small blind $0.05
a41a5c6e: posts big blind $0.1
*** HOLE CARDS ***
Dealt to Hero [4s Kd]
Dealt to a42a4e96 
Dealt to a41a5c6e 
Dealt to 527de330 
Dealt to 90577903 
Dealt to a181a32a 
527de330: folds
90577903: folds
a181a32a: raises $0.15 to $0.25
Hero: folds
a42a4e96: folds
a41a5c6e: calls $0.15
*** FLOP *** [Jd 9d 3c]
a41a5c6e: checks
a181a32a: bets $0.19
a41a5c6e: folds
Uncalled bet ($0.19) returned to a181a32a
*** SHOWDOWN ***
a181a32a collected $0.53 from pot
*** SUMMARY ***
Total pot $0.55 | Rake $0.02 | Jackpot $0 | Bingo $0 | Fortune $0 | Tax $0
Board [Jd 9d 3c]
Seat 1: Hero (button) folded before Flop (didn't bet)
Seat 2: a42a4e96 (small blind) folded before Flop
Seat 3: a41a5c6e (big blind) folded on the Flop
Seat 4: 527de330 folded before Flop (didn't bet)
Seat 5: 90577903 folded before Flop (didn't bet)
Seat 6: a181a32a won ($0.53)


Poker Hand #RC2774714999: Hold'em No Limit ($0.05/$0.1) - 2024/08/05 12:24:38
Table 'RushAndCash21380259' 6-max Seat #1 is the button
Seat 1: 8b8c29f1 ($23.94 in chips)
Seat 2: 860bc69a ($12.19 in chips)
Seat 3: d4cb0a8 ($10.38 in chips)
Seat 4: 9886bba4 ($10.22 in chips)
Seat 5: 511bf05 ($16.47 in chips)
Seat 6: Hero ($10.43 in chips)
860bc69a: posts small blind $0.05
d4cb0a8: posts big blind $0.1
*** HOLE CARDS ***
Dealt to 8b8c29f1 
Dealt to 860bc69a 
Dealt to d4cb0a8 
Dealt to 9886bba4 
Dealt to 511bf05 
Dealt to Hero [2s 5s]
9886bba4: folds
511bf05: raises $0.2 to $0.3
Hero: folds
8b8c29f1: folds
860bc69a: folds
d4cb0a8: folds
Uncalled bet ($0.2) returned to 511bf05
*** SHOWDOWN ***
511bf05 collected $0.25 from pot
*** SUMMARY ***
Total pot $0.25 | Rake $0 | Jackpot $0 | Bingo $0 | Fortune $0 | Tax $0
Seat 1: 8b8c29f1 (button) folded before Flop (didn't bet)
Seat 2: 860bc69a (small blind) folded before Flop
Seat 3: d4cb0a8 (big blind) folded before Flop
Seat 4: 9886bba4 folded before Flop (didn't bet)
Seat 5: 511bf05 collected ($0.25)
Seat 6: Hero folded before Flop (didn't bet)


Poker Hand #RC2774714947: Hold'em No Limit ($0.05/$0.1) - 2024/08/05 12:24:31
Table 'RushAndCash21380207' 6-max Seat #1 is the button
Seat 1: 44cfb570 ($13.12 in chips)
Seat 2: 94218f2 ($11.68 in chips)
Seat 3: d26f83cb ($14.07 in chips)
Seat 4: 320f691a ($13.36 in chips)
Seat 5: f273aa04 ($13.12 in chips)
Seat 6: Hero ($10.43 in chips)
94218f2: posts small blind $0.05
d26f83cb: posts big blind $0.1
*** HOLE CARDS ***
Dealt to 44cfb570 
Dealt to 94218f2 
Dealt to d26f83cb 
Dealt to 320f691a 
Dealt to f273aa04 
Dealt to Hero [Th 7c]
320f691a: folds
f273aa04: folds
Hero: folds
44cfb570: folds
94218f2: raises $0.2 to $0.3
d26f83cb: calls $0.2
*** FLOP *** [Qc 4c 5s]
94218f2: bets $0.2
d26f83cb: folds
Uncalled bet ($0.2) returned to 94218f2
*** SHOWDOWN ***
94218f2 collected $0.57 from pot
*** SUMMARY ***
Total pot $0.6 | Rake $0.03 | Jackpot $0 | Bingo $0 | Fortune $0 | Tax $0
Board [Qc 4c 5s]
Seat 1: 44cfb570 (button) folded before Flop (didn't bet)
Seat 2: 94218f2 (small blind) won ($0.57)
Seat 3: d26f83cb (big blind) folded on the Flop
Seat 4: 320f691a folded before Flop (didn't bet)
Seat 5: f273aa04 folded before Flop (didn't bet)
Seat 6: Hero folded before Flop (didn't bet)


Poker Hand #RC2774714919: Hold'em No Limit ($0.05/$0.1) - 2024/08/05 12:24:27
Table 'RushAndCash21380179' 6-max Seat #1 is the button
Seat 1: Hero ($10.43 in chips)
Seat 2: ea29259a ($11.47 in chips)
Seat 3: 9ac005fd ($12.16 in chips)
Seat 4: a42a4e96 ($13.05 in chips)
Seat 5: f6613215 ($19.54 in chips)
Seat 6: 1cfe1fc0 ($10.28 in chips)
ea29259a: posts small blind $0.05
9ac005fd: posts big blind $0.1
*** HOLE CARDS ***
Dealt to Hero [3d Ts]
Dealt to ea29259a 
Dealt to 9ac005fd 
Dealt to a42a4e96 
Dealt to f6613215 
Dealt to 1cfe1fc0 
a42a4e96: folds
f6613215: folds
1cfe1fc0: folds
Hero: folds
ea29259a: raises $0.2 to $0.3
9ac005fd: folds
Uncalled bet ($0.2) returned to ea29259a
*** SHOWDOWN ***
ea29259a collected $0.2 from pot
*** SUMMARY ***
Total pot $0.2 | Rake $0 | Jackpot $0 | Bingo $0 | Fortune $0 | Tax $0
Seat 1: Hero (button) folded before Flop (didn't bet)
Seat 2: ea29259a (small blind) collected ($0.2)
Seat 3: 9ac005fd (big blind) folded before Flop
Seat 4: a42a4e96 folded before Flop (didn't bet)
Seat 5: f6613215 folded before Flop (didn't bet)
Seat 6: 1cfe1fc0 folded before Flop (didn't bet)


Poker Hand #RC2774714894: Hold'em No Limit ($0.05/$0.1) - 2024/08/05 12:24:24
Table 'RushAndCash21380154' 6-max Seat #1 is the button
Seat 1: f880ba3f ($4.58 in chips)
Seat 2: Hero ($10.48 in chips)
Seat 3: 2051a9e6 ($10.05 in chips)
Seat 4: 6c735362 ($9.59 in chips)
Seat 5: b30e0cdc ($11.5 in chips)
Seat 6: 33c885e6 ($11.75 in chips)
Hero: posts small blind $0.05
2051a9e6: posts big blind $0.1
*** HOLE CARDS ***
Dealt to f880ba3f 
Dealt to Hero [8h 3h]
Dealt to 2051a9e6 
Dealt to 6c735362 
Dealt to b30e0cdc 
Dealt to 33c885e6 
6c735362: raises $0.2 to $0.3
b30e0cdc: folds
33c885e6: folds
f880ba3f: folds
Hero: folds
2051a9e6: folds
Uncalled bet ($0.2) returned to 6c735362
*** SHOWDOWN ***
6c735362 collected $0.25 from pot
*** SUMMARY ***
Total pot $0.25 | Rake $0 | Jackpot $0 | Bingo $0 | Fortune $0 | Tax $0
Seat 1: f880ba3f (button) folded before Flop (didn't bet)
Seat 2: Hero (small blind) folded before Flop
Seat 3: 2051a9e6 (big blind) folded before Flop
Seat 4: 6c735362 collected ($0.25)
Seat 5: b30e0cdc folded before Flop (didn't bet)
Seat 6: 33c885e6 folded before Flop (didn't bet)


Poker Hand #RC2774714867: Hold'em No Limit ($0.05/$0.1) - 2024/08/05 12:24:20
Table 'RushAndCash21380127' 6-max Seat #1 is the button
Seat 1: 9b9d8b69 ($20.04 in chips)
Seat 2: 1c9061e5 ($18.53 in chips)
Seat 3: 8f878aa9 ($10.9 in chips)
Seat 4: 3cd72ff5 ($10.96 in chips)
Seat 5: 33c885e6 ($11.75 in chips)
Seat 6: Hero ($10.48 in chips)
1c9061e5: posts small blind $0.05
8f878aa9: posts big blind $0.1
*** HOLE CARDS ***
Dealt to 9b9d8b69 
Dealt to 1c9061e5 
Dealt to 8f878aa9 
Dealt to 3cd72ff5 
Dealt to 33c885e6 
Dealt to Hero [3d Ts]
3cd72ff5: folds
33c885e6: folds
Hero: folds
9b9d8b69: raises $0.1 to $0.2
1c9061e5: folds
8f878aa9: raises $0.34 to $0.54
9b9d8b69: calls $0.34
*** FLOP *** [5c Ah Kc]
8f878aa9: checks
9b9d8b69: checks
*** TURN *** [5c Ah Kc] [3h]
8f878aa9: bets $0.85
9b9d8b69: folds
Uncalled bet ($0.85) returned to 8f878aa9
*** SHOWDOWN ***
8f878aa9 collected $1.08 from pot
*** SUMMARY ***
Total pot $1.13 | Rake $0.05 | Jackpot $0 | Bingo $0 | Fortune $0 | Tax $0
Board [5c Ah Kc 3h]
Seat 1: 9b9d8b69 (button) folded on the Turn
Seat 2: 1c9061e5 (small blind) folded before Flop
Seat 3: 8f878aa9 (big blind) won ($1.08)
Seat 4: 3cd72ff5 folded before Flop (didn't bet)
Seat 5: 33c885e6 folded before Flop (didn't bet)
Seat 6: Hero folded before Flop (didn't bet)


Poker Hand #RC2774714842: Hold'em No Limit ($0.05/$0.1) - 2024/08/05 12:24:17
Table 'RushAndCash21380102' 6-max Seat #1 is the button
Seat 1: bc31de8a ($10 in chips)
Seat 2: 150a0f7d ($3.9 in chips)
Seat 3: Hero ($10.58 in chips)
Seat 4: 7991388d ($16 in chips)
Seat 5: f95ea52 ($11.71 in chips)
Seat 6: b407a400 ($10.9 in chips)
150a0f7d: posts small blind $0.05
Hero: posts big blind $0.1
*** HOLE CARDS ***
Dealt to bc31de8a 
Dealt to 150a0f7d 
Dealt to Hero [6d Ac]
Dealt to 7991388d 
Dealt to f95ea52 
Dealt to b407a400 
7991388d: folds
f95ea52: raises $0.15 to $0.25
b407a400: folds
bc31de8a: folds
150a0f7d: raises $0.66 to $0.91
Hero: folds
f95ea52: calls $0.66
*** FLOP *** [Qd 2d 4h]
150a0f7d: bets $2.99 and is all-in
f95ea52: calls $2.99
150a0f7d: shows [Qs Ah] (Pair of Queens)
f95ea52: shows [Qc Ks] (Pair of Queens)
*** TURN *** [Qd 2d 4h] [4d]
*** RIVER *** [Qd 2d 4h 4d] [9c]
*** SHOWDOWN ***
150a0f7d collected $7.45 from pot
*** SUMMARY ***
Total pot $7.9 | Rake $0.3 | Jackpot $0.15 | Bingo $0 | Fortune $0 | Tax $0
Board [Qd 2d 4h 4d 9c]
Seat 1: bc31de8a (button) folded before Flop (didn't bet)
Seat 2: 150a0f7d (small blind) showed [Qs Ah] and won ($7.45) with Pair of Queens and Pair of Fours
Seat 3: Hero (big blind) folded before Flop
Seat 4: 7991388d folded before Flop (didn't bet)
Seat 5: f95ea52 showed [Qc Ks] and lost with Pair of Queens and Pair of Fours
Seat 6: b407a400 folded before Flop (didn't bet)


Poker Hand #RC2774714817: Hold'em No Limit ($0.05/$0.1) - 2024/08/05 12:24:14
Table 'RushAndCash21380077' 6-max Seat #1 is the button
Seat 1: 38ec9e55 ($8.3 in chips)
Seat 2: 7e3d74ea ($10 in chips)
Seat 3: f8ded6e2 ($19.65 in chips)
Seat 4: 2087d64 ($11.61 in chips)
Seat 5: 8c035ec7 ($10 in chips)
Seat 6: Hero ($10.58 in chips)
7e3d74ea: posts small blind $0.05
f8ded6e2: posts big blind $0.1
*** HOLE CARDS ***
Dealt to 38ec9e55 
Dealt to 7e3d74ea 
Dealt to f8ded6e2 
Dealt to 2087d64 
Dealt to 8c035ec7 
Dealt to Hero [Qc 3s]
2087d64: raises $0.1 to $0.2
8c035ec7: folds
Hero: folds
38ec9e55: folds
7e3d74ea: folds
f8ded6e2: folds
Uncalled bet ($0.1) returned to 2087d64
*** SHOWDOWN ***
2087d64 collected $0.25 from pot
*** SUMMARY ***
Total pot $0.25 | Rake $0 | Jackpot $0 | Bingo $0 | Fortune $0 | Tax $0
Seat 1: 38ec9e55 (button) folded before Flop (didn't bet)
Seat 2: 7e3d74ea (small blind) folded before Flop
Seat 3: f8ded6e2 (big blind) folded before Flop
Seat 4: 2087d64 collected ($0.25)
Seat 5: 8c035ec7 folded before Flop (didn't bet)
Seat 6: Hero folded before Flop (didn't bet)


Poker Hand #RC2774714771: Hold'em No Limit ($0.05/$0.1) - 2024/08/05 12:24:07
Table 'RushAndCash21380031' 6-max Seat #1 is the button
Seat 1: 87d59ce6 ($11.33 in chips)
Seat 2: 90577903 ($10.22 in chips)
Seat 3: 53dbe5c2 ($10.61 in chips)
Seat 4: 794c80b8 ($27.07 in chips)
Seat 5: Hero ($10.58 in chips)
Seat 6: 7db9a084 ($11.33 in chips)
90577903: posts small blind $0.05
53dbe5c2: posts big blind $0.1
*** HOLE CARDS ***
Dealt to 87d59ce6 
Dealt to 90577903 
Dealt to 53dbe5c2 
Dealt to 794c80b8 
Dealt to Hero [8h 2h]
Dealt to 7db9a084 
794c80b8: folds
Hero: folds
7db9a084: folds
87d59ce6: folds
90577903: raises $0.2 to $0.3
53dbe5c2: calls $0.2
*** FLOP *** [Ts Ah 3h]
90577903: checks
53dbe5c2: bets $0.2
90577903: folds
Uncalled bet ($0.2) returned to 53dbe5c2
*** SHOWDOWN ***
53dbe5c2 collected $0.57 from pot
*** SUMMARY ***
Total pot $0.6 | Rake $0.03 | Jackpot $0 | Bingo $0 | Fortune $0 | Tax $0
Board [Ts Ah 3h]
Seat 1: 87d59ce6 (button) folded before Flop (didn't bet)
Seat 2: 90577903 (small blind) folded on the Flop
Seat 3: 53dbe5c2 (big blind) won ($0.57)
Seat 4: 794c80b8 folded before Flop (didn't bet)
Seat 5: Hero folded before Flop (didn't bet)
Seat 6: 7db9a084 folded before Flop (didn't bet)


Poker Hand #RC2774679629: Hold'em No Limit ($0.05/$0.1) - 2024/08/05 12:13:10
Table 'RushAndCash21374889' 6-max Seat #1 is the button
Seat 1: 4f1f3f47 ($19.04 in chips)
Seat 2: be6b5098 ($14.43 in chips)
Seat 3: Hero ($11.12 in chips)
Seat 4: 96d7955 ($19.02 in chips)
Seat 5: 49d2b5ba ($11.61 in chips)
Seat 6: ea774947 ($11.48 in chips)
be6b5098: posts small blind $0.05
Hero: posts big blind $0.1
*** HOLE CARDS ***
Dealt to 4f1f3f47 
Dealt to be6b5098 
Dealt to Hero [9d 9c]
Dealt to 96d7955 
Dealt to 49d2b5ba 
Dealt to ea774947 
96d7955: raises $0.1 to $0.2
49d2b5ba: folds
ea774947: folds
4f1f3f47: folds
be6b5098: folds
Hero: calls $0.1
*** FLOP *** [Th 8d 8h]
Hero: checks
96d7955: bets $0.34
Hero: calls $0.34
*** TURN *** [Th 8d 8h] [2h]
Hero: checks
96d7955: bets $0.57
Hero: folds
Uncalled bet ($0.57) returned to 96d7955
*** SHOWDOWN ***
96d7955 collected $1.08 from pot
*** SUMMARY ***
Total pot $1.13 | Rake $0.05 | Jackpot $0 | Bingo $0 | Fortune $0 | Tax $0
Board [Th 8d 8h 2h]
Seat 1: 4f1f3f47 (button) folded before Flop (didn't bet)
Seat 2: be6b5098 (small blind) folded before Flop
Seat 3: Hero (big blind) folded on the Turn
Seat 4: 96d7955 won ($1.08)
Seat 5: 49d2b5ba folded before Flop (didn't bet)
Seat 6: ea774947 folded before Flop (didn't bet)


Poker Hand #RC2774679597: Hold'em No Limit ($0.05/$0.1) - 2024/08/05 12:13:06
Table 'RushAndCash21374857' 6-max Seat #1 is the button
Seat 1: 6b4fe244 ($10 in chips)
Seat 2: Hero ($11.17 in chips)
Seat 3: 605962a ($10 in chips)
Seat 4: dc8e0be1 ($10 in chips)
Seat 5: 4a5029c2 ($10.13 in chips)
Seat 6: dcd0673c ($14.85 in chips)
Hero: posts small blind $0.05
605962a: posts big blind $0.1
*** HOLE CARDS ***
Dealt to 6b4fe244 
Dealt to Hero [5d 2s]
Dealt to 605962a 
Dealt to dc8e0be1 
Dealt to 4a5029c2 
Dealt to dcd0673c 
dc8e0be1: folds
4a5029c2: folds
dcd0673c: folds
6b4fe244: folds
Hero: folds
Uncalled bet ($0.05) returned to 605962a
*** SHOWDOWN ***
605962a collected $0.1 from pot
*** SUMMARY ***
Total pot $0.1 | Rake $0 | Jackpot $0 | Bingo $0 | Fortune $0 | Tax $0
Seat 1: 6b4fe244 (button) folded before Flop (didn't bet)
Seat 2: Hero (small blind) folded before Flop
Seat 3: 605962a (big blind) collected ($0.1)
Seat 4: dc8e0be1 folded before Flop (didn't bet)
Seat 5: 4a5029c2 folded before Flop (didn't bet)
Seat 6: dcd0673c folded before Flop (didn't bet)


Poker Hand #RC2774679516: Hold'em No Limit ($0.05/$0.1) - 2024/08/05 12:12:56
Table 'RushAndCash21374776' 6-max Seat #1 is the button
Seat 1: Hero ($11.17 in chips)
Seat 2: db694ae4 ($13.06 in chips)
Seat 3: 675e1925 ($10.05 in chips)
Seat 4: eca0bbe7 ($10 in chips)
Seat 5: fd5f51fb ($21.36 in chips)
Seat 6: 3956a8ec ($26.92 in chips)
db694ae4: posts small blind $0.05
675e1925: posts big blind $0.1
*** HOLE CARDS ***
Dealt to Hero [5d 2c]
Dealt to db694ae4 
Dealt to 675e1925 
Dealt to eca0bbe7 
Dealt to fd5f51fb 
Dealt to 3956a8ec 
eca0bbe7: raises $0.1 to $0.2
fd5f51fb: folds
3956a8ec: folds
Hero: folds
db694ae4: raises $0.83 to $1.03
675e1925: folds
eca0bbe7: folds
Uncalled bet ($0.83) returned to db694ae4
*** SHOWDOWN ***
db694ae4 collected $0.48 from pot
*** SUMMARY ***
Total pot $0.5 | Rake $0.02 | Jackpot $0 | Bingo $0 | Fortune $0 | Tax $0
Seat 1: Hero (button) folded before Flop (didn't bet)
Seat 2: db694ae4 (small blind) collected ($0.48)
Seat 3: 675e1925 (big blind) folded before Flop
Seat 4: eca0bbe7 folded before Flop
Seat 5: fd5f51fb folded before Flop (didn't bet)
Seat 6: 3956a8ec folded before Flop (didn't bet)


Poker Hand #RC2774679487: Hold'em No Limit ($0.05/$0.1) - 2024/08/05 12:12:53
Table 'RushAndCash21374747' 6-max Seat #1 is the button
Seat 1: ee50c8ac ($13.01 in chips)
Seat 2: 3681db75 ($12.58 in chips)
Seat 3: 888e2275 ($10.15 in chips)
Seat 4: e49005b6 ($10.1 in chips)
Seat 5: c7552f9 ($9.85 in chips)
Seat 6: Hero ($11.17 in chips)
3681db75: posts small blind $0.05
888e2275: posts big blind $0.1
*** HOLE CARDS ***
Dealt to ee50c8ac 
Dealt to 3681db75 
Dealt to 888e2275 
Dealt to e49005b6 
Dealt to c7552f9 
Dealt to Hero [Tc 5d]
e49005b6: folds
c7552f9: folds
Hero: folds
ee50c8ac: raises $0.1 to $0.2
3681db75: folds
888e2275: calls $0.1
*** FLOP *** [6d Td 3h]
888e2275: checks
ee50c8ac: bets $0.15
888e2275: calls $0.15
*** TURN *** [6d Td 3h] [Qd]
888e2275: checks
ee50c8ac: bets $0.57
888e2275: folds
Uncalled bet ($0.57) returned to ee50c8ac
*** SHOWDOWN ***
ee50c8ac collected $0.72 from pot
*** SUMMARY ***
Total pot $0.75 | Rake $0.03 | Jackpot $0 | Bingo $0 | Fortune $0 | Tax $0
Board [6d Td 3h Qd]
Seat 1: ee50c8ac (button) won ($0.72)
Seat 2: 3681db75 (small blind) folded before Flop
Seat 3: 888e2275 (big blind) folded on the Turn
Seat 4: e49005b6 folded before Flop (didn't bet)
Seat 5: c7552f9 folded before Flop (didn't bet)
Seat 6: Hero folded before Flop (didn't bet)


Poker Hand #RC2774679444: Hold'em No Limit ($0.05/$0.1) - 2024/08/05 12:12:47
Table 'RushAndCash21374704' 6-max Seat #1 is the button
Seat 1: dede9713 ($17.39 in chips)
Seat 2: ae6a98bd ($11.94 in chips)
Seat 3: fe151409 ($20.26 in chips)
Seat 4: Hero ($11.17 in chips)
Seat 5: 1433ed2c ($13.08 in chips)
Seat 6: 8a3c0da8 ($18.87 in chips)
ae6a98bd: posts small blind $0.05
fe151409: posts big blind $0.1
*** HOLE CARDS ***
Dealt to dede9713 
Dealt to ae6a98bd 
Dealt to fe151409 
Dealt to Hero [9c 5c]
Dealt to 1433ed2c 
Dealt to 8a3c0da8 
Hero: folds
1433ed2c: folds
8a3c0da8: raises $0.1 to $0.2
dede9713: folds
ae6a98bd: folds
fe151409: folds
Uncalled bet ($0.1) returned to 8a3c0da8
*** SHOWDOWN ***
8a3c0da8 collected $0.25 from pot
*** SUMMARY ***
Total pot $0.25 | Rake $0 | Jackpot $0 | Bingo $0 | Fortune $0 | Tax $0
Seat 1: dede9713 (button) folded before Flop (didn't bet)
Seat 2: ae6a98bd (small blind) folded before Flop
Seat 3: fe151409 (big blind) folded before Flop
Seat 4: Hero folded before Flop (didn't bet)
Seat 5: 1433ed2c folded before Flop (didn't bet)
Seat 6: 8a3c0da8 collected ($0.25)


Poker Hand #RC2774679403: Hold'em No Limit ($0.05/$0.1) - 2024/08/05 12:12:42
Table 'RushAndCash21374663' 6-max Seat #1 is the button
Seat 1: Hero ($11.17 in chips)
Seat 2: 9944d193 ($10.9 in chips)
Seat 3: 5580da68 ($10 in chips)
Seat 4: 30ada1b3 ($11.33 in chips)
Seat 5: a065f94e ($10 in chips)
Seat 6: e1ffe7bb ($13.92 in chips)
9944d193: posts small blind $0.05
5580da68: posts big blind $0.1
*** HOLE CARDS ***
Dealt to Hero [6h Jd]
Dealt to 9944d193 
Dealt to 5580da68 
Dealt to 30ada1b3 
Dealt to a065f94e 
Dealt to e1ffe7bb 
30ada1b3: folds
a065f94e: folds
e1ffe7bb: folds
Hero: folds
9944d193: folds
Uncalled bet ($0.05) returned to 5580da68
*** SHOWDOWN ***
5580da68 collected $0.1 from pot
*** SUMMARY ***
Total pot $0.1 | Rake $0 | Jackpot $0 | Bingo $0 | Fortune $0 | Tax $0
Seat 1: Hero (button) folded before Flop (didn't bet)
Seat 2: 9944d193 (small blind) folded before Flop
Seat 3: 5580da68 (big blind) collected ($0.1)
Seat 4: 30ada1b3 folded before Flop (didn't bet)
Seat 5: a065f94e folded before Flop (didn't bet)
Seat 6: e1ffe7bb folded before Flop (didn't bet)


Poker Hand #RC2774679359: Hold'em No Limit ($0.05/$0.1) - 2024/08/05 12:12:36
Table 'RushAndCash21374619' 6-max Seat #1 is the button
Seat 1: 8669e249 ($32.91 in chips)
Seat 2: 90577903 ($11.41 in chips)
Seat 3: Hero ($11.27 in chips)
Seat 4: 364902ff ($10.37 in chips)
Seat 5: 93557287 ($22.85 in chips)
Seat 6: bdadd860 ($10.03 in chips)
90577903: posts small blind $0.05
Hero: posts big blind $0.1
*** HOLE CARDS ***
Dealt to 8669e249 
Dealt to 90577903 
Dealt to Hero [9d 3d]
Dealt to 364902ff 
Dealt to 93557287 
Dealt to bdadd860 
364902ff: raises $0.12 to $0.22
93557287: folds
bdadd860: raises $0.45 to $0.67
8669e249: folds
90577903: folds
Hero: folds
364902ff: raises $1.12 to $1.79
bdadd860: folds
Uncalled bet ($1.12) returned to 364902ff
*** SHOWDOWN ***
364902ff collected $1.42 from pot
*** SUMMARY ***
Total pot $1.49 | Rake $0.07 | Jackpot $0 | Bingo $0 | Fortune $0 | Tax $0
Seat 1: 8669e249 (button) folded before Flop (didn't bet)
Seat 2: 90577903 (small blind) folded before Flop
Seat 3: Hero (big blind) folded before Flop
Seat 4: 364902ff collected ($1.42)
Seat 5: 93557287 folded before Flop (didn't bet)
Seat 6: bdadd860 folded before Flop


Poker Hand #RC2774679335: Hold'em No Limit ($0.05/$0.1) - 2024/08/05 12:12:33
Table 'RushAndCash21374595' 6-max Seat #1 is the button
Seat 1: 8f7c02cf ($17.82 in chips)
Seat 2: Hero ($11.32 in chips)
Seat 3: aa57610b ($10 in chips)
Seat 4: 18e5d625 ($11.92 in chips)
Seat 5: 9944d193 ($11 in chips)
Seat 6: df1ab532 ($10 in chips)
Hero: posts small blind $0.05
aa57610b: posts big blind $0.1
*** HOLE CARDS ***
Dealt to 8f7c02cf 
Dealt to Hero [5c Ts]
Dealt to aa57610b 
Dealt to 18e5d625 
Dealt to 9944d193 
Dealt to df1ab532 
18e5d625: raises $0.1 to $0.2
9944d193: folds
df1ab532: folds
8f7c02cf: folds
Hero: folds
aa57610b: folds
Uncalled bet ($0.1) returned to 18e5d625
*** SHOWDOWN ***
18e5d625 collected $0.25 from pot
*** SUMMARY ***
Total pot $0.25 | Rake $0 | Jackpot $0 | Bingo $0 | Fortune $0 | Tax $0
Seat 1: 8f7c02cf (button) folded before Flop (didn't bet)
Seat 2: Hero (small blind) folded before Flop
Seat 3: aa57610b (big blind) folded before Flop
Seat 4: 18e5d625 collected ($0.25)
Seat 5: 9944d193 folded before Flop (didn't bet)
Seat 6: df1ab532 folded before Flop (didn't bet)


Poker Hand #RC2774679264: Hold'em No Limit ($0.05/$0.1) - 2024/08/05 12:12:25
Table 'RushAndCash21374524' 6-max Seat #1 is the button
Seat 1: ea774947 ($11.07 in chips)
Seat 2: 74ce64d1 ($10 in chips)
Seat 3: fbe6dd7e ($14.38 in chips)
Seat 4: Hero ($11.32 in chips)
Seat 5: 644022ea ($16.64 in chips)
Seat 6: 2035c523 ($10.87 in chips)
74ce64d1: posts small blind $0.05
fbe6dd7e: posts big blind $0.1
*** HOLE CARDS ***
Dealt to ea774947 
Dealt to 74ce64d1 
Dealt to fbe6dd7e 
Dealt to Hero [6h 7h]
Dealt to 644022ea 
Dealt to 2035c523 
Hero: folds
644022ea: raises $0.15 to $0.25
2035c523: folds
ea774947: folds
74ce64d1: folds
fbe6dd7e: folds
Uncalled bet ($0.15) returned to 644022ea
*** SHOWDOWN ***
644022ea collected $0.25 from pot
*** SUMMARY ***
Total pot $0.25 | Rake $0 | Jackpot $0 | Bingo $0 | Fortune $0 | Tax $0
Seat 1: ea774947 (button) folded before Flop (didn't bet)
Seat 2: 74ce64d1 (small blind) folded before Flop
Seat 3: fbe6dd7e (big blind) folded before Flop
Seat 4: Hero folded before Flop (didn't bet)
Seat 5: 644022ea collected ($0.25)
Seat 6: 2035c523 folded before Flop (didn't bet)


Poker Hand #RC2774679234: Hold'em No Limit ($0.05/$0.1) - 2024/08/05 12:12:21
Table 'RushAndCash21374494' 6-max Seat #1 is the button
Seat 1: 35672bc8 ($10.58 in chips)
Seat 2: c0d0e77 ($10 in chips)
Seat 3: 55744bec ($10.7 in chips)
Seat 4: Hero ($11.32 in chips)
Seat 5: 837ed007 ($10 in chips)
Seat 6: e3b959e2 ($10.04 in chips)
c0d0e77: posts small blind $0.05
55744bec: posts big blind $0.1
*** HOLE CARDS ***
Dealt to 35672bc8 
Dealt to c0d0e77 
Dealt to 55744bec 
Dealt to Hero [5c 9c]
Dealt to 837ed007 
Dealt to e3b959e2 
Hero: folds
837ed007: folds
e3b959e2: folds
35672bc8: folds
c0d0e77: raises $0.2 to $0.3
55744bec: folds
Uncalled bet ($0.2) returned to c0d0e77
*** SHOWDOWN ***
c0d0e77 collected $0.2 from pot
*** SUMMARY ***
Total pot $0.2 | Rake $0 | Jackpot $0 | Bingo $0 | Fortune $0 | Tax $0
Seat 1: 35672bc8 (button) folded before Flop (didn't bet)
Seat 2: c0d0e77 (small blind) collected ($0.2)
Seat 3: 55744bec (big blind) folded before Flop
Seat 4: Hero folded before Flop (didn't bet)
Seat 5: 837ed007 folded before Flop (didn't bet)
Seat 6: e3b959e2 folded before Flop (didn't bet)


Poker Hand #RC2774679208: Hold'em No Limit ($0.05/$0.1) - 2024/08/05 12:12:18
Table 'RushAndCash21374468' 6-max Seat #1 is the button
Seat 1: 3ed5852c ($10.76 in chips)
Seat 2: b8e23b7 ($26.88 in chips)
Seat 3: edc7356b ($22.67 in chips)
Seat 4: Hero ($11.32 in chips)
Seat 5: 3f3545f ($10.42 in chips)
Seat 6: 55744bec ($10.7 in chips)
b8e23b7: posts small blind $0.05
edc7356b: posts big blind $0.1
*** HOLE CARDS ***
Dealt to 3ed5852c 
Dealt to b8e23b7 
Dealt to edc7356b 
Dealt to Hero [Ks 6c]
Dealt to 3f3545f 
Dealt to 55744bec 
Hero: folds
3f3545f: folds
55744bec: folds
3ed5852c: folds
b8e23b7: raises $0.2 to $0.3
edc7356b: folds
Uncalled bet ($0.2) returned to b8e23b7
*** SHOWDOWN ***
b8e23b7 collected $0.2 from pot
*** SUMMARY ***
Total pot $0.2 | Rake $0 | Jackpot $0 | Bingo $0 | Fortune $0 | Tax $0
Seat 1: 3ed5852c (button) folded before Flop (didn't bet)
Seat 2: b8e23b7 (small blind) collected ($0.2)
Seat 3: edc7356b (big blind) folded before Flop
Seat 4: Hero folded before Flop (didn't bet)
Seat 5: 3f3545f folded before Flop (didn't bet)
Seat 6: 55744bec folded before Flop (didn't bet)


Poker Hand #RC2774679168: Hold'em No Limit ($0.05/$0.1) - 2024/08/05 12:12:12
Table 'RushAndCash21374428' 6-max Seat #1 is the button
Seat 1: 119b4384 ($10.08 in chips)
Seat 2: 494400ed ($10 in chips)
Seat 3: 6d32edbd ($13.3 in chips)
Seat 4: 3681db75 ($12.73 in chips)
Seat 5: Hero ($11.32 in chips)
Seat 6: ff18697 ($10.15 in chips)
494400ed: posts small blind $0.05
6d32edbd: posts big blind $0.1
*** HOLE CARDS ***
Dealt to 119b4384 
Dealt to 494400ed 
Dealt to 6d32edbd 
Dealt to 3681db75 
Dealt to Hero [Kc 9h]
Dealt to ff18697 
3681db75: folds
Hero: folds
ff18697: folds
119b4384: raises $0.1 to $0.2
494400ed: folds
6d32edbd: folds
Uncalled bet ($0.1) returned to 119b4384
*** SHOWDOWN ***
119b4384 collected $0.25 from pot
*** SUMMARY ***
Total pot $0.25 | Rake $0 | Jackpot $0 | Bingo $0 | Fortune $0 | Tax $0
Seat 1: 119b4384 (button) collected ($0.25)
Seat 2: 494400ed (small blind) folded before Flop
Seat 3: 6d32edbd (big blind) folded before Flop
Seat 4: 3681db75 folded before Flop (didn't bet)
Seat 5: Hero folded before Flop (didn't bet)
Seat 6: ff18697 folded before Flop (didn't bet)


Poker Hand #RC2774679121: Hold'em No Limit ($0.05/$0.1) - 2024/08/05 12:12:06
Table 'RushAndCash21374381' 6-max Seat #1 is the button
Seat 1: afa8f28a ($9.01 in chips)
Seat 2: Hero ($11.37 in chips)
Seat 3: 93557287 ($22.9 in chips)
Seat 4: 1c7dcb28 ($11.13 in chips)
Seat 5: f758d044 ($10 in chips)
Seat 6: 3d571954 ($30.08 in chips)
Hero: posts small blind $0.05
93557287: posts big blind $0.1
*** HOLE CARDS ***
Dealt to afa8f28a 
Dealt to Hero [8s Qc]
Dealt to 93557287 
Dealt to 1c7dcb28 
Dealt to f758d044 
Dealt to 3d571954 
1c7dcb28: folds
f758d044: folds
3d571954: folds
afa8f28a: folds
Hero: folds
Uncalled bet ($0.05) returned to 93557287
*** SHOWDOWN ***
93557287 collected $0.1 from pot
*** SUMMARY ***
Total pot $0.1 | Rake $0 | Jackpot $0 | Bingo $0 | Fortune $0 | Tax $0
Seat 1: afa8f28a (button) folded before Flop (didn't bet)
Seat 2: Hero (small blind) folded before Flop
Seat 3: 93557287 (big blind) collected ($0.1)
Seat 4: 1c7dcb28 folded before Flop (didn't bet)
Seat 5: f758d044 folded before Flop (didn't bet)
Seat 6: 3d571954 folded before Flop (didn't bet)


Poker Hand #RC2774679088: Hold'em No Limit ($0.05/$0.1) - 2024/08/05 12:12:01
Table 'RushAndCash21374348' 6-max Seat #1 is the button
Seat 1: db694ae4 ($13.21 in chips)
Seat 2: 3b684a3b ($12.73 in chips)
Seat 3: Hero ($11.47 in chips)
Seat 4: 47f607d ($10.07 in chips)
Seat 5: 118773cf ($10.68 in chips)
Seat 6: 27c7b1c ($12.94 in chips)
3b684a3b: posts small blind $0.05
Hero: posts big blind $0.1
*** HOLE CARDS ***
Dealt to db694ae4 
Dealt to 3b684a3b 
Dealt to Hero [8c 2d]
Dealt to 47f607d 
Dealt to 118773cf 
Dealt to 27c7b1c 
47f607d: raises $0.15 to $0.25
118773cf: folds
27c7b1c: folds
db694ae4: folds
3b684a3b: folds
Hero: folds
Uncalled bet ($0.15) returned to 47f607d
*** SHOWDOWN ***
47f607d collected $0.25 from pot
*** SUMMARY ***
Total pot $0.25 | Rake $0 | Jackpot $0 | Bingo $0 | Fortune $0 | Tax $0
Seat 1: db694ae4 (button) folded before Flop (didn't bet)
Seat 2: 3b684a3b (small blind) folded before Flop
Seat 3: Hero (big blind) folded before Flop
Seat 4: 47f607d collected ($0.25)
Seat 5: 118773cf folded before Flop (didn't bet)
Seat 6: 27c7b1c folded before Flop (didn't bet)


Poker Hand #RC2774679054: Hold'em No Limit ($0.05/$0.1) - 2024/08/05 12:11:57
Table 'RushAndCash21374314' 6-max Seat #1 is the button
Seat 1: Hero ($11.47 in chips)
Seat 2: 737850eb ($13.79 in chips)
Seat 3: 2bf97f5f ($13.31 in chips)
Seat 4: 73b08961 ($65.39 in chips)
Seat 5: d3c98539 ($19.87 in chips)
Seat 6: b5d9fe7c ($13.4 in chips)
737850eb: posts small blind $0.05
2bf97f5f: posts big blind $0.1
*** HOLE CARDS ***
Dealt to Hero [Td 6d]
Dealt to 737850eb 
Dealt to 2bf97f5f 
Dealt to 73b08961 
Dealt to d3c98539 
Dealt to b5d9fe7c 
73b08961: raises $0.1 to $0.2
d3c98539: folds
b5d9fe7c: folds
Hero: folds
737850eb: folds
2bf97f5f: folds
Uncalled bet ($0.1) returned to 73b08961
*** SHOWDOWN ***
73b08961 collected $0.25 from pot
*** SUMMARY ***
Total pot $0.25 | Rake $0 | Jackpot $0 | Bingo $0 | Fortune $0 | Tax $0
Seat 1: Hero (button) folded before Flop (didn't bet)
Seat 2: 737850eb (small blind) folded before Flop
Seat 3: 2bf97f5f (big blind) folded before Flop
Seat 4: 73b08961 collected ($0.25)
Seat 5: d3c98539 folded before Flop (didn't bet)
Seat 6: b5d9fe7c folded before Flop (didn't bet)


Poker Hand #RC2774679026: Hold'em No Limit ($0.05/$0.1) - 2024/08/05 12:11:53
Table 'RushAndCash21374286' 6-max Seat #1 is the button
Seat 1: 1d581932 ($10.15 in chips)
Seat 2: d1f767ee ($25.52 in chips)
Seat 3: b65d2a12 ($12.74 in chips)
Seat 4: 8da55835 ($15.25 in chips)
Seat 5: Hero ($11.47 in chips)
Seat 6: ee50c8ac ($12.74 in chips)
d1f767ee: posts small blind $0.05
b65d2a12: posts big blind $0.1
*** HOLE CARDS ***
Dealt to 1d581932 
Dealt to d1f767ee 
Dealt to b65d2a12 
Dealt to 8da55835 
Dealt to Hero [9d 4s]
Dealt to ee50c8ac 
8da55835: raises $0.15 to $0.25
Hero: folds
ee50c8ac: folds
1d581932: folds
d1f767ee: calls $0.2
b65d2a12: folds
*** FLOP *** [Tc 7d 5h]
d1f767ee: checks
8da55835: checks
*** TURN *** [Tc 7d 5h] [As]
d1f767ee: checks
8da55835: checks
*** RIVER *** [Tc 7d 5h As] [Qc]
d1f767ee: bets $1
8da55835: folds
Uncalled bet ($1) returned to d1f767ee
*** SHOWDOWN ***
d1f767ee collected $0.57 from pot
*** SUMMARY ***
Total pot $0.6 | Rake $0.03 | Jackpot $0 | Bingo $0 | Fortune $0 | Tax $0
Board [Tc 7d 5h As Qc]
Seat 1: 1d581932 (button) folded before Flop (didn't bet)
Seat 2: d1f767ee (small blind) won ($0.57)
Seat 3: b65d2a12 (big blind) folded before Flop
Seat 4: 8da55835 folded on the River
Seat 5: Hero folded before Flop (didn't bet)
Seat 6: ee50c8ac folded before Flop (didn't bet)


Poker Hand #RC2774679003: Hold'em No Limit ($0.05/$0.1) - 2024/08/05 12:11:50
Table 'RushAndCash21374263' 6-max Seat #1 is the button
Seat 1: b65d2a12 ($12.74 in chips)
Seat 2: c7144491 ($18.75 in chips)
Seat 3: 58694b26 ($2.01 in chips)
Seat 4: d1f767ee ($25.52 in chips)
Seat 5: Hero ($11.47 in chips)
Seat 6: 5b7b2a1f ($12.87 in chips)
c7144491: posts small blind $0.05
58694b26: posts big blind $0.1
*** HOLE CARDS ***
Dealt to b65d2a12 
Dealt to c7144491 
Dealt to 58694b26 
Dealt to d1f767ee 
Dealt to Hero [3h 7h]
Dealt to 5b7b2a1f 
d1f767ee: folds
Hero: folds
5b7b2a1f: raises $0.12 to $0.22
b65d2a12: folds
c7144491: raises $0.77 to $0.99
58694b26: folds
5b7b2a1f: calls $0.77
*** FLOP *** [4d 8s 4s]
c7144491: bets $1.04
5b7b2a1f: calls $1.04
*** TURN *** [4d 8s 4s] [7s]
c7144491: bets $1.38
5b7b2a1f: calls $1.38
*** RIVER *** [4d 8s 4s 7s] [4c]
c7144491: checks
5b7b2a1f: checks
c7144491: shows [Qc Qd] (Fours Full over Queens)
5b7b2a1f: shows [Ts Tc] (Fours Full over Tens)
*** SHOWDOWN ***
c7144491 collected $6.47 from pot
*** SUMMARY ***
Total pot $6.92 | Rake $0.3 | Jackpot $0.15 | Bingo $0 | Fortune $0 | Tax $0
Board [4d 8s 4s 7s 4c]
Seat 1: b65d2a12 (button) folded before Flop (didn't bet)
Seat 2: c7144491 (small blind) showed [Qc Qd] and won ($6.47) with Fours Full over Queens
Seat 3: 58694b26 (big blind) folded before Flop
Seat 4: d1f767ee folded before Flop (didn't bet)
Seat 5: Hero folded before Flop (didn't bet)
Seat 6: 5b7b2a1f showed [Ts Tc] and lost with Fours Full over Tens


Poker Hand #RC2774678917: Hold'em No Limit ($0.05/$0.1) - 2024/08/05 12:11:40
Table 'RushAndCash21374177' 6-max Seat #1 is the button
Seat 1: bf933ab7 ($10 in chips)
Seat 2: Hero ($11.37 in chips)
Seat 3: a41a5c6e ($10.62 in chips)
Seat 4: e5b05063 ($11.65 in chips)
Seat 5: f0263df4 ($27.24 in chips)
Seat 6: 8a3c0da8 ($19.07 in chips)
Hero: posts small blind $0.05
a41a5c6e: posts big blind $0.1
*** HOLE CARDS ***
Dealt to bf933ab7 
Dealt to Hero [Jc 8c]
Dealt to a41a5c6e 
Dealt to e5b05063 
Dealt to f0263df4 
Dealt to 8a3c0da8 
e5b05063: folds
f0263df4: folds
8a3c0da8: folds
bf933ab7: folds
Hero: raises $0.2 to $0.3
a41a5c6e: folds
Uncalled bet ($0.2) returned to Hero
*** SHOWDOWN ***
Hero collected $0.2 from pot
*** SUMMARY ***
Total pot $0.2 | Rake $0 | Jackpot $0 | Bingo $0 | Fortune $0 | Tax $0
Seat 1: bf933ab7 (button) folded before Flop (didn't bet)
Seat 2: Hero (small blind) collected ($0.2)
Seat 3: a41a5c6e (big blind) folded before Flop
Seat 4: e5b05063 folded before Flop (didn't bet)
Seat 5: f0263df4 folded before Flop (didn't bet)
Seat 6: 8a3c0da8 folded before Flop (didn't bet)


Poker Hand #RC2774678886: Hold'em No Limit ($0.05/$0.1) - 2024/08/05 12:11:36
Table 'RushAndCash21374146' 6-max Seat #1 is the button
Seat 1: Hero ($11.37 in chips)
Seat 2: 38ec9e55 ($10.63 in chips)
Seat 3: 1ec0fd17 ($16.71 in chips)
Seat 4: f6e6234 ($10.47 in chips)
Seat 5: 15f1871b ($11.67 in chips)
Seat 6: 1956b168 ($6.28 in chips)
38ec9e55: posts small blind $0.05
1ec0fd17: posts big blind $0.1
*** HOLE CARDS ***
Dealt to Hero [Ks 8c]
Dealt to 38ec9e55 
Dealt to 1ec0fd17 
Dealt to f6e6234 
Dealt to 15f1871b 
Dealt to 1956b168 
f6e6234: folds
15f1871b: raises $0.1 to $0.2
1956b168: folds
Hero: folds
38ec9e55: folds
1ec0fd17: calls $0.1
*** FLOP *** [Ts 8s 3h]
1ec0fd17: checks
15f1871b: bets $0.14
1ec0fd17: folds
Uncalled bet ($0.14) returned to 15f1871b
*** SHOWDOWN ***
15f1871b collected $0.43 from pot
*** SUMMARY ***
Total pot $0.45 | Rake $0.02 | Jackpot $0 | Bingo $0 | Fortune $0 | Tax $0
Board [Ts 8s 3h]
Seat 1: Hero (button) folded before Flop (didn't bet)
Seat 2: 38ec9e55 (small blind) folded before Flop
Seat 3: 1ec0fd17 (big blind) folded on the Flop
Seat 4: f6e6234 folded before Flop (didn't bet)
Seat 5: 15f1871b won ($0.43)
Seat 6: 1956b168 folded before Flop (didn't bet)


Poker Hand #RC2774678427: Hold'em No Limit ($0.05/$0.1) - 2024/08/05 12:10:37
Table 'RushAndCash21373687' 6-max Seat #1 is the button
Seat 1: a8812213 ($10.23 in chips)
Seat 2: 8a2a2f03 ($12.49 in chips)
Seat 3: Hero ($11.14 in chips)
Seat 4: a065f94e ($10 in chips)
Seat 5: f6e6234 ($10.67 in chips)
Seat 6: eff08648 ($11.88 in chips)
8a2a2f03: posts small blind $0.05
Hero: posts big blind $0.1
*** HOLE CARDS ***
Dealt to a8812213 
Dealt to 8a2a2f03 
Dealt to Hero [9d Ad]
Dealt to a065f94e 
Dealt to f6e6234 
Dealt to eff08648 
a065f94e: folds
f6e6234: raises $0.1 to $0.2
eff08648: folds
a8812213: folds
8a2a2f03: folds
Hero: calls $0.1
*** FLOP *** [2d Kc 3s]
Hero: checks
f6e6234: checks
*** TURN *** [2d Kc 3s] [Jh]
Hero: checks
f6e6234: checks
*** RIVER *** [2d Kc 3s Jh] [4h]
Hero: checks
f6e6234: checks
Hero: shows [9d Ad] (Ace-High)
f6e6234: shows [6c Qc] (King-High)
*** SHOWDOWN ***
Hero collected $0.43 from pot
*** SUMMARY ***
Total pot $0.45 | Rake $0.02 | Jackpot $0 | Bingo $0 | Fortune $0 | Tax $0
Board [2d Kc 3s Jh 4h]
Seat 1: a8812213 (button) folded before Flop (didn't bet)
Seat 2: 8a2a2f03 (small blind) folded before Flop
Seat 3: Hero (big blind) showed [9d Ad] and won ($0.43) with Ace-High
Seat 4: a065f94e folded before Flop (didn't bet)
Seat 5: f6e6234 showed [6c Qc] and lost with King-High
Seat 6: eff08648 folded before Flop (didn't bet)


Poker Hand #RC2774678378: Hold'em No Limit ($0.05/$0.1) - 2024/08/05 12:10:31
Table 'RushAndCash21373638' 6-max Seat #1 is the button
Seat 1: d227cdbd ($8.29 in chips)
Seat 2: 64703012 ($10 in chips)
Seat 3: 2f6e7bb0 ($21.04 in chips)
Seat 4: 47f607d ($10.32 in chips)
Seat 5: Hero ($11.14 in chips)
Seat 6: 13355c12 ($26.48 in chips)
64703012: posts small blind $0.05
2f6e7bb0: posts big blind $0.1
*** HOLE CARDS ***
Dealt to d227cdbd 
Dealt to 64703012 
Dealt to 2f6e7bb0 
Dealt to 47f607d 
Dealt to Hero [Td Qs]
Dealt to 13355c12 
47f607d: folds
Hero: folds
13355c12: folds
d227cdbd: folds
64703012: raises $0.2 to $0.3
2f6e7bb0: raises $0.6 to $0.9
64703012: calls $0.6
*** FLOP *** [Jh Jc Ah]
64703012: checks
2f6e7bb0: bets $0.9
64703012: folds
Uncalled bet ($0.9) returned to 2f6e7bb0
*** SHOWDOWN ***
2f6e7bb0 collected $1.71 from pot
*** SUMMARY ***
Total pot $1.8 | Rake $0.09 | Jackpot $0 | Bingo $0 | Fortune $0 | Tax $0
Board [Jh Jc Ah]
Seat 1: d227cdbd (button) folded before Flop (didn't bet)
Seat 2: 64703012 (small blind) folded on the Flop
Seat 3: 2f6e7bb0 (big blind) won ($1.71)
Seat 4: 47f607d folded before Flop (didn't bet)
Seat 5: Hero folded before Flop (didn't bet)
Seat 6: 13355c12 folded before Flop (didn't bet)


Poker Hand #RC2774678346: Hold'em No Limit ($0.05/$0.1) - 2024/08/05 12:10:28
Table 'RushAndCash21373606' 6-max Seat #1 is the button
Seat 1: ed41ea81 ($12.14 in chips)
Seat 2: ded485f3 ($10 in chips)
Seat 3: 62110fa0 ($13.56 in chips)
Seat 4: Hero ($11.14 in chips)
Seat 5: 9be5d7e7 ($16.5 in chips)
Seat 6: 64b8e998 ($16.68 in chips)
ded485f3: posts small blind $0.05
62110fa0: posts big blind $0.1
*** HOLE CARDS ***
Dealt to ed41ea81 
Dealt to ded485f3 
Dealt to 62110fa0 
Dealt to Hero [5h 2s]
Dealt to 9be5d7e7 
Dealt to 64b8e998 
Hero: folds
9be5d7e7: folds
64b8e998: folds
ed41ea81: raises $0.1 to $0.2
ded485f3: folds
62110fa0: folds
Uncalled bet ($0.1) returned to ed41ea81
*** SHOWDOWN ***
ed41ea81 collected $0.25 from pot
*** SUMMARY ***
Total pot $0.25 | Rake $0 | Jackpot $0 | Bingo $0 | Fortune $0 | Tax $0
Seat 1: ed41ea81 (button) collected ($0.25)
Seat 2: ded485f3 (small blind) folded before Flop
Seat 3: 62110fa0 (big blind) folded before Flop
Seat 4: Hero folded before Flop (didn't bet)
Seat 5: 9be5d7e7 folded before Flop (didn't bet)
Seat 6: 64b8e998 folded before Flop (didn't bet)


Poker Hand #RC2774678318: Hold'em No Limit ($0.05/$0.1) - 2024/08/05 12:10:24
Table 'RushAndCash21373578' 6-max Seat #1 is the button
Seat 1: dea3c09f ($32.39 in chips)
Seat 2: a811df52 ($16.68 in chips)
Seat 3: de4478b2 ($12.57 in chips)
Seat 4: Hero ($11.14 in chips)
Seat 5: 4c6f7aad ($10.23 in chips)
Seat 6: 4f1f3f47 ($10 in chips)
a811df52: posts small blind $0.05
de4478b2: posts big blind $0.1
*** HOLE CARDS ***
Dealt to dea3c09f 
Dealt to a811df52 
Dealt to de4478b2 
Dealt to Hero [8d 4h]
Dealt to 4c6f7aad 
Dealt to 4f1f3f47 
Hero: folds
4c6f7aad: raises $0.15 to $0.25
4f1f3f47: raises $0.5 to $0.75
dea3c09f: folds
a811df52: folds
de4478b2: folds
4c6f7aad: calls $0.5
*** FLOP *** [8h 7c 4s]
4c6f7aad: checks
4f1f3f47: bets $1.09
4c6f7aad: calls $1.09
*** TURN *** [8h 7c 4s] [9d]
4c6f7aad: checks
4f1f3f47: bets $8.16 and is all-in
4c6f7aad: calls $8.16
4f1f3f47: shows [Jd Js] (Pair of Jacks)
4c6f7aad: shows [Ts 9s] (Pair of Nines)
*** RIVER *** [8h 7c 4s 9d] [Td]
*** SHOWDOWN ***
4f1f3f47 collected $19.7 from pot
*** SUMMARY ***
Total pot $20.15 | Rake $0.3 | Jackpot $0.15 | Bingo $0 | Fortune $0 | Tax $0
Board [8h 7c 4s 9d Td]
Seat 1: dea3c09f (button) folded before Flop (didn't bet)
Seat 2: a811df52 (small blind) folded before Flop
Seat 3: de4478b2 (big blind) folded before Flop
Seat 4: Hero folded before Flop (didn't bet)
Seat 5: 4c6f7aad showed [Ts 9s] and lost with Pair of Tens and Pair of Nines
Seat 6: 4f1f3f47 showed [Jd Js] and won ($19.7) with Jacks-High Straight


Poker Hand #RC2774678277: Hold'em No Limit ($0.05/$0.1) - 2024/08/05 12:10:19
Table 'RushAndCash21373537' 6-max Seat #1 is the button
Seat 1: 85749a92 ($8.96 in chips)
Seat 2: 4a5029c2 ($10.35 in chips)
Seat 3: 84291406 ($12.28 in chips)
Seat 4: 332975dd ($15.11 in chips)
Seat 5: Hero ($11.14 in chips)
Seat 6: bdadd860 ($10.15 in chips)
4a5029c2: posts small blind $0.05
84291406: posts big blind $0.1
*** HOLE CARDS ***
Dealt to 85749a92 
Dealt to 4a5029c2 
Dealt to 84291406 
Dealt to 332975dd 
Dealt to Hero [2h 7s]
Dealt to bdadd860 
332975dd: folds
Hero: folds
bdadd860: folds
85749a92: folds
4a5029c2: raises $0.18 to $0.28
84291406: folds
Uncalled bet ($0.18) returned to 4a5029c2
*** SHOWDOWN ***
4a5029c2 collected $0.2 from pot
*** SUMMARY ***
Total pot $0.2 | Rake $0 | Jackpot $0 | Bingo $0 | Fortune $0 | Tax $0
Seat 1: 85749a92 (button) folded before Flop (didn't bet)
Seat 2: 4a5029c2 (small blind) collected ($0.2)
Seat 3: 84291406 (big blind) folded before Flop
Seat 4: 332975dd folded before Flop (didn't bet)
Seat 5: Hero folded before Flop (didn't bet)
Seat 6: bdadd860 folded before Flop (didn't bet)


Poker Hand #RC2774677982: Hold'em No Limit ($0.05/$0.1) - 2024/08/05 12:09:41
Table 'RushAndCash21373242' 6-max Seat #1 is the button
Seat 1: 3ed5852c ($10.38 in chips)
Seat 2: Hero ($10.05 in chips)
Seat 3: a6f05778 ($10.1 in chips)
Seat 4: 1734edaa ($11.34 in chips)
Seat 5: 97ee54db ($8.56 in chips)
Seat 6: bb4f333a ($17.24 in chips)
Hero: posts small blind $0.05
a6f05778: posts big blind $0.1
*** HOLE CARDS ***
Dealt to 3ed5852c 
Dealt to Hero [Kd Ah]
Dealt to a6f05778 
Dealt to 1734edaa 
Dealt to 97ee54db 
Dealt to bb4f333a 
1734edaa: folds
97ee54db: folds
bb4f333a: folds
3ed5852c: raises $0.15 to $0.25
Hero: raises $0.85 to $1.1
a6f05778: folds
3ed5852c: calls $0.85
*** FLOP *** [Qh 2h Jh]
Hero: bets $1.2
3ed5852c: folds
Uncalled bet ($1.2) returned to Hero
*** SHOWDOWN ***
Hero collected $2.19 from pot
*** SUMMARY ***
Total pot $2.3 | Rake $0.11 | Jackpot $0 | Bingo $0 | Fortune $0 | Tax $0
Board [Qh 2h Jh]
Seat 1: 3ed5852c (button) folded on the Flop
Seat 2: Hero (small blind) won ($2.19)
Seat 3: a6f05778 (big blind) folded before Flop
Seat 4: 1734edaa folded before Flop (didn't bet)
Seat 5: 97ee54db folded before Flop (didn't bet)
Seat 6: bb4f333a folded before Flop (didn't bet)


Poker Hand #RC2774677953: Hold'em No Limit ($0.05/$0.1) - 2024/08/05 12:09:38
Table 'RushAndCash21373213' 6-max Seat #1 is the button
Seat 1: 42ea9e42 ($24.78 in chips)
Seat 2: 8f7c02cf ($19.05 in chips)
Seat 3: Hero ($10.15 in chips)
Seat 4: 9941da91 ($15.33 in chips)
Seat 5: d28d30e4 ($29.12 in chips)
Seat 6: 85749a92 ($9.21 in chips)
8f7c02cf: posts small blind $0.05
Hero: posts big blind $0.1
*** HOLE CARDS ***
Dealt to 42ea9e42 
Dealt to 8f7c02cf 
Dealt to Hero [5h 9d]
Dealt to 9941da91 
Dealt to d28d30e4 
Dealt to 85749a92 
9941da91: folds
d28d30e4: folds
85749a92: raises $0.1 to $0.2
42ea9e42: folds
8f7c02cf: folds
Hero: folds
Uncalled bet ($0.1) returned to 85749a92
*** SHOWDOWN ***
85749a92 collected $0.25 from pot
*** SUMMARY ***
Total pot $0.25 | Rake $0 | Jackpot $0 | Bingo $0 | Fortune $0 | Tax $0
Seat 1: 42ea9e42 (button) folded before Flop (didn't bet)
Seat 2: 8f7c02cf (small blind) folded before Flop
Seat 3: Hero (big blind) folded before Flop
Seat 4: 9941da91 folded before Flop (didn't bet)
Seat 5: d28d30e4 folded before Flop (didn't bet)
Seat 6: 85749a92 collected ($0.25)


Poker Hand #RC2774677928: Hold'em No Limit ($0.05/$0.1) - 2024/08/05 12:09:34
Table 'RushAndCash21373188' 6-max Seat #1 is the button
Seat 1: Hero ($10.15 in chips)
Seat 2: f1e457c3 ($10 in chips)
Seat 3: 1aa5206a ($19.72 in chips)
Seat 4: 8f7c02cf ($19.05 in chips)
Seat 5: f2941229 ($10.05 in chips)
Seat 6: fc4f9a1b ($1.72 in chips)
f1e457c3: posts small blind $0.05
1aa5206a: posts big blind $0.1
*** HOLE CARDS ***
Dealt to Hero [5s 6h]
Dealt to f1e457c3 
Dealt to 1aa5206a 
Dealt to 8f7c02cf 
Dealt to f2941229 
Dealt to fc4f9a1b 
8f7c02cf: folds
f2941229: folds
fc4f9a1b: folds
Hero: folds
f1e457c3: folds
Uncalled bet ($0.05) returned to 1aa5206a
*** SHOWDOWN ***
1aa5206a collected $0.1 from pot
*** SUMMARY ***
Total pot $0.1 | Rake $0 | Jackpot $0 | Bingo $0 | Fortune $0 | Tax $0
Seat 1: Hero (button) folded before Flop (didn't bet)
Seat 2: f1e457c3 (small blind) folded before Flop
Seat 3: 1aa5206a (big blind) collected ($0.1)
Seat 4: 8f7c02cf folded before Flop (didn't bet)
Seat 5: f2941229 folded before Flop (didn't bet)
Seat 6: fc4f9a1b folded before Flop (didn't bet)


Poker Hand #RC2774677901: Hold'em No Limit ($0.05/$0.1) - 2024/08/05 12:09:31
Table 'RushAndCash21373161' 6-max Seat #1 is the button
Seat 1: 78664b40 ($23.13 in chips)
Seat 2: e045d102 ($14.23 in chips)
Seat 3: 67b9a108 ($8.21 in chips)
Seat 4: d5247781 ($10 in chips)
Seat 5: fc4f9a1b ($1.72 in chips)
Seat 6: Hero ($10.15 in chips)
e045d102: posts small blind $0.05
67b9a108: posts big blind $0.1
*** HOLE CARDS ***
Dealt to 78664b40 
Dealt to e045d102 
Dealt to 67b9a108 
Dealt to d5247781 
Dealt to fc4f9a1b 
Dealt to Hero [6h 4s]
d5247781: raises $0.1 to $0.2
fc4f9a1b: folds
Hero: folds
78664b40: folds
e045d102: folds
67b9a108: calls $0.1
*** FLOP *** [6s Td 3h]
67b9a108: checks
d5247781: checks
*** TURN *** [6s Td 3h] [6c]
67b9a108: bets $0.23
d5247781: folds
Uncalled bet ($0.23) returned to 67b9a108
*** SHOWDOWN ***
67b9a108 collected $0.43 from pot
*** SUMMARY ***
Total pot $0.45 | Rake $0.02 | Jackpot $0 | Bingo $0 | Fortune $0 | Tax $0
Board [6s Td 3h 6c]
Seat 1: 78664b40 (button) folded before Flop (didn't bet)
Seat 2: e045d102 (small blind) folded before Flop
Seat 3: 67b9a108 (big blind) won ($0.43)
Seat 4: d5247781 folded on the Turn
Seat 5: fc4f9a1b folded before Flop (didn't bet)
Seat 6: Hero folded before Flop (didn't bet)


Poker Hand #RC2774677875: Hold'em No Limit ($0.05/$0.1) - 2024/08/05 12:09:28
Table 'RushAndCash21373135' 6-max Seat #1 is the button
Seat 1: ff18697 ($10.06 in chips)
Seat 2: 118773cf ($10.71 in chips)
Seat 3: 87c9acad ($17.6 in chips)
Seat 4: Hero ($10.15 in chips)
Seat 5: fc4f9a1b ($1.72 in chips)
Seat 6: 94218f2 ($11.14 in chips)
118773cf: posts small blind $0.05
87c9acad: posts big blind $0.1
*** HOLE CARDS ***
Dealt to ff18697 
Dealt to 118773cf 
Dealt to 87c9acad 
Dealt to Hero [2s Qs]
Dealt to fc4f9a1b 
Dealt to 94218f2 
Hero: folds
fc4f9a1b: folds
94218f2: folds
ff18697: folds
118773cf: raises $0.15 to $0.25
87c9acad: raises $0.63 to $0.88
118773cf: calls $0.63
*** FLOP *** [4s 3s Kh]
118773cf: checks
87c9acad: bets $0.44
118773cf: calls $0.44
*** TURN *** [4s 3s Kh] [Jh]
118773cf: checks
87c9acad: checks
*** RIVER *** [4s 3s Kh Jh] [6h]
118773cf: checks
87c9acad: checks
118773cf: shows [9s 9h] (Pair of Nines)
87c9acad: shows [Tc 2c] (King-High)
*** SHOWDOWN ***
118773cf collected $2.51 from pot
*** SUMMARY ***
Total pot $2.64 | Rake $0.13 | Jackpot $0 | Bingo $0 | Fortune $0 | Tax $0
Board [4s 3s Kh Jh 6h]
Seat 1: ff18697 (button) folded before Flop (didn't bet)
Seat 2: 118773cf (small blind) showed [9s 9h] and won ($2.51) with Pair of Nines
Seat 3: 87c9acad (big blind) showed [Tc 2c] and lost with King-High
Seat 4: Hero folded before Flop (didn't bet)
Seat 5: fc4f9a1b folded before Flop (didn't bet)
Seat 6: 94218f2 folded before Flop (didn't bet)


Poker Hand #RC2774677850: Hold'em No Limit ($0.05/$0.1) - 2024/08/05 12:09:24
Table 'RushAndCash21373110' 6-max Seat #1 is the button
Seat 1: eed55452 ($13.05 in chips)
Seat 2: 1728dde1 ($9.75 in chips)
Seat 3: e045d102 ($14.33 in chips)
Seat 4: e56eab42 ($13.29 in chips)
Seat 5: e155962f ($17.35 in chips)
Seat 6: Hero ($10.15 in chips)
1728dde1: posts small blind $0.05
e045d102: posts big blind $0.1
*** HOLE CARDS ***
Dealt to eed55452 
Dealt to 1728dde1 
Dealt to e045d102 
Dealt to e56eab42 
Dealt to e155962f 
Dealt to Hero [Js 9c]
e56eab42: folds
e155962f: folds
Hero: folds
eed55452: folds
1728dde1: folds
Uncalled bet ($0.05) returned to e045d102
*** SHOWDOWN ***
e045d102 collected $0.1 from pot
*** SUMMARY ***
Total pot $0.1 | Rake $0 | Jackpot $0 | Bingo $0 | Fortune $0 | Tax $0
Seat 1: eed55452 (button) folded before Flop (didn't bet)
Seat 2: 1728dde1 (small blind) folded before Flop
Seat 3: e045d102 (big blind) collected ($0.1)
Seat 4: e56eab42 folded before Flop (didn't bet)
Seat 5: e155962f folded before Flop (didn't bet)
Seat 6: Hero folded before Flop (didn't bet)


Poker Hand #RC2774677770: Hold'em No Limit ($0.05/$0.1) - 2024/08/05 12:09:15
Table 'RushAndCash21373030' 6-max Seat #1 is the button
Seat 1: Hero ($10 in chips)
Seat 2: 1927bc12 ($10 in chips)
Seat 3: 9a46da17 ($14.38 in chips)
Seat 4: 99d264c4 ($11 in chips)
Seat 5: 119b4384 ($10 in chips)
Seat 6: e74c79de ($10.17 in chips)
1927bc12: posts small blind $0.05
9a46da17: posts big blind $0.1
*** HOLE CARDS ***
Dealt to Hero [9h Qc]
Dealt to 1927bc12 
Dealt to 9a46da17 
Dealt to 99d264c4 
Dealt to 119b4384 
Dealt to e74c79de 
99d264c4: folds
119b4384: raises $0.1 to $0.2
e74c79de: raises $0.55 to $0.75
Hero: folds
1927bc12: folds
9a46da17: folds
119b4384: folds
Uncalled bet ($0.55) returned to e74c79de
*** SHOWDOWN ***
e74c79de collected $0.53 from pot
*** SUMMARY ***
Total pot $0.55 | Rake $0.02 | Jackpot $0 | Bingo $0 | Fortune $0 | Tax $0
Seat 1: Hero (button) folded before Flop (didn't bet)
Seat 2: 1927bc12 (small blind) folded before Flop
Seat 3: 9a46da17 (big blind) folded before Flop
Seat 4: 99d264c4 folded before Flop (didn't bet)
Seat 5: 119b4384 folded before Flop
Seat 6: e74c79de collected ($0.53)


Poker Hand #RC2774677745: Hold'em No Limit ($0.05/$0.1) - 2024/08/05 12:09:11
Table 'RushAndCash21373005' 6-max Seat #1 is the button
Seat 1: 8a3c0da8 ($18.97 in chips)
Seat 2: 119b4384 ($10.05 in chips)
Seat 3: Hero ($10 in chips)
Seat 4: 9a46da17 ($14.38 in chips)
Seat 5: b886ba1 ($10.39 in chips)
Seat 6: 904b4948 ($10 in chips)
119b4384: posts small blind $0.05
Hero: posts big blind $0.1
*** HOLE CARDS ***
Dealt to 8a3c0da8 
Dealt to 119b4384 
Dealt to Hero [5c 2d]
Dealt to 9a46da17 
Dealt to b886ba1 
Dealt to 904b4948 
9a46da17: folds
b886ba1: folds
904b4948: folds
8a3c0da8: folds
119b4384: folds
Uncalled bet ($0.05) returned to Hero
*** SHOWDOWN ***
Hero collected $0.1 from pot
*** SUMMARY ***
Total pot $0.1 | Rake $0 | Jackpot $0 | Bingo $0 | Fortune $0 | Tax $0
Seat 1: 8a3c0da8 (button) folded before Flop (didn't bet)
Seat 2: 119b4384 (small blind) folded before Flop
Seat 3: Hero (big blind) collected ($0.1)
Seat 4: 9a46da17 folded before Flop (didn't bet)
Seat 5: b886ba1 folded before Flop (didn't bet)
Seat 6: 904b4948 folded before Flop (didn't bet)


Poker Hand #RC2774677718: Hold'em No Limit ($0.05/$0.1) - 2024/08/05 12:09:08
Table 'RushAndCash21372978' 6-max Seat #1 is the button
Seat 1: 8b8c29f1 ($17.68 in chips)
Seat 2: Hero ($10 in chips)
Seat 3: 118b2939 ($10 in chips)
Seat 4: f89c8a74 ($11.42 in chips)
Seat 5: 9d4a79c9 ($10.33 in chips)
Seat 6: 43b74fd ($12.3 in chips)
Hero: posts small blind $0.05
118b2939: posts big blind $0.1
*** HOLE CARDS ***
Dealt to 8b8c29f1 
Dealt to Hero [2c Th]
Dealt to 118b2939 
Dealt to f89c8a74 
Dealt to 9d4a79c9 
Dealt to 43b74fd 
f89c8a74: raises $0.12 to $0.22
9d4a79c9: folds
43b74fd: folds
8b8c29f1: raises $0.48 to $0.7
Hero: folds
118b2939: folds
f89c8a74: calls $0.48
*** FLOP *** [7h 8s 7c]
f89c8a74: checks
8b8c29f1: bets $0.78
f89c8a74: calls $0.78
*** TURN *** [7h 8s 7c] [Tc]
f89c8a74: checks
8b8c29f1: checks
*** RIVER *** [7h 8s 7c Tc] [Kc]
f89c8a74: checks
8b8c29f1: bets $1.56
f89c8a74: folds
Uncalled bet ($1.56) returned to 8b8c29f1
*** SHOWDOWN ***
8b8c29f1 collected $2.82 from pot
*** SUMMARY ***
Total pot $3.11 | Rake $0.14 | Jackpot $0.15 | Bingo $0 | Fortune $0 | Tax $0
Board [7h 8s 7c Tc Kc]
Seat 1: 8b8c29f1 (button) won ($2.82)
Seat 2: Hero (small blind) folded before Flop
Seat 3: 118b2939 (big blind) folded before Flop
Seat 4: f89c8a74 folded on the River
Seat 5: 9d4a79c9 folded before Flop (didn't bet)
Seat 6: 43b74fd folded before Flop (didn't bet)


Poker Hand #RC2774677688: Hold'em No Limit ($0.05/$0.1) - 2024/08/05 12:09:04
Table 'RushAndCash21372948' 6-max Seat #1 is the button
Seat 1: dbffffb3 ($10 in chips)
Seat 2: 3f815a4c ($10.25 in chips)
Seat 3: c4584975 ($10 in chips)
Seat 4: 654a9157 ($10.41 in chips)
Seat 5: Hero ($10 in chips)
Seat 6: 27c7b1c ($12.97 in chips)
3f815a4c: posts small blind $0.05
c4584975: posts big blind $0.1
*** HOLE CARDS ***
Dealt to dbffffb3 
Dealt to 3f815a4c 
Dealt to c4584975 
Dealt to 654a9157 
Dealt to Hero [7d Jd]
Dealt to 27c7b1c 
654a9157: folds
Hero: folds
27c7b1c: folds
dbffffb3: folds
3f815a4c: raises $0.1 to $0.2
c4584975: folds
Uncalled bet ($0.1) returned to 3f815a4c
*** SHOWDOWN ***
3f815a4c collected $0.2 from pot
*** SUMMARY ***
Total pot $0.2 | Rake $0 | Jackpot $0 | Bingo $0 | Fortune $0 | Tax $0
Seat 1: dbffffb3 (button) folded before Flop (didn't bet)
Seat 2: 3f815a4c (small blind) collected ($0.2)
Seat 3: c4584975 (big blind) folded before Flop
Seat 4: 654a9157 folded before Flop (didn't bet)
Seat 5: Hero folded before Flop (didn't bet)
Seat 6: 27c7b1c folded before Flop (didn't bet)


Poker Hand #RC2774677659: Hold'em No Limit ($0.05/$0.1) - 2024/08/05 12:09:01
Table 'RushAndCash21372919' 6-max Seat #1 is the button
Seat 1: 64c6fd00 ($10.98 in chips)
Seat 2: c7cfb4b2 ($12.42 in chips)
Seat 3: 630edda2 ($8.21 in chips)
Seat 4: Hero ($10 in chips)
Seat 5: 54ce7d55 ($10.15 in chips)
Seat 6: 566062c3 ($22.67 in chips)
c7cfb4b2: posts small blind $0.05
630edda2: posts big blind $0.1
*** HOLE CARDS ***
Dealt to 64c6fd00 
Dealt to c7cfb4b2 
Dealt to 630edda2 
Dealt to Hero [Ac 2s]
Dealt to 54ce7d55 
Dealt to 566062c3 
Hero: folds
54ce7d55: folds
566062c3: folds
64c6fd00: folds
c7cfb4b2: folds
Uncalled bet ($0.05) returned to 630edda2
*** SHOWDOWN ***
630edda2 collected $0.1 from pot
*** SUMMARY ***
Total pot $0.1 | Rake $0 | Jackpot $0 | Bingo $0 | Fortune $0 | Tax $0
Seat 1: 64c6fd00 (button) folded before Flop (didn't bet)
Seat 2: c7cfb4b2 (small blind) folded before Flop
Seat 3: 630edda2 (big blind) collected ($0.1)
Seat 4: Hero folded before Flop (didn't bet)
Seat 5: 54ce7d55 folded before Flop (didn't bet)
Seat 6: 566062c3 folded before Flop (didn't bet)


Poker Hand #RC2774677589: Hold'em No Limit ($0.05/$0.1) - 2024/08/05 12:08:52
Table 'RushAndCash21372849' 6-max Seat #1 is the button
Seat 1: 938dc1b0 ($10.34 in chips)
Seat 2: 8b72aa95 ($11.32 in chips)
Seat 3: a219470f ($11.11 in chips)
Seat 4: 70126d5c ($25.93 in chips)
Seat 5: 8a2a2f03 ($12.46 in chips)
Seat 6: Hero ($10 in chips)
8b72aa95: posts small blind $0.05
a219470f: posts big blind $0.1
*** HOLE CARDS ***
Dealt to 938dc1b0 
Dealt to 8b72aa95 
Dealt to a219470f 
Dealt to 70126d5c 
Dealt to 8a2a2f03 
Dealt to Hero [4c 6d]
70126d5c: folds
8a2a2f03: raises $0.13 to $0.23
Hero: folds
938dc1b0: folds
8b72aa95: folds
a219470f: folds
Uncalled bet ($0.13) returned to 8a2a2f03
*** SHOWDOWN ***
8a2a2f03 collected $0.25 from pot
*** SUMMARY ***
Total pot $0.25 | Rake $0 | Jackpot $0 | Bingo $0 | Fortune $0 | Tax $0
Seat 1: 938dc1b0 (button) folded before Flop (didn't bet)
Seat 2: 8b72aa95 (small blind) folded before Flop
Seat 3: a219470f (big blind) folded before Flop
Seat 4: 70126d5c folded before Flop (didn't bet)
Seat 5: 8a2a2f03 collected ($0.25)
Seat 6: Hero folded before Flop (didn't bet)


Poker Hand #RC2774677547: Hold'em No Limit ($0.05/$0.1) - 2024/08/05 12:08:47
Table 'RushAndCash21372807' 6-max Seat #1 is the button
Seat 1: 7155dca ($10 in chips)
Seat 2: Hero ($10 in chips)
Seat 3: f9b9586e ($12.48 in chips)
Seat 4: 79089438 ($16.58 in chips)
Seat 5: fd8df02c ($10 in chips)
Seat 6: 20a37074 ($10.25 in chips)
Hero: posts small blind $0.05
f9b9586e: posts big blind $0.1
*** HOLE CARDS ***
Dealt to 7155dca 
Dealt to Hero [Qc Td]
Dealt to f9b9586e 
Dealt to 79089438 
Dealt to fd8df02c 
Dealt to 20a37074 
79089438: folds
fd8df02c: raises $0.1 to $0.2
20a37074: raises $0.9 to $1.1
7155dca: folds
Hero: folds
f9b9586e: folds
fd8df02c: calls $0.9
*** FLOP *** [7d Jc 3s]
fd8df02c: checks
20a37074: bets $1.18
fd8df02c: calls $1.18
*** TURN *** [7d Jc 3s] [Qd]
fd8df02c: checks
20a37074: bets $3.54
fd8df02c: raises $4.18 to $7.72 and is all-in
20a37074: folds
Uncalled bet ($4.18) returned to fd8df02c
*** SHOWDOWN ***
fd8df02c collected $11.34 from pot
*** SUMMARY ***
Total pot $11.79 | Rake $0.3 | Jackpot $0.15 | Bingo $0 | Fortune $0 | Tax $0
Board [7d Jc 3s Qd]
Seat 1: 7155dca (button) folded before Flop (didn't bet)
Seat 2: Hero (small blind) folded before Flop
Seat 3: f9b9586e (big blind) folded before Flop
Seat 4: 79089438 folded before Flop (didn't bet)
Seat 5: fd8df02c won ($11.34)
Seat 6: 20a37074 folded on the Turn


Poker Hand #RC2774677448: Hold'em No Limit ($0.05/$0.1) - 2024/08/05 12:08:34
Table 'RushAndCash21372708' 6-max Seat #1 is the button
Seat 1: 30ada1b3 ($10.43 in chips)
Seat 2: 633bc458 ($12.47 in chips)
Seat 3: Hero ($10 in chips)
Seat 4: d20bef0e ($6.07 in chips)
Seat 5: c802bf76 ($11.02 in chips)
Seat 6: 4fafc83 ($11.53 in chips)
633bc458: posts small blind $0.05
Hero: posts big blind $0.1
*** HOLE CARDS ***
Dealt to 30ada1b3 
Dealt to 633bc458 
Dealt to Hero [8s Jh]
Dealt to d20bef0e 
Dealt to c802bf76 
Dealt to 4fafc83 
d20bef0e: folds
c802bf76: folds
4fafc83: raises $0.2 to $0.3
30ada1b3: raises $0.57 to $0.87
633bc458: folds
Hero: folds
4fafc83: calls $0.57
*** FLOP *** [7d Ac 9c]
4fafc83: checks
30ada1b3: checks
*** TURN *** [7d Ac 9c] [Ah]
4fafc83: checks
30ada1b3: bets $0.63
4fafc83: folds
Uncalled bet ($0.63) returned to 30ada1b3
*** SHOWDOWN ***
30ada1b3 collected $1.8 from pot
*** SUMMARY ***
Total pot $1.89 | Rake $0.09 | Jackpot $0 | Bingo $0 | Fortune $0 | Tax $0
Board [7d Ac 9c Ah]
Seat 1: 30ada1b3 (button) won ($1.8)
Seat 2: 633bc458 (small blind) folded before Flop
Seat 3: Hero (big blind) folded before Flop
Seat 4: d20bef0e folded before Flop (didn't bet)
Seat 5: c802bf76 folded before Flop (didn't bet)
Seat 6: 4fafc83 folded on the Turn


Poker Hand #RC2774677421: Hold'em No Limit ($0.05/$0.1) - 2024/08/05 12:08:30
Table 'RushAndCash21372681' 6-max Seat #1 is the button
Seat 1: Hero ($10 in chips)
Seat 2: ac8f8a49 ($10 in chips)
Seat 3: 118b2939 ($10 in chips)
Seat 4: d20bef0e ($6.07 in chips)
Seat 5: 3681db75 ($15.29 in chips)
Seat 6: 8b48aa8d ($9.33 in chips)
ac8f8a49: posts small blind $0.05
118b2939: posts big blind $0.1
*** HOLE CARDS ***
Dealt to Hero [7h 6c]
Dealt to ac8f8a49 
Dealt to 118b2939 
Dealt to d20bef0e 
Dealt to 3681db75 
Dealt to 8b48aa8d 
d20bef0e: folds
3681db75: raises $0.11 to $0.21
8b48aa8d: folds
Hero: folds
ac8f8a49: folds
118b2939: folds
Uncalled bet ($0.11) returned to 3681db75
*** SHOWDOWN ***
3681db75 collected $0.25 from pot
*** SUMMARY ***
Total pot $0.25 | Rake $0 | Jackpot $0 | Bingo $0 | Fortune $0 | Tax $0
Seat 1: Hero (button) folded before Flop (didn't bet)
Seat 2: ac8f8a49 (small blind) folded before Flop
Seat 3: 118b2939 (big blind) folded before Flop
Seat 4: d20bef0e folded before Flop (didn't bet)
Seat 5: 3681db75 collected ($0.25)
Seat 6: 8b48aa8d folded before Flop (didn't bet)


Poker Hand #RC2774677394: Hold'em No Limit ($0.05/$0.1) - 2024/08/05 12:08:27
Table 'RushAndCash21372654' 6-max Seat #1 is the button
Seat 1: 6ec734a9 ($10.58 in chips)
Seat 2: 488b2b ($14.26 in chips)
Seat 3: 77599916 ($15.33 in chips)
Seat 4: 11b42223 ($10 in chips)
Seat 5: Hero ($10 in chips)
Seat 6: 5b7b2a1f ($11.7 in chips)
488b2b: posts small blind $0.05
77599916: posts big blind $0.1
*** HOLE CARDS ***
Dealt to 6ec734a9 
Dealt to 488b2b 
Dealt to 77599916 
Dealt to 11b42223 
Dealt to Hero [9s 4d]
Dealt to 5b7b2a1f 
11b42223: folds
Hero: folds
5b7b2a1f: folds
6ec734a9: raises $0.15 to $0.25
488b2b: folds
77599916: folds
Uncalled bet ($0.15) returned to 6ec734a9
*** SHOWDOWN ***
6ec734a9 collected $0.25 from pot
*** SUMMARY ***
Total pot $0.25 | Rake $0 | Jackpot $0 | Bingo $0 | Fortune $0 | Tax $0
Seat 1: 6ec734a9 (button) collected ($0.25)
Seat 2: 488b2b (small blind) folded before Flop
Seat 3: 77599916 (big blind) folded before Flop
Seat 4: 11b42223 folded before Flop (didn't bet)
Seat 5: Hero folded before Flop (didn't bet)
Seat 6: 5b7b2a1f folded before Flop (didn't bet)


Poker Hand #RC2774677350: Hold'em No Limit ($0.05/$0.1) - 2024/08/05 12:08:21
Table 'RushAndCash21372610' 6-max Seat #1 is the button
Seat 1: 96d7955 ($10.15 in chips)
Seat 2: 8b72aa95 ($11.37 in chips)
Seat 3: c0d0e77 ($12.54 in chips)
Seat 4: 938dc1b0 ($10.39 in chips)
Seat 5: Hero ($10 in chips)
Seat 6: 61ed8740 ($10.15 in chips)
8b72aa95: posts small blind $0.05
c0d0e77: posts big blind $0.1
*** HOLE CARDS ***
Dealt to 96d7955 
Dealt to 8b72aa95 
Dealt to c0d0e77 
Dealt to 938dc1b0 
Dealt to Hero [5c Ah]
Dealt to 61ed8740 
938dc1b0: folds
Hero: folds
61ed8740: folds
96d7955: folds
8b72aa95: folds
Uncalled bet ($0.05) returned to c0d0e77
*** SHOWDOWN ***
c0d0e77 collected $0.1 from pot
*** SUMMARY ***
Total pot $0.1 | Rake $0 | Jackpot $0 | Bingo $0 | Fortune $0 | Tax $0
Seat 1: 96d7955 (button) folded before Flop (didn't bet)
Seat 2: 8b72aa95 (small blind) folded before Flop
Seat 3: c0d0e77 (big blind) collected ($0.1)
Seat 4: 938dc1b0 folded before Flop (didn't bet)
Seat 5: Hero folded before Flop (didn't bet)
Seat 6: 61ed8740 folded before Flop (didn't bet)


Poker Hand #RC2774677250: Hold'em No Limit ($0.05/$0.1) - 2024/08/05 12:08:09
Table 'RushAndCash21372510' 6-max Seat #1 is the button
Seat 1: Hero ($10 in chips)
Seat 2: 50cfcced ($18 in chips)
Seat 3: e1ffe7bb ($10 in chips)
Seat 4: 20b3e70 ($10.57 in chips)
Seat 5: e56eab42 ($11.3 in chips)
Seat 6: 119b4384 ($10.15 in chips)
50cfcced: posts small blind $0.05
e1ffe7bb: posts big blind $0.1
*** HOLE CARDS ***
Dealt to Hero [7c 8c]
Dealt to 50cfcced 
Dealt to e1ffe7bb 
Dealt to 20b3e70 
Dealt to e56eab42 
Dealt to 119b4384 
20b3e70: raises $0.15 to $0.25
e56eab42: folds
119b4384: folds
Hero: folds
50cfcced: calls $0.2
e1ffe7bb: calls $0.15
*** FLOP *** [4d Jc 3s]
50cfcced: checks
e1ffe7bb: checks
20b3e70: checks
*** TURN *** [4d Jc 3s] [9d]
50cfcced: bets $0.38
e1ffe7bb: calls $0.38
20b3e70: folds
*** RIVER *** [4d Jc 3s 9d] [Js]
50cfcced: bets $1.14
e1ffe7bb: calls $1.14
50cfcced: shows [Qd Ts] (Pair of Jacks)
e1ffe7bb: shows [9s As] (Pair of Jacks and Pair of Nines)
*** SHOWDOWN ***
e1ffe7bb collected $3.46 from pot
*** SUMMARY ***
Total pot $3.79 | Rake $0.18 | Jackpot $0.15 | Bingo $0 | Fortune $0 | Tax $0
Board [4d Jc 3s 9d Js]
Seat 1: Hero (button) folded before Flop (didn't bet)
Seat 2: 50cfcced (small blind) showed [Qd Ts] and lost with Pair of Jacks
Seat 3: e1ffe7bb (big blind) showed [9s As] and won ($3.46) with Pair of Jacks and Pair of Nines
Seat 4: 20b3e70 folded on the Turn
Seat 5: e56eab42 folded before Flop (didn't bet)
Seat 6: 119b4384 folded before Flop (didn't bet)


Poker Hand #RC2774677193: Hold'em No Limit ($0.05/$0.1) - 2024/08/05 12:08:02
Table 'RushAndCash21372453' 6-max Seat #1 is the button
Seat 1: 5ab94028 ($8.84 in chips)
Seat 2: Hero ($10.05 in chips)
Seat 3: 4c6f7aad ($10 in chips)
Seat 4: 3d337591 ($16.9 in chips)
Seat 5: 92539bcc ($10.37 in chips)
Seat 6: ee46ea07 ($10.38 in chips)
Hero: posts small blind $0.05
4c6f7aad: posts big blind $0.1
*** HOLE CARDS ***
Dealt to 5ab94028 
Dealt to Hero [Ts 8s]
Dealt to 4c6f7aad 
Dealt to 3d337591 
Dealt to 92539bcc 
Dealt to ee46ea07 
3d337591: folds
92539bcc: raises $0.18 to $0.28
ee46ea07: folds
5ab94028: calls $0.28
Hero: folds
4c6f7aad: folds
*** FLOP *** [Qc Jh 2h]
92539bcc: checks
5ab94028: checks
*** TURN *** [Qc Jh 2h] [5s]
92539bcc: bets $0.18
5ab94028: calls $0.18
*** RIVER *** [Qc Jh 2h 5s] [4s]
92539bcc: checks
5ab94028: checks
92539bcc: shows [Jc Ac] (Pair of Jacks)
5ab94028: shows [As Kh] (Ace-High)
*** SHOWDOWN ***
92539bcc collected $1.02 from pot
*** SUMMARY ***
Total pot $1.07 | Rake $0.05 | Jackpot $0 | Bingo $0 | Fortune $0 | Tax $0
Board [Qc Jh 2h 5s 4s]
Seat 1: 5ab94028 (button) showed [As Kh] and lost with Ace-High
Seat 2: Hero (small blind) folded before Flop
Seat 3: 4c6f7aad (big blind) folded before Flop
Seat 4: 3d337591 folded before Flop (didn't bet)
Seat 5: 92539bcc showed [Jc Ac] and won ($1.02) with Pair of Jacks
Seat 6: ee46ea07 folded before Flop (didn't bet)


Poker Hand #RC2774677101: Hold'em No Limit ($0.05/$0.1) - 2024/08/05 12:07:51
Table 'RushAndCash21372361' 6-max Seat #1 is the button
Seat 1: e1ffe7bb ($10 in chips)
Seat 2: d8412bc5 ($8.84 in chips)
Seat 3: Hero ($10.15 in chips)
Seat 4: 659b7394 ($12.52 in chips)
Seat 5: cc898bd2 ($21.99 in chips)
Seat 6: 7ace1cc0 ($17.62 in chips)
d8412bc5: posts small blind $0.05
Hero: posts big blind $0.1
*** HOLE CARDS ***
Dealt to e1ffe7bb 
Dealt to d8412bc5 
Dealt to Hero [As 6s]
Dealt to 659b7394 
Dealt to cc898bd2 
Dealt to 7ace1cc0 
659b7394: raises $0.2 to $0.3
cc898bd2: folds
7ace1cc0: folds
e1ffe7bb: folds
d8412bc5: raises $0.7 to $1
Hero: folds
659b7394: calls $0.7
*** FLOP *** [Ks 5h 3c]
d8412bc5: checks
659b7394: bets $1.05
d8412bc5: folds
Uncalled bet ($1.05) returned to 659b7394
*** SHOWDOWN ***
659b7394 collected $2 from pot
*** SUMMARY ***
Total pot $2.1 | Rake $0.1 | Jackpot $0 | Bingo $0 | Fortune $0 | Tax $0
Board [Ks 5h 3c]
Seat 1: e1ffe7bb (button) folded before Flop (didn't bet)
Seat 2: d8412bc5 (small blind) folded on the Flop
Seat 3: Hero (big blind) folded before Flop
Seat 4: 659b7394 won ($2)
Seat 5: cc898bd2 folded before Flop (didn't bet)
Seat 6: 7ace1cc0 folded before Flop (didn't bet)


Poker Hand #RC2774677064: Hold'em No Limit ($0.05/$0.1) - 2024/08/05 12:07:47
Table 'RushAndCash21372324' 6-max Seat #1 is the button
Seat 1: 6b7afbbe ($10 in chips)
Seat 2: 64b8e998 ($17.78 in chips)
Seat 3: 67ddcdcd ($17.1 in chips)
Seat 4: 94c07dec ($16.09 in chips)
Seat 5: 8ddd04bb ($10.7 in chips)
Seat 6: Hero ($10.15 in chips)
64b8e998: posts small blind $0.05
67ddcdcd: posts big blind $0.1
*** HOLE CARDS ***
Dealt to 6b7afbbe 
Dealt to 64b8e998 
Dealt to 67ddcdcd 
Dealt to 94c07dec 
Dealt to 8ddd04bb 
Dealt to Hero [Qh 4c]
94c07dec: folds
8ddd04bb: folds
Hero: folds
6b7afbbe: folds
64b8e998: folds
Uncalled bet ($0.05) returned to 67ddcdcd
*** SHOWDOWN ***
67ddcdcd collected $0.1 from pot
*** SUMMARY ***
Total pot $0.1 | Rake $0 | Jackpot $0 | Bingo $0 | Fortune $0 | Tax $0
Seat 1: 6b7afbbe (button) folded before Flop (didn't bet)
Seat 2: 64b8e998 (small blind) folded before Flop
Seat 3: 67ddcdcd (big blind) collected ($0.1)
Seat 4: 94c07dec folded before Flop (didn't bet)
Seat 5: 8ddd04bb folded before Flop (didn't bet)
Seat 6: Hero folded before Flop (didn't bet)


Poker Hand #RC2774677021: Hold'em No Limit ($0.05/$0.1) - 2024/08/05 12:07:41
Table 'RushAndCash21372281' 6-max Seat #1 is the button
Seat 1: c9a2f192 ($25.22 in chips)
Seat 2: 44cfb570 ($17.19 in chips)
Seat 3: 7c8f5b37 ($14.97 in chips)
Seat 4: 8fefbc9a ($10.67 in chips)
Seat 5: Hero ($10.15 in chips)
Seat 6: 90577903 ($10.78 in chips)
44cfb570: posts small blind $0.05
7c8f5b37: posts big blind $0.1
*** HOLE CARDS ***
Dealt to c9a2f192 
Dealt to 44cfb570 
Dealt to 7c8f5b37 
Dealt to 8fefbc9a 
Dealt to Hero [Jc 6s]
Dealt to 90577903 
8fefbc9a: raises $0.1 to $0.2
Hero: folds
90577903: folds
c9a2f192: folds
44cfb570: folds
7c8f5b37: folds
Uncalled bet ($0.1) returned to 8fefbc9a
*** SHOWDOWN ***
8fefbc9a collected $0.25 from pot
*** SUMMARY ***
Total pot $0.25 | Rake $0 | Jackpot $0 | Bingo $0 | Fortune $0 | Tax $0
Seat 1: c9a2f192 (button) folded before Flop (didn't bet)
Seat 2: 44cfb570 (small blind) folded before Flop
Seat 3: 7c8f5b37 (big blind) folded before Flop
Seat 4: 8fefbc9a collected ($0.25)
Seat 5: Hero folded before Flop (didn't bet)
Seat 6: 90577903 folded before Flop (didn't bet)


Poker Hand #RC2774676940: Hold'em No Limit ($0.05/$0.1) - 2024/08/05 12:07:31
Table 'RushAndCash21372200' 6-max Seat #1 is the button
Seat 1: eff08648 ($10.32 in chips)
Seat 2: 85749a92 ($9.9 in chips)
Seat 3: ae6a98bd ($12.26 in chips)
Seat 4: Hero ($10 in chips)
Seat 5: 5580da68 ($10 in chips)
Seat 6: 1692eb58 ($11.51 in chips)
85749a92: posts small blind $0.05
ae6a98bd: posts big blind $0.1
*** HOLE CARDS ***
Dealt to eff08648 
Dealt to 85749a92 
Dealt to ae6a98bd 
Dealt to Hero [Ad Qd]
Dealt to 5580da68 
Dealt to 1692eb58 
Hero: raises $0.1 to $0.2
5580da68: folds
1692eb58: folds
eff08648: folds
85749a92: folds
ae6a98bd: folds
Uncalled bet ($0.1) returned to Hero
*** SHOWDOWN ***
Hero collected $0.25 from pot
*** SUMMARY ***
Total pot $0.25 | Rake $0 | Jackpot $0 | Bingo $0 | Fortune $0 | Tax $0
Seat 1: eff08648 (button) folded before Flop (didn't bet)
Seat 2: 85749a92 (small blind) folded before Flop
Seat 3: ae6a98bd (big blind) folded before Flop
Seat 4: Hero collected ($0.25)
Seat 5: 5580da68 folded before Flop (didn't bet)
Seat 6: 1692eb58 folded before Flop (didn't bet)


Poker Hand #RC2774676914: Hold'em No Limit ($0.05/$0.1) - 2024/08/05 12:07:27
Table 'RushAndCash21372174' 6-max Seat #1 is the button
Seat 1: 7a36d7b2 ($16.17 in chips)
Seat 2: ec055f5c ($10.82 in chips)
Seat 3: bcc30718 ($12.23 in chips)
Seat 4: fbe6dd7e ($14.4 in chips)
Seat 5: Hero ($10 in chips)
Seat 6: 7ace1cc0 ($17.67 in chips)
ec055f5c: posts small blind $0.05
bcc30718: posts big blind $0.1
*** HOLE CARDS ***
Dealt to 7a36d7b2 
Dealt to ec055f5c 
Dealt to bcc30718 
Dealt to fbe6dd7e 
Dealt to Hero [8h 9d]
Dealt to 7ace1cc0 
fbe6dd7e: folds
Hero: folds
7ace1cc0: folds
7a36d7b2: folds
ec055f5c: folds
Uncalled bet ($0.05) returned to bcc30718
*** SHOWDOWN ***
bcc30718 collected $0.1 from pot
*** SUMMARY ***
Total pot $0.1 | Rake $0 | Jackpot $0 | Bingo $0 | Fortune $0 | Tax $0
Seat 1: 7a36d7b2 (button) folded before Flop (didn't bet)
Seat 2: ec055f5c (small blind) folded before Flop
Seat 3: bcc30718 (big blind) collected ($0.1)
Seat 4: fbe6dd7e folded before Flop (didn't bet)
Seat 5: Hero folded before Flop (didn't bet)
Seat 6: 7ace1cc0 folded before Flop (didn't bet)


Poker Hand #RC2774676881: Hold'em No Limit ($0.05/$0.1) - 2024/08/05 12:07:23
Table 'RushAndCash21372141' 6-max Seat #1 is the button
Seat 1: f0263df4 ($25.97 in chips)
Seat 2: Hero ($10 in chips)
Seat 3: 13b99118 ($16 in chips)
Seat 4: 3589c211 ($11.42 in chips)
Seat 5: 7c891321 ($16.48 in chips)
Seat 6: a012bc22 ($15.15 in chips)
Hero: posts small blind $0.05
13b99118: posts big blind $0.1
*** HOLE CARDS ***
Dealt to f0263df4 
Dealt to Hero [3s 8s]
Dealt to 13b99118 
Dealt to 3589c211 
Dealt to 7c891321 
Dealt to a012bc22 
3589c211: folds
7c891321: folds
a012bc22: folds
f0263df4: raises $0.1 to $0.2
Hero: folds
13b99118: folds
Uncalled bet ($0.1) returned to f0263df4
*** SHOWDOWN ***
f0263df4 collected $0.25 from pot
*** SUMMARY ***
Total pot $0.25 | Rake $0 | Jackpot $0 | Bingo $0 | Fortune $0 | Tax $0
Seat 1: f0263df4 (button) collected ($0.25)
Seat 2: Hero (small blind) folded before Flop
Seat 3: 13b99118 (big blind) folded before Flop
Seat 4: 3589c211 folded before Flop (didn't bet)
Seat 5: 7c891321 folded before Flop (didn't bet)
Seat 6: a012bc22 folded before Flop (didn't bet)


Poker Hand #RC2774676823: Hold'em No Limit ($0.05/$0.1) - 2024/08/05 12:07:16
Table 'RushAndCash21372083' 6-max Seat #1 is the button
Seat 1: 54ce7d55 ($10.15 in chips)
Seat 2: e3c1056c ($11.81 in chips)
Seat 3: Hero ($10 in chips)
Seat 4: dbe3cff8 ($16.01 in chips)
Seat 5: 15f1871b ($10.17 in chips)
Seat 6: 62110fa0 ($11.59 in chips)
e3c1056c: posts small blind $0.05
Hero: posts big blind $0.1
*** HOLE CARDS ***
Dealt to 54ce7d55 
Dealt to e3c1056c 
Dealt to Hero [Tc 4d]
Dealt to dbe3cff8 
Dealt to 15f1871b 
Dealt to 62110fa0 
dbe3cff8: folds
15f1871b: folds
62110fa0: folds
54ce7d55: raises $0.1 to $0.2
e3c1056c: folds
Hero: folds
Uncalled bet ($0.1) returned to 54ce7d55
*** SHOWDOWN ***
54ce7d55 collected $0.25 from pot
*** SUMMARY ***
Total pot $0.25 | Rake $0 | Jackpot $0 | Bingo $0 | Fortune $0 | Tax $0
Seat 1: 54ce7d55 (button) collected ($0.25)
Seat 2: e3c1056c (small blind) folded before Flop
Seat 3: Hero (big blind) folded before Flop
Seat 4: dbe3cff8 folded before Flop (didn't bet)
Seat 5: 15f1871b folded before Flop (didn't bet)
Seat 6: 62110fa0 folded before Flop (didn't bet)


Poker Hand #RC2774676795: Hold'em No Limit ($0.05/$0.1) - 2024/08/05 12:07:12
Table 'RushAndCash21372055' 6-max Seat #1 is the button
Seat 1: Hero ($10 in chips)
Seat 2: 7a36d7b2 ($16.32 in chips)
Seat 3: a012bc22 ($15.1 in chips)
Seat 4: 8f7c02cf ($19.08 in chips)
Seat 5: 5ec6e508 ($9.85 in chips)
Seat 6: 888e2275 ($10 in chips)
7a36d7b2: posts small blind $0.05
a012bc22: posts big blind $0.1
*** HOLE CARDS ***
Dealt to Hero [9c 4d]
Dealt to 7a36d7b2 
Dealt to a012bc22 
Dealt to 8f7c02cf 
Dealt to 5ec6e508 
Dealt to 888e2275 
8f7c02cf: folds
5ec6e508: folds
888e2275: folds
Hero: folds
7a36d7b2: folds
Uncalled bet ($0.05) returned to a012bc22
*** SHOWDOWN ***
a012bc22 collected $0.1 from pot
*** SUMMARY ***
Total pot $0.1 | Rake $0 | Jackpot $0 | Bingo $0 | Fortune $0 | Tax $0
Seat 1: Hero (button) folded before Flop (didn't bet)
Seat 2: 7a36d7b2 (small blind) folded before Flop
Seat 3: a012bc22 (big blind) collected ($0.1)
Seat 4: 8f7c02cf folded before Flop (didn't bet)
Seat 5: 5ec6e508 folded before Flop (didn't bet)
Seat 6: 888e2275 folded before Flop (didn't bet)


Poker Hand #RC2774676762: Hold'em No Limit ($0.05/$0.1) - 2024/08/05 12:07:09
Table 'RushAndCash21372022' 6-max Seat #1 is the button
Seat 1: 8af1362 ($13.15 in chips)
Seat 2: 50c984fb ($13.99 in chips)
Seat 3: 15e8bc52 ($16.88 in chips)
Seat 4: 8a57788f ($10.72 in chips)
Seat 5: Hero ($10 in chips)
Seat 6: 5ec6e508 ($9.85 in chips)
50c984fb: posts small blind $0.05
15e8bc52: posts big blind $0.1
*** HOLE CARDS ***
Dealt to 8af1362 
Dealt to 50c984fb 
Dealt to 15e8bc52 
Dealt to 8a57788f 
Dealt to Hero [8d 2h]
Dealt to 5ec6e508 
8a57788f: raises $0.12 to $0.22
Hero: folds
5ec6e508: folds
8af1362: folds
50c984fb: folds
15e8bc52: folds
Uncalled bet ($0.12) returned to 8a57788f
*** SHOWDOWN ***
8a57788f collected $0.25 from pot
*** SUMMARY ***
Total pot $0.25 | Rake $0 | Jackpot $0 | Bingo $0 | Fortune $0 | Tax $0
Seat 1: 8af1362 (button) folded before Flop (didn't bet)
Seat 2: 50c984fb (small blind) folded before Flop
Seat 3: 15e8bc52 (big blind) folded before Flop
Seat 4: 8a57788f collected ($0.25)
Seat 5: Hero folded before Flop (didn't bet)
Seat 6: 5ec6e508 folded before Flop (didn't bet)


Poker Hand #RC2774676704: Hold'em No Limit ($0.05/$0.1) - 2024/08/05 12:07:02
Table 'RushAndCash21371964' 6-max Seat #1 is the button
Seat 1: 8b48aa8d ($9.85 in chips)
Seat 2: 6e6756d9 ($10 in chips)
Seat 3: ed41ea81 ($13.21 in chips)
Seat 4: e6cc4f7f ($9.07 in chips)
Seat 5: 7d4b7916 ($10 in chips)
Seat 6: Hero ($10 in chips)
6e6756d9: posts small blind $0.05
ed41ea81: posts big blind $0.1
*** HOLE CARDS ***
Dealt to 8b48aa8d 
Dealt to 6e6756d9 
Dealt to ed41ea81 
Dealt to e6cc4f7f 
Dealt to 7d4b7916 
Dealt to Hero [3h Qd]
e6cc4f7f: folds
7d4b7916: folds
Hero: folds
8b48aa8d: folds
6e6756d9: raises $0.15 to $0.25
ed41ea81: raises $0.65 to $0.9
6e6756d9: folds
Uncalled bet ($0.65) returned to ed41ea81
*** SHOWDOWN ***
ed41ea81 collected $0.48 from pot
*** SUMMARY ***
Total pot $0.5 | Rake $0.02 | Jackpot $0 | Bingo $0 | Fortune $0 | Tax $0
Seat 1: 8b48aa8d (button) folded before Flop (didn't bet)
Seat 2: 6e6756d9 (small blind) folded before Flop
Seat 3: ed41ea81 (big blind) collected ($0.48)
Seat 4: e6cc4f7f folded before Flop (didn't bet)
Seat 5: 7d4b7916 folded before Flop (didn't bet)
Seat 6: Hero folded before Flop (didn't bet)


Poker Hand #RC2774676665: Hold'em No Limit ($0.05/$0.1) - 2024/08/05 12:06:57
Table 'RushAndCash21371925' 6-max Seat #1 is the button
Seat 1: d4a81bd6 ($12.4 in chips)
Seat 2: ed41ea81 ($13.26 in chips)
Seat 3: c4584975 ($12.61 in chips)
Seat 4: 87ef9cfe ($3.11 in chips)
Seat 5: Hero ($10 in chips)
Seat 6: d12dc75 ($10.56 in chips)
ed41ea81: posts small blind $0.05
c4584975: posts big blind $0.1
*** HOLE CARDS ***
Dealt to d4a81bd6 
Dealt to ed41ea81 
Dealt to c4584975 
Dealt to 87ef9cfe 
Dealt to Hero [9h 7s]
Dealt to d12dc75 
87ef9cfe: folds
Hero: folds
d12dc75: folds
d4a81bd6: folds
ed41ea81: folds
Uncalled bet ($0.05) returned to c4584975
*** SHOWDOWN ***
c4584975 collected $0.1 from pot
*** SUMMARY ***
Total pot $0.1 | Rake $0 | Jackpot $0 | Bingo $0 | Fortune $0 | Tax $0
Seat 1: d4a81bd6 (button) folded before Flop (didn't bet)
Seat 2: ed41ea81 (small blind) folded before Flop
Seat 3: c4584975 (big blind) collected ($0.1)
Seat 4: 87ef9cfe folded before Flop (didn't bet)
Seat 5: Hero folded before Flop (didn't bet)
Seat 6: d12dc75 folded before Flop (didn't bet)


Poker Hand #RC2774676610: Hold'em No Limit ($0.05/$0.1) - 2024/08/05 12:06:51
Table 'RushAndCash21371870' 6-max Seat #1 is the button
Seat 1: Hero ($10 in chips)
Seat 2: fa34ddf4 ($10.05 in chips)
Seat 3: 6cf0878a ($10 in chips)
Seat 4: 2a3d5d7e ($10.16 in chips)
Seat 5: b3123c97 ($19.28 in chips)
Seat 6: 320f691a ($10.82 in chips)
fa34ddf4: posts small blind $0.05
6cf0878a: posts big blind $0.1
*** HOLE CARDS ***
Dealt to Hero [2c 9d]
Dealt to fa34ddf4 
Dealt to 6cf0878a 
Dealt to 2a3d5d7e 
Dealt to b3123c97 
Dealt to 320f691a 
2a3d5d7e: folds
b3123c97: folds
320f691a: folds
Hero: folds
fa34ddf4: raises $0.2 to $0.3
6cf0878a: folds
Uncalled bet ($0.2) returned to fa34ddf4
*** SHOWDOWN ***
fa34ddf4 collected $0.2 from pot
*** SUMMARY ***
Total pot $0.2 | Rake $0 | Jackpot $0 | Bingo $0 | Fortune $0 | Tax $0
Seat 1: Hero (button) folded before Flop (didn't bet)
Seat 2: fa34ddf4 (small blind) collected ($0.2)
Seat 3: 6cf0878a (big blind) folded before Flop
Seat 4: 2a3d5d7e folded before Flop (didn't bet)
Seat 5: b3123c97 folded before Flop (didn't bet)
Seat 6: 320f691a folded before Flop (didn't bet)


Poker Hand #RC2774676537: Hold'em No Limit ($0.05/$0.1) - 2024/08/05 12:06:41
Table 'RushAndCash21371797' 6-max Seat #1 is the button
Seat 1: b2188f2a ($10.05 in chips)
Seat 2: Hero ($10 in chips)
Seat 3: 99d264c4 ($10.5 in chips)
Seat 4: 657ccbb9 ($7.97 in chips)
Seat 5: 66b312b5 ($10.05 in chips)
Seat 6: e831f71e ($9.55 in chips)
Hero: posts small blind $0.05
99d264c4: posts big blind $0.1
*** HOLE CARDS ***
Dealt to b2188f2a 
Dealt to Hero [2d 3d]
Dealt to 99d264c4 
Dealt to 657ccbb9 
Dealt to 66b312b5 
Dealt to e831f71e 
657ccbb9: folds
66b312b5: folds
e831f71e: folds
b2188f2a: folds
Hero: folds
Uncalled bet ($0.05) returned to 99d264c4
*** SHOWDOWN ***
99d264c4 collected $0.1 from pot
*** SUMMARY ***
Total pot $0.1 | Rake $0 | Jackpot $0 | Bingo $0 | Fortune $0 | Tax $0
Seat 1: b2188f2a (button) folded before Flop (didn't bet)
Seat 2: Hero (small blind) folded before Flop
Seat 3: 99d264c4 (big blind) collected ($0.1)
Seat 4: 657ccbb9 folded before Flop (didn't bet)
Seat 5: 66b312b5 folded before Flop (didn't bet)
Seat 6: e831f71e folded before Flop (didn't bet)


Poker Hand #RC2774676446: Hold'em No Limit ($0.05/$0.1) - 2024/08/05 12:06:29
Table 'RushAndCash21371706' 6-max Seat #1 is the button
Seat 1: fc759a03 ($11.31 in chips)
Seat 2: d69aa3f7 ($11.83 in chips)
Seat 3: Hero ($10 in chips)
Seat 4: 1d2045bc ($7.46 in chips)
Seat 5: 5ab94028 ($9.8 in chips)
Seat 6: 77599916 ($14.75 in chips)
d69aa3f7: posts small blind $0.05
Hero: posts big blind $0.1
*** HOLE CARDS ***
Dealt to fc759a03 
Dealt to d69aa3f7 
Dealt to Hero [9s 4s]
Dealt to 1d2045bc 
Dealt to 5ab94028 
Dealt to 77599916 
1d2045bc: folds
5ab94028: folds
77599916: raises $0.1 to $0.2
fc759a03: folds
d69aa3f7: folds
Hero: folds
Uncalled bet ($0.1) returned to 77599916
*** SHOWDOWN ***
77599916 collected $0.25 from pot
*** SUMMARY ***
Total pot $0.25 | Rake $0 | Jackpot $0 | Bingo $0 | Fortune $0 | Tax $0
Seat 1: fc759a03 (button) folded before Flop (didn't bet)
Seat 2: d69aa3f7 (small blind) folded before Flop
Seat 3: Hero (big blind) folded before Flop
Seat 4: 1d2045bc folded before Flop (didn't bet)
Seat 5: 5ab94028 folded before Flop (didn't bet)
Seat 6: 77599916 collected ($0.25)


