Poker Hand #HD1738842513: Hold'em No Limit ($0.02/$0.05) - 2024/04/20 15:49:33
Table 'NLHBlue13' 6-max Seat #4 is the button
Seat 1: Hero ($9.08 in chips)
Seat 2: f6d650f4 ($15.67 in chips)
Seat 3: 6fbb6d8b ($3.2 in chips)
Seat 4: 247787fe ($6.75 in chips)
Seat 5: 898a27d9 ($4.5 in chips)
Seat 6: e82c68a6 ($5 in chips)
898a27d9: posts small blind $0.02
e82c68a6: posts big blind $0.05
*** HOLE CARDS ***
Dealt to Hero [Ad 7c]
Dealt to f6d650f4 
Dealt to 6fbb6d8b 
Dealt to 247787fe 
Dealt to 898a27d9 
Dealt to e82c68a6 
Hero: folds
f6d650f4: calls $0.05
6fbb6d8b: raises $0.1 to $0.15
247787fe: folds
898a27d9: folds
e82c68a6: folds
f6d650f4: calls $0.1
*** FLOP *** [6h Qh 2s]
f6d650f4: checks
6fbb6d8b: bets $0.13
f6d650f4: calls $0.13
*** TURN *** [6h Qh 2s] [8c]
f6d650f4: checks
6fbb6d8b: bets $0.48
f6d650f4: calls $0.48
*** RIVER *** [6h Qh 2s 8c] [Jc]
f6d650f4: checks
6fbb6d8b: checks
f6d650f4: shows [Qs 9h] (Pair of Queens)
6fbb6d8b: shows [Ts Ac] (Ace-High)
*** SHOWDOWN ***
f6d650f4 collected $1.47 from pot
*** SUMMARY ***
Total pot $1.59 | Rake $0.07 | Jackpot $0.05 | Bingo $0 | Fortune $0 | Tax $0
Board [6h Qh 2s 8c Jc]
Seat 1: Hero folded before Flop (didn't bet)
Seat 2: f6d650f4 showed [Qs 9h] and won ($1.47) with Pair of Queens
Seat 3: 6fbb6d8b showed [Ts Ac] and lost with Ace-High
Seat 4: 247787fe (button) folded before Flop (didn't bet)
Seat 5: 898a27d9 (small blind) folded before Flop
Seat 6: e82c68a6 (big blind) folded before Flop


Poker Hand #HD1738842489: Hold'em No Limit ($0.02/$0.05) - 2024/04/20 15:49:20
Table 'NLHBlue13' 6-max Seat #3 is the button
Seat 1: Hero ($9.01 in chips)
Seat 2: f6d650f4 ($15.67 in chips)
Seat 3: 6fbb6d8b ($3.2 in chips)
Seat 4: 247787fe ($6.77 in chips)
Seat 5: 898a27d9 ($4.55 in chips)
247787fe: posts small blind $0.02
898a27d9: posts big blind $0.05
*** HOLE CARDS ***
Dealt to Hero [Jh Qd]
Dealt to f6d650f4 
Dealt to 6fbb6d8b 
Dealt to 247787fe 
Dealt to 898a27d9 
Hero: raises $0.07 to $0.12
f6d650f4: folds
6fbb6d8b: folds
247787fe: folds
898a27d9: folds
Uncalled bet ($0.07) returned to Hero
*** SHOWDOWN ***
Hero collected $0.12 from pot
*** SUMMARY ***
Total pot $0.12 | Rake $0 | Jackpot $0 | Bingo $0 | Fortune $0 | Tax $0
Seat 1: Hero collected ($0.12)
Seat 2: f6d650f4 folded before Flop (didn't bet)
Seat 3: 6fbb6d8b (button) folded before Flop (didn't bet)
Seat 4: 247787fe (small blind) folded before Flop
Seat 5: 898a27d9 (big blind) folded before Flop


Poker Hand #HD1738842466: Hold'em No Limit ($0.02/$0.05) - 2024/04/20 15:49:08
Table 'NLHBlue13' 6-max Seat #2 is the button
Seat 1: Hero ($9.01 in chips)
Seat 2: f6d650f4 ($15.67 in chips)
Seat 3: 6fbb6d8b ($3.15 in chips)
Seat 4: 247787fe ($6.82 in chips)
Seat 5: 898a27d9 ($4.55 in chips)
6fbb6d8b: posts small blind $0.02
247787fe: posts big blind $0.05
*** HOLE CARDS ***
Dealt to Hero [Qh 2h]
Dealt to f6d650f4 
Dealt to 6fbb6d8b 
Dealt to 247787fe 
Dealt to 898a27d9 
898a27d9: folds
Hero: folds
f6d650f4: folds
6fbb6d8b: raises $0.1 to $0.15
247787fe: folds
Uncalled bet ($0.1) returned to 6fbb6d8b
*** SHOWDOWN ***
6fbb6d8b collected $0.1 from pot
*** SUMMARY ***
Total pot $0.1 | Rake $0 | Jackpot $0 | Bingo $0 | Fortune $0 | Tax $0
Seat 1: Hero folded before Flop (didn't bet)
Seat 2: f6d650f4 (button) folded before Flop (didn't bet)
Seat 3: 6fbb6d8b (small blind) collected ($0.1)
Seat 4: 247787fe (big blind) folded before Flop
Seat 5: 898a27d9 folded before Flop (didn't bet)


Poker Hand #HD1738842372: Hold'em No Limit ($0.02/$0.05) - 2024/04/20 15:48:26
Table 'NLHBlue13' 6-max Seat #1 is the button
Seat 1: Hero ($9.01 in chips)
Seat 2: f6d650f4 ($15.69 in chips)
Seat 3: 6fbb6d8b ($2.94 in chips)
Seat 4: 247787fe ($6.82 in chips)
Seat 5: 898a27d9 ($4.76 in chips)
f6d650f4: posts small blind $0.02
6fbb6d8b: posts big blind $0.05
*** HOLE CARDS ***
Dealt to Hero [5s Qd]
Dealt to f6d650f4 
Dealt to 6fbb6d8b 
Dealt to 247787fe 
Dealt to 898a27d9 
247787fe: folds
898a27d9: raises $0.05 to $0.1
Hero: folds
f6d650f4: folds
6fbb6d8b: calls $0.05
*** FLOP *** [9d 8h 6h]
6fbb6d8b: checks
898a27d9: checks
*** TURN *** [9d 8h 6h] [6c]
6fbb6d8b: bets $0.11
898a27d9: calls $0.11
*** RIVER *** [9d 8h 6h 6c] [Ah]
6fbb6d8b: checks
898a27d9: checks
6fbb6d8b: shows [Kd 9h] (Pair of Nines and Pair of Sixes)
898a27d9: shows [7d 7s] (Pair of Sevens and Pair of Sixes)
*** SHOWDOWN ***
6fbb6d8b collected $0.42 from pot
*** SUMMARY ***
Total pot $0.44 | Rake $0.02 | Jackpot $0 | Bingo $0 | Fortune $0 | Tax $0
Board [9d 8h 6h 6c Ah]
Seat 1: Hero (button) folded before Flop (didn't bet)
Seat 2: f6d650f4 (small blind) folded before Flop
Seat 3: 6fbb6d8b (big blind) showed [Kd 9h] and won ($0.42) with Pair of Nines and Pair of Sixes
Seat 4: 247787fe folded before Flop (didn't bet)
Seat 5: 898a27d9 showed [7d 7s] and lost with Pair of Sevens and Pair of Sixes


Poker Hand #HD1738842331: Hold'em No Limit ($0.02/$0.05) - 2024/04/20 15:48:03
Table 'NLHBlue13' 6-max Seat #5 is the button
Seat 1: Hero ($8.87 in chips)
Seat 2: f6d650f4 ($15.84 in chips)
Seat 3: 6fbb6d8b ($2.94 in chips)
Seat 4: 247787fe ($6.82 in chips)
Seat 5: 898a27d9 ($4.76 in chips)
Hero: posts small blind $0.02
f6d650f4: posts big blind $0.05
*** HOLE CARDS ***
Dealt to Hero [Qd As]
Dealt to f6d650f4 
Dealt to 6fbb6d8b 
Dealt to 247787fe 
Dealt to 898a27d9 
6fbb6d8b: folds
247787fe: folds
898a27d9: folds
Hero: raises $0.1 to $0.15
f6d650f4: calls $0.1
*** FLOP *** [Ts Ah 8s]
Hero: bets $0.15
f6d650f4: folds
Uncalled bet ($0.15) returned to Hero
*** SHOWDOWN ***
Hero collected $0.29 from pot
*** SUMMARY ***
Total pot $0.3 | Rake $0.01 | Jackpot $0 | Bingo $0 | Fortune $0 | Tax $0
Board [Ts Ah 8s]
Seat 1: Hero (small blind) won ($0.29)
Seat 2: f6d650f4 (big blind) folded on the Flop
Seat 3: 6fbb6d8b folded before Flop (didn't bet)
Seat 4: 247787fe folded before Flop (didn't bet)
Seat 5: 898a27d9 (button) folded before Flop (didn't bet)


Poker Hand #HD1738842318: Hold'em No Limit ($0.02/$0.05) - 2024/04/20 15:47:52
Table 'NLHBlue13' 6-max Seat #4 is the button
Seat 1: Hero ($8.92 in chips)
Seat 2: f6d650f4 ($15.84 in chips)
Seat 3: 6fbb6d8b ($2.94 in chips)
Seat 4: 247787fe ($6.75 in chips)
Seat 5: 898a27d9 ($4.78 in chips)
898a27d9: posts small blind $0.02
Hero: posts big blind $0.05
*** HOLE CARDS ***
Dealt to Hero [Kh 7d]
Dealt to f6d650f4 
Dealt to 6fbb6d8b 
Dealt to 247787fe 
Dealt to 898a27d9 
f6d650f4: folds
6fbb6d8b: folds
247787fe: raises $0.08 to $0.13
898a27d9: folds
Hero: folds
Uncalled bet ($0.08) returned to 247787fe
*** SHOWDOWN ***
247787fe collected $0.12 from pot
*** SUMMARY ***
Total pot $0.12 | Rake $0 | Jackpot $0 | Bingo $0 | Fortune $0 | Tax $0
Seat 1: Hero (big blind) folded before Flop
Seat 2: f6d650f4 folded before Flop (didn't bet)
Seat 3: 6fbb6d8b folded before Flop (didn't bet)
Seat 4: 247787fe (button) collected ($0.12)
Seat 5: 898a27d9 (small blind) folded before Flop


Poker Hand #HD1738842252: Hold'em No Limit ($0.02/$0.05) - 2024/04/20 15:47:20
Table 'NLHBlue13' 6-max Seat #3 is the button
Seat 1: Hero ($8.92 in chips)
Seat 2: f6d650f4 ($15.57 in chips)
Seat 3: 6fbb6d8b ($2.99 in chips)
Seat 4: 247787fe ($6.77 in chips)
Seat 5: 898a27d9 ($5 in chips)
247787fe: posts small blind $0.02
898a27d9: posts big blind $0.05
*** HOLE CARDS ***
Dealt to Hero [8c 2h]
Dealt to f6d650f4 
Dealt to 6fbb6d8b 
Dealt to 247787fe 
Dealt to 898a27d9 
Hero: folds
f6d650f4: calls $0.05
6fbb6d8b: calls $0.05
247787fe: folds
898a27d9: raises $0.17 to $0.22
f6d650f4: calls $0.17
6fbb6d8b: folds
*** FLOP *** [4s Kh 6h]
898a27d9: checks
f6d650f4: checks
*** TURN *** [4s Kh 6h] [As]
898a27d9: checks
f6d650f4: checks
*** RIVER *** [4s Kh 6h As] [3h]
898a27d9: checks
f6d650f4: checks
898a27d9: shows [Qh Jc] (Ace-High)
f6d650f4: shows [Ts Ad] (Pair of Aces)
*** SHOWDOWN ***
f6d650f4 collected $0.49 from pot
*** SUMMARY ***
Total pot $0.51 | Rake $0.02 | Jackpot $0 | Bingo $0 | Fortune $0 | Tax $0
Board [4s Kh 6h As 3h]
Seat 1: Hero folded before Flop (didn't bet)
Seat 2: f6d650f4 showed [Ts Ad] and won ($0.49) with Pair of Aces
Seat 3: 6fbb6d8b (button) folded before Flop
Seat 4: 247787fe (small blind) folded before Flop
Seat 5: 898a27d9 (big blind) showed [Qh Jc] and lost with Ace-High


Poker Hand #HD1738842217: Hold'em No Limit ($0.02/$0.05) - 2024/04/20 15:47:00
Table 'NLHBlue13' 6-max Seat #2 is the button
Seat 1: Hero ($8.85 in chips)
Seat 2: f6d650f4 ($15.57 in chips)
Seat 3: 6fbb6d8b ($3.01 in chips)
Seat 4: 247787fe ($6.82 in chips)
Seat 5: 898a27d9 ($5 in chips)
6fbb6d8b: posts small blind $0.02
247787fe: posts big blind $0.05
*** HOLE CARDS ***
Dealt to Hero [Ah Qs]
Dealt to f6d650f4 
Dealt to 6fbb6d8b 
Dealt to 247787fe 
Dealt to 898a27d9 
898a27d9: folds
Hero: raises $0.07 to $0.12
f6d650f4: folds
6fbb6d8b: folds
247787fe: folds
Uncalled bet ($0.07) returned to Hero
*** SHOWDOWN ***
Hero collected $0.12 from pot
*** SUMMARY ***
Total pot $0.12 | Rake $0 | Jackpot $0 | Bingo $0 | Fortune $0 | Tax $0
Seat 1: Hero collected ($0.12)
Seat 2: f6d650f4 (button) folded before Flop (didn't bet)
Seat 3: 6fbb6d8b (small blind) folded before Flop
Seat 4: 247787fe (big blind) folded before Flop
Seat 5: 898a27d9 folded before Flop (didn't bet)


Poker Hand #HD1738842130: Hold'em No Limit ($0.02/$0.05) - 2024/04/20 15:46:17
Table 'NLHBlue13' 6-max Seat #1 is the button
Seat 1: Hero ($8.85 in chips)
Seat 2: f6d650f4 ($15.97 in chips)
Seat 3: 6fbb6d8b ($2.65 in chips)
Seat 5: 898a27d9 ($5 in chips)
f6d650f4: posts small blind $0.02
6fbb6d8b: posts big blind $0.05
*** HOLE CARDS ***
Dealt to Hero [2h 6h]
Dealt to f6d650f4 
Dealt to 6fbb6d8b 
Dealt to 898a27d9 
898a27d9: folds
Hero: folds
f6d650f4: calls $0.03
6fbb6d8b: raises $0.15 to $0.2
f6d650f4: calls $0.15
*** FLOP *** [Qs Ad 2c]
f6d650f4: checks
6fbb6d8b: checks
*** TURN *** [Qs Ad 2c] [8d]
f6d650f4: bets $0.2
6fbb6d8b: raises $0.6 to $0.8
f6d650f4: folds
Uncalled bet ($0.6) returned to 6fbb6d8b
*** SHOWDOWN ***
6fbb6d8b collected $0.76 from pot
*** SUMMARY ***
Total pot $0.8 | Rake $0.04 | Jackpot $0 | Bingo $0 | Fortune $0 | Tax $0
Board [Qs Ad 2c 8d]
Seat 1: Hero (button) folded before Flop (didn't bet)
Seat 2: f6d650f4 (small blind) folded on the Turn
Seat 3: 6fbb6d8b (big blind) won ($0.76)
Seat 5: 898a27d9 folded before Flop (didn't bet)


Poker Hand #HD1738842074: Hold'em No Limit ($0.02/$0.05) - 2024/04/20 15:45:47
Table 'NLHBlue13' 6-max Seat #5 is the button
Seat 1: Hero ($8.87 in chips)
Seat 2: f6d650f4 ($16.07 in chips)
Seat 3: 6fbb6d8b ($2.65 in chips)
Seat 5: 898a27d9 ($4.89 in chips)
Hero: posts small blind $0.02
f6d650f4: posts big blind $0.05
*** HOLE CARDS ***
Dealt to Hero [Ad 7s]
Dealt to f6d650f4 
Dealt to 6fbb6d8b 
Dealt to 898a27d9 
6fbb6d8b: folds
898a27d9: raises $0.05 to $0.1
Hero: folds
f6d650f4: calls $0.05
*** FLOP *** [Qd 5c 8d]
f6d650f4: checks
898a27d9: checks
*** TURN *** [Qd 5c 8d] [8c]
f6d650f4: checks
898a27d9: checks
*** RIVER *** [Qd 5c 8d 8c] [Kc]
f6d650f4: checks
898a27d9: checks
f6d650f4: shows [4s 9c] (Pair of Eights)
898a27d9: shows [3s Ac] (Pair of Eights)
*** SHOWDOWN ***
898a27d9 collected $0.21 from pot
*** SUMMARY ***
Total pot $0.22 | Rake $0.01 | Jackpot $0 | Bingo $0 | Fortune $0 | Tax $0
Board [Qd 5c 8d 8c Kc]
Seat 1: Hero (small blind) folded before Flop
Seat 2: f6d650f4 (big blind) showed [4s 9c] and lost with Pair of Eights
Seat 3: 6fbb6d8b folded before Flop (didn't bet)
Seat 5: 898a27d9 (button) showed [3s Ac] and won ($0.21) with Pair of Eights


Poker Hand #HD1738841992: Hold'em No Limit ($0.02/$0.05) - 2024/04/20 15:45:06
Table 'NLHBlue13' 6-max Seat #3 is the button
Seat 1: Hero ($8.92 in chips)
Seat 2: f6d650f4 ($15.16 in chips)
Seat 3: 6fbb6d8b ($2.7 in chips)
Seat 5: 898a27d9 ($5.84 in chips)
898a27d9: posts small blind $0.02
Hero: posts big blind $0.05
*** HOLE CARDS ***
Dealt to Hero [7h 4h]
Dealt to f6d650f4 
Dealt to 6fbb6d8b 
Dealt to 898a27d9 
f6d650f4: calls $0.05
6fbb6d8b: calls $0.05
898a27d9: raises $0.2 to $0.25
Hero: folds
f6d650f4: calls $0.2
6fbb6d8b: folds
*** FLOP *** [6s Jd 4c]
898a27d9: bets $0.2
f6d650f4: calls $0.2
*** TURN *** [6s Jd 4c] [7s]
898a27d9: bets $0.5
f6d650f4: raises $0.66 to $1.16
898a27d9: folds
Uncalled bet ($0.66) returned to f6d650f4
*** SHOWDOWN ***
f6d650f4 collected $1.86 from pot
*** SUMMARY ***
Total pot $2 | Rake $0.09 | Jackpot $0.05 | Bingo $0 | Fortune $0 | Tax $0
Board [6s Jd 4c 7s]
Seat 1: Hero (big blind) folded before Flop
Seat 2: f6d650f4 won ($1.86)
Seat 3: 6fbb6d8b (button) folded before Flop
Seat 5: 898a27d9 (small blind) folded on the Turn


Poker Hand #HD1738841929: Hold'em No Limit ($0.02/$0.05) - 2024/04/20 15:44:33
Table 'NLHBlue13' 6-max Seat #2 is the button
Seat 1: Hero ($8.69 in chips)
Seat 2: f6d650f4 ($15.16 in chips)
Seat 3: 6fbb6d8b ($2.82 in chips)
Seat 5: 898a27d9 ($5.96 in chips)
6fbb6d8b: posts small blind $0.02
898a27d9: posts big blind $0.05
*** HOLE CARDS ***
Dealt to Hero [Qd Ks]
Dealt to f6d650f4 
Dealt to 6fbb6d8b 
Dealt to 898a27d9 
Hero: raises $0.07 to $0.12
f6d650f4: folds
6fbb6d8b: calls $0.1
898a27d9: calls $0.07
*** FLOP *** [Ts 7s Kd]
6fbb6d8b: checks
898a27d9: checks
Hero: bets $0.15
6fbb6d8b: folds
898a27d9: folds
Uncalled bet ($0.15) returned to Hero
*** SHOWDOWN ***
Hero collected $0.35 from pot
*** SUMMARY ***
Total pot $0.36 | Rake $0.01 | Jackpot $0 | Bingo $0 | Fortune $0 | Tax $0
Board [Ts 7s Kd]
Seat 1: Hero won ($0.35)
Seat 2: f6d650f4 (button) folded before Flop (didn't bet)
Seat 3: 6fbb6d8b (small blind) folded on the Flop
Seat 5: 898a27d9 (big blind) folded on the Flop


Poker Hand #HD1738841849: Hold'em No Limit ($0.02/$0.05) - 2024/04/20 15:43:50
Table 'NLHBlue13' 6-max Seat #1 is the button
Seat 1: Hero ($8.69 in chips)
Seat 2: f6d650f4 ($15.36 in chips)
Seat 3: 6fbb6d8b ($2.64 in chips)
Seat 4: 247787fe ($6.82 in chips)
Seat 5: 898a27d9 ($5.96 in chips)
f6d650f4: posts small blind $0.02
6fbb6d8b: posts big blind $0.05
*** HOLE CARDS ***
Dealt to Hero [2s Td]
Dealt to f6d650f4 
Dealt to 6fbb6d8b 
Dealt to 247787fe 
Dealt to 898a27d9 
247787fe: folds
898a27d9: folds
Hero: folds
f6d650f4: calls $0.03
6fbb6d8b: checks
*** FLOP *** [Kc Ac 4d]
f6d650f4: bets $0.05
6fbb6d8b: calls $0.05
*** TURN *** [Kc Ac 4d] [7s]
f6d650f4: bets $0.1
6fbb6d8b: calls $0.1
*** RIVER *** [Kc Ac 4d 7s] [Ah]
f6d650f4: checks
6fbb6d8b: bets $0.14
f6d650f4: folds
Uncalled bet ($0.14) returned to 6fbb6d8b
*** SHOWDOWN ***
6fbb6d8b collected $0.38 from pot
*** SUMMARY ***
Total pot $0.4 | Rake $0.02 | Jackpot $0 | Bingo $0 | Fortune $0 | Tax $0
Board [Kc Ac 4d 7s Ah]
Seat 1: Hero (button) folded before Flop (didn't bet)
Seat 2: f6d650f4 (small blind) folded on the River
Seat 3: 6fbb6d8b (big blind) won ($0.38)
Seat 4: 247787fe folded before Flop (didn't bet)
Seat 5: 898a27d9 folded before Flop (didn't bet)


Poker Hand #HD1738841751: Hold'em No Limit ($0.02/$0.05) - 2024/04/20 15:43:01
Table 'NLHBlue13' 6-max Seat #5 is the button
Seat 1: Hero ($8.71 in chips)
Seat 2: f6d650f4 ($15.46 in chips)
Seat 3: 6fbb6d8b ($2.64 in chips)
Seat 4: 247787fe ($6.82 in chips)
Seat 5: 898a27d9 ($5.85 in chips)
Hero: posts small blind $0.02
f6d650f4: posts big blind $0.05
*** HOLE CARDS ***
Dealt to Hero [6c Th]
Dealt to f6d650f4 
Dealt to 6fbb6d8b 
Dealt to 247787fe 
Dealt to 898a27d9 
6fbb6d8b: folds
247787fe: folds
898a27d9: raises $0.05 to $0.1
Hero: folds
f6d650f4: calls $0.05
*** FLOP *** [Ah 5h 6s]
f6d650f4: checks
898a27d9: checks
*** TURN *** [Ah 5h 6s] [4d]
f6d650f4: checks
898a27d9: bets $0.22
f6d650f4: folds
Uncalled bet ($0.22) returned to 898a27d9
*** SHOWDOWN ***
898a27d9 collected $0.21 from pot
*** SUMMARY ***
Total pot $0.22 | Rake $0.01 | Jackpot $0 | Bingo $0 | Fortune $0 | Tax $0
Board [Ah 5h 6s 4d]
Seat 1: Hero (small blind) folded before Flop
Seat 2: f6d650f4 (big blind) folded on the Turn
Seat 3: 6fbb6d8b folded before Flop (didn't bet)
Seat 4: 247787fe folded before Flop (didn't bet)
Seat 5: 898a27d9 (button) won ($0.21)


Poker Hand #HD1738841714: Hold'em No Limit ($0.02/$0.05) - 2024/04/20 15:42:44
Table 'NLHBlue13' 6-max Seat #4 is the button
Seat 1: Hero ($8.69 in chips)
Seat 2: f6d650f4 ($15.46 in chips)
Seat 3: 6fbb6d8b ($2.64 in chips)
Seat 4: 247787fe ($6.82 in chips)
Seat 5: 898a27d9 ($5.87 in chips)
898a27d9: posts small blind $0.02
Hero: posts big blind $0.05
*** HOLE CARDS ***
Dealt to Hero [6d 4d]
Dealt to f6d650f4 
Dealt to 6fbb6d8b 
Dealt to 247787fe 
Dealt to 898a27d9 
f6d650f4: folds
6fbb6d8b: folds
247787fe: folds
898a27d9: folds
Uncalled bet ($0.03) returned to Hero
*** SHOWDOWN ***
Hero collected $0.04 from pot
*** SUMMARY ***
Total pot $0.04 | Rake $0 | Jackpot $0 | Bingo $0 | Fortune $0 | Tax $0
Seat 1: Hero (big blind) collected ($0.04)
Seat 2: f6d650f4 folded before Flop (didn't bet)
Seat 3: 6fbb6d8b folded before Flop (didn't bet)
Seat 4: 247787fe (button) folded before Flop (didn't bet)
Seat 5: 898a27d9 (small blind) folded before Flop


Poker Hand #HD1738841680: Hold'em No Limit ($0.02/$0.05) - 2024/04/20 15:42:26
Table 'NLHBlue13' 6-max Seat #3 is the button
Seat 1: Hero ($8.69 in chips)
Seat 2: f6d650f4 ($15.46 in chips)
Seat 3: 6fbb6d8b ($2.64 in chips)
Seat 4: 247787fe ($6.84 in chips)
Seat 5: 898a27d9 ($5.85 in chips)
247787fe: posts small blind $0.02
898a27d9: posts big blind $0.05
*** HOLE CARDS ***
Dealt to Hero [4c Kd]
Dealt to f6d650f4 
Dealt to 6fbb6d8b 
Dealt to 247787fe 
Dealt to 898a27d9 
Hero: folds
f6d650f4: folds
6fbb6d8b: folds
247787fe: folds
Uncalled bet ($0.03) returned to 898a27d9
*** SHOWDOWN ***
898a27d9 collected $0.04 from pot
*** SUMMARY ***
Total pot $0.04 | Rake $0 | Jackpot $0 | Bingo $0 | Fortune $0 | Tax $0
Seat 1: Hero folded before Flop (didn't bet)
Seat 2: f6d650f4 folded before Flop (didn't bet)
Seat 3: 6fbb6d8b (button) folded before Flop (didn't bet)
Seat 4: 247787fe (small blind) folded before Flop
Seat 5: 898a27d9 (big blind) collected ($0.04)


Poker Hand #HD1738841657: Hold'em No Limit ($0.02/$0.05) - 2024/04/20 15:42:16
Table 'NLHBlue13' 6-max Seat #2 is the button
Seat 1: Hero ($8.69 in chips)
Seat 2: f6d650f4 ($15.46 in chips)
Seat 3: 6fbb6d8b ($2.66 in chips)
Seat 4: 247787fe ($6.82 in chips)
Seat 5: 898a27d9 ($5.85 in chips)
6fbb6d8b: posts small blind $0.02
247787fe: posts big blind $0.05
*** HOLE CARDS ***
Dealt to Hero [3h 5d]
Dealt to f6d650f4 
Dealt to 6fbb6d8b 
Dealt to 247787fe 
Dealt to 898a27d9 
898a27d9: folds
Hero: folds
f6d650f4: folds
6fbb6d8b: folds
Uncalled bet ($0.03) returned to 247787fe
*** SHOWDOWN ***
247787fe collected $0.04 from pot
*** SUMMARY ***
Total pot $0.04 | Rake $0 | Jackpot $0 | Bingo $0 | Fortune $0 | Tax $0
Seat 1: Hero folded before Flop (didn't bet)
Seat 2: f6d650f4 (button) folded before Flop (didn't bet)
Seat 3: 6fbb6d8b (small blind) folded before Flop
Seat 4: 247787fe (big blind) collected ($0.04)
Seat 5: 898a27d9 folded before Flop (didn't bet)


Poker Hand #HD1738841542: Hold'em No Limit ($0.02/$0.05) - 2024/04/20 15:41:26
Table 'NLHBlue13' 6-max Seat #1 is the button
Seat 1: Hero ($8.69 in chips)
Seat 2: f6d650f4 ($15.56 in chips)
Seat 3: 6fbb6d8b ($3.37 in chips)
Seat 4: 247787fe ($6.82 in chips)
Seat 5: 898a27d9 ($5.16 in chips)
f6d650f4: posts small blind $0.02
6fbb6d8b: posts big blind $0.05
*** HOLE CARDS ***
Dealt to Hero [3h 8c]
Dealt to f6d650f4 
Dealt to 6fbb6d8b 
Dealt to 247787fe 
Dealt to 898a27d9 
247787fe: folds
898a27d9: raises $0.05 to $0.1
Hero: folds
f6d650f4: calls $0.08
6fbb6d8b: calls $0.05
*** FLOP *** [2c 3c 4c]
f6d650f4: checks
6fbb6d8b: checks
898a27d9: bets $0.23
f6d650f4: folds
6fbb6d8b: raises $0.38 to $0.61
898a27d9: calls $0.38
*** TURN *** [2c 3c 4c] [Qd]
6fbb6d8b: checks
898a27d9: bets $0.76
6fbb6d8b: folds
Uncalled bet ($0.76) returned to 898a27d9
*** SHOWDOWN ***
898a27d9 collected $1.4 from pot
*** SUMMARY ***
Total pot $1.52 | Rake $0.07 | Jackpot $0.05 | Bingo $0 | Fortune $0 | Tax $0
Board [2c 3c 4c Qd]
Seat 1: Hero (button) folded before Flop (didn't bet)
Seat 2: f6d650f4 (small blind) folded on the Flop
Seat 3: 6fbb6d8b (big blind) folded on the Turn
Seat 4: 247787fe folded before Flop (didn't bet)
Seat 5: 898a27d9 won ($1.4)


Poker Hand #HD1738841499: Hold'em No Limit ($0.02/$0.05) - 2024/04/20 15:41:01
Table 'NLHBlue13' 6-max Seat #5 is the button
Seat 1: Hero ($8.71 in chips)
Seat 2: f6d650f4 ($15.71 in chips)
Seat 3: 6fbb6d8b ($3.37 in chips)
Seat 4: 247787fe ($6.82 in chips)
Seat 5: 898a27d9 ($5 in chips)
Hero: posts small blind $0.02
f6d650f4: posts big blind $0.05
*** HOLE CARDS ***
Dealt to Hero [Tc 9d]
Dealt to f6d650f4 
Dealt to 6fbb6d8b 
Dealt to 247787fe 
Dealt to 898a27d9 
6fbb6d8b: folds
247787fe: folds
898a27d9: raises $0.1 to $0.15
Hero: folds
f6d650f4: calls $0.1
*** FLOP *** [6s 8h 2s]
f6d650f4: checks
898a27d9: bets $0.16
f6d650f4: folds
Uncalled bet ($0.16) returned to 898a27d9
*** SHOWDOWN ***
898a27d9 collected $0.31 from pot
*** SUMMARY ***
Total pot $0.32 | Rake $0.01 | Jackpot $0 | Bingo $0 | Fortune $0 | Tax $0
Board [6s 8h 2s]
Seat 1: Hero (small blind) folded before Flop
Seat 2: f6d650f4 (big blind) folded on the Flop
Seat 3: 6fbb6d8b folded before Flop (didn't bet)
Seat 4: 247787fe folded before Flop (didn't bet)
Seat 5: 898a27d9 (button) won ($0.31)


Poker Hand #HD1738841429: Hold'em No Limit ($0.02/$0.05) - 2024/04/20 15:40:23
Table 'NLHBlue13' 6-max Seat #4 is the button
Seat 1: Hero ($8.71 in chips)
Seat 2: f6d650f4 ($15 in chips)
Seat 3: 6fbb6d8b ($4.13 in chips)
Seat 4: 247787fe ($6.82 in chips)
Seat 5: 898a27d9 ($4.4 in chips)
Seat 6: d7806a1 ($6.07 in chips)
898a27d9: posts small blind $0.02
d7806a1: posts big blind $0.05
*** HOLE CARDS ***
Dealt to Hero [Jh 3c]
Dealt to f6d650f4 
Dealt to 6fbb6d8b 
Dealt to 247787fe 
Dealt to 898a27d9 
Dealt to d7806a1 
Hero: folds
f6d650f4: calls $0.05
6fbb6d8b: raises $0.15 to $0.2
247787fe: folds
898a27d9: folds
d7806a1: folds
f6d650f4: calls $0.15
*** FLOP *** [9c Tc Ts]
f6d650f4: checks
6fbb6d8b: bets $0.24
f6d650f4: calls $0.24
*** TURN *** [9c Tc Ts] [4d]
f6d650f4: checks
6fbb6d8b: checks
*** RIVER *** [9c Tc Ts 4d] [2c]
f6d650f4: bets $0.32
6fbb6d8b: calls $0.32
f6d650f4: shows [Th Kc] (Three Tens)
6fbb6d8b: shows [Jd 9d] (Pair of Tens and Pair of Nines)
*** SHOWDOWN ***
f6d650f4 collected $1.47 from pot
*** SUMMARY ***
Total pot $1.59 | Rake $0.07 | Jackpot $0.05 | Bingo $0 | Fortune $0 | Tax $0
Board [9c Tc Ts 4d 2c]
Seat 1: Hero folded before Flop (didn't bet)
Seat 2: f6d650f4 showed [Th Kc] and won ($1.47) with Three Tens
Seat 3: 6fbb6d8b showed [Jd 9d] and lost with Pair of Tens and Pair of Nines
Seat 4: 247787fe (button) folded before Flop (didn't bet)
Seat 5: 898a27d9 (small blind) folded before Flop
Seat 6: d7806a1 (big blind) folded before Flop


Poker Hand #HD1738841351: Hold'em No Limit ($0.02/$0.05) - 2024/04/20 15:39:45
Table 'NLHBlue13' 6-max Seat #3 is the button
Seat 1: Hero ($8.71 in chips)
Seat 2: f6d650f4 ($15 in chips)
Seat 3: 6fbb6d8b ($3.97 in chips)
Seat 4: 247787fe ($6.84 in chips)
Seat 5: 898a27d9 ($4.55 in chips)
Seat 6: d7806a1 ($6.07 in chips)
247787fe: posts small blind $0.02
898a27d9: posts big blind $0.05
*** HOLE CARDS ***
Dealt to Hero [Qd 4c]
Dealt to f6d650f4 
Dealt to 6fbb6d8b 
Dealt to 247787fe 
Dealt to 898a27d9 
Dealt to d7806a1 
d7806a1: folds
Hero: folds
f6d650f4: folds
6fbb6d8b: raises $0.1 to $0.15
247787fe: folds
898a27d9: calls $0.1
*** FLOP *** [5h 4h Jh]
898a27d9: checks
6fbb6d8b: checks
*** TURN *** [5h 4h Jh] [Kd]
898a27d9: checks
6fbb6d8b: bets $0.16
898a27d9: folds
Uncalled bet ($0.16) returned to 6fbb6d8b
*** SHOWDOWN ***
6fbb6d8b collected $0.31 from pot
*** SUMMARY ***
Total pot $0.32 | Rake $0.01 | Jackpot $0 | Bingo $0 | Fortune $0 | Tax $0
Board [5h 4h Jh Kd]
Seat 1: Hero folded before Flop (didn't bet)
Seat 2: f6d650f4 folded before Flop (didn't bet)
Seat 3: 6fbb6d8b (button) won ($0.31)
Seat 4: 247787fe (small blind) folded before Flop
Seat 5: 898a27d9 (big blind) folded on the Turn
Seat 6: d7806a1 folded before Flop (didn't bet)


Poker Hand #HD1738841316: Hold'em No Limit ($0.02/$0.05) - 2024/04/20 15:39:28
Table 'NLHBlue13' 6-max Seat #2 is the button
Seat 1: Hero ($8.71 in chips)
Seat 2: f6d650f4 ($15 in chips)
Seat 3: 6fbb6d8b ($3.99 in chips)
Seat 4: 247787fe ($6.89 in chips)
Seat 5: 898a27d9 ($4.55 in chips)
Seat 6: d7806a1 ($6 in chips)
6fbb6d8b: posts small blind $0.02
247787fe: posts big blind $0.05
*** HOLE CARDS ***
Dealt to Hero [Jh 2h]
Dealt to f6d650f4 
Dealt to 6fbb6d8b 
Dealt to 247787fe 
Dealt to 898a27d9 
Dealt to d7806a1 
898a27d9: folds
d7806a1: raises $0.08 to $0.13
Hero: folds
f6d650f4: folds
6fbb6d8b: folds
247787fe: folds
Uncalled bet ($0.08) returned to d7806a1
*** SHOWDOWN ***
d7806a1 collected $0.12 from pot
*** SUMMARY ***
Total pot $0.12 | Rake $0 | Jackpot $0 | Bingo $0 | Fortune $0 | Tax $0
Seat 1: Hero folded before Flop (didn't bet)
Seat 2: f6d650f4 (button) folded before Flop (didn't bet)
Seat 3: 6fbb6d8b (small blind) folded before Flop
Seat 4: 247787fe (big blind) folded before Flop
Seat 5: 898a27d9 folded before Flop (didn't bet)
Seat 6: d7806a1 collected ($0.12)


Poker Hand #HD1738841211: Hold'em No Limit ($0.02/$0.05) - 2024/04/20 15:38:35
Table 'NLHBlue13' 6-max Seat #1 is the button
Seat 1: Hero ($8.19 in chips)
Seat 2: f6d650f4 ($15.52 in chips)
Seat 3: 6fbb6d8b ($4.04 in chips)
Seat 4: 247787fe ($6.89 in chips)
Seat 5: 898a27d9 ($4.55 in chips)
Seat 6: d7806a1 ($6 in chips)
f6d650f4: posts small blind $0.02
6fbb6d8b: posts big blind $0.05
*** HOLE CARDS ***
Dealt to Hero [Qc Qd]
Dealt to f6d650f4 
Dealt to 6fbb6d8b 
Dealt to 247787fe 
Dealt to 898a27d9 
Dealt to d7806a1 
247787fe: folds
898a27d9: folds
d7806a1: folds
Hero: raises $0.07 to $0.12
f6d650f4: calls $0.1
6fbb6d8b: folds
*** FLOP *** [Ad 4d 4h]
f6d650f4: checks
Hero: checks
*** TURN *** [Ad 4d 4h] [5h]
f6d650f4: checks
Hero: bets $0.15
f6d650f4: calls $0.15
*** RIVER *** [Ad 4d 4h 5h] [Qh]
f6d650f4: checks
Hero: bets $0.25
f6d650f4: calls $0.25
Hero: shows [Qc Qd] (Queens Full over Fours)
f6d650f4: shows [7d 7h] (Pair of Sevens and Pair of Fours)
*** SHOWDOWN ***
Hero collected $1.04 from pot
*** SUMMARY ***
Total pot $1.09 | Rake $0.05 | Jackpot $0 | Bingo $0 | Fortune $0 | Tax $0
Board [Ad 4d 4h 5h Qh]
Seat 1: Hero (button) showed [Qc Qd] and won ($1.04) with Queens Full over Fours
Seat 2: f6d650f4 (small blind) showed [7d 7h] and lost with Pair of Sevens and Pair of Fours
Seat 3: 6fbb6d8b (big blind) folded before Flop
Seat 4: 247787fe folded before Flop (didn't bet)
Seat 5: 898a27d9 folded before Flop (didn't bet)
Seat 6: d7806a1 folded before Flop (didn't bet)


Poker Hand #HD1738841119: Hold'em No Limit ($0.02/$0.05) - 2024/04/20 15:37:51
Table 'NLHBlue13' 6-max Seat #6 is the button
Seat 1: Hero ($8.21 in chips)
Seat 2: f6d650f4 ($15.67 in chips)
Seat 3: 6fbb6d8b ($4.43 in chips)
Seat 4: 247787fe ($6.37 in chips)
Seat 5: 898a27d9 ($4.55 in chips)
Seat 6: d7806a1 ($6 in chips)
Hero: posts small blind $0.02
f6d650f4: posts big blind $0.05
*** HOLE CARDS ***
Dealt to Hero [Td 8s]
Dealt to f6d650f4 
Dealt to 6fbb6d8b 
Dealt to 247787fe 
Dealt to 898a27d9 
Dealt to d7806a1 
6fbb6d8b: raises $0.1 to $0.15
247787fe: calls $0.15
898a27d9: folds
d7806a1: folds
Hero: folds
f6d650f4: calls $0.1
*** FLOP *** [Qs 6h 2d]
f6d650f4: checks
6fbb6d8b: bets $0.24
247787fe: calls $0.24
f6d650f4: folds
*** TURN *** [Qs 6h 2d] [Jd]
6fbb6d8b: checks
247787fe: checks
*** RIVER *** [Qs 6h 2d Jd] [Tc]
6fbb6d8b: checks
247787fe: checks
6fbb6d8b: shows [8c 8h] (Pair of Eights)
247787fe: shows [9c 9h] (Pair of Nines)
*** SHOWDOWN ***
247787fe collected $0.91 from pot
*** SUMMARY ***
Total pot $0.95 | Rake $0.04 | Jackpot $0 | Bingo $0 | Fortune $0 | Tax $0
Board [Qs 6h 2d Jd Tc]
Seat 1: Hero (small blind) folded before Flop
Seat 2: f6d650f4 (big blind) folded on the Flop
Seat 3: 6fbb6d8b showed [8c 8h] and lost with Pair of Eights
Seat 4: 247787fe showed [9c 9h] and won ($0.91) with Pair of Nines
Seat 5: 898a27d9 folded before Flop (didn't bet)
Seat 6: d7806a1 (button) folded before Flop (didn't bet)


Poker Hand #HD1738841057: Hold'em No Limit ($0.02/$0.05) - 2024/04/20 15:37:16
Table 'NLHBlue13' 6-max Seat #5 is the button
Seat 1: Hero ($8.26 in chips)
Seat 2: f6d650f4 ($15.67 in chips)
Seat 3: 6fbb6d8b ($4.43 in chips)
Seat 4: 247787fe ($6.37 in chips)
Seat 5: 898a27d9 ($4.65 in chips)
Seat 6: d7806a1 ($5.86 in chips)
d7806a1: posts small blind $0.02
Hero: posts big blind $0.05
*** HOLE CARDS ***
Dealt to Hero [Jc 6d]
Dealt to f6d650f4 
Dealt to 6fbb6d8b 
Dealt to 247787fe 
Dealt to 898a27d9 
Dealt to d7806a1 
f6d650f4: folds
6fbb6d8b: folds
247787fe: folds
898a27d9: raises $0.05 to $0.1
d7806a1: calls $0.08
Hero: folds
*** FLOP *** [8s 8c 3c]
d7806a1: checks
898a27d9: checks
*** TURN *** [8s 8c 3c] [Qc]
d7806a1: bets $0.09
898a27d9: folds
Uncalled bet ($0.09) returned to d7806a1
*** SHOWDOWN ***
d7806a1 collected $0.24 from pot
*** SUMMARY ***
Total pot $0.25 | Rake $0.01 | Jackpot $0 | Bingo $0 | Fortune $0 | Tax $0
Board [8s 8c 3c Qc]
Seat 1: Hero (big blind) folded before Flop
Seat 2: f6d650f4 folded before Flop (didn't bet)
Seat 3: 6fbb6d8b folded before Flop (didn't bet)
Seat 4: 247787fe folded before Flop (didn't bet)
Seat 5: 898a27d9 (button) folded on the Turn
Seat 6: d7806a1 (small blind) won ($0.24)


Poker Hand #HD1738840981: Hold'em No Limit ($0.02/$0.05) - 2024/04/20 15:36:42
Table 'NLHBlue13' 6-max Seat #4 is the button
Seat 1: Hero ($8.26 in chips)
Seat 2: f6d650f4 ($15.67 in chips)
Seat 3: 6fbb6d8b ($4.43 in chips)
Seat 4: 247787fe ($5.99 in chips)
Seat 5: 898a27d9 ($3.81 in chips)
Seat 6: d7806a1 ($5.91 in chips)
898a27d9: posts small blind $0.02
d7806a1: posts big blind $0.05
*** HOLE CARDS ***
Dealt to Hero [Kh 3s]
Dealt to f6d650f4 
Dealt to 6fbb6d8b 
Dealt to 247787fe 
Dealt to 898a27d9 
Dealt to d7806a1 
Hero: folds
f6d650f4: folds
6fbb6d8b: folds
247787fe: raises $0.08 to $0.13
898a27d9: calls $0.11
d7806a1: folds
*** FLOP *** [7d 8c 8h]
898a27d9: checks
247787fe: bets $0.24
898a27d9: calls $0.24
*** TURN *** [7d 8c 8h] [Ah]
898a27d9: checks
247787fe: checks
*** RIVER *** [7d 8c 8h Ah] [9c]
898a27d9: checks
247787fe: checks
898a27d9: shows [6h 6d] (Pair of Eights and Pair of Sixes)
247787fe: shows [Ts Th] (Pair of Tens and Pair of Eights)
*** SHOWDOWN ***
247787fe collected $0.75 from pot
*** SUMMARY ***
Total pot $0.79 | Rake $0.04 | Jackpot $0 | Bingo $0 | Fortune $0 | Tax $0
Board [7d 8c 8h Ah 9c]
Seat 1: Hero folded before Flop (didn't bet)
Seat 2: f6d650f4 folded before Flop (didn't bet)
Seat 3: 6fbb6d8b folded before Flop (didn't bet)
Seat 4: 247787fe (button) showed [Ts Th] and won ($0.75) with Pair of Tens and Pair of Eights
Seat 5: 898a27d9 (small blind) showed [6h 6d] and lost with Pair of Eights and Pair of Sixes
Seat 6: d7806a1 (big blind) folded before Flop


Poker Hand #HD1738840893: Hold'em No Limit ($0.02/$0.05) - 2024/04/20 15:35:54
Table 'NLHBlue13' 6-max Seat #3 is the button
Seat 1: Hero ($8.26 in chips)
Seat 2: f6d650f4 ($15.8 in chips)
Seat 3: 6fbb6d8b ($4.56 in chips)
Seat 4: 247787fe ($6.01 in chips)
Seat 5: 898a27d9 ($4.57 in chips)
Seat 6: d7806a1 ($5 in chips)
247787fe: posts small blind $0.02
898a27d9: posts big blind $0.05
*** HOLE CARDS ***
Dealt to Hero [5h 2d]
Dealt to f6d650f4 
Dealt to 6fbb6d8b 
Dealt to 247787fe 
Dealt to 898a27d9 
Dealt to d7806a1 
d7806a1: raises $0.08 to $0.13
Hero: folds
f6d650f4: calls $0.13
6fbb6d8b: calls $0.13
247787fe: folds
898a27d9: calls $0.08
*** FLOP *** [Kc 4s 3s]
898a27d9: checks
d7806a1: bets $0.18
f6d650f4: folds
6fbb6d8b: folds
898a27d9: calls $0.18
*** TURN *** [Kc 4s 3s] [7h]
898a27d9: checks
d7806a1: bets $0.45
898a27d9: calls $0.45
*** RIVER *** [Kc 4s 3s 7h] [4d]
898a27d9: checks
d7806a1: checks
898a27d9: shows [9d Ks] (Pair of Kings and Pair of Fours)
d7806a1: shows [Qc Kh] (Pair of Kings and Pair of Fours)
*** SHOWDOWN ***
d7806a1 collected $1.67 from pot
*** SUMMARY ***
Total pot $1.8 | Rake $0.08 | Jackpot $0.05 | Bingo $0 | Fortune $0 | Tax $0
Board [Kc 4s 3s 7h 4d]
Seat 1: Hero folded before Flop (didn't bet)
Seat 2: f6d650f4 folded on the Flop
Seat 3: 6fbb6d8b (button) folded on the Flop
Seat 4: 247787fe (small blind) folded before Flop
Seat 5: 898a27d9 (big blind) showed [9d Ks] and lost with Pair of Kings and Pair of Fours
Seat 6: d7806a1 showed [Qc Kh] and won ($1.67) with Pair of Kings and Pair of Fours


Poker Hand #HD1738840864: Hold'em No Limit ($0.02/$0.05) - 2024/04/20 15:35:42
Table 'NLHBlue13' 6-max Seat #2 is the button
Seat 1: Hero ($8.26 in chips)
Seat 2: f6d650f4 ($15.73 in chips)
Seat 3: 6fbb6d8b ($4.58 in chips)
Seat 4: 247787fe ($6.06 in chips)
Seat 5: 898a27d9 ($4.57 in chips)
Seat 6: d7806a1 ($5 in chips)
6fbb6d8b: posts small blind $0.02
247787fe: posts big blind $0.05
*** HOLE CARDS ***
Dealt to Hero [5c Ks]
Dealt to f6d650f4 
Dealt to 6fbb6d8b 
Dealt to 247787fe 
Dealt to 898a27d9 
Dealt to d7806a1 
898a27d9: folds
d7806a1: folds
Hero: folds
f6d650f4: raises $0.1 to $0.15
6fbb6d8b: folds
247787fe: folds
Uncalled bet ($0.1) returned to f6d650f4
*** SHOWDOWN ***
f6d650f4 collected $0.12 from pot
*** SUMMARY ***
Total pot $0.12 | Rake $0 | Jackpot $0 | Bingo $0 | Fortune $0 | Tax $0
Seat 1: Hero folded before Flop (didn't bet)
Seat 2: f6d650f4 (button) collected ($0.12)
Seat 3: 6fbb6d8b (small blind) folded before Flop
Seat 4: 247787fe (big blind) folded before Flop
Seat 5: 898a27d9 folded before Flop (didn't bet)
Seat 6: d7806a1 folded before Flop (didn't bet)


Poker Hand #HD1738840833: Hold'em No Limit ($0.02/$0.05) - 2024/04/20 15:35:27
Table 'NLHBlue13' 6-max Seat #1 is the button
Seat 1: Hero ($8.26 in chips)
Seat 2: f6d650f4 ($15.68 in chips)
Seat 3: 6fbb6d8b ($4.63 in chips)
Seat 4: 247787fe ($6.06 in chips)
Seat 5: 898a27d9 ($4.57 in chips)
Seat 6: d7806a1 ($5 in chips)
f6d650f4: posts small blind $0.02
6fbb6d8b: posts big blind $0.05
*** HOLE CARDS ***
Dealt to Hero [Qs Tc]
Dealt to f6d650f4 
Dealt to 6fbb6d8b 
Dealt to 247787fe 
Dealt to 898a27d9 
Dealt to d7806a1 
247787fe: folds
898a27d9: folds
d7806a1: folds
Hero: folds
f6d650f4: raises $0.15 to $0.2
6fbb6d8b: folds
Uncalled bet ($0.15) returned to f6d650f4
*** SHOWDOWN ***
f6d650f4 collected $0.1 from pot
*** SUMMARY ***
Total pot $0.1 | Rake $0 | Jackpot $0 | Bingo $0 | Fortune $0 | Tax $0
Seat 1: Hero (button) folded before Flop (didn't bet)
Seat 2: f6d650f4 (small blind) collected ($0.1)
Seat 3: 6fbb6d8b (big blind) folded before Flop
Seat 4: 247787fe folded before Flop (didn't bet)
Seat 5: 898a27d9 folded before Flop (didn't bet)
Seat 6: d7806a1 folded before Flop (didn't bet)


Poker Hand #HD1738840782: Hold'em No Limit ($0.02/$0.05) - 2024/04/20 15:35:02
Table 'NLHBlue13' 6-max Seat #6 is the button
Seat 1: Hero ($8.28 in chips)
Seat 2: f6d650f4 ($15.66 in chips)
Seat 3: 6fbb6d8b ($4.63 in chips)
Seat 4: 247787fe ($6.06 in chips)
Seat 5: 898a27d9 ($4.57 in chips)
Seat 6: d7806a1 ($5 in chips)
Hero: posts small blind $0.02
f6d650f4: posts big blind $0.05
*** HOLE CARDS ***
Dealt to Hero [8h 2c]
Dealt to f6d650f4 
Dealt to 6fbb6d8b 
Dealt to 247787fe 
Dealt to 898a27d9 
Dealt to d7806a1 
6fbb6d8b: folds
247787fe: folds
898a27d9: folds
d7806a1: folds
Hero: folds
Uncalled bet ($0.03) returned to f6d650f4
*** SHOWDOWN ***
f6d650f4 collected $0.04 from pot
*** SUMMARY ***
Total pot $0.04 | Rake $0 | Jackpot $0 | Bingo $0 | Fortune $0 | Tax $0
Seat 1: Hero (small blind) folded before Flop
Seat 2: f6d650f4 (big blind) collected ($0.04)
Seat 3: 6fbb6d8b folded before Flop (didn't bet)
Seat 4: 247787fe folded before Flop (didn't bet)
Seat 5: 898a27d9 folded before Flop (didn't bet)
Seat 6: d7806a1 (button) folded before Flop (didn't bet)


Poker Hand #HD1738840708: Hold'em No Limit ($0.02/$0.05) - 2024/04/20 15:34:24
Table 'NLHBlue13' 6-max Seat #5 is the button
Seat 1: Hero ($7.76 in chips)
Seat 2: f6d650f4 ($15.66 in chips)
Seat 3: 6fbb6d8b ($5.18 in chips)
Seat 4: 247787fe ($6.06 in chips)
Seat 5: 898a27d9 ($4.57 in chips)
Seat 6: d7806a1 ($5 in chips)
d7806a1: posts small blind $0.02
Hero: posts big blind $0.05
*** HOLE CARDS ***
Dealt to Hero [Kd Jd]
Dealt to f6d650f4 
Dealt to 6fbb6d8b 
Dealt to 247787fe 
Dealt to 898a27d9 
Dealt to d7806a1 
f6d650f4: folds
6fbb6d8b: raises $0.1 to $0.15
247787fe: folds
898a27d9: folds
d7806a1: folds
Hero: raises $0.4 to $0.55
6fbb6d8b: calls $0.4
*** FLOP *** [Ac Ad 5s]
Hero: bets $0.45
6fbb6d8b: folds
Uncalled bet ($0.45) returned to Hero
*** SHOWDOWN ***
Hero collected $1.07 from pot
*** SUMMARY ***
Total pot $1.12 | Rake $0.05 | Jackpot $0 | Bingo $0 | Fortune $0 | Tax $0
Board [Ac Ad 5s]
Seat 1: Hero (big blind) won ($1.07)
Seat 2: f6d650f4 folded before Flop (didn't bet)
Seat 3: 6fbb6d8b folded on the Flop
Seat 4: 247787fe folded before Flop (didn't bet)
Seat 5: 898a27d9 (button) folded before Flop (didn't bet)
Seat 6: d7806a1 (small blind) folded before Flop


Poker Hand #HD1738840652: Hold'em No Limit ($0.02/$0.05) - 2024/04/20 15:34:00
Table 'NLHBlue13' 6-max Seat #4 is the button
Seat 1: Hero ($7.76 in chips)
Seat 2: f6d650f4 ($15.59 in chips)
Seat 3: 6fbb6d8b ($5.18 in chips)
Seat 4: 247787fe ($6.06 in chips)
Seat 5: 898a27d9 ($4.59 in chips)
Seat 6: d7806a1 ($5 in chips)
898a27d9: posts small blind $0.02
d7806a1: posts big blind $0.05
*** HOLE CARDS ***
Dealt to Hero [3s Ac]
Dealt to f6d650f4 
Dealt to 6fbb6d8b 
Dealt to 247787fe 
Dealt to 898a27d9 
Dealt to d7806a1 
Hero: folds
f6d650f4: calls $0.05
6fbb6d8b: folds
247787fe: folds
898a27d9: folds
d7806a1: checks
*** FLOP *** [6h 2d 4s]
d7806a1: checks
f6d650f4: bets $0.06
d7806a1: folds
Uncalled bet ($0.06) returned to f6d650f4
*** SHOWDOWN ***
f6d650f4 collected $0.12 from pot
*** SUMMARY ***
Total pot $0.12 | Rake $0 | Jackpot $0 | Bingo $0 | Fortune $0 | Tax $0
Board [6h 2d 4s]
Seat 1: Hero folded before Flop (didn't bet)
Seat 2: f6d650f4 won ($0.12)
Seat 3: 6fbb6d8b folded before Flop (didn't bet)
Seat 4: 247787fe (button) folded before Flop (didn't bet)
Seat 5: 898a27d9 (small blind) folded before Flop
Seat 6: d7806a1 (big blind) folded on the Flop


Poker Hand #HD1738840572: Hold'em No Limit ($0.02/$0.05) - 2024/04/20 15:33:18
Table 'NLHBlue13' 6-max Seat #3 is the button
Seat 1: Hero ($7.76 in chips)
Seat 2: f6d650f4 ($14.77 in chips)
Seat 3: 6fbb6d8b ($5.61 in chips)
Seat 4: 247787fe ($6.08 in chips)
Seat 5: 898a27d9 ($5.02 in chips)
Seat 6: d7806a1 ($5 in chips)
247787fe: posts small blind $0.02
898a27d9: posts big blind $0.05
*** HOLE CARDS ***
Dealt to Hero [6s Ks]
Dealt to f6d650f4 
Dealt to 6fbb6d8b 
Dealt to 247787fe 
Dealt to 898a27d9 
Dealt to d7806a1 
d7806a1: folds
Hero: folds
f6d650f4: raises $0.1 to $0.15
6fbb6d8b: raises $0.28 to $0.43
247787fe: folds
898a27d9: calls $0.38
f6d650f4: calls $0.28
*** FLOP *** [8h Ad 4h]
898a27d9: checks
f6d650f4: checks
6fbb6d8b: checks
*** TURN *** [8h Ad 4h] [8c]
898a27d9: checks
f6d650f4: checks
6fbb6d8b: checks
*** RIVER *** [8h Ad 4h 8c] [As]
898a27d9: checks
f6d650f4: checks
6fbb6d8b: checks
898a27d9: shows [Qs Js] (Pair of Aces and Pair of Eights)
f6d650f4: shows [Kh Jd] (Pair of Aces and Pair of Eights)
6fbb6d8b: shows [6h 6c] (Pair of Aces and Pair of Eights)
*** SHOWDOWN ***
f6d650f4 collected $1.25 from pot
*** SUMMARY ***
Total pot $1.31 | Rake $0.06 | Jackpot $0 | Bingo $0 | Fortune $0 | Tax $0
Board [8h Ad 4h 8c As]
Seat 1: Hero folded before Flop (didn't bet)
Seat 2: f6d650f4 showed [Kh Jd] and won ($1.25) with Pair of Aces and Pair of Eights
Seat 3: 6fbb6d8b (button) showed [6h 6c] and lost with Pair of Aces and Pair of Eights
Seat 4: 247787fe (small blind) folded before Flop
Seat 5: 898a27d9 (big blind) showed [Qs Js] and lost with Pair of Aces and Pair of Eights
Seat 6: d7806a1 folded before Flop (didn't bet)


Poker Hand #HD1738840520: Hold'em No Limit ($0.02/$0.05) - 2024/04/20 15:32:51
Table 'NLHBlue13' 6-max Seat #2 is the button
Seat 1: Hero ($7.76 in chips)
Seat 2: f6d650f4 ($14.77 in chips)
Seat 3: 6fbb6d8b ($5.44 in chips)
Seat 4: 247787fe ($6.13 in chips)
Seat 5: 898a27d9 ($5.02 in chips)
Seat 6: d7806a1 ($5 in chips)
6fbb6d8b: posts small blind $0.02
247787fe: posts big blind $0.05
*** HOLE CARDS ***
Dealt to Hero [Th 4s]
Dealt to f6d650f4 
Dealt to 6fbb6d8b 
Dealt to 247787fe 
Dealt to 898a27d9 
Dealt to d7806a1 
898a27d9: folds
d7806a1: raises $0.08 to $0.13
Hero: folds
f6d650f4: folds
6fbb6d8b: calls $0.11
247787fe: folds
*** FLOP *** [4d 9h Qc]
6fbb6d8b: bets $0.16
d7806a1: folds
Uncalled bet ($0.16) returned to 6fbb6d8b
*** SHOWDOWN ***
6fbb6d8b collected $0.3 from pot
*** SUMMARY ***
Total pot $0.31 | Rake $0.01 | Jackpot $0 | Bingo $0 | Fortune $0 | Tax $0
Board [4d 9h Qc]
Seat 1: Hero folded before Flop (didn't bet)
Seat 2: f6d650f4 (button) folded before Flop (didn't bet)
Seat 3: 6fbb6d8b (small blind) won ($0.3)
Seat 4: 247787fe (big blind) folded before Flop
Seat 5: 898a27d9 folded before Flop (didn't bet)
Seat 6: d7806a1 folded on the Flop


Poker Hand #HD1738840440: Hold'em No Limit ($0.02/$0.05) - 2024/04/20 15:32:12
Table 'NLHBlue13' 6-max Seat #1 is the button
Seat 1: Hero ($7.76 in chips)
Seat 2: f6d650f4 ($14.23 in chips)
Seat 3: 6fbb6d8b ($6.04 in chips)
Seat 4: 247787fe ($6.13 in chips)
Seat 5: 898a27d9 ($5.02 in chips)
Seat 6: d7806a1 ($5 in chips)
f6d650f4: posts small blind $0.02
6fbb6d8b: posts big blind $0.05
*** HOLE CARDS ***
Dealt to Hero [8h 9c]
Dealt to f6d650f4 
Dealt to 6fbb6d8b 
Dealt to 247787fe 
Dealt to 898a27d9 
Dealt to d7806a1 
247787fe: folds
898a27d9: folds
d7806a1: folds
Hero: folds
f6d650f4: raises $0.1 to $0.15
6fbb6d8b: calls $0.1
*** FLOP *** [7s 5d Ah]
f6d650f4: bets $0.15
6fbb6d8b: raises $0.3 to $0.45
f6d650f4: calls $0.3
*** TURN *** [7s 5d Ah] [Qs]
f6d650f4: bets $0.6
6fbb6d8b: folds
Uncalled bet ($0.6) returned to f6d650f4
*** SHOWDOWN ***
f6d650f4 collected $1.14 from pot
*** SUMMARY ***
Total pot $1.2 | Rake $0.06 | Jackpot $0 | Bingo $0 | Fortune $0 | Tax $0
Board [7s 5d Ah Qs]
Seat 1: Hero (button) folded before Flop (didn't bet)
Seat 2: f6d650f4 (small blind) won ($1.14)
Seat 3: 6fbb6d8b (big blind) folded on the Turn
Seat 4: 247787fe folded before Flop (didn't bet)
Seat 5: 898a27d9 folded before Flop (didn't bet)
Seat 6: d7806a1 folded before Flop (didn't bet)


Poker Hand #HD1738840332: Hold'em No Limit ($0.02/$0.05) - 2024/04/20 15:31:12
Table 'NLHBlue13' 6-max Seat #6 is the button
Seat 1: Hero ($6.37 in chips)
Seat 2: f6d650f4 ($15.61 in chips)
Seat 3: 6fbb6d8b ($6.24 in chips)
Seat 4: 247787fe ($6.13 in chips)
Seat 5: 898a27d9 ($5.02 in chips)
Seat 6: d7806a1 ($5 in chips)
Hero: posts small blind $0.02
f6d650f4: posts big blind $0.05
*** HOLE CARDS ***
Dealt to Hero [Th 9h]
Dealt to f6d650f4 
Dealt to 6fbb6d8b 
Dealt to 247787fe 
Dealt to 898a27d9 
Dealt to d7806a1 
6fbb6d8b: calls $0.05
247787fe: folds
898a27d9: folds
d7806a1: folds
Hero: raises $0.15 to $0.2
f6d650f4: calls $0.15
6fbb6d8b: calls $0.15
*** FLOP *** [9d 9c Ks]
Hero: checks
f6d650f4: bets $0.2
6fbb6d8b: folds
Hero: calls $0.2
*** TURN *** [9d 9c Ks] [5s]
Hero: checks
f6d650f4: checks
*** RIVER *** [9d 9c Ks 5s] [6d]
Hero: checks
f6d650f4: bets $0.33
Hero: raises $0.65 to $0.98
f6d650f4: calls $0.65
Hero: shows [Th 9h] (Three Nines)
f6d650f4: shows [Kc Qs] (Pair of Kings and Pair of Nines)
*** SHOWDOWN ***
Hero collected $2.77 from pot
*** SUMMARY ***
Total pot $2.96 | Rake $0.14 | Jackpot $0.05 | Bingo $0 | Fortune $0 | Tax $0
Board [9d 9c Ks 5s 6d]
Seat 1: Hero (small blind) showed [Th 9h] and won ($2.77) with Three Nines
Seat 2: f6d650f4 (big blind) showed [Kc Qs] and lost with Pair of Kings and Pair of Nines
Seat 3: 6fbb6d8b folded on the Flop
Seat 4: 247787fe folded before Flop (didn't bet)
Seat 5: 898a27d9 folded before Flop (didn't bet)
Seat 6: d7806a1 (button) folded before Flop (didn't bet)


Poker Hand #HD1738840220: Hold'em No Limit ($0.02/$0.05) - 2024/04/20 15:30:16
Table 'NLHBlue13' 6-max Seat #5 is the button
Seat 1: Hero ($5.64 in chips)
Seat 2: f6d650f4 ($15.61 in chips)
Seat 3: 6fbb6d8b ($6.24 in chips)
Seat 4: 247787fe ($6.13 in chips)
Seat 5: 898a27d9 ($5.67 in chips)
Seat 6: d7806a1 ($5.02 in chips)
d7806a1: posts small blind $0.02
Hero: posts big blind $0.05
*** HOLE CARDS ***
Dealt to Hero [Js Ad]
Dealt to f6d650f4 
Dealt to 6fbb6d8b 
Dealt to 247787fe 
Dealt to 898a27d9 
Dealt to d7806a1 
f6d650f4: folds
6fbb6d8b: folds
247787fe: folds
898a27d9: raises $0.1 to $0.15
d7806a1: calls $0.13
Hero: raises $0.5 to $0.65
898a27d9: calls $0.5
d7806a1: folds
*** FLOP *** [Qc 4s Ah]
Hero: checks
898a27d9: checks
*** TURN *** [Qc 4s Ah] [6s]
Hero: bets $0.5
898a27d9: folds
Uncalled bet ($0.5) returned to Hero
*** SHOWDOWN ***
Hero collected $1.38 from pot
*** SUMMARY ***
Total pot $1.45 | Rake $0.07 | Jackpot $0 | Bingo $0 | Fortune $0 | Tax $0
Board [Qc 4s Ah 6s]
Seat 1: Hero (big blind) won ($1.38)
Seat 2: f6d650f4 folded before Flop (didn't bet)
Seat 3: 6fbb6d8b folded before Flop (didn't bet)
Seat 4: 247787fe folded before Flop (didn't bet)
Seat 5: 898a27d9 (button) folded on the Turn
Seat 6: d7806a1 (small blind) folded before Flop


Poker Hand #HD1738840122: Hold'em No Limit ($0.02/$0.05) - 2024/04/20 15:29:29
Table 'NLHBlue13' 6-max Seat #4 is the button
Seat 1: Hero ($5.64 in chips)
Seat 2: f6d650f4 ($16.05 in chips)
Seat 3: 6fbb6d8b ($5.77 in chips)
Seat 4: 247787fe ($6.13 in chips)
Seat 5: 898a27d9 ($5.69 in chips)
Seat 6: d7806a1 ($5.07 in chips)
898a27d9: posts small blind $0.02
d7806a1: posts big blind $0.05
*** HOLE CARDS ***
Dealt to Hero [2s 7s]
Dealt to f6d650f4 
Dealt to 6fbb6d8b 
Dealt to 247787fe 
Dealt to 898a27d9 
Dealt to d7806a1 
Hero: folds
f6d650f4: calls $0.05
6fbb6d8b: raises $0.15 to $0.2
247787fe: folds
898a27d9: folds
d7806a1: folds
f6d650f4: calls $0.15
*** FLOP *** [As 6c Jd]
f6d650f4: checks
6fbb6d8b: checks
*** TURN *** [As 6c Jd] [4s]
f6d650f4: checks
6fbb6d8b: bets $0.24
f6d650f4: calls $0.24
*** RIVER *** [As 6c Jd 4s] [4c]
f6d650f4: checks
6fbb6d8b: checks
f6d650f4: shows [Kc Td] (Pair of Fours)
6fbb6d8b: shows [9h Jh] (Pair of Jacks and Pair of Fours)
*** SHOWDOWN ***
6fbb6d8b collected $0.91 from pot
*** SUMMARY ***
Total pot $0.95 | Rake $0.04 | Jackpot $0 | Bingo $0 | Fortune $0 | Tax $0
Board [As 6c Jd 4s 4c]
Seat 1: Hero folded before Flop (didn't bet)
Seat 2: f6d650f4 showed [Kc Td] and lost with Pair of Fours
Seat 3: 6fbb6d8b showed [9h Jh] and won ($0.91) with Pair of Jacks and Pair of Fours
Seat 4: 247787fe (button) folded before Flop (didn't bet)
Seat 5: 898a27d9 (small blind) folded before Flop
Seat 6: d7806a1 (big blind) folded before Flop


Poker Hand #HD1738839990: Hold'em No Limit ($0.02/$0.05) - 2024/04/20 15:28:17
Table 'NLHBlue13' 6-max Seat #3 is the button
Seat 1: Hero ($5.64 in chips)
Seat 2: f6d650f4 ($16.92 in chips)
Seat 3: 6fbb6d8b ($4.6 in chips)
Seat 4: 247787fe ($6.15 in chips)
Seat 5: 898a27d9 ($6.12 in chips)
Seat 6: d7806a1 ($5.07 in chips)
247787fe: posts small blind $0.02
898a27d9: posts big blind $0.05
*** HOLE CARDS ***
Dealt to Hero [6d 5d]
Dealt to f6d650f4 
Dealt to 6fbb6d8b 
Dealt to 247787fe 
Dealt to 898a27d9 
Dealt to d7806a1 
d7806a1: folds
Hero: folds
f6d650f4: raises $0.1 to $0.15
6fbb6d8b: raises $0.28 to $0.43
247787fe: folds
898a27d9: calls $0.38
f6d650f4: calls $0.28
*** FLOP *** [8d Tc Kh]
898a27d9: checks
f6d650f4: checks
6fbb6d8b: bets $0.44
898a27d9: folds
f6d650f4: calls $0.44
*** TURN *** [8d Tc Kh] [Ac]
f6d650f4: checks
6fbb6d8b: bets $1.1
f6d650f4: folds
Uncalled bet ($1.1) returned to 6fbb6d8b
*** SHOWDOWN ***
6fbb6d8b collected $2.04 from pot
*** SUMMARY ***
Total pot $2.19 | Rake $0.1 | Jackpot $0.05 | Bingo $0 | Fortune $0 | Tax $0
Board [8d Tc Kh Ac]
Seat 1: Hero folded before Flop (didn't bet)
Seat 2: f6d650f4 folded on the Turn
Seat 3: 6fbb6d8b (button) won ($2.04)
Seat 4: 247787fe (small blind) folded before Flop
Seat 5: 898a27d9 (big blind) folded on the Flop
Seat 6: d7806a1 folded before Flop (didn't bet)


Poker Hand #HD1738839907: Hold'em No Limit ($0.02/$0.05) - 2024/04/20 15:27:34
Table 'NLHBlue13' 6-max Seat #2 is the button
Seat 1: Hero ($5.48 in chips)
Seat 2: f6d650f4 ($16.92 in chips)
Seat 3: 6fbb6d8b ($4.72 in chips)
Seat 4: 247787fe ($6.2 in chips)
Seat 5: 898a27d9 ($6.12 in chips)
Seat 6: d7806a1 ($5.07 in chips)
6fbb6d8b: posts small blind $0.02
247787fe: posts big blind $0.05
*** HOLE CARDS ***
Dealt to Hero [Jc Qs]
Dealt to f6d650f4 
Dealt to 6fbb6d8b 
Dealt to 247787fe 
Dealt to 898a27d9 
Dealt to d7806a1 
898a27d9: folds
d7806a1: folds
Hero: raises $0.07 to $0.12
f6d650f4: folds
6fbb6d8b: calls $0.1
247787fe: folds
*** FLOP *** [5h Js 5s]
6fbb6d8b: checks
Hero: bets $0.2
6fbb6d8b: folds
Uncalled bet ($0.2) returned to Hero
*** SHOWDOWN ***
Hero collected $0.28 from pot
*** SUMMARY ***
Total pot $0.29 | Rake $0.01 | Jackpot $0 | Bingo $0 | Fortune $0 | Tax $0
Board [5h Js 5s]
Seat 1: Hero won ($0.28)
Seat 2: f6d650f4 (button) folded before Flop (didn't bet)
Seat 3: 6fbb6d8b (small blind) folded on the Flop
Seat 4: 247787fe (big blind) folded before Flop
Seat 5: 898a27d9 folded before Flop (didn't bet)
Seat 6: d7806a1 folded before Flop (didn't bet)


Poker Hand #HD1738839855: Hold'em No Limit ($0.02/$0.05) - 2024/04/20 15:27:10
Table 'NLHBlue13' 6-max Seat #1 is the button
Seat 1: Hero ($5.48 in chips)
Seat 2: f6d650f4 ($16.94 in chips)
Seat 3: 6fbb6d8b ($4.77 in chips)
Seat 4: 247787fe ($6.2 in chips)
Seat 5: 898a27d9 ($6.12 in chips)
Seat 6: d7806a1 ($5 in chips)
f6d650f4: posts small blind $0.02
6fbb6d8b: posts big blind $0.05
*** HOLE CARDS ***
Dealt to Hero [6c Kc]
Dealt to f6d650f4 
Dealt to 6fbb6d8b 
Dealt to 247787fe 
Dealt to 898a27d9 
Dealt to d7806a1 
247787fe: folds
898a27d9: folds
d7806a1: raises $0.08 to $0.13
Hero: folds
f6d650f4: folds
6fbb6d8b: folds
Uncalled bet ($0.08) returned to d7806a1
*** SHOWDOWN ***
d7806a1 collected $0.12 from pot
*** SUMMARY ***
Total pot $0.12 | Rake $0 | Jackpot $0 | Bingo $0 | Fortune $0 | Tax $0
Seat 1: Hero (button) folded before Flop (didn't bet)
Seat 2: f6d650f4 (small blind) folded before Flop
Seat 3: 6fbb6d8b (big blind) folded before Flop
Seat 4: 247787fe folded before Flop (didn't bet)
Seat 5: 898a27d9 folded before Flop (didn't bet)
Seat 6: d7806a1 collected ($0.12)


Poker Hand #HD1738839836: Hold'em No Limit ($0.02/$0.05) - 2024/04/20 15:27:03
Table 'NLHBlue13' 6-max Seat #6 is the button
Seat 1: Hero ($5.5 in chips)
Seat 2: f6d650f4 ($16.92 in chips)
Seat 3: 6fbb6d8b ($4.77 in chips)
Seat 4: 247787fe ($6.2 in chips)
Seat 5: 898a27d9 ($6.12 in chips)
Seat 6: d7806a1 ($5 in chips)
Hero: posts small blind $0.02
f6d650f4: posts big blind $0.05
*** HOLE CARDS ***
Dealt to Hero [8h Qs]
Dealt to f6d650f4 
Dealt to 6fbb6d8b 
Dealt to 247787fe 
Dealt to 898a27d9 
Dealt to d7806a1 
6fbb6d8b: folds
247787fe: folds
898a27d9: folds
d7806a1: folds
Hero: folds
Uncalled bet ($0.03) returned to f6d650f4
*** SHOWDOWN ***
f6d650f4 collected $0.04 from pot
*** SUMMARY ***
Total pot $0.04 | Rake $0 | Jackpot $0 | Bingo $0 | Fortune $0 | Tax $0
Seat 1: Hero (small blind) folded before Flop
Seat 2: f6d650f4 (big blind) collected ($0.04)
Seat 3: 6fbb6d8b folded before Flop (didn't bet)
Seat 4: 247787fe folded before Flop (didn't bet)
Seat 5: 898a27d9 folded before Flop (didn't bet)
Seat 6: d7806a1 (button) folded before Flop (didn't bet)


Poker Hand #HD1738839764: Hold'em No Limit ($0.02/$0.05) - 2024/04/20 15:26:25
Table 'NLHBlue13' 6-max Seat #5 is the button
Seat 1: Hero ($5.55 in chips)
Seat 2: f6d650f4 ($16.92 in chips)
Seat 3: 6fbb6d8b ($4.58 in chips)
Seat 4: 247787fe ($6.2 in chips)
Seat 5: 898a27d9 ($6.12 in chips)
Seat 6: d7806a1 ($5 in chips)
d7806a1: posts small blind $0.02
Hero: posts big blind $0.05
*** HOLE CARDS ***
Dealt to Hero [Jc 4d]
Dealt to f6d650f4 
Dealt to 6fbb6d8b 
Dealt to 247787fe 
Dealt to 898a27d9 
Dealt to d7806a1 
f6d650f4: folds
6fbb6d8b: raises $0.1 to $0.15
247787fe: folds
898a27d9: folds
d7806a1: calls $0.13
Hero: folds
*** FLOP *** [7h 9c 5c]
d7806a1: checks
6fbb6d8b: checks
*** TURN *** [7h 9c 5c] [Ac]
d7806a1: checks
6fbb6d8b: checks
*** RIVER *** [7h 9c 5c Ac] [Ts]
d7806a1: checks
6fbb6d8b: checks
d7806a1: shows [8h Th] (Pair of Tens)
6fbb6d8b: shows [Ks Kd] (Pair of Kings)
*** SHOWDOWN ***
6fbb6d8b collected $0.34 from pot
*** SUMMARY ***
Total pot $0.35 | Rake $0.01 | Jackpot $0 | Bingo $0 | Fortune $0 | Tax $0
Board [7h 9c 5c Ac Ts]
Seat 1: Hero (big blind) folded before Flop
Seat 2: f6d650f4 folded before Flop (didn't bet)
Seat 3: 6fbb6d8b showed [Ks Kd] and won ($0.34) with Pair of Kings
Seat 4: 247787fe folded before Flop (didn't bet)
Seat 5: 898a27d9 (button) folded before Flop (didn't bet)
Seat 6: d7806a1 (small blind) showed [8h Th] and lost with Pair of Tens


Poker Hand #HD1738839657: Hold'em No Limit ($0.02/$0.05) - 2024/04/20 15:25:29
Table 'NLHBlue13' 6-max Seat #4 is the button
Seat 1: Hero ($5.55 in chips)
Seat 2: f6d650f4 ($17.67 in chips)
Seat 3: 6fbb6d8b ($4.58 in chips)
Seat 4: 247787fe ($6.2 in chips)
Seat 5: 898a27d9 ($4.78 in chips)
Seat 6: d7806a1 ($5.35 in chips)
898a27d9: posts small blind $0.02
d7806a1: posts big blind $0.05
*** HOLE CARDS ***
Dealt to Hero [3d 7s]
Dealt to f6d650f4 
Dealt to 6fbb6d8b 
Dealt to 247787fe 
Dealt to 898a27d9 
Dealt to d7806a1 
Hero: folds
f6d650f4: raises $0.1 to $0.15
6fbb6d8b: folds
247787fe: folds
898a27d9: calls $0.13
d7806a1: calls $0.1
*** FLOP *** [Qh 4h 9d]
898a27d9: checks
d7806a1: checks
f6d650f4: bets $0.15
898a27d9: calls $0.15
d7806a1: calls $0.15
*** TURN *** [Qh 4h 9d] [Kd]
898a27d9: checks
d7806a1: checks
f6d650f4: checks
*** RIVER *** [Qh 4h 9d Kd] [6c]
898a27d9: bets $0.45
d7806a1: calls $0.45
f6d650f4: calls $0.45
898a27d9: shows [Kh Jd] (Pair of Kings)
d7806a1: shows [Kc Tc] (Pair of Kings)
f6d650f4: shows [Td Ts] (Pair of Tens)
*** SHOWDOWN ***
898a27d9 collected $2.09 from pot
*** SUMMARY ***
Total pot $2.25 | Rake $0.11 | Jackpot $0.05 | Bingo $0 | Fortune $0 | Tax $0
Board [Qh 4h 9d Kd 6c]
Seat 1: Hero folded before Flop (didn't bet)
Seat 2: f6d650f4 showed [Td Ts] and lost with Pair of Tens
Seat 3: 6fbb6d8b folded before Flop (didn't bet)
Seat 4: 247787fe (button) folded before Flop (didn't bet)
Seat 5: 898a27d9 (small blind) showed [Kh Jd] and won ($2.09) with Pair of Kings
Seat 6: d7806a1 (big blind) showed [Kc Tc] and lost with Pair of Kings


Poker Hand #HD1738839576: Hold'em No Limit ($0.02/$0.05) - 2024/04/20 15:24:53
Table 'NLHBlue13' 6-max Seat #3 is the button
Seat 1: Hero ($5.55 in chips)
Seat 2: f6d650f4 ($17.49 in chips)
Seat 3: 6fbb6d8b ($4.58 in chips)
Seat 4: 247787fe ($6.22 in chips)
Seat 5: 898a27d9 ($4.95 in chips)
Seat 6: d7806a1 ($5.35 in chips)
247787fe: posts small blind $0.02
898a27d9: posts big blind $0.05
*** HOLE CARDS ***
Dealt to Hero [8h 6h]
Dealt to f6d650f4 
Dealt to 6fbb6d8b 
Dealt to 247787fe 
Dealt to 898a27d9 
Dealt to d7806a1 
d7806a1: folds
Hero: folds
f6d650f4: calls $0.05
6fbb6d8b: folds
247787fe: folds
898a27d9: raises $0.12 to $0.17
f6d650f4: calls $0.12
*** FLOP *** [5s 7h Qs]
898a27d9: checks
f6d650f4: bets $0.12
898a27d9: folds
Uncalled bet ($0.12) returned to f6d650f4
f6d650f4: shows [Qh]
*** SHOWDOWN ***
f6d650f4 collected $0.35 from pot
*** SUMMARY ***
Total pot $0.36 | Rake $0.01 | Jackpot $0 | Bingo $0 | Fortune $0 | Tax $0
Board [5s 7h Qs]
Seat 1: Hero folded before Flop (didn't bet)
Seat 2: f6d650f4 showed [Qh] and won ($0.35)
Seat 3: 6fbb6d8b (button) folded before Flop (didn't bet)
Seat 4: 247787fe (small blind) folded before Flop
Seat 5: 898a27d9 (big blind) folded on the Flop
Seat 6: d7806a1 folded before Flop (didn't bet)


Poker Hand #HD1738839531: Hold'em No Limit ($0.02/$0.05) - 2024/04/20 15:24:28
Table 'NLHBlue13' 6-max Seat #2 is the button
Seat 1: Hero ($5.55 in chips)
Seat 2: f6d650f4 ($17.49 in chips)
Seat 3: 6fbb6d8b ($4.6 in chips)
Seat 4: 247787fe ($6.27 in chips)
Seat 5: 898a27d9 ($4.95 in chips)
Seat 6: d7806a1 ($5.28 in chips)
6fbb6d8b: posts small blind $0.02
247787fe: posts big blind $0.05
*** HOLE CARDS ***
Dealt to Hero [9h 4h]
Dealt to f6d650f4 
Dealt to 6fbb6d8b 
Dealt to 247787fe 
Dealt to 898a27d9 
Dealt to d7806a1 
898a27d9: folds
d7806a1: raises $0.08 to $0.13
Hero: folds
f6d650f4: folds
6fbb6d8b: folds
247787fe: folds
Uncalled bet ($0.08) returned to d7806a1
*** SHOWDOWN ***
d7806a1 collected $0.12 from pot
*** SUMMARY ***
Total pot $0.12 | Rake $0 | Jackpot $0 | Bingo $0 | Fortune $0 | Tax $0
Seat 1: Hero folded before Flop (didn't bet)
Seat 2: f6d650f4 (button) folded before Flop (didn't bet)
Seat 3: 6fbb6d8b (small blind) folded before Flop
Seat 4: 247787fe (big blind) folded before Flop
Seat 5: 898a27d9 folded before Flop (didn't bet)
Seat 6: d7806a1 collected ($0.12)


Poker Hand #HD1738839441: Hold'em No Limit ($0.02/$0.05) - 2024/04/20 15:23:50
Table 'NLHBlue13' 6-max Seat #1 is the button
Seat 1: Hero ($5.55 in chips)
Seat 2: f6d650f4 ($17.59 in chips)
Seat 3: 6fbb6d8b ($4.51 in chips)
Seat 4: 247787fe ($6.27 in chips)
Seat 5: 898a27d9 ($4.95 in chips)
Seat 6: d7806a1 ($5.28 in chips)
f6d650f4: posts small blind $0.02
6fbb6d8b: posts big blind $0.05
*** HOLE CARDS ***
Dealt to Hero [Kd 2s]
Dealt to f6d650f4 
Dealt to 6fbb6d8b 
Dealt to 247787fe 
Dealt to 898a27d9 
Dealt to d7806a1 
247787fe: folds
898a27d9: folds
d7806a1: folds
Hero: folds
f6d650f4: calls $0.03
6fbb6d8b: checks
*** FLOP *** [8s 6h 3h]
f6d650f4: checks
6fbb6d8b: checks
*** TURN *** [8s 6h 3h] [As]
f6d650f4: checks
6fbb6d8b: bets $0.05
f6d650f4: calls $0.05
*** RIVER *** [8s 6h 3h As] [4s]
f6d650f4: checks
6fbb6d8b: checks
f6d650f4: shows [Ks 7c] (Ace-High)
6fbb6d8b: shows [2d Ac] (Pair of Aces)
*** SHOWDOWN ***
6fbb6d8b collected $0.19 from pot
*** SUMMARY ***
Total pot $0.2 | Rake $0.01 | Jackpot $0 | Bingo $0 | Fortune $0 | Tax $0
Board [8s 6h 3h As 4s]
Seat 1: Hero (button) folded before Flop (didn't bet)
Seat 2: f6d650f4 (small blind) showed [Ks 7c] and lost with Ace-High
Seat 3: 6fbb6d8b (big blind) showed [2d Ac] and won ($0.19) with Pair of Aces
Seat 4: 247787fe folded before Flop (didn't bet)
Seat 5: 898a27d9 folded before Flop (didn't bet)
Seat 6: d7806a1 folded before Flop (didn't bet)


Poker Hand #HD1738839351: Hold'em No Limit ($0.02/$0.05) - 2024/04/20 15:22:59
Table 'NLHBlue13' 6-max Seat #6 is the button
Seat 1: Hero ($5.98 in chips)
Seat 2: f6d650f4 ($17.15 in chips)
Seat 3: 6fbb6d8b ($4.51 in chips)
Seat 4: 247787fe ($6.27 in chips)
Seat 5: 898a27d9 ($5 in chips)
Seat 6: d7806a1 ($5.28 in chips)
Hero: posts small blind $0.02
f6d650f4: posts big blind $0.05
898a27d9: posts big blind $0.05
*** HOLE CARDS ***
Dealt to Hero [Kd Qd]
Dealt to f6d650f4 
Dealt to 6fbb6d8b 
Dealt to 247787fe 
Dealt to 898a27d9 
Dealt to d7806a1 
6fbb6d8b: folds
247787fe: folds
898a27d9: checks
d7806a1: folds
Hero: raises $0.15 to $0.2
f6d650f4: raises $0.23 to $0.43
898a27d9: folds
Hero: calls $0.23
*** FLOP *** [9h 5c 5s]
Hero: checks
f6d650f4: bets $0.31
Hero: folds
Uncalled bet ($0.31) returned to f6d650f4
f6d650f4: shows [Qs Ac] (Pair of Fives)
*** SHOWDOWN ***
f6d650f4 collected $0.87 from pot
*** SUMMARY ***
Total pot $0.91 | Rake $0.04 | Jackpot $0 | Bingo $0 | Fortune $0 | Tax $0
Board [9h 5c 5s]
Seat 1: Hero (small blind) folded on the Flop
Seat 2: f6d650f4 (big blind) showed [Qs Ac] and won ($0.87)
Seat 3: 6fbb6d8b folded before Flop (didn't bet)
Seat 4: 247787fe folded before Flop (didn't bet)
Seat 5: 898a27d9 folded before Flop
Seat 6: d7806a1 (button) folded before Flop (didn't bet)


Poker Hand #HD1738839332: Hold'em No Limit ($0.02/$0.05) - 2024/04/20 15:22:48
Table 'NLHBlue13' 6-max Seat #4 is the button
Seat 1: Hero ($6.03 in chips)
Seat 2: f6d650f4 ($17.08 in chips)
Seat 3: 6fbb6d8b ($4.51 in chips)
Seat 4: 247787fe ($6.27 in chips)
Seat 6: d7806a1 ($5.3 in chips)
d7806a1: posts small blind $0.02
Hero: posts big blind $0.05
*** HOLE CARDS ***
Dealt to Hero [6c 7d]
Dealt to f6d650f4 
Dealt to 6fbb6d8b 
Dealt to 247787fe 
Dealt to d7806a1 
f6d650f4: raises $0.15 to $0.2
6fbb6d8b: folds
247787fe: folds
d7806a1: folds
Hero: folds
Uncalled bet ($0.15) returned to f6d650f4
*** SHOWDOWN ***
f6d650f4 collected $0.12 from pot
*** SUMMARY ***
Total pot $0.12 | Rake $0 | Jackpot $0 | Bingo $0 | Fortune $0 | Tax $0
Seat 1: Hero (big blind) folded before Flop
Seat 2: f6d650f4 collected ($0.12)
Seat 3: 6fbb6d8b folded before Flop (didn't bet)
Seat 4: 247787fe (button) folded before Flop (didn't bet)
Seat 6: d7806a1 (small blind) folded before Flop


Poker Hand #HD1738839308: Hold'em No Limit ($0.02/$0.05) - 2024/04/20 15:22:37
Table 'NLHBlue13' 6-max Seat #3 is the button
Seat 1: Hero ($6.03 in chips)
Seat 2: f6d650f4 ($17.01 in chips)
Seat 3: 6fbb6d8b ($4.51 in chips)
Seat 4: 247787fe ($6.29 in chips)
Seat 6: d7806a1 ($5.35 in chips)
247787fe: posts small blind $0.02
d7806a1: posts big blind $0.05
*** HOLE CARDS ***
Dealt to Hero [5c 7c]
Dealt to f6d650f4 
Dealt to 6fbb6d8b 
Dealt to 247787fe 
Dealt to d7806a1 
Hero: folds
f6d650f4: raises $0.15 to $0.2
6fbb6d8b: folds
247787fe: folds
d7806a1: folds
Uncalled bet ($0.15) returned to f6d650f4
*** SHOWDOWN ***
f6d650f4 collected $0.12 from pot
*** SUMMARY ***
Total pot $0.12 | Rake $0 | Jackpot $0 | Bingo $0 | Fortune $0 | Tax $0
Seat 1: Hero folded before Flop (didn't bet)
Seat 2: f6d650f4 collected ($0.12)
Seat 3: 6fbb6d8b (button) folded before Flop (didn't bet)
Seat 4: 247787fe (small blind) folded before Flop
Seat 6: d7806a1 (big blind) folded before Flop


Poker Hand #HD1738839216: Hold'em No Limit ($0.02/$0.05) - 2024/04/20 15:21:51
Table 'NLHBlue13' 6-max Seat #2 is the button
Seat 1: Hero ($6.03 in chips)
Seat 2: f6d650f4 ($16.16 in chips)
Seat 3: 6fbb6d8b ($4.53 in chips)
Seat 4: 247787fe ($6.34 in chips)
Seat 5: 77e1e215 ($6.86 in chips)
Seat 6: d7806a1 ($5.35 in chips)
6fbb6d8b: posts small blind $0.02
247787fe: posts big blind $0.05
*** HOLE CARDS ***
Dealt to Hero [4d 9s]
Dealt to f6d650f4 
Dealt to 6fbb6d8b 
Dealt to 247787fe 
Dealt to 77e1e215 
Dealt to d7806a1 
77e1e215: raises $0.05 to $0.1
d7806a1: folds
Hero: folds
f6d650f4: raises $0.21 to $0.31
6fbb6d8b: folds
247787fe: folds
77e1e215: calls $0.21
*** FLOP *** [Jd 4c 7h]
77e1e215: checks
f6d650f4: bets $0.23
77e1e215: calls $0.23
*** TURN *** [Jd 4c 7h] [4s]
77e1e215: bets $0.38
f6d650f4: calls $0.38
*** RIVER *** [Jd 4c 7h 4s] [5d]
77e1e215: checks
f6d650f4: checks
77e1e215: shows [Ah Qh] (Pair of Fours)
f6d650f4: shows [Ac Kh] (Pair of Fours)
*** SHOWDOWN ***
f6d650f4 collected $1.77 from pot
*** SUMMARY ***
Total pot $1.91 | Rake $0.09 | Jackpot $0.05 | Bingo $0 | Fortune $0 | Tax $0
Board [Jd 4c 7h 4s 5d]
Seat 1: Hero folded before Flop (didn't bet)
Seat 2: f6d650f4 (button) showed [Ac Kh] and won ($1.77) with Pair of Fours
Seat 3: 6fbb6d8b (small blind) folded before Flop
Seat 4: 247787fe (big blind) folded before Flop
Seat 5: 77e1e215 showed [Ah Qh] and lost with Pair of Fours
Seat 6: d7806a1 folded before Flop (didn't bet)


Poker Hand #HD1738839108: Hold'em No Limit ($0.02/$0.05) - 2024/04/20 15:21:00
Table 'NLHBlue13' 6-max Seat #1 is the button
Seat 1: Hero ($6.48 in chips)
Seat 2: f6d650f4 ($16.18 in chips)
Seat 3: 6fbb6d8b ($4.58 in chips)
Seat 4: 247787fe ($5.86 in chips)
Seat 5: 77e1e215 ($6.86 in chips)
Seat 6: d7806a1 ($5.35 in chips)
f6d650f4: posts small blind $0.02
6fbb6d8b: posts big blind $0.05
*** HOLE CARDS ***
Dealt to Hero [Qh Ah]
Dealt to f6d650f4 
Dealt to 6fbb6d8b 
Dealt to 247787fe 
Dealt to 77e1e215 
Dealt to d7806a1 
247787fe: raises $0.08 to $0.13
77e1e215: folds
d7806a1: folds
Hero: raises $0.32 to $0.45
f6d650f4: folds
6fbb6d8b: folds
247787fe: calls $0.32
*** FLOP *** [9c 4d 7s]
247787fe: checks
Hero: checks
*** TURN *** [9c 4d 7s] [8s]
247787fe: bets $0.73
Hero: folds
Uncalled bet ($0.73) returned to 247787fe
*** SHOWDOWN ***
247787fe collected $0.93 from pot
*** SUMMARY ***
Total pot $0.97 | Rake $0.04 | Jackpot $0 | Bingo $0 | Fortune $0 | Tax $0
Board [9c 4d 7s 8s]
Seat 1: Hero (button) folded on the Turn
Seat 2: f6d650f4 (small blind) folded before Flop
Seat 3: 6fbb6d8b (big blind) folded before Flop
Seat 4: 247787fe won ($0.93)
Seat 5: 77e1e215 folded before Flop (didn't bet)
Seat 6: d7806a1 folded before Flop (didn't bet)


Poker Hand #HD1738839044: Hold'em No Limit ($0.02/$0.05) - 2024/04/20 15:20:34
Table 'NLHBlue13' 6-max Seat #6 is the button
Seat 1: Hero ($6.78 in chips)
Seat 2: f6d650f4 ($15.91 in chips)
Seat 3: 6fbb6d8b ($4.58 in chips)
Seat 4: 247787fe ($5.86 in chips)
Seat 5: 77e1e215 ($6.86 in chips)
Seat 6: d7806a1 ($5.35 in chips)
Hero: posts small blind $0.02
f6d650f4: posts big blind $0.05
*** HOLE CARDS ***
Dealt to Hero [Ah 2c]
Dealt to f6d650f4 
Dealt to 6fbb6d8b 
Dealt to 247787fe 
Dealt to 77e1e215 
Dealt to d7806a1 
6fbb6d8b: folds
247787fe: folds
77e1e215: folds
d7806a1: folds
Hero: raises $0.1 to $0.15
f6d650f4: calls $0.1
*** FLOP *** [5d Jc 9s]
Hero: bets $0.15
f6d650f4: raises $0.2 to $0.35
Hero: folds
Uncalled bet ($0.2) returned to f6d650f4
*** SHOWDOWN ***
f6d650f4 collected $0.57 from pot
*** SUMMARY ***
Total pot $0.6 | Rake $0.03 | Jackpot $0 | Bingo $0 | Fortune $0 | Tax $0
Board [5d Jc 9s]
Seat 1: Hero (small blind) folded on the Flop
Seat 2: f6d650f4 (big blind) won ($0.57)
Seat 3: 6fbb6d8b folded before Flop (didn't bet)
Seat 4: 247787fe folded before Flop (didn't bet)
Seat 5: 77e1e215 folded before Flop (didn't bet)
Seat 6: d7806a1 (button) folded before Flop (didn't bet)


Poker Hand #HD1738839002: Hold'em No Limit ($0.02/$0.05) - 2024/04/20 15:20:07
Table 'NLHBlue13' 6-max Seat #5 is the button
Seat 1: Hero ($6.83 in chips)
Seat 2: f6d650f4 ($15.91 in chips)
Seat 3: 6fbb6d8b ($4.73 in chips)
Seat 4: 247787fe ($5.86 in chips)
Seat 5: 77e1e215 ($7.01 in chips)
Seat 6: d7806a1 ($5.02 in chips)
d7806a1: posts small blind $0.02
Hero: posts big blind $0.05
*** HOLE CARDS ***
Dealt to Hero [8d Jc]
Dealt to f6d650f4 
Dealt to 6fbb6d8b 
Dealt to 247787fe 
Dealt to 77e1e215 
Dealt to d7806a1 
f6d650f4: folds
6fbb6d8b: raises $0.1 to $0.15
247787fe: folds
77e1e215: calls $0.15
d7806a1: raises $0.4 to $0.55
Hero: folds
6fbb6d8b: folds
77e1e215: folds
Uncalled bet ($0.4) returned to d7806a1
*** SHOWDOWN ***
d7806a1 collected $0.48 from pot
*** SUMMARY ***
Total pot $0.5 | Rake $0.02 | Jackpot $0 | Bingo $0 | Fortune $0 | Tax $0
Seat 1: Hero (big blind) folded before Flop
Seat 2: f6d650f4 folded before Flop (didn't bet)
Seat 3: 6fbb6d8b folded before Flop
Seat 4: 247787fe folded before Flop (didn't bet)
Seat 5: 77e1e215 (button) folded before Flop
Seat 6: d7806a1 (small blind) collected ($0.48)


Poker Hand #HD1738838482: Hold'em No Limit ($0.02/$0.05) - 2024/04/20 15:15:38
Table 'NLHBlue13' 6-max Seat #1 is the button
Seat 1: Hero ($6.76 in chips)
Seat 2: f6d650f4 ($18.84 in chips)
Seat 3: 6fbb6d8b ($2.31 in chips)
Seat 4: 247787fe ($5 in chips)
Seat 6: d7806a1 ($5 in chips)
f6d650f4: posts small blind $0.02
6fbb6d8b: posts big blind $0.05
*** HOLE CARDS ***
Dealt to Hero [Kc Ah]
Dealt to f6d650f4 
Dealt to 6fbb6d8b 
Dealt to 247787fe 
Dealt to d7806a1 
247787fe: folds
d7806a1: folds
Hero: raises $0.07 to $0.12
f6d650f4: folds
6fbb6d8b: folds
Uncalled bet ($0.07) returned to Hero
*** SHOWDOWN ***
Hero collected $0.12 from pot
*** SUMMARY ***
Total pot $0.12 | Rake $0 | Jackpot $0 | Bingo $0 | Fortune $0 | Tax $0
Seat 1: Hero (button) collected ($0.12)
Seat 2: f6d650f4 (small blind) folded before Flop
Seat 3: 6fbb6d8b (big blind) folded before Flop
Seat 4: 247787fe folded before Flop (didn't bet)
Seat 6: d7806a1 folded before Flop (didn't bet)


Poker Hand #HD1738838396: Hold'em No Limit ($0.02/$0.05) - 2024/04/20 15:14:54
Table 'NLHBlue13' 6-max Seat #6 is the button
Seat 1: Hero ($6.78 in chips)
Seat 2: f6d650f4 ($17.66 in chips)
Seat 3: 6fbb6d8b ($3.65 in chips)
Seat 4: 247787fe ($5 in chips)
Seat 6: d7806a1 ($5 in chips)
Hero: posts small blind $0.02
f6d650f4: posts big blind $0.05
*** HOLE CARDS ***
Dealt to Hero [3c 8s]
Dealt to f6d650f4 
Dealt to 6fbb6d8b 
Dealt to 247787fe 
Dealt to d7806a1 
6fbb6d8b: raises $0.1 to $0.15
247787fe: folds
d7806a1: folds
Hero: folds
f6d650f4: calls $0.1
*** FLOP *** [2d 4s 5c]
f6d650f4: bets $0.11
6fbb6d8b: raises $0.27 to $0.38
f6d650f4: calls $0.27
*** TURN *** [2d 4s 5c] [9d]
f6d650f4: checks
6fbb6d8b: bets $0.81
f6d650f4: calls $0.81
*** RIVER *** [2d 4s 5c 9d] [3d]
f6d650f4: checks
6fbb6d8b: checks
f6d650f4: shows [2s 3h] (Pair of Treys and Pair of Twos)
6fbb6d8b: shows [Kd Kc] (Pair of Kings)
*** SHOWDOWN ***
f6d650f4 collected $2.52 from pot
*** SUMMARY ***
Total pot $2.7 | Rake $0.13 | Jackpot $0.05 | Bingo $0 | Fortune $0 | Tax $0
Board [2d 4s 5c 9d 3d]
Seat 1: Hero (small blind) folded before Flop
Seat 2: f6d650f4 (big blind) showed [2s 3h] and won ($2.52) with Pair of Treys and Pair of Twos
Seat 3: 6fbb6d8b showed [Kd Kc] and lost with Pair of Kings
Seat 4: 247787fe folded before Flop (didn't bet)
Seat 6: d7806a1 (button) folded before Flop (didn't bet)


Poker Hand #HD1738838347: Hold'em No Limit ($0.02/$0.05) - 2024/04/20 15:14:33
Table 'NLHBlue13' 6-max Seat #4 is the button
Seat 1: Hero ($6.66 in chips)
Seat 2: f6d650f4 ($17.66 in chips)
Seat 3: 6fbb6d8b ($3.65 in chips)
Seat 4: 247787fe ($5 in chips)
Seat 6: d7806a1 ($5.02 in chips)
d7806a1: posts small blind $0.02
Hero: posts big blind $0.05
*** HOLE CARDS ***
Dealt to Hero [Kh Js]
Dealt to f6d650f4 
Dealt to 6fbb6d8b 
Dealt to 247787fe 
Dealt to d7806a1 
f6d650f4: folds
6fbb6d8b: folds
247787fe: folds
d7806a1: raises $0.08 to $0.13
Hero: raises $0.32 to $0.45
d7806a1: folds
Uncalled bet ($0.32) returned to Hero
*** SHOWDOWN ***
Hero collected $0.25 from pot
*** SUMMARY ***
Total pot $0.26 | Rake $0.01 | Jackpot $0 | Bingo $0 | Fortune $0 | Tax $0
Seat 1: Hero (big blind) collected ($0.25)
Seat 2: f6d650f4 folded before Flop (didn't bet)
Seat 3: 6fbb6d8b folded before Flop (didn't bet)
Seat 4: 247787fe (button) folded before Flop (didn't bet)
Seat 6: d7806a1 (small blind) folded before Flop


Poker Hand #HD1738838272: Hold'em No Limit ($0.02/$0.05) - 2024/04/20 15:13:51
Table 'NLHBlue13' 6-max Seat #3 is the button
Seat 1: Hero ($6.35 in chips)
Seat 2: f6d650f4 ($17.66 in chips)
Seat 3: 6fbb6d8b ($3.92 in chips)
Seat 4: 247787fe ($5 in chips)
Seat 6: d7806a1 ($5.07 in chips)
247787fe: posts small blind $0.02
d7806a1: posts big blind $0.05
*** HOLE CARDS ***
Dealt to Hero [Ah Td]
Dealt to f6d650f4 
Dealt to 6fbb6d8b 
Dealt to 247787fe 
Dealt to d7806a1 
Hero: raises $0.07 to $0.12
f6d650f4: folds
6fbb6d8b: calls $0.12
247787fe: folds
d7806a1: folds
*** FLOP *** [Kh 6c 5c]
Hero: bets $0.15
6fbb6d8b: calls $0.15
*** TURN *** [Kh 6c 5c] [7s]
Hero: checks
6fbb6d8b: checks
*** RIVER *** [Kh 6c 5c 7s] [Ts]
Hero: checks
6fbb6d8b: checks
Hero: shows [Ah Td] (Pair of Tens)
6fbb6d8b: shows [Qd Jc] (King-High)
f6d650f4: shows [3s 4s] (Sevens-High Straight)
*** SHOWDOWN ***
Hero collected $0.58 from pot
*** SUMMARY ***
Total pot $0.61 | Rake $0.03 | Jackpot $0 | Bingo $0 | Fortune $0 | Tax $0
Board [Kh 6c 5c 7s Ts]
Seat 1: Hero showed [Ah Td] and won ($0.58) with Pair of Tens
Seat 2: f6d650f4 folded before Flop (didn't bet)
Seat 3: 6fbb6d8b (button) showed [Qd Jc] and lost with King-High
Seat 4: 247787fe (small blind) folded before Flop
Seat 6: d7806a1 (big blind) folded before Flop


Poker Hand #HD1738838220: Hold'em No Limit ($0.02/$0.05) - 2024/04/20 15:13:27
Table 'NLHBlue13' 6-max Seat #2 is the button
Seat 1: Hero ($6.35 in chips)
Seat 2: f6d650f4 ($17.66 in chips)
Seat 3: 6fbb6d8b ($3.94 in chips)
Seat 4: 247787fe ($5 in chips)
Seat 5: 77e1e215 ($4.08 in chips)
Seat 6: d7806a1 ($5 in chips)
6fbb6d8b: posts small blind $0.02
247787fe: posts big blind $0.05
*** HOLE CARDS ***
Dealt to Hero [3h 8h]
Dealt to f6d650f4 
Dealt to 6fbb6d8b 
Dealt to 247787fe 
Dealt to 77e1e215 
Dealt to d7806a1 
77e1e215: folds
d7806a1: raises $0.08 to $0.13
Hero: folds
f6d650f4: folds
6fbb6d8b: folds
247787fe: folds
Uncalled bet ($0.08) returned to d7806a1
*** SHOWDOWN ***
d7806a1 collected $0.12 from pot
*** SUMMARY ***
Total pot $0.12 | Rake $0 | Jackpot $0 | Bingo $0 | Fortune $0 | Tax $0
Seat 1: Hero folded before Flop (didn't bet)
Seat 2: f6d650f4 (button) folded before Flop (didn't bet)
Seat 3: 6fbb6d8b (small blind) folded before Flop
Seat 4: 247787fe (big blind) folded before Flop
Seat 5: 77e1e215 folded before Flop (didn't bet)
Seat 6: d7806a1 collected ($0.12)


Poker Hand #HD1738838169: Hold'em No Limit ($0.02/$0.05) - 2024/04/20 15:13:00
Table 'NLHBlue13' 6-max Seat #1 is the button
Seat 1: Hero ($6.35 in chips)
Seat 2: f6d650f4 ($17.43 in chips)
Seat 3: 6fbb6d8b ($4.19 in chips)
Seat 4: 247787fe ($5 in chips)
Seat 5: 77e1e215 ($4.08 in chips)
Seat 6: d7806a1 ($5 in chips)
f6d650f4: posts small blind $0.02
6fbb6d8b: posts big blind $0.05
*** HOLE CARDS ***
Dealt to Hero [2h Jh]
Dealt to f6d650f4 
Dealt to 6fbb6d8b 
Dealt to 247787fe 
Dealt to 77e1e215 
Dealt to d7806a1 
247787fe: folds
77e1e215: folds
d7806a1: folds
Hero: folds
f6d650f4: calls $0.03
6fbb6d8b: raises $0.1 to $0.15
f6d650f4: calls $0.1
*** FLOP *** [Td 3c 3s]
f6d650f4: checks
6fbb6d8b: bets $0.1
f6d650f4: raises $0.17 to $0.27
6fbb6d8b: folds
Uncalled bet ($0.17) returned to f6d650f4
*** SHOWDOWN ***
f6d650f4 collected $0.48 from pot
*** SUMMARY ***
Total pot $0.5 | Rake $0.02 | Jackpot $0 | Bingo $0 | Fortune $0 | Tax $0
Board [Td 3c 3s]
Seat 1: Hero (button) folded before Flop (didn't bet)
Seat 2: f6d650f4 (small blind) won ($0.48)
Seat 3: 6fbb6d8b (big blind) folded on the Flop
Seat 4: 247787fe folded before Flop (didn't bet)
Seat 5: 77e1e215 folded before Flop (didn't bet)
Seat 6: d7806a1 folded before Flop (didn't bet)


Poker Hand #HD1738838046: Hold'em No Limit ($0.02/$0.05) - 2024/04/20 15:11:54
Table 'NLHBlue13' 6-max Seat #6 is the button
Seat 1: Hero ($6.37 in chips)
Seat 2: f6d650f4 ($18.06 in chips)
Seat 3: 6fbb6d8b ($4.19 in chips)
Seat 4: 247787fe ($5 in chips)
Seat 5: 77e1e215 ($3.49 in chips)
Seat 6: d7806a1 ($5 in chips)
Hero: posts small blind $0.02
f6d650f4: posts big blind $0.05
*** HOLE CARDS ***
Dealt to Hero [3c Jd]
Dealt to f6d650f4 
Dealt to 6fbb6d8b 
Dealt to 247787fe 
Dealt to 77e1e215 
Dealt to d7806a1 
6fbb6d8b: folds
247787fe: folds
77e1e215: raises $0.05 to $0.1
d7806a1: folds
Hero: folds
f6d650f4: calls $0.05
*** FLOP *** [4d Qs 7d]
f6d650f4: checks
77e1e215: bets $0.08
f6d650f4: calls $0.08
*** TURN *** [4d Qs 7d] [3h]
f6d650f4: checks
77e1e215: bets $0.13
f6d650f4: calls $0.13
*** RIVER *** [4d Qs 7d 3h] [7c]
f6d650f4: checks
77e1e215: bets $0.32
f6d650f4: calls $0.32
77e1e215: shows [9s Qd] (Pair of Queens and Pair of Sevens)
f6d650f4: shows [Qc 8d] (Pair of Queens and Pair of Sevens)
*** SHOWDOWN ***
77e1e215 collected $1.22 from pot
*** SUMMARY ***
Total pot $1.28 | Rake $0.06 | Jackpot $0 | Bingo $0 | Fortune $0 | Tax $0
Board [4d Qs 7d 3h 7c]
Seat 1: Hero (small blind) folded before Flop
Seat 2: f6d650f4 (big blind) showed [Qc 8d] and lost with Pair of Queens and Pair of Sevens
Seat 3: 6fbb6d8b folded before Flop (didn't bet)
Seat 4: 247787fe folded before Flop (didn't bet)
Seat 5: 77e1e215 showed [9s Qd] and won ($1.22) with Pair of Queens and Pair of Sevens
Seat 6: d7806a1 (button) folded before Flop (didn't bet)


Poker Hand #HD1738837968: Hold'em No Limit ($0.02/$0.05) - 2024/04/20 15:11:11
Table 'NLHBlue13' 6-max Seat #5 is the button
Seat 1: Hero ($6.42 in chips)
Seat 2: f6d650f4 ($18.37 in chips)
Seat 3: 6fbb6d8b ($5 in chips)
Seat 4: 247787fe ($5 in chips)
Seat 5: 77e1e215 ($2.44 in chips)
Seat 6: d7806a1 ($5 in chips)
d7806a1: posts small blind $0.02
Hero: posts big blind $0.05
6fbb6d8b: posts big blind $0.05
*** HOLE CARDS ***
Dealt to Hero [8c 5c]
Dealt to f6d650f4 
Dealt to 6fbb6d8b 
Dealt to 247787fe 
Dealt to 77e1e215 
Dealt to d7806a1 
f6d650f4: raises $0.05 to $0.1
6fbb6d8b: raises $0.21 to $0.31
247787fe: folds
77e1e215: calls $0.31
d7806a1: folds
Hero: folds
f6d650f4: calls $0.21
*** FLOP *** [9h Ah 9s]
f6d650f4: checks
6fbb6d8b: bets $0.5
77e1e215: raises $0.5 to $1
f6d650f4: folds
6fbb6d8b: folds
Uncalled bet ($0.5) returned to 77e1e215
f6d650f4: shows [Td Th] (Pair of Tens and Pair of Nines)
*** SHOWDOWN ***
77e1e215 collected $1.86 from pot
*** SUMMARY ***
Total pot $2 | Rake $0.09 | Jackpot $0.05 | Bingo $0 | Fortune $0 | Tax $0
Board [9h Ah 9s]
Seat 1: Hero (big blind) folded before Flop
Seat 2: f6d650f4 folded on the Flop
Seat 3: 6fbb6d8b folded on the Flop
Seat 4: 247787fe folded before Flop (didn't bet)
Seat 5: 77e1e215 (button) won ($1.86)
Seat 6: d7806a1 (small blind) folded before Flop


Poker Hand #HD1738837766: Hold'em No Limit ($0.02/$0.05) - 2024/04/20 15:09:35
Table 'NLHBlue13' 6-max Seat #4 is the button
Seat 1: Hero ($6.42 in chips)
Seat 2: f6d650f4 ($15.5 in chips)
Seat 4: 247787fe ($5 in chips)
Seat 5: 77e1e215 ($5.47 in chips)
Seat 6: d7806a1 ($5 in chips)
77e1e215: posts small blind $0.02
d7806a1: posts big blind $0.05
*** HOLE CARDS ***
Dealt to Hero [5s Qd]
Dealt to f6d650f4 
Dealt to 247787fe 
Dealt to 77e1e215 
Dealt to d7806a1 
Hero: folds
f6d650f4: raises $0.1 to $0.15
247787fe: calls $0.15
77e1e215: calls $0.13
d7806a1: folds
*** FLOP *** [2d 6s 2h]
77e1e215: checks
f6d650f4: bets $0.25
247787fe: folds
77e1e215: raises $0.25 to $0.5
f6d650f4: calls $0.25
*** TURN *** [2d 6s 2h] [4h]
77e1e215: checks
f6d650f4: bets $0.5
77e1e215: calls $0.5
*** RIVER *** [2d 6s 2h 4h] [Ts]
77e1e215: checks
f6d650f4: bets $1.88
77e1e215: calls $1.88
f6d650f4: shows [Td Th] (Tens Full over Twos)
77e1e215: shows [Ks Kh] (Pair of Kings and Pair of Twos)
*** SHOWDOWN ***
f6d650f4 collected $5.9 from pot
*** SUMMARY ***
Total pot $6.26 | Rake $0.31 | Jackpot $0.05 | Bingo $0 | Fortune $0 | Tax $0
Board [2d 6s 2h 4h Ts]
Seat 1: Hero folded before Flop (didn't bet)
Seat 2: f6d650f4 showed [Td Th] and won ($5.9) with Tens Full over Twos
Seat 4: 247787fe (button) folded on the Flop
Seat 5: 77e1e215 (small blind) showed [Ks Kh] and lost with Pair of Kings and Pair of Twos
Seat 6: d7806a1 (big blind) folded before Flop


Poker Hand #HD1738837733: Hold'em No Limit ($0.02/$0.05) - 2024/04/20 15:09:14
Table 'NLHBlue13' 6-max Seat #2 is the button
Seat 1: Hero ($6.35 in chips)
Seat 2: f6d650f4 ($15.5 in chips)
Seat 4: 247787fe ($5 in chips)
Seat 5: 77e1e215 ($5.52 in chips)
Seat 6: d7806a1 ($5 in chips)
247787fe: posts small blind $0.02
77e1e215: posts big blind $0.05
*** HOLE CARDS ***
Dealt to Hero [Ks Tc]
Dealt to f6d650f4 
Dealt to 247787fe 
Dealt to 77e1e215 
Dealt to d7806a1 
d7806a1: folds
Hero: raises $0.07 to $0.12
f6d650f4: folds
247787fe: folds
77e1e215: folds
Uncalled bet ($0.07) returned to Hero
*** SHOWDOWN ***
Hero collected $0.12 from pot
*** SUMMARY ***
Total pot $0.12 | Rake $0 | Jackpot $0 | Bingo $0 | Fortune $0 | Tax $0
Seat 1: Hero collected ($0.12)
Seat 2: f6d650f4 (button) folded before Flop (didn't bet)
Seat 4: 247787fe (small blind) folded before Flop
Seat 5: 77e1e215 (big blind) folded before Flop
Seat 6: d7806a1 folded before Flop (didn't bet)


Poker Hand #HD1738837531: Hold'em No Limit ($0.02/$0.05) - 2024/04/20 15:07:30
Table 'NLHBlue13' 6-max Seat #1 is the button
Seat 1: Hero ($6.35 in chips)
Seat 2: f6d650f4 ($10.56 in chips)
Seat 3: a308231c ($5.36 in chips)
Seat 4: 247787fe ($5 in chips)
Seat 5: 77e1e215 ($5.65 in chips)
Seat 6: d7806a1 ($5 in chips)
f6d650f4: posts small blind $0.02
a308231c: posts big blind $0.05
*** HOLE CARDS ***
Dealt to Hero [Jc 6c]
Dealt to f6d650f4 
Dealt to a308231c 
Dealt to 247787fe 
Dealt to 77e1e215 
Dealt to d7806a1 
247787fe: folds
77e1e215: raises $0.08 to $0.13
d7806a1: folds
Hero: folds
f6d650f4: calls $0.11
a308231c: raises $0.43 to $0.56
77e1e215: folds
f6d650f4: calls $0.43
*** FLOP *** [Td 5d 6s]
f6d650f4: checks
a308231c: bets $0.75
f6d650f4: calls $0.75
*** TURN *** [Td 5d 6s] [9s]
f6d650f4: checks
a308231c: bets $1
f6d650f4: raises $2.38 to $3.38
a308231c: raises $0.67 to $4.05 and is all-in
f6d650f4: calls $0.67
a308231c: shows [Kd Kc] (Pair of Kings)
f6d650f4: shows [9d 9h] (Three Nines)
*** FIRST RIVER *** [Td 5d 6s 9s] [Js]
*** SECOND RIVER *** [Td 5d 6s 9s] [Ts]
*** FIRST SHOWDOWN ***
f6d650f4 collected $5.15 from pot
*** SECOND SHOWDOWN ***
f6d650f4 collected $5.15 from pot
*** SUMMARY ***
Total pot $10.85 | Rake $0.5 | Jackpot $0.05 | Bingo $0 | Fortune $0 | Tax $0
Hand was run two times
FIRST Board [Td 5d 6s 9s Js]
SECOND Board [Ts]
Seat 1: Hero (button) folded before Flop (didn't bet)
Seat 2: f6d650f4 (small blind) showed [9d 9h] and won ($5.15) with Three Nines, and won ($5.15)
Seat 3: a308231c (big blind) showed [Kd Kc] and lost with Pair of Kings, and lost
Seat 4: 247787fe folded before Flop (didn't bet)
Seat 5: 77e1e215 folded before Flop
Seat 6: d7806a1 folded before Flop (didn't bet)


Poker Hand #HD1738837396: Hold'em No Limit ($0.02/$0.05) - 2024/04/20 15:06:19
Table 'NLHBlue13' 6-max Seat #6 is the button
Seat 1: Hero ($6.37 in chips)
Seat 2: f6d650f4 ($10.66 in chips)
Seat 3: a308231c ($5.02 in chips)
Seat 4: 247787fe ($5 in chips)
Seat 5: 77e1e215 ($5.9 in chips)
Seat 6: d7806a1 ($5 in chips)
Hero: posts small blind $0.02
f6d650f4: posts big blind $0.05
*** HOLE CARDS ***
Dealt to Hero [3s 9c]
Dealt to f6d650f4 
Dealt to a308231c 
Dealt to 247787fe 
Dealt to 77e1e215 
Dealt to d7806a1 
a308231c: calls $0.05
247787fe: folds
77e1e215: raises $0.05 to $0.1
d7806a1: folds
Hero: folds
f6d650f4: calls $0.05
a308231c: calls $0.05
*** FLOP *** [5s Qd 9d]
f6d650f4: checks
a308231c: bets $0.15
77e1e215: calls $0.15
f6d650f4: folds
*** TURN *** [5s Qd 9d] [Td]
a308231c: bets $0.45
77e1e215: folds
Uncalled bet ($0.45) returned to a308231c
*** SHOWDOWN ***
a308231c collected $0.59 from pot
*** SUMMARY ***
Total pot $0.62 | Rake $0.03 | Jackpot $0 | Bingo $0 | Fortune $0 | Tax $0
Board [5s Qd 9d Td]
Seat 1: Hero (small blind) folded before Flop
Seat 2: f6d650f4 (big blind) folded on the Flop
Seat 3: a308231c won ($0.59)
Seat 4: 247787fe folded before Flop (didn't bet)
Seat 5: 77e1e215 folded on the Turn
Seat 6: d7806a1 (button) folded before Flop (didn't bet)


Poker Hand #HD1738837363: Hold'em No Limit ($0.02/$0.05) - 2024/04/20 15:05:59
Table 'NLHBlue13' 6-max Seat #5 is the button
Seat 1: Hero ($6.42 in chips)
Seat 2: f6d650f4 ($10.66 in chips)
Seat 3: a308231c ($5.07 in chips)
Seat 4: 247787fe ($5 in chips)
Seat 5: 77e1e215 ($5.78 in chips)
Seat 6: d7806a1 ($5 in chips)
d7806a1: posts small blind $0.02
Hero: posts big blind $0.05
*** HOLE CARDS ***
Dealt to Hero [5c Kd]
Dealt to f6d650f4 
Dealt to a308231c 
Dealt to 247787fe 
Dealt to 77e1e215 
Dealt to d7806a1 
f6d650f4: folds
a308231c: calls $0.05
247787fe: folds
77e1e215: raises $0.05 to $0.1
d7806a1: folds
Hero: folds
a308231c: folds
Uncalled bet ($0.05) returned to 77e1e215
*** SHOWDOWN ***
77e1e215 collected $0.17 from pot
*** SUMMARY ***
Total pot $0.17 | Rake $0 | Jackpot $0 | Bingo $0 | Fortune $0 | Tax $0
Seat 1: Hero (big blind) folded before Flop
Seat 2: f6d650f4 folded before Flop (didn't bet)
Seat 3: a308231c folded before Flop
Seat 4: 247787fe folded before Flop (didn't bet)
Seat 5: 77e1e215 (button) collected ($0.17)
Seat 6: d7806a1 (small blind) folded before Flop


Poker Hand #HD1738837296: Hold'em No Limit ($0.02/$0.05) - 2024/04/20 15:05:26
Table 'NLHBlue13' 6-max Seat #4 is the button
Seat 1: Hero ($6.54 in chips)
Seat 2: f6d650f4 ($10.66 in chips)
Seat 3: a308231c ($5.07 in chips)
Seat 4: 247787fe ($5 in chips)
Seat 5: 77e1e215 ($5.51 in chips)
Seat 6: d7806a1 ($5 in chips)
77e1e215: posts small blind $0.02
d7806a1: posts big blind $0.05
*** HOLE CARDS ***
Dealt to Hero [5s 5c]
Dealt to f6d650f4 
Dealt to a308231c 
Dealt to 247787fe 
Dealt to 77e1e215 
Dealt to d7806a1 
Hero: raises $0.07 to $0.12
f6d650f4: folds
a308231c: folds
247787fe: calls $0.12
77e1e215: raises $0.31 to $0.43
d7806a1: folds
Hero: folds
247787fe: folds
Uncalled bet ($0.31) returned to 77e1e215
*** SHOWDOWN ***
77e1e215 collected $0.39 from pot
*** SUMMARY ***
Total pot $0.41 | Rake $0.02 | Jackpot $0 | Bingo $0 | Fortune $0 | Tax $0
Seat 1: Hero folded before Flop
Seat 2: f6d650f4 folded before Flop (didn't bet)
Seat 3: a308231c folded before Flop (didn't bet)
Seat 4: 247787fe (button) folded before Flop
Seat 5: 77e1e215 (small blind) collected ($0.39)
Seat 6: d7806a1 (big blind) folded before Flop


Poker Hand #HD1738837170: Hold'em No Limit ($0.02/$0.05) - 2024/04/20 15:04:26
Table 'NLHBlue13' 6-max Seat #3 is the button
Seat 1: Hero ($6.54 in chips)
Seat 2: f6d650f4 ($10.11 in chips)
Seat 3: a308231c ($5.07 in chips)
Seat 4: 247787fe ($5 in chips)
Seat 5: 77e1e215 ($5.94 in chips)
Seat 6: 87a37679 ($5 in chips)
247787fe: posts small blind $0.02
77e1e215: posts big blind $0.05
*** HOLE CARDS ***
Dealt to Hero [4c 7d]
Dealt to f6d650f4 
Dealt to a308231c 
Dealt to 247787fe 
Dealt to 77e1e215 
Dealt to 87a37679 
87a37679: folds
Hero: folds
f6d650f4: calls $0.05
a308231c: folds
247787fe: raises $0.12 to $0.17
77e1e215: calls $0.12
f6d650f4: calls $0.12
*** FLOP *** [Jh 7c 3d]
247787fe: checks
77e1e215: checks
f6d650f4: bets $0.26
247787fe: folds
77e1e215: calls $0.26
*** TURN *** [Jh 7c 3d] [Ks]
77e1e215: checks
f6d650f4: bets $0.52
77e1e215: folds
Uncalled bet ($0.52) returned to f6d650f4
*** SHOWDOWN ***
f6d650f4 collected $0.98 from pot
*** SUMMARY ***
Total pot $1.03 | Rake $0.05 | Jackpot $0 | Bingo $0 | Fortune $0 | Tax $0
Board [Jh 7c 3d Ks]
Seat 1: Hero folded before Flop (didn't bet)
Seat 2: f6d650f4 won ($0.98)
Seat 3: a308231c (button) folded before Flop (didn't bet)
Seat 4: 247787fe (small blind) folded on the Flop
Seat 5: 77e1e215 (big blind) folded on the Turn
Seat 6: 87a37679 folded before Flop (didn't bet)


Poker Hand #HD1738837140: Hold'em No Limit ($0.02/$0.05) - 2024/04/20 15:04:13
Table 'NLHBlue13' 6-max Seat #2 is the button
Seat 1: Hero ($6.54 in chips)
Seat 2: f6d650f4 ($10.11 in chips)
Seat 3: a308231c ($5.09 in chips)
Seat 4: 247787fe ($5 in chips)
Seat 5: 77e1e215 ($5.87 in chips)
Seat 6: 87a37679 ($5 in chips)
a308231c: posts small blind $0.02
247787fe: posts big blind $0.05
*** HOLE CARDS ***
Dealt to Hero [7d Jc]
Dealt to f6d650f4 
Dealt to a308231c 
Dealt to 247787fe 
Dealt to 77e1e215 
Dealt to 87a37679 
77e1e215: raises $0.05 to $0.1
87a37679: folds
Hero: folds
f6d650f4: folds
a308231c: folds
247787fe: folds
Uncalled bet ($0.05) returned to 77e1e215
*** SHOWDOWN ***
77e1e215 collected $0.12 from pot
*** SUMMARY ***
Total pot $0.12 | Rake $0 | Jackpot $0 | Bingo $0 | Fortune $0 | Tax $0
Seat 1: Hero folded before Flop (didn't bet)
Seat 2: f6d650f4 (button) folded before Flop (didn't bet)
Seat 3: a308231c (small blind) folded before Flop
Seat 4: 247787fe (big blind) folded before Flop
Seat 5: 77e1e215 collected ($0.12)
Seat 6: 87a37679 folded before Flop (didn't bet)


Poker Hand #HD1738837071: Hold'em No Limit ($0.02/$0.05) - 2024/04/20 15:03:40
Table 'NLHBlue13' 6-max Seat #1 is the button
Seat 1: Hero ($6.54 in chips)
Seat 2: f6d650f4 ($10.26 in chips)
Seat 3: a308231c ($4.95 in chips)
Seat 5: 77e1e215 ($5.87 in chips)
Seat 6: 87a37679 ($5 in chips)
f6d650f4: posts small blind $0.02
a308231c: posts big blind $0.05
*** HOLE CARDS ***
Dealt to Hero [2c 6h]
Dealt to f6d650f4 
Dealt to a308231c 
Dealt to 77e1e215 
Dealt to 87a37679 
77e1e215: folds
87a37679: folds
Hero: folds
f6d650f4: calls $0.03
a308231c: raises $0.1 to $0.15
f6d650f4: calls $0.1
*** FLOP *** [Tc 2h 5s]
f6d650f4: checks
a308231c: bets $0.35
f6d650f4: folds
Uncalled bet ($0.35) returned to a308231c
*** SHOWDOWN ***
a308231c collected $0.29 from pot
*** SUMMARY ***
Total pot $0.3 | Rake $0.01 | Jackpot $0 | Bingo $0 | Fortune $0 | Tax $0
Board [Tc 2h 5s]
Seat 1: Hero (button) folded before Flop (didn't bet)
Seat 2: f6d650f4 (small blind) folded on the Flop
Seat 3: a308231c (big blind) won ($0.29)
Seat 5: 77e1e215 folded before Flop (didn't bet)
Seat 6: 87a37679 folded before Flop (didn't bet)


Poker Hand #HD1738836928: Hold'em No Limit ($0.02/$0.05) - 2024/04/20 15:02:26
Table 'NLHBlue13' 6-max Seat #6 is the button
Seat 1: Hero ($7.36 in chips)
Seat 2: f6d650f4 ($10.36 in chips)
Seat 3: a308231c ($4.95 in chips)
Seat 5: 77e1e215 ($4.99 in chips)
Seat 6: 87a37679 ($5.1 in chips)
Hero: posts small blind $0.02
f6d650f4: posts big blind $0.05
*** HOLE CARDS ***
Dealt to Hero [Qc Jh]
Dealt to f6d650f4 
Dealt to a308231c 
Dealt to 77e1e215 
Dealt to 87a37679 
a308231c: folds
77e1e215: raises $0.05 to $0.1
87a37679: calls $0.1
Hero: calls $0.08
f6d650f4: calls $0.05
*** FLOP *** [9s 8h 4c]
Hero: checks
f6d650f4: checks
77e1e215: bets $0.2
87a37679: folds
Hero: calls $0.2
f6d650f4: folds
*** TURN *** [9s 8h 4c] [6c]
Hero: checks
77e1e215: checks
*** RIVER *** [9s 8h 4c 6c] [5s]
Hero: bets $0.52
77e1e215: raises $0.52 to $1.04
Hero: folds
Uncalled bet ($0.52) returned to 77e1e215
*** SHOWDOWN ***
77e1e215 collected $1.7 from pot
*** SUMMARY ***
Total pot $1.84 | Rake $0.09 | Jackpot $0.05 | Bingo $0 | Fortune $0 | Tax $0
Board [9s 8h 4c 6c 5s]
Seat 1: Hero (small blind) folded on the River
Seat 2: f6d650f4 (big blind) folded on the Flop
Seat 3: a308231c folded before Flop (didn't bet)
Seat 5: 77e1e215 won ($1.7)
Seat 6: 87a37679 (button) folded on the Flop


Poker Hand #HD1738836887: Hold'em No Limit ($0.02/$0.05) - 2024/04/20 15:02:03
Table 'NLHBlue13' 6-max Seat #5 is the button
Seat 1: Hero ($7.41 in chips)
Seat 2: f6d650f4 ($10.36 in chips)
Seat 3: a308231c ($5 in chips)
Seat 5: 77e1e215 ($4.99 in chips)
Seat 6: 87a37679 ($5 in chips)
87a37679: posts small blind $0.02
Hero: posts big blind $0.05
a308231c: posts big blind $0.05
*** HOLE CARDS ***
Dealt to Hero [6d Tc]
Dealt to f6d650f4 
Dealt to a308231c 
Dealt to 77e1e215 
Dealt to 87a37679 
f6d650f4: folds
a308231c: checks
77e1e215: folds
87a37679: raises $0.1 to $0.15
Hero: folds
a308231c: folds
Uncalled bet ($0.1) returned to 87a37679
*** SHOWDOWN ***
87a37679 collected $0.15 from pot
*** SUMMARY ***
Total pot $0.15 | Rake $0 | Jackpot $0 | Bingo $0 | Fortune $0 | Tax $0
Seat 1: Hero (big blind) folded before Flop
Seat 2: f6d650f4 folded before Flop (didn't bet)
Seat 3: a308231c folded before Flop
Seat 5: 77e1e215 (button) folded before Flop (didn't bet)
Seat 6: 87a37679 (small blind) collected ($0.15)


Poker Hand #HD1738836831: Hold'em No Limit ($0.02/$0.05) - 2024/04/20 15:01:33
Table 'NLHBlue13' 6-max Seat #2 is the button
Seat 1: Hero ($7.41 in chips)
Seat 2: f6d650f4 ($10.19 in chips)
Seat 5: 77e1e215 ($5.12 in chips)
Seat 6: 87a37679 ($5 in chips)
77e1e215: posts small blind $0.02
87a37679: posts big blind $0.05
*** HOLE CARDS ***
Dealt to Hero [5h Jd]
Dealt to f6d650f4 
Dealt to 77e1e215 
Dealt to 87a37679 
Hero: folds
f6d650f4: calls $0.05
77e1e215: raises $0.08 to $0.13
87a37679: folds
f6d650f4: calls $0.08
*** FLOP *** [8s Qh Tc]
77e1e215: checks
f6d650f4: bets $0.11
77e1e215: folds
Uncalled bet ($0.11) returned to f6d650f4
*** SHOWDOWN ***
f6d650f4 collected $0.3 from pot
*** SUMMARY ***
Total pot $0.31 | Rake $0.01 | Jackpot $0 | Bingo $0 | Fortune $0 | Tax $0
Board [8s Qh Tc]
Seat 1: Hero folded before Flop (didn't bet)
Seat 2: f6d650f4 (button) won ($0.3)
Seat 5: 77e1e215 (small blind) folded on the Flop
Seat 6: 87a37679 (big blind) folded before Flop


Poker Hand #HD1738836737: Hold'em No Limit ($0.02/$0.05) - 2024/04/20 15:00:48
Table 'NLHBlue13' 6-max Seat #1 is the button
Seat 1: Hero ($7.28 in chips)
Seat 2: f6d650f4 ($10.21 in chips)
Seat 5: 77e1e215 ($5.24 in chips)
Seat 6: 87a37679 ($5 in chips)
f6d650f4: posts small blind $0.02
77e1e215: posts big blind $0.05
*** HOLE CARDS ***
Dealt to Hero [Jd Kc]
Dealt to f6d650f4 
Dealt to 77e1e215 
Dealt to 87a37679 
87a37679: folds
Hero: raises $0.07 to $0.12
f6d650f4: folds
77e1e215: calls $0.07
*** FLOP *** [Ac Ah Kd]
77e1e215: checks
Hero: checks
*** TURN *** [Ac Ah Kd] [Jh]
77e1e215: checks
Hero: checks
*** RIVER *** [Ac Ah Kd Jh] [7c]
77e1e215: checks
Hero: bets $0.15
77e1e215: folds
Uncalled bet ($0.15) returned to Hero
*** SHOWDOWN ***
Hero collected $0.25 from pot
*** SUMMARY ***
Total pot $0.26 | Rake $0.01 | Jackpot $0 | Bingo $0 | Fortune $0 | Tax $0
Board [Ac Ah Kd Jh 7c]
Seat 1: Hero (button) won ($0.25)
Seat 2: f6d650f4 (small blind) folded before Flop
Seat 5: 77e1e215 (big blind) folded on the River
Seat 6: 87a37679 folded before Flop (didn't bet)


Poker Hand #HD1738836686: Hold'em No Limit ($0.02/$0.05) - 2024/04/20 15:00:18
Table 'NLHBlue13' 6-max Seat #6 is the button
Seat 1: Hero ($7.3 in chips)
Seat 2: f6d650f4 ($10.64 in chips)
Seat 5: 77e1e215 ($4.83 in chips)
Seat 6: 87a37679 ($5 in chips)
Hero: posts small blind $0.02
f6d650f4: posts big blind $0.05
*** HOLE CARDS ***
Dealt to Hero [5c Ad]
Dealt to f6d650f4 
Dealt to 77e1e215 
Dealt to 87a37679 
77e1e215: raises $0.05 to $0.1
87a37679: folds
Hero: folds
f6d650f4: calls $0.05
*** FLOP *** [2c 5h 7s]
f6d650f4: checks
77e1e215: bets $0.11
f6d650f4: calls $0.11
*** TURN *** [2c 5h 7s] [Jd]
f6d650f4: checks
77e1e215: bets $0.22
f6d650f4: calls $0.22
*** RIVER *** [2c 5h 7s Jd] [9s]
f6d650f4: checks
77e1e215: bets $0.66
f6d650f4: folds
Uncalled bet ($0.66) returned to 77e1e215
*** SHOWDOWN ***
77e1e215 collected $0.84 from pot
*** SUMMARY ***
Total pot $0.88 | Rake $0.04 | Jackpot $0 | Bingo $0 | Fortune $0 | Tax $0
Board [2c 5h 7s Jd 9s]
Seat 1: Hero (small blind) folded before Flop
Seat 2: f6d650f4 (big blind) folded on the River
Seat 5: 77e1e215 won ($0.84)
Seat 6: 87a37679 (button) folded before Flop (didn't bet)


Poker Hand #HD1738836628: Hold'em No Limit ($0.02/$0.05) - 2024/04/20 14:59:47
Table 'NLHBlue13' 6-max Seat #5 is the button
Seat 1: Hero ($7.35 in chips)
Seat 2: f6d650f4 ($9.98 in chips)
Seat 5: 77e1e215 ($4.83 in chips)
Seat 6: 87a37679 ($5.27 in chips)
87a37679: posts small blind $0.02
Hero: posts big blind $0.05
*** HOLE CARDS ***
Dealt to Hero [7c Ah]
Dealt to f6d650f4 
Dealt to 77e1e215 
Dealt to 87a37679 
f6d650f4: calls $0.05
77e1e215: folds
87a37679: raises $0.15 to $0.2
Hero: folds
f6d650f4: calls $0.15
*** FLOP *** [Tc 2s Jc]
87a37679: bets $0.15
f6d650f4: calls $0.15
*** TURN *** [Tc 2s Jc] [3h]
87a37679: bets $0.38
f6d650f4: calls $0.38
*** RIVER *** [Tc 2s Jc 3h] [9d]
87a37679: checks
f6d650f4: checks
87a37679: shows [Qd Ac] (Ace-High)
f6d650f4: shows [Th 4h] (Pair of Tens)
*** SHOWDOWN ***
f6d650f4 collected $1.39 from pot
*** SUMMARY ***
Total pot $1.51 | Rake $0.07 | Jackpot $0.05 | Bingo $0 | Fortune $0 | Tax $0
Board [Tc 2s Jc 3h 9d]
Seat 1: Hero (big blind) folded before Flop
Seat 2: f6d650f4 showed [Th 4h] and won ($1.39) with Pair of Tens
Seat 5: 77e1e215 (button) folded before Flop (didn't bet)
Seat 6: 87a37679 (small blind) showed [Qd Ac] and lost with Ace-High


Poker Hand #HD1738836533: Hold'em No Limit ($0.02/$0.05) - 2024/04/20 14:58:59
Table 'NLHBlue13' 6-max Seat #2 is the button
Seat 1: Hero ($7.35 in chips)
Seat 2: f6d650f4 ($10.03 in chips)
Seat 5: 77e1e215 ($5.07 in chips)
Seat 6: 87a37679 ($5 in chips)
77e1e215: posts small blind $0.02
87a37679: posts big blind $0.05
*** HOLE CARDS ***
Dealt to Hero [8h 2d]
Dealt to f6d650f4 
Dealt to 77e1e215 
Dealt to 87a37679 
Hero: folds
f6d650f4: calls $0.05
77e1e215: calls $0.03
87a37679: checks
*** FLOP *** [9s 6s 9h]
77e1e215: checks
87a37679: checks
f6d650f4: checks
*** TURN *** [9s 6s 9h] [Ks]
77e1e215: checks
87a37679: checks
f6d650f4: checks
*** RIVER *** [9s 6s 9h Ks] [8c]
77e1e215: bets $0.08
87a37679: raises $0.11 to $0.19
f6d650f4: folds
77e1e215: calls $0.11
87a37679: shows [9c 5s] (Three Nines)
77e1e215: shows [Js 6c] (Pair of Nines and Pair of Sixes)
*** SHOWDOWN ***
87a37679 collected $0.51 from pot
*** SUMMARY ***
Total pot $0.53 | Rake $0.02 | Jackpot $0 | Bingo $0 | Fortune $0 | Tax $0
Board [9s 6s 9h Ks 8c]
Seat 1: Hero folded before Flop (didn't bet)
Seat 2: f6d650f4 (button) folded on the River
Seat 5: 77e1e215 (small blind) showed [Js 6c] and lost with Pair of Nines and Pair of Sixes
Seat 6: 87a37679 (big blind) showed [9c 5s] and won ($0.51) with Three Nines


Poker Hand #HD1738836454: Hold'em No Limit ($0.02/$0.05) - 2024/04/20 14:58:18
Table 'NLHBlue13' 6-max Seat #1 is the button
Seat 1: Hero ($7.35 in chips)
Seat 2: f6d650f4 ($10.05 in chips)
Seat 5: 77e1e215 ($5.05 in chips)
Seat 6: 87a37679 ($5 in chips)
f6d650f4: posts small blind $0.02
77e1e215: posts big blind $0.05
*** HOLE CARDS ***
Dealt to Hero [Ad 5c]
Dealt to f6d650f4 
Dealt to 77e1e215 
Dealt to 87a37679 
87a37679: folds
Hero: folds
f6d650f4: folds
Uncalled bet ($0.03) returned to 77e1e215
*** SHOWDOWN ***
77e1e215 collected $0.04 from pot
*** SUMMARY ***
Total pot $0.04 | Rake $0 | Jackpot $0 | Bingo $0 | Fortune $0 | Tax $0
Seat 1: Hero (button) folded before Flop (didn't bet)
Seat 2: f6d650f4 (small blind) folded before Flop
Seat 5: 77e1e215 (big blind) collected ($0.04)
Seat 6: 87a37679 folded before Flop (didn't bet)


Poker Hand #HD1738836354: Hold'em No Limit ($0.02/$0.05) - 2024/04/20 14:57:29
Table 'NLHBlue13' 6-max Seat #6 is the button
Seat 1: Hero ($7.37 in chips)
Seat 2: f6d650f4 ($9.78 in chips)
Seat 3: 33f5621b ($5.1 in chips)
Seat 4: b14d35ee ($13.7 in chips)
Seat 5: 77e1e215 ($5.05 in chips)
Seat 6: 87a37679 ($5 in chips)
Hero: posts small blind $0.02
f6d650f4: posts big blind $0.05
*** HOLE CARDS ***
Dealt to Hero [Qc 6d]
Dealt to f6d650f4 
Dealt to 33f5621b 
Dealt to b14d35ee 
Dealt to 77e1e215 
Dealt to 87a37679 
33f5621b: folds
b14d35ee: folds
77e1e215: folds
87a37679: raises $0.08 to $0.13
Hero: folds
f6d650f4: calls $0.08
*** FLOP *** [6s As Tc]
f6d650f4: checks
87a37679: bets $0.14
f6d650f4: calls $0.14
*** TURN *** [6s As Tc] [9d]
f6d650f4: checks
87a37679: checks
*** RIVER *** [6s As Tc 9d] [2s]
f6d650f4: checks
87a37679: checks
f6d650f4: shows [Qh 9c] (Pair of Nines)
87a37679: shows [4s 4h] (Pair of Fours)
*** SHOWDOWN ***
f6d650f4 collected $0.54 from pot
*** SUMMARY ***
Total pot $0.56 | Rake $0.02 | Jackpot $0 | Bingo $0 | Fortune $0 | Tax $0
Board [6s As Tc 9d 2s]
Seat 1: Hero (small blind) folded before Flop
Seat 2: f6d650f4 (big blind) showed [Qh 9c] and won ($0.54) with Pair of Nines
Seat 3: 33f5621b folded before Flop (didn't bet)
Seat 4: b14d35ee folded before Flop (didn't bet)
Seat 5: 77e1e215 folded before Flop (didn't bet)
Seat 6: 87a37679 (button) showed [4s 4h] and lost with Pair of Fours


Poker Hand #HD1738836222: Hold'em No Limit ($0.02/$0.05) - 2024/04/20 14:56:21
Table 'NLHBlue13' 6-max Seat #5 is the button
Seat 1: Hero ($7.42 in chips)
Seat 2: f6d650f4 ($5 in chips)
Seat 3: 33f5621b ($5.1 in chips)
Seat 4: b14d35ee ($13.7 in chips)
Seat 5: 77e1e215 ($5.33 in chips)
Seat 6: 87a37679 ($5 in chips)
87a37679: posts small blind $0.02
Hero: posts big blind $0.05
f6d650f4: posts big blind $0.05
*** HOLE CARDS ***
Dealt to Hero [6h Kc]
Dealt to f6d650f4 
Dealt to 33f5621b 
Dealt to b14d35ee 
Dealt to 77e1e215 
Dealt to 87a37679 
f6d650f4: checks
33f5621b: folds
b14d35ee: folds
77e1e215: raises $0.05 to $0.1
87a37679: calls $0.08
Hero: folds
f6d650f4: calls $0.05
*** FLOP *** [2c Jc 5h]
87a37679: checks
f6d650f4: bets $0.18
77e1e215: calls $0.18
87a37679: raises $0.67 to $0.85
f6d650f4: raises $4.05 to $4.9 and is all-in
77e1e215: folds
87a37679: calls $4.05 and is all-in
f6d650f4: shows [Js 5d] (Pair of Jacks and Pair of Fives)
87a37679: shows [Ac Jh] (Pair of Jacks)
*** FIRST TURN *** [2c Jc 5h] [7s]
*** FIRST RIVER *** [2c Jc 5h 7s] [4h]
*** SECOND TURN *** [2c Jc 5h] [Qc]
*** SECOND RIVER *** [2c Jc 5h Qc] [Td]
*** FIRST SHOWDOWN ***
f6d650f4 collected $4.89 from pot
*** SECOND SHOWDOWN ***
f6d650f4 collected $4.89 from pot
*** SUMMARY ***
Total pot $10.33 | Rake $0.5 | Jackpot $0.05 | Bingo $0 | Fortune $0 | Tax $0
Hand was run two times
FIRST Board [2c Jc 5h 7s 4h]
SECOND Board [Qc Td]
Seat 1: Hero (big blind) folded before Flop
Seat 2: f6d650f4 showed [Js 5d] and won ($4.89) with Pair of Jacks and Pair of Fives, and won ($4.89)
Seat 3: 33f5621b folded before Flop (didn't bet)
Seat 4: b14d35ee folded before Flop (didn't bet)
Seat 5: 77e1e215 (button) folded on the Flop
Seat 6: 87a37679 (small blind) showed [Ac Jh] and lost with Pair of Jacks, and lost


Poker Hand #HD1738836140: Hold'em No Limit ($0.02/$0.05) - 2024/04/20 14:55:36
Table 'NLHBlue13' 6-max Seat #4 is the button
Seat 1: Hero ($7.42 in chips)
Seat 3: 33f5621b ($5.23 in chips)
Seat 4: b14d35ee ($13.7 in chips)
Seat 5: 77e1e215 ($5.16 in chips)
Seat 6: 87a37679 ($5 in chips)
77e1e215: posts small blind $0.02
87a37679: posts big blind $0.05
*** HOLE CARDS ***
Dealt to Hero [8d Jh]
Dealt to 33f5621b 
Dealt to b14d35ee 
Dealt to 77e1e215 
Dealt to 87a37679 
Hero: folds
33f5621b: raises $0.08 to $0.13
b14d35ee: folds
77e1e215: calls $0.11
87a37679: folds
*** FLOP *** [4s 9d 6d]
77e1e215: checks
33f5621b: checks
*** TURN *** [4s 9d 6d] [Ah]
77e1e215: bets $0.11
33f5621b: folds
Uncalled bet ($0.11) returned to 77e1e215
*** SHOWDOWN ***
77e1e215 collected $0.3 from pot
*** SUMMARY ***
Total pot $0.31 | Rake $0.01 | Jackpot $0 | Bingo $0 | Fortune $0 | Tax $0
Board [4s 9d 6d Ah]
Seat 1: Hero folded before Flop (didn't bet)
Seat 3: 33f5621b folded on the Turn
Seat 4: b14d35ee (button) folded before Flop (didn't bet)
Seat 5: 77e1e215 (small blind) won ($0.3)
Seat 6: 87a37679 (big blind) folded before Flop


Poker Hand #HD1738836111: Hold'em No Limit ($0.02/$0.05) - 2024/04/20 14:55:21
Table 'NLHBlue13' 6-max Seat #3 is the button
Seat 1: Hero ($7.42 in chips)
Seat 3: 33f5621b ($5.16 in chips)
Seat 4: b14d35ee ($13.72 in chips)
Seat 5: 77e1e215 ($5.21 in chips)
Seat 6: 87a37679 ($5 in chips)
b14d35ee: posts small blind $0.02
77e1e215: posts big blind $0.05
*** HOLE CARDS ***
Dealt to Hero [Kd 6c]
Dealt to 33f5621b 
Dealt to b14d35ee 
Dealt to 77e1e215 
Dealt to 87a37679 
87a37679: folds
Hero: folds
33f5621b: raises $0.08 to $0.13
b14d35ee: folds
77e1e215: folds
Uncalled bet ($0.08) returned to 33f5621b
*** SHOWDOWN ***
33f5621b collected $0.12 from pot
*** SUMMARY ***
Total pot $0.12 | Rake $0 | Jackpot $0 | Bingo $0 | Fortune $0 | Tax $0
Seat 1: Hero folded before Flop (didn't bet)
Seat 3: 33f5621b (button) collected ($0.12)
Seat 4: b14d35ee (small blind) folded before Flop
Seat 5: 77e1e215 (big blind) folded before Flop
Seat 6: 87a37679 folded before Flop (didn't bet)


Poker Hand #HD1738836075: Hold'em No Limit ($0.02/$0.05) - 2024/04/20 14:55:04
Table 'NLHBlue13' 6-max Seat #1 is the button
Seat 1: Hero ($7.42 in chips)
Seat 2: fa716687 ($8.06 in chips)
Seat 3: 33f5621b ($5.21 in chips)
Seat 4: b14d35ee ($13.65 in chips)
Seat 5: 77e1e215 ($5.21 in chips)
Seat 6: 87a37679 ($5 in chips)
fa716687: posts small blind $0.02
33f5621b: posts big blind $0.05
*** HOLE CARDS ***
Dealt to Hero [Kh 7h]
Dealt to fa716687 
Dealt to 33f5621b 
Dealt to b14d35ee 
Dealt to 77e1e215 
Dealt to 87a37679 
b14d35ee: raises $0.08 to $0.13
77e1e215: folds
87a37679: folds
Hero: folds
fa716687: folds
33f5621b: folds
Uncalled bet ($0.08) returned to b14d35ee
*** SHOWDOWN ***
b14d35ee collected $0.12 from pot
*** SUMMARY ***
Total pot $0.12 | Rake $0 | Jackpot $0 | Bingo $0 | Fortune $0 | Tax $0
Seat 1: Hero (button) folded before Flop (didn't bet)
Seat 2: fa716687 (small blind) folded before Flop
Seat 3: 33f5621b (big blind) folded before Flop
Seat 4: b14d35ee collected ($0.12)
Seat 5: 77e1e215 folded before Flop (didn't bet)
Seat 6: 87a37679 folded before Flop (didn't bet)


Poker Hand #HD1738836004: Hold'em No Limit ($0.02/$0.05) - 2024/04/20 14:54:24
Table 'NLHBlue13' 6-max Seat #6 is the button
Seat 1: Hero ($7.44 in chips)
Seat 2: fa716687 ($8.19 in chips)
Seat 4: b14d35ee ($13.65 in chips)
Seat 5: 77e1e215 ($5.07 in chips)
Seat 6: 87a37679 ($5 in chips)
Hero: posts small blind $0.02
fa716687: posts big blind $0.05
*** HOLE CARDS ***
Dealt to Hero [2s Qs]
Dealt to fa716687 
Dealt to b14d35ee 
Dealt to 77e1e215 
Dealt to 87a37679 
b14d35ee: folds
77e1e215: raises $0.08 to $0.13
87a37679: folds
Hero: folds
fa716687: calls $0.08
*** FLOP *** [9d 6d Ks]
fa716687: checks
77e1e215: bets $0.1
fa716687: folds
Uncalled bet ($0.1) returned to 77e1e215
*** SHOWDOWN ***
77e1e215 collected $0.27 from pot
*** SUMMARY ***
Total pot $0.28 | Rake $0.01 | Jackpot $0 | Bingo $0 | Fortune $0 | Tax $0
Board [9d 6d Ks]
Seat 1: Hero (small blind) folded before Flop
Seat 2: fa716687 (big blind) folded on the Flop
Seat 4: b14d35ee folded before Flop (didn't bet)
Seat 5: 77e1e215 won ($0.27)
Seat 6: 87a37679 (button) folded before Flop (didn't bet)


Poker Hand #HD1738835978: Hold'em No Limit ($0.02/$0.05) - 2024/04/20 14:54:12
Table 'NLHBlue13' 6-max Seat #5 is the button
Seat 1: Hero ($7.49 in chips)
Seat 2: fa716687 ($8.19 in chips)
Seat 4: b14d35ee ($13.65 in chips)
Seat 5: 77e1e215 ($5 in chips)
Seat 6: 87a37679 ($5.02 in chips)
87a37679: posts small blind $0.02
Hero: posts big blind $0.05
*** HOLE CARDS ***
Dealt to Hero [4h Jd]
Dealt to fa716687 
Dealt to b14d35ee 
Dealt to 77e1e215 
Dealt to 87a37679 
fa716687: folds
b14d35ee: folds
77e1e215: raises $0.05 to $0.1
87a37679: folds
Hero: folds
Uncalled bet ($0.05) returned to 77e1e215
*** SHOWDOWN ***
77e1e215 collected $0.12 from pot
*** SUMMARY ***
Total pot $0.12 | Rake $0 | Jackpot $0 | Bingo $0 | Fortune $0 | Tax $0
Seat 1: Hero (big blind) folded before Flop
Seat 2: fa716687 folded before Flop (didn't bet)
Seat 4: b14d35ee folded before Flop (didn't bet)
Seat 5: 77e1e215 (button) collected ($0.12)
Seat 6: 87a37679 (small blind) folded before Flop


Poker Hand #HD1738835948: Hold'em No Limit ($0.02/$0.05) - 2024/04/20 14:53:58
Table 'NLHBlue13' 6-max Seat #4 is the button
Seat 1: Hero ($7.49 in chips)
Seat 2: fa716687 ($8.19 in chips)
Seat 4: b14d35ee ($13.65 in chips)
Seat 5: 77e1e215 ($4.95 in chips)
Seat 6: 87a37679 ($5.07 in chips)
77e1e215: posts small blind $0.02
87a37679: posts big blind $0.05
*** HOLE CARDS ***
Dealt to Hero [4c 8c]
Dealt to fa716687 
Dealt to b14d35ee 
Dealt to 77e1e215 
Dealt to 87a37679 
Hero: folds
fa716687: folds
b14d35ee: folds
77e1e215: raises $0.05 to $0.1
87a37679: folds
Uncalled bet ($0.05) returned to 77e1e215
*** SHOWDOWN ***
77e1e215 collected $0.1 from pot
*** SUMMARY ***
Total pot $0.1 | Rake $0 | Jackpot $0 | Bingo $0 | Fortune $0 | Tax $0
Seat 1: Hero folded before Flop (didn't bet)
Seat 2: fa716687 folded before Flop (didn't bet)
Seat 4: b14d35ee (button) folded before Flop (didn't bet)
Seat 5: 77e1e215 (small blind) collected ($0.1)
Seat 6: 87a37679 (big blind) folded before Flop


Poker Hand #HD1738835909: Hold'em No Limit ($0.02/$0.05) - 2024/04/20 14:53:41
Table 'NLHBlue13' 6-max Seat #2 is the button
Seat 1: Hero ($7.49 in chips)
Seat 2: fa716687 ($8.12 in chips)
Seat 4: b14d35ee ($13.67 in chips)
Seat 5: 77e1e215 ($5 in chips)
Seat 6: 87a37679 ($5.07 in chips)
b14d35ee: posts small blind $0.02
77e1e215: posts big blind $0.05
*** HOLE CARDS ***
Dealt to Hero [Kd 3c]
Dealt to fa716687 
Dealt to b14d35ee 
Dealt to 77e1e215 
Dealt to 87a37679 
87a37679: folds
Hero: folds
fa716687: raises $0.08 to $0.13
b14d35ee: folds
77e1e215: folds
Uncalled bet ($0.08) returned to fa716687
*** SHOWDOWN ***
fa716687 collected $0.12 from pot
*** SUMMARY ***
Total pot $0.12 | Rake $0 | Jackpot $0 | Bingo $0 | Fortune $0 | Tax $0
Seat 1: Hero folded before Flop (didn't bet)
Seat 2: fa716687 (button) collected ($0.12)
Seat 4: b14d35ee (small blind) folded before Flop
Seat 5: 77e1e215 (big blind) folded before Flop
Seat 6: 87a37679 folded before Flop (didn't bet)


Poker Hand #HD1738835885: Hold'em No Limit ($0.02/$0.05) - 2024/04/20 14:53:26
Table 'NLHBlue13' 6-max Seat #1 is the button
Seat 1: Hero ($7.49 in chips)
Seat 2: fa716687 ($8.07 in chips)
Seat 4: b14d35ee ($13.72 in chips)
Seat 6: 87a37679 ($5.07 in chips)
fa716687: posts small blind $0.02
b14d35ee: posts big blind $0.05
*** HOLE CARDS ***
Dealt to Hero [3h 8s]
Dealt to fa716687 
Dealt to b14d35ee 
Dealt to 87a37679 
87a37679: folds
Hero: folds
fa716687: raises $0.13 to $0.18
b14d35ee: folds
Uncalled bet ($0.13) returned to fa716687
*** SHOWDOWN ***
fa716687 collected $0.1 from pot
*** SUMMARY ***
Total pot $0.1 | Rake $0 | Jackpot $0 | Bingo $0 | Fortune $0 | Tax $0
Seat 1: Hero (button) folded before Flop (didn't bet)
Seat 2: fa716687 (small blind) collected ($0.1)
Seat 4: b14d35ee (big blind) folded before Flop
Seat 6: 87a37679 folded before Flop (didn't bet)


Poker Hand #HD1738835862: Hold'em No Limit ($0.02/$0.05) - 2024/04/20 14:53:15
Table 'NLHBlue13' 6-max Seat #6 is the button
Seat 1: Hero ($7.51 in chips)
Seat 2: fa716687 ($8.12 in chips)
Seat 4: b14d35ee ($13.72 in chips)
Seat 6: 87a37679 ($5 in chips)
Hero: posts small blind $0.02
fa716687: posts big blind $0.05
*** HOLE CARDS ***
Dealt to Hero [6s 7s]
Dealt to fa716687 
Dealt to b14d35ee 
Dealt to 87a37679 
b14d35ee: folds
87a37679: raises $0.08 to $0.13
Hero: folds
fa716687: folds
Uncalled bet ($0.08) returned to 87a37679
*** SHOWDOWN ***
87a37679 collected $0.12 from pot
*** SUMMARY ***
Total pot $0.12 | Rake $0 | Jackpot $0 | Bingo $0 | Fortune $0 | Tax $0
Seat 1: Hero (small blind) folded before Flop
Seat 2: fa716687 (big blind) folded before Flop
Seat 4: b14d35ee folded before Flop (didn't bet)
Seat 6: 87a37679 (button) collected ($0.12)


Poker Hand #HD1738835839: Hold'em No Limit ($0.02/$0.05) - 2024/04/20 14:53:08
Table 'NLHBlue13' 6-max Seat #4 is the button
Seat 1: Hero ($7.56 in chips)
Seat 2: fa716687 ($8.05 in chips)
Seat 4: b14d35ee ($13.72 in chips)
Seat 6: 87a37679 ($5 in chips)
87a37679: posts small blind $0.02
Hero: posts big blind $0.05
*** HOLE CARDS ***
Dealt to Hero [3c Qd]
Dealt to fa716687 
Dealt to b14d35ee 
Dealt to 87a37679 
fa716687: raises $0.08 to $0.13
b14d35ee: folds
87a37679: folds
Hero: folds
Uncalled bet ($0.08) returned to fa716687
*** SHOWDOWN ***
fa716687 collected $0.12 from pot
*** SUMMARY ***
Total pot $0.12 | Rake $0 | Jackpot $0 | Bingo $0 | Fortune $0 | Tax $0
Seat 1: Hero (big blind) folded before Flop
Seat 2: fa716687 collected ($0.12)
Seat 4: b14d35ee (button) folded before Flop (didn't bet)
Seat 6: 87a37679 (small blind) folded before Flop


Poker Hand #HD1738835665: Hold'em No Limit ($0.02/$0.05) - 2024/04/20 14:51:44
Table 'NLHBlue13' 6-max Seat #2 is the button
Seat 1: Hero ($7.56 in chips)
Seat 2: fa716687 ($8.05 in chips)
Seat 3: 7c601d1d ($4.77 in chips)
Seat 4: b14d35ee ($9.47 in chips)
Seat 5: 33cf6203 ($2.04 in chips)
Seat 6: 87a37679 ($5 in chips)
7c601d1d: posts small blind $0.02
b14d35ee: posts big blind $0.05
*** HOLE CARDS ***
Dealt to Hero [5d Jd]
Dealt to fa716687 
Dealt to 7c601d1d 
Dealt to b14d35ee 
Dealt to 33cf6203 
Dealt to 87a37679 
33cf6203: folds
87a37679: folds
Hero: folds
fa716687: folds
7c601d1d: raises $0.1 to $0.15
b14d35ee: raises $0.45 to $0.6
7c601d1d: calls $0.45
*** FLOP *** [6h Kd 9h]
7c601d1d: checks
b14d35ee: bets $0.65
7c601d1d: calls $0.65
*** TURN *** [6h Kd 9h] [2d]
7c601d1d: checks
b14d35ee: bets $1.5
7c601d1d: raises $2.02 to $3.52 and is all-in
b14d35ee: calls $2.02
7c601d1d: shows [Jh Ah] (Ace-High)
b14d35ee: shows [Kc Qc] (Pair of Kings)
*** RIVER *** [6h Kd 9h 2d] [8c]
*** SHOWDOWN ***
b14d35ee collected $9.02 from pot
*** SUMMARY ***
Total pot $9.54 | Rake $0.47 | Jackpot $0.05 | Bingo $0 | Fortune $0 | Tax $0
Board [6h Kd 9h 2d 8c]
Seat 1: Hero folded before Flop (didn't bet)
Seat 2: fa716687 (button) folded before Flop (didn't bet)
Seat 3: 7c601d1d (small blind) showed [Jh Ah] and lost with Ace-High
Seat 4: b14d35ee (big blind) showed [Kc Qc] and won ($9.02) with Pair of Kings
Seat 5: 33cf6203 folded before Flop (didn't bet)
Seat 6: 87a37679 folded before Flop (didn't bet)


Poker Hand #HD1738745621: Hold'em No Limit ($0.02/$0.05) - 2024/04/20 14:51:22
Table 'NLHBlue13' 6-max Seat #1 is the button
Seat 1: Hero ($7.37 in chips)
Seat 2: fa716687 ($8.07 in chips)
Seat 3: 7c601d1d ($4.82 in chips)
Seat 4: b14d35ee ($9.47 in chips)
Seat 6: 87a37679 ($5 in chips)
fa716687: posts small blind $0.02
7c601d1d: posts big blind $0.05
*** HOLE CARDS ***
Dealt to Hero [Kc Qs]
Dealt to fa716687 
Dealt to 7c601d1d 
Dealt to b14d35ee 
Dealt to 87a37679 
b14d35ee: folds
87a37679: raises $0.08 to $0.13
Hero: raises $0.27 to $0.4
fa716687: folds
7c601d1d: folds
87a37679: folds
Uncalled bet ($0.27) returned to Hero
*** SHOWDOWN ***
Hero collected $0.32 from pot
*** SUMMARY ***
Total pot $0.33 | Rake $0.01 | Jackpot $0 | Bingo $0 | Fortune $0 | Tax $0
Seat 1: Hero (button) collected ($0.32)
Seat 2: fa716687 (small blind) folded before Flop
Seat 3: 7c601d1d (big blind) folded before Flop
Seat 4: b14d35ee folded before Flop (didn't bet)
Seat 6: 87a37679 folded before Flop


Poker Hand #HD1738745548: Hold'em No Limit ($0.02/$0.05) - 2024/04/20 14:50:39
Table 'NLHBlue13' 6-max Seat #6 is the button
Seat 1: Hero ($7.23 in chips)
Seat 2: fa716687 ($8.22 in chips)
Seat 3: 7c601d1d ($4.82 in chips)
Seat 4: b14d35ee ($9.47 in chips)
Seat 5: 33cf6203 ($2.04 in chips)
Seat 6: 87a37679 ($5 in chips)
Hero: posts small blind $0.02
fa716687: posts big blind $0.05
*** HOLE CARDS ***
Dealt to Hero [Qs Ac]
Dealt to fa716687 
Dealt to 7c601d1d 
Dealt to b14d35ee 
Dealt to 33cf6203 
Dealt to 87a37679 
7c601d1d: folds
b14d35ee: folds
33cf6203: folds
87a37679: folds
Hero: raises $0.1 to $0.15
fa716687: calls $0.1
*** FLOP *** [7s 3d Qc]
Hero: bets $0.15
fa716687: folds
Uncalled bet ($0.15) returned to Hero
*** SHOWDOWN ***
Hero collected $0.29 from pot
*** SUMMARY ***
Total pot $0.3 | Rake $0.01 | Jackpot $0 | Bingo $0 | Fortune $0 | Tax $0
Board [7s 3d Qc]
Seat 1: Hero (small blind) won ($0.29)
Seat 2: fa716687 (big blind) folded on the Flop
Seat 3: 7c601d1d folded before Flop (didn't bet)
Seat 4: b14d35ee folded before Flop (didn't bet)
Seat 5: 33cf6203 folded before Flop (didn't bet)
Seat 6: 87a37679 (button) folded before Flop (didn't bet)


Poker Hand #HD1738745494: Hold'em No Limit ($0.02/$0.05) - 2024/04/20 14:50:08
Table 'NLHBlue13' 6-max Seat #5 is the button
Seat 1: Hero ($7.21 in chips)
Seat 2: fa716687 ($8.22 in chips)
Seat 3: 7c601d1d ($4.82 in chips)
Seat 4: b14d35ee ($9.47 in chips)
Seat 5: 33cf6203 ($2.04 in chips)
Seat 6: 87a37679 ($5 in chips)
87a37679: posts small blind $0.02
Hero: posts big blind $0.05
*** HOLE CARDS ***
Dealt to Hero [9s 8c]
Dealt to fa716687 
Dealt to 7c601d1d 
Dealt to b14d35ee 
Dealt to 33cf6203 
Dealt to 87a37679 
fa716687: folds
7c601d1d: folds
b14d35ee: folds
33cf6203: folds
87a37679: folds
Uncalled bet ($0.03) returned to Hero
*** SHOWDOWN ***
Hero collected $0.04 from pot
*** SUMMARY ***
Total pot $0.04 | Rake $0 | Jackpot $0 | Bingo $0 | Fortune $0 | Tax $0
Seat 1: Hero (big blind) collected ($0.04)
Seat 2: fa716687 folded before Flop (didn't bet)
Seat 3: 7c601d1d folded before Flop (didn't bet)
Seat 4: b14d35ee folded before Flop (didn't bet)
Seat 5: 33cf6203 (button) folded before Flop (didn't bet)
Seat 6: 87a37679 (small blind) folded before Flop


Poker Hand #HD1738745455: Hold'em No Limit ($0.02/$0.05) - 2024/04/20 14:49:52
Table 'NLHBlue13' 6-max Seat #4 is the button
Seat 1: Hero ($7.21 in chips)
Seat 2: fa716687 ($8.15 in chips)
Seat 3: 7c601d1d ($4.82 in chips)
Seat 4: b14d35ee ($9.47 in chips)
Seat 5: 33cf6203 ($2.06 in chips)
Seat 6: 87a37679 ($5 in chips)
33cf6203: posts small blind $0.02
87a37679: posts big blind $0.05
*** HOLE CARDS ***
Dealt to Hero [6d 9c]
Dealt to fa716687 
Dealt to 7c601d1d 
Dealt to b14d35ee 
Dealt to 33cf6203 
Dealt to 87a37679 
Hero: folds
fa716687: raises $0.08 to $0.13
7c601d1d: folds
b14d35ee: folds
33cf6203: folds
87a37679: folds
Uncalled bet ($0.08) returned to fa716687
*** SHOWDOWN ***
fa716687 collected $0.12 from pot
*** SUMMARY ***
Total pot $0.12 | Rake $0 | Jackpot $0 | Bingo $0 | Fortune $0 | Tax $0
Seat 1: Hero folded before Flop (didn't bet)
Seat 2: fa716687 collected ($0.12)
Seat 3: 7c601d1d folded before Flop (didn't bet)
Seat 4: b14d35ee (button) folded before Flop (didn't bet)
Seat 5: 33cf6203 (small blind) folded before Flop
Seat 6: 87a37679 (big blind) folded before Flop


Poker Hand #HD1738745346: Hold'em No Limit ($0.02/$0.05) - 2024/04/20 14:48:57
Table 'NLHBlue13' 6-max Seat #3 is the button
Seat 1: Hero ($7.21 in chips)
Seat 2: fa716687 ($8.15 in chips)
Seat 3: 7c601d1d ($4.66 in chips)
Seat 4: b14d35ee ($9.49 in chips)
Seat 5: 33cf6203 ($2.21 in chips)
b14d35ee: posts small blind $0.02
33cf6203: posts big blind $0.05
*** HOLE CARDS ***
Dealt to Hero [2d 4s]
Dealt to fa716687 
Dealt to 7c601d1d 
Dealt to b14d35ee 
Dealt to 33cf6203 
Hero: folds
fa716687: folds
7c601d1d: raises $0.1 to $0.15
b14d35ee: folds
33cf6203: calls $0.1
*** FLOP *** [8d Qc 7h]
33cf6203: checks
7c601d1d: bets $0.32
33cf6203: folds
Uncalled bet ($0.32) returned to 7c601d1d
*** SHOWDOWN ***
7c601d1d collected $0.31 from pot
*** SUMMARY ***
Total pot $0.32 | Rake $0.01 | Jackpot $0 | Bingo $0 | Fortune $0 | Tax $0
Board [8d Qc 7h]
Seat 1: Hero folded before Flop (didn't bet)
Seat 2: fa716687 folded before Flop (didn't bet)
Seat 3: 7c601d1d (button) won ($0.31)
Seat 4: b14d35ee (small blind) folded before Flop
Seat 5: 33cf6203 (big blind) folded on the Flop


Poker Hand #HD1738745286: Hold'em No Limit ($0.02/$0.05) - 2024/04/20 14:48:29
Table 'NLHBlue13' 6-max Seat #2 is the button
Seat 1: Hero ($7.21 in chips)
Seat 2: fa716687 ($7.91 in chips)
Seat 3: 7c601d1d ($4.79 in chips)
Seat 4: b14d35ee ($9.62 in chips)
Seat 5: 33cf6203 ($2.21 in chips)
7c601d1d: posts small blind $0.02
b14d35ee: posts big blind $0.05
*** HOLE CARDS ***
Dealt to Hero [4d 5s]
Dealt to fa716687 
Dealt to 7c601d1d 
Dealt to b14d35ee 
Dealt to 33cf6203 
33cf6203: folds
Hero: folds
fa716687: raises $0.08 to $0.13
7c601d1d: calls $0.11
b14d35ee: calls $0.08
*** FLOP *** [Ah Tc 8s]
7c601d1d: checks
b14d35ee: checks
fa716687: bets $0.13
7c601d1d: folds
b14d35ee: folds
Uncalled bet ($0.13) returned to fa716687
*** SHOWDOWN ***
fa716687 collected $0.37 from pot
*** SUMMARY ***
Total pot $0.39 | Rake $0.02 | Jackpot $0 | Bingo $0 | Fortune $0 | Tax $0
Board [Ah Tc 8s]
Seat 1: Hero folded before Flop (didn't bet)
Seat 2: fa716687 (button) won ($0.37)
Seat 3: 7c601d1d (small blind) folded on the Flop
Seat 4: b14d35ee (big blind) folded on the Flop
Seat 5: 33cf6203 folded before Flop (didn't bet)


Poker Hand #HD1738745259: Hold'em No Limit ($0.02/$0.05) - 2024/04/20 14:48:15
Table 'NLHBlue13' 6-max Seat #1 is the button
Seat 1: Hero ($7.21 in chips)
Seat 2: fa716687 ($7.93 in chips)
Seat 3: 7c601d1d ($4.77 in chips)
Seat 4: b14d35ee ($9.62 in chips)
Seat 5: 33cf6203 ($2.21 in chips)
fa716687: posts small blind $0.02
7c601d1d: posts big blind $0.05
*** HOLE CARDS ***
Dealt to Hero [2c 3d]
Dealt to fa716687 
Dealt to 7c601d1d 
Dealt to b14d35ee 
Dealt to 33cf6203 
b14d35ee: folds
33cf6203: folds
Hero: folds
fa716687: folds
Uncalled bet ($0.03) returned to 7c601d1d
*** SHOWDOWN ***
7c601d1d collected $0.04 from pot
*** SUMMARY ***
Total pot $0.04 | Rake $0 | Jackpot $0 | Bingo $0 | Fortune $0 | Tax $0
Seat 1: Hero (button) folded before Flop (didn't bet)
Seat 2: fa716687 (small blind) folded before Flop
Seat 3: 7c601d1d (big blind) collected ($0.04)
Seat 4: b14d35ee folded before Flop (didn't bet)
Seat 5: 33cf6203 folded before Flop (didn't bet)


Poker Hand #HD1738745176: Hold'em No Limit ($0.02/$0.05) - 2024/04/20 14:47:31
Table 'NLHBlue13' 6-max Seat #5 is the button
Seat 1: Hero ($7.23 in chips)
Seat 2: fa716687 ($8.03 in chips)
Seat 3: 7c601d1d ($4.77 in chips)
Seat 4: b14d35ee ($9.62 in chips)
Seat 5: 33cf6203 ($2.1 in chips)
Hero: posts small blind $0.02
fa716687: posts big blind $0.05
*** HOLE CARDS ***
Dealt to Hero [6h Ks]
Dealt to fa716687 
Dealt to 7c601d1d 
Dealt to b14d35ee 
Dealt to 33cf6203 
7c601d1d: folds
b14d35ee: folds
33cf6203: raises $0.05 to $0.1
Hero: folds
fa716687: calls $0.05
*** FLOP *** [5h Kd 3h]
fa716687: checks
33cf6203: checks
*** TURN *** [5h Kd 3h] [Th]
fa716687: checks
33cf6203: bets $0.08
fa716687: folds
Uncalled bet ($0.08) returned to 33cf6203
*** SHOWDOWN ***
33cf6203 collected $0.21 from pot
*** SUMMARY ***
Total pot $0.22 | Rake $0.01 | Jackpot $0 | Bingo $0 | Fortune $0 | Tax $0
Board [5h Kd 3h Th]
Seat 1: Hero (small blind) folded before Flop
Seat 2: fa716687 (big blind) folded on the Turn
Seat 3: 7c601d1d folded before Flop (didn't bet)
Seat 4: b14d35ee folded before Flop (didn't bet)
Seat 5: 33cf6203 (button) won ($0.21)


Poker Hand #HD1738744975: Hold'em No Limit ($0.02/$0.05) - 2024/04/20 14:45:51
Table 'NLHBlue13' 6-max Seat #4 is the button
Seat 1: Hero ($7.28 in chips)
Seat 2: fa716687 ($8.03 in chips)
Seat 3: 7c601d1d ($4.77 in chips)
Seat 4: b14d35ee ($7.43 in chips)
Seat 5: 33cf6203 ($4.53 in chips)
33cf6203: posts small blind $0.02
Hero: posts big blind $0.05
*** HOLE CARDS ***
Dealt to Hero [Qs 3h]
Dealt to fa716687 
Dealt to 7c601d1d 
Dealt to b14d35ee 
Dealt to 33cf6203 
fa716687: folds
7c601d1d: folds
b14d35ee: raises $0.08 to $0.13
33cf6203: raises $0.16 to $0.29
Hero: folds
b14d35ee: calls $0.16
*** FLOP *** [Kd Js 2d]
33cf6203: bets $0.21
b14d35ee: calls $0.21
*** TURN *** [Kd Js 2d] [Qd]
33cf6203: bets $0.53
b14d35ee: calls $0.53
*** RIVER *** [Kd Js 2d Qd] [Jh]
33cf6203: bets $0.7
b14d35ee: raises $0.7 to $1.4
33cf6203: calls $0.7
b14d35ee: shows [Ad 8d] (Ace High Flush)
33cf6203: shows [Ah Jc] (Three Jacks)
*** SHOWDOWN ***
b14d35ee collected $4.62 from pot
*** SUMMARY ***
Total pot $4.91 | Rake $0.24 | Jackpot $0.05 | Bingo $0 | Fortune $0 | Tax $0
Board [Kd Js 2d Qd Jh]
Seat 1: Hero (big blind) folded before Flop
Seat 2: fa716687 folded before Flop (didn't bet)
Seat 3: 7c601d1d folded before Flop (didn't bet)
Seat 4: b14d35ee (button) showed [Ad 8d] and won ($4.62) with Ace High Flush
Seat 5: 33cf6203 (small blind) showed [Ah Jc] and lost with Three Jacks


Poker Hand #HD1738744901: Hold'em No Limit ($0.02/$0.05) - 2024/04/20 14:45:15
Table 'NLHBlue13' 6-max Seat #3 is the button
Seat 1: Hero ($7.28 in chips)
Seat 2: fa716687 ($8.03 in chips)
Seat 3: 7c601d1d ($4.92 in chips)
Seat 4: b14d35ee ($7.24 in chips)
Seat 5: 33cf6203 ($4.58 in chips)
Seat 6: 87a37679 ($5 in chips)
b14d35ee: posts small blind $0.02
33cf6203: posts big blind $0.05
*** HOLE CARDS ***
Dealt to Hero [Th 3d]
Dealt to fa716687 
Dealt to 7c601d1d 
Dealt to b14d35ee 
Dealt to 33cf6203 
Dealt to 87a37679 
87a37679: folds
Hero: folds
fa716687: folds
7c601d1d: raises $0.1 to $0.15
b14d35ee: raises $0.45 to $0.6
33cf6203: folds
7c601d1d: folds
Uncalled bet ($0.45) returned to b14d35ee
*** SHOWDOWN ***
b14d35ee collected $0.34 from pot
*** SUMMARY ***
Total pot $0.35 | Rake $0.01 | Jackpot $0 | Bingo $0 | Fortune $0 | Tax $0
Seat 1: Hero folded before Flop (didn't bet)
Seat 2: fa716687 folded before Flop (didn't bet)
Seat 3: 7c601d1d (button) folded before Flop
Seat 4: b14d35ee (small blind) collected ($0.34)
Seat 5: 33cf6203 (big blind) folded before Flop
Seat 6: 87a37679 folded before Flop (didn't bet)


Poker Hand #HD1738744848: Hold'em No Limit ($0.02/$0.05) - 2024/04/20 14:44:49
Table 'NLHBlue13' 6-max Seat #2 is the button
Seat 1: Hero ($7.28 in chips)
Seat 2: fa716687 ($8.03 in chips)
Seat 3: 7c601d1d ($4.87 in chips)
Seat 4: b14d35ee ($7.29 in chips)
Seat 5: 33cf6203 ($4.58 in chips)
Seat 6: 87a37679 ($5 in chips)
7c601d1d: posts small blind $0.02
b14d35ee: posts big blind $0.05
*** HOLE CARDS ***
Dealt to Hero [6c Kc]
Dealt to fa716687 
Dealt to 7c601d1d 
Dealt to b14d35ee 
Dealt to 33cf6203 
Dealt to 87a37679 
33cf6203: folds
87a37679: folds
Hero: folds
fa716687: folds
7c601d1d: raises $0.1 to $0.15
b14d35ee: folds
Uncalled bet ($0.1) returned to 7c601d1d
*** SHOWDOWN ***
7c601d1d collected $0.1 from pot
*** SUMMARY ***
Total pot $0.1 | Rake $0 | Jackpot $0 | Bingo $0 | Fortune $0 | Tax $0
Seat 1: Hero folded before Flop (didn't bet)
Seat 2: fa716687 (button) folded before Flop (didn't bet)
Seat 3: 7c601d1d (small blind) collected ($0.1)
Seat 4: b14d35ee (big blind) folded before Flop
Seat 5: 33cf6203 folded before Flop (didn't bet)
Seat 6: 87a37679 folded before Flop (didn't bet)


Poker Hand #HD1738744753: Hold'em No Limit ($0.02/$0.05) - 2024/04/20 14:44:03
Table 'NLHBlue13' 6-max Seat #1 is the button
Seat 1: Hero ($7.28 in chips)
Seat 2: fa716687 ($8.05 in chips)
Seat 3: 7c601d1d ($5 in chips)
Seat 4: b14d35ee ($7.29 in chips)
Seat 5: 33cf6203 ($4.32 in chips)
Seat 6: 87a37679 ($5 in chips)
fa716687: posts small blind $0.02
7c601d1d: posts big blind $0.05
*** HOLE CARDS ***
Dealt to Hero [3c Qd]
Dealt to fa716687 
Dealt to 7c601d1d 
Dealt to b14d35ee 
Dealt to 33cf6203 
Dealt to 87a37679 
b14d35ee: folds
33cf6203: raises $0.08 to $0.13
87a37679: calls $0.13
Hero: folds
fa716687: folds
7c601d1d: calls $0.08
*** FLOP *** [4h 6s 9d]
7c601d1d: checks
33cf6203: checks
87a37679: checks
*** TURN *** [4h 6s 9d] [Td]
7c601d1d: checks
33cf6203: bets $0.14
87a37679: folds
7c601d1d: folds
Uncalled bet ($0.14) returned to 33cf6203
*** SHOWDOWN ***
33cf6203 collected $0.39 from pot
*** SUMMARY ***
Total pot $0.41 | Rake $0.02 | Jackpot $0 | Bingo $0 | Fortune $0 | Tax $0
Board [4h 6s 9d Td]
Seat 1: Hero (button) folded before Flop (didn't bet)
Seat 2: fa716687 (small blind) folded before Flop
Seat 3: 7c601d1d (big blind) folded on the Turn
Seat 4: b14d35ee folded before Flop (didn't bet)
Seat 5: 33cf6203 won ($0.39)
Seat 6: 87a37679 folded on the Turn


Poker Hand #HD1738744720: Hold'em No Limit ($0.02/$0.05) - 2024/04/20 14:43:47
Table 'NLHBlue13' 6-max Seat #6 is the button
Seat 1: Hero ($7.23 in chips)
Seat 2: fa716687 ($8.1 in chips)
Seat 4: b14d35ee ($7.29 in chips)
Seat 5: 33cf6203 ($4.32 in chips)
Seat 6: 87a37679 ($5 in chips)
Hero: posts small blind $0.02
fa716687: posts big blind $0.05
*** HOLE CARDS ***
Dealt to Hero [Ac 8d]
Dealt to fa716687 
Dealt to b14d35ee 
Dealt to 33cf6203 
Dealt to 87a37679 
b14d35ee: folds
33cf6203: folds
87a37679: folds
Hero: raises $0.1 to $0.15
fa716687: folds
Uncalled bet ($0.1) returned to Hero
*** SHOWDOWN ***
Hero collected $0.1 from pot
*** SUMMARY ***
Total pot $0.1 | Rake $0 | Jackpot $0 | Bingo $0 | Fortune $0 | Tax $0
Seat 1: Hero (small blind) collected ($0.1)
Seat 2: fa716687 (big blind) folded before Flop
Seat 4: b14d35ee folded before Flop (didn't bet)
Seat 5: 33cf6203 folded before Flop (didn't bet)
Seat 6: 87a37679 (button) folded before Flop (didn't bet)


Poker Hand #HD1738744564: Hold'em No Limit ($0.02/$0.05) - 2024/04/20 14:42:31
Table 'NLHBlue13' 6-max Seat #5 is the button
Seat 1: Hero ($7.28 in chips)
Seat 2: fa716687 ($8.1 in chips)
Seat 3: 9d71d622 ($4.74 in chips)
Seat 4: b14d35ee ($7.29 in chips)
Seat 5: 33cf6203 ($3.55 in chips)
Seat 6: 87a37679 ($5 in chips)
87a37679: posts small blind $0.02
Hero: posts big blind $0.05
*** HOLE CARDS ***
Dealt to Hero [7s 9c]
Dealt to fa716687 
Dealt to 9d71d622 
Dealt to b14d35ee 
Dealt to 33cf6203 
Dealt to 87a37679 
fa716687: folds
9d71d622: calls $0.05
b14d35ee: folds
33cf6203: raises $0.05 to $0.1
87a37679: raises $0.3 to $0.4
Hero: folds
9d71d622: folds
33cf6203: calls $0.3
*** FLOP *** [7d 5c Jd]
87a37679: bets $0.4
33cf6203: raises $0.85 to $1.25
87a37679: folds
Uncalled bet ($0.85) returned to 33cf6203
*** SHOWDOWN ***
33cf6203 collected $1.57 from pot
*** SUMMARY ***
Total pot $1.7 | Rake $0.08 | Jackpot $0.05 | Bingo $0 | Fortune $0 | Tax $0
Board [7d 5c Jd]
Seat 1: Hero (big blind) folded before Flop
Seat 2: fa716687 folded before Flop (didn't bet)
Seat 3: 9d71d622 folded before Flop
Seat 4: b14d35ee folded before Flop (didn't bet)
Seat 5: 33cf6203 (button) won ($1.57)
Seat 6: 87a37679 (small blind) folded on the Flop


Poker Hand #HD1738744483: Hold'em No Limit ($0.02/$0.05) - 2024/04/20 14:41:51
Table 'NLHBlue13' 6-max Seat #4 is the button
Seat 1: Hero ($7.28 in chips)
Seat 2: fa716687 ($8.23 in chips)
Seat 3: 9d71d622 ($4.55 in chips)
Seat 4: b14d35ee ($7.29 in chips)
Seat 5: 33cf6203 ($3.57 in chips)
Seat 6: 87a37679 ($5 in chips)
33cf6203: posts small blind $0.02
87a37679: posts big blind $0.05
*** HOLE CARDS ***
Dealt to Hero [5d Qs]
Dealt to fa716687 
Dealt to 9d71d622 
Dealt to b14d35ee 
Dealt to 33cf6203 
Dealt to 87a37679 
Hero: folds
fa716687: raises $0.08 to $0.13
9d71d622: calls $0.13
b14d35ee: folds
33cf6203: folds
87a37679: folds
*** FLOP *** [2s 8s Kh]
fa716687: checks
9d71d622: bets $0.11
fa716687: folds
Uncalled bet ($0.11) returned to 9d71d622
*** SHOWDOWN ***
9d71d622 collected $0.32 from pot
*** SUMMARY ***
Total pot $0.33 | Rake $0.01 | Jackpot $0 | Bingo $0 | Fortune $0 | Tax $0
Board [2s 8s Kh]
Seat 1: Hero folded before Flop (didn't bet)
Seat 2: fa716687 folded on the Flop
Seat 3: 9d71d622 won ($0.32)
Seat 4: b14d35ee (button) folded before Flop (didn't bet)
Seat 5: 33cf6203 (small blind) folded before Flop
Seat 6: 87a37679 (big blind) folded before Flop


Poker Hand #HD1738744452: Hold'em No Limit ($0.02/$0.05) - 2024/04/20 14:41:41
Table 'NLHBlue13' 6-max Seat #3 is the button
Seat 1: Hero ($7.28 in chips)
Seat 2: fa716687 ($8.23 in chips)
Seat 3: 9d71d622 ($4.55 in chips)
Seat 4: b14d35ee ($7.31 in chips)
Seat 5: 33cf6203 ($3.55 in chips)
b14d35ee: posts small blind $0.02
33cf6203: posts big blind $0.05
*** HOLE CARDS ***
Dealt to Hero [2h Jc]
Dealt to fa716687 
Dealt to 9d71d622 
Dealt to b14d35ee 
Dealt to 33cf6203 
Hero: folds
fa716687: folds
9d71d622: folds
b14d35ee: folds
Uncalled bet ($0.03) returned to 33cf6203
*** SHOWDOWN ***
33cf6203 collected $0.04 from pot
*** SUMMARY ***
Total pot $0.04 | Rake $0 | Jackpot $0 | Bingo $0 | Fortune $0 | Tax $0
Seat 1: Hero folded before Flop (didn't bet)
Seat 2: fa716687 folded before Flop (didn't bet)
Seat 3: 9d71d622 (button) folded before Flop (didn't bet)
Seat 4: b14d35ee (small blind) folded before Flop
Seat 5: 33cf6203 (big blind) collected ($0.04)


Poker Hand #HD1738744426: Hold'em No Limit ($0.02/$0.05) - 2024/04/20 14:41:30
Table 'NLHBlue13' 6-max Seat #2 is the button
Seat 1: Hero ($7.28 in chips)
Seat 2: fa716687 ($8.23 in chips)
Seat 3: 9d71d622 ($4.5 in chips)
Seat 4: b14d35ee ($7.36 in chips)
Seat 5: 33cf6203 ($3.55 in chips)
9d71d622: posts small blind $0.02
b14d35ee: posts big blind $0.05
*** HOLE CARDS ***
Dealt to Hero [6c Jd]
Dealt to fa716687 
Dealt to 9d71d622 
Dealt to b14d35ee 
Dealt to 33cf6203 
33cf6203: folds
Hero: folds
fa716687: folds
9d71d622: raises $0.1 to $0.15
b14d35ee: folds
Uncalled bet ($0.1) returned to 9d71d622
*** SHOWDOWN ***
9d71d622 collected $0.1 from pot
*** SUMMARY ***
Total pot $0.1 | Rake $0 | Jackpot $0 | Bingo $0 | Fortune $0 | Tax $0
Seat 1: Hero folded before Flop (didn't bet)
Seat 2: fa716687 (button) folded before Flop (didn't bet)
Seat 3: 9d71d622 (small blind) collected ($0.1)
Seat 4: b14d35ee (big blind) folded before Flop
Seat 5: 33cf6203 folded before Flop (didn't bet)


Poker Hand #HD1738744406: Hold'em No Limit ($0.02/$0.05) - 2024/04/20 14:41:18
Table 'NLHBlue13' 6-max Seat #1 is the button
Seat 1: Hero ($7.21 in chips)
Seat 2: fa716687 ($8.25 in chips)
Seat 3: 9d71d622 ($4.55 in chips)
Seat 4: b14d35ee ($7.36 in chips)
Seat 5: 33cf6203 ($3.55 in chips)
fa716687: posts small blind $0.02
9d71d622: posts big blind $0.05
*** HOLE CARDS ***
Dealt to Hero [8h Th]
Dealt to fa716687 
Dealt to 9d71d622 
Dealt to b14d35ee 
Dealt to 33cf6203 
b14d35ee: folds
33cf6203: folds
Hero: raises $0.07 to $0.12
fa716687: folds
9d71d622: folds
Uncalled bet ($0.07) returned to Hero
*** SHOWDOWN ***
Hero collected $0.12 from pot
*** SUMMARY ***
Total pot $0.12 | Rake $0 | Jackpot $0 | Bingo $0 | Fortune $0 | Tax $0
Seat 1: Hero (button) collected ($0.12)
Seat 2: fa716687 (small blind) folded before Flop
Seat 3: 9d71d622 (big blind) folded before Flop
Seat 4: b14d35ee folded before Flop (didn't bet)
Seat 5: 33cf6203 folded before Flop (didn't bet)


Poker Hand #HD1738744315: Hold'em No Limit ($0.02/$0.05) - 2024/04/20 14:40:33
Table 'NLHBlue13' 6-max Seat #5 is the button
Seat 1: Hero ($7.26 in chips)
Seat 2: fa716687 ($8.25 in chips)
Seat 3: 9d71d622 ($5 in chips)
Seat 4: b14d35ee ($6.88 in chips)
Seat 5: 33cf6203 ($3.55 in chips)
Seat 6: 6fa75dc0 ($5.03 in chips)
6fa75dc0: posts small blind $0.02
Hero: posts big blind $0.05
*** HOLE CARDS ***
Dealt to Hero [6d 3h]
Dealt to fa716687 
Dealt to 9d71d622 
Dealt to b14d35ee 
Dealt to 33cf6203 
Dealt to 6fa75dc0 
fa716687: folds
9d71d622: raises $0.1 to $0.15
b14d35ee: raises $0.3 to $0.45
33cf6203: folds
6fa75dc0: folds
Hero: folds
9d71d622: calls $0.3
*** FLOP *** [7s Td 6c]
9d71d622: checks
b14d35ee: bets $0.25
9d71d622: folds
Uncalled bet ($0.25) returned to b14d35ee
*** SHOWDOWN ***
b14d35ee collected $0.93 from pot
*** SUMMARY ***
Total pot $0.97 | Rake $0.04 | Jackpot $0 | Bingo $0 | Fortune $0 | Tax $0
Board [7s Td 6c]
Seat 1: Hero (big blind) folded before Flop
Seat 2: fa716687 folded before Flop (didn't bet)
Seat 3: 9d71d622 folded on the Flop
Seat 4: b14d35ee won ($0.93)
Seat 5: 33cf6203 (button) folded before Flop (didn't bet)
Seat 6: 6fa75dc0 (small blind) folded before Flop


Poker Hand #HD1738744222: Hold'em No Limit ($0.02/$0.05) - 2024/04/20 14:39:39
Table 'NLHBlue13' 6-max Seat #4 is the button
Seat 1: Hero ($7.26 in chips)
Seat 2: fa716687 ($7.28 in chips)
Seat 4: b14d35ee ($6.88 in chips)
Seat 5: 33cf6203 ($3.57 in chips)
Seat 6: 6fa75dc0 ($6.14 in chips)
33cf6203: posts small blind $0.02
6fa75dc0: posts big blind $0.05
*** HOLE CARDS ***
Dealt to Hero [Qd 3c]
Dealt to fa716687 
Dealt to b14d35ee 
Dealt to 33cf6203 
Dealt to 6fa75dc0 
Hero: folds
fa716687: raises $0.08 to $0.13
b14d35ee: folds
33cf6203: folds
6fa75dc0: raises $0.14 to $0.27
fa716687: calls $0.14
*** FLOP *** [8c Kc 5h]
6fa75dc0: checks
fa716687: bets $0.39
6fa75dc0: raises $0.45 to $0.84
fa716687: raises $6.17 to $7.01 and is all-in
6fa75dc0: folds
Uncalled bet ($6.17) returned to fa716687
*** SHOWDOWN ***
fa716687 collected $2.08 from pot
*** SUMMARY ***
Total pot $2.24 | Rake $0.11 | Jackpot $0.05 | Bingo $0 | Fortune $0 | Tax $0
Board [8c Kc 5h]
Seat 1: Hero folded before Flop (didn't bet)
Seat 2: fa716687 won ($2.08)
Seat 4: b14d35ee (button) folded before Flop (didn't bet)
Seat 5: 33cf6203 (small blind) folded before Flop
Seat 6: 6fa75dc0 (big blind) folded on the Flop


Poker Hand #HD1738744115: Hold'em No Limit ($0.02/$0.05) - 2024/04/20 14:38:45
Table 'NLHBlue13' 6-max Seat #2 is the button
Seat 1: Hero ($7.26 in chips)
Seat 2: fa716687 ($7.28 in chips)
Seat 3: 9d71d622 ($1.85 in chips)
Seat 4: b14d35ee ($6.93 in chips)
Seat 5: 33cf6203 ($3.57 in chips)
Seat 6: 6fa75dc0 ($4.47 in chips)
9d71d622: posts small blind $0.02
b14d35ee: posts big blind $0.05
*** HOLE CARDS ***
Dealt to Hero [4c 5s]
Dealt to fa716687 
Dealt to 9d71d622 
Dealt to b14d35ee 
Dealt to 33cf6203 
Dealt to 6fa75dc0 
33cf6203: folds
6fa75dc0: raises $0.1 to $0.15
Hero: folds
fa716687: folds
9d71d622: raises $0.18 to $0.33
b14d35ee: folds
6fa75dc0: calls $0.18
*** FLOP *** [Jh Ac 9h]
9d71d622: bets $1.52 and is all-in
6fa75dc0: calls $1.52
9d71d622: shows [8c 8h] (Pair of Eights)
6fa75dc0: shows [Th Td] (Pair of Tens)
*** TURN *** [Jh Ac 9h] [2h]
*** RIVER *** [Jh Ac 9h 2h] [Kh]
*** SHOWDOWN ***
6fa75dc0 collected $3.52 from pot
*** SUMMARY ***
Total pot $3.75 | Rake $0.18 | Jackpot $0.05 | Bingo $0 | Fortune $0 | Tax $0
Board [Jh Ac 9h 2h Kh]
Seat 1: Hero folded before Flop (didn't bet)
Seat 2: fa716687 (button) folded before Flop (didn't bet)
Seat 3: 9d71d622 (small blind) showed [8c 8h] and lost with King High Flush
Seat 4: b14d35ee (big blind) folded before Flop
Seat 5: 33cf6203 folded before Flop (didn't bet)
Seat 6: 6fa75dc0 showed [Th Td] and won ($3.52) with King High Flush


Poker Hand #HD1738743927: Hold'em No Limit ($0.02/$0.05) - 2024/04/20 14:37:01
Table 'NLHBlue13' 6-max Seat #1 is the button
Seat 1: Hero ($7.26 in chips)
Seat 2: fa716687 ($5.04 in chips)
Seat 3: 9d71d622 ($1.98 in chips)
Seat 4: b14d35ee ($6.93 in chips)
Seat 5: 33cf6203 ($5.97 in chips)
Seat 6: 6fa75dc0 ($4.47 in chips)
fa716687: posts small blind $0.02
9d71d622: posts big blind $0.05
*** HOLE CARDS ***
Dealt to Hero [3c Ks]
Dealt to fa716687 
Dealt to 9d71d622 
Dealt to b14d35ee 
Dealt to 33cf6203 
Dealt to 6fa75dc0 
b14d35ee: folds
33cf6203: raises $0.08 to $0.13
6fa75dc0: folds
Hero: folds
fa716687: calls $0.11
9d71d622: calls $0.08
*** FLOP *** [7s Kd Jd]
fa716687: checks
9d71d622: checks
33cf6203: checks
*** TURN *** [7s Kd Jd] [Qh]
fa716687: bets $0.27
9d71d622: folds
33cf6203: calls $0.27
*** RIVER *** [7s Kd Jd Qh] [5c]
fa716687: bets $0.52
33cf6203: raises $1.48 to $2
fa716687: calls $1.48
33cf6203: shows [Jh Kc] (Pair of Kings and Pair of Jacks)
fa716687: shows [Td 9d] (Kings-High Straight)
*** SHOWDOWN ***
fa716687 collected $4.64 from pot
*** SUMMARY ***
Total pot $4.93 | Rake $0.24 | Jackpot $0.05 | Bingo $0 | Fortune $0 | Tax $0
Board [7s Kd Jd Qh 5c]
Seat 1: Hero (button) folded before Flop (didn't bet)
Seat 2: fa716687 (small blind) showed [Td 9d] and won ($4.64) with Kings-High Straight
Seat 3: 9d71d622 (big blind) folded on the Turn
Seat 4: b14d35ee folded before Flop (didn't bet)
Seat 5: 33cf6203 showed [Jh Kc] and lost with Pair of Kings and Pair of Jacks
Seat 6: 6fa75dc0 folded before Flop (didn't bet)


Poker Hand #HD1738743911: Hold'em No Limit ($0.02/$0.05) - 2024/04/20 14:36:47
Table 'NLHBlue13' 6-max Seat #6 is the button
Seat 1: Hero ($7.28 in chips)
Seat 2: fa716687 ($5.09 in chips)
Seat 3: 9d71d622 ($1.98 in chips)
Seat 4: b14d35ee ($6.86 in chips)
Seat 5: 33cf6203 ($5.97 in chips)
Seat 6: 6fa75dc0 ($4.47 in chips)
Hero: posts small blind $0.02
fa716687: posts big blind $0.05
*** HOLE CARDS ***
Dealt to Hero [8d Ac]
Dealt to fa716687 
Dealt to 9d71d622 
Dealt to b14d35ee 
Dealt to 33cf6203 
Dealt to 6fa75dc0 
9d71d622: folds
b14d35ee: raises $0.08 to $0.13
33cf6203: folds
6fa75dc0: folds
Hero: folds
fa716687: folds
Uncalled bet ($0.08) returned to b14d35ee
*** SHOWDOWN ***
b14d35ee collected $0.12 from pot
*** SUMMARY ***
Total pot $0.12 | Rake $0 | Jackpot $0 | Bingo $0 | Fortune $0 | Tax $0
Seat 1: Hero (small blind) folded before Flop
Seat 2: fa716687 (big blind) folded before Flop
Seat 3: 9d71d622 folded before Flop (didn't bet)
Seat 4: b14d35ee collected ($0.12)
Seat 5: 33cf6203 folded before Flop (didn't bet)
Seat 6: 6fa75dc0 (button) folded before Flop (didn't bet)


Poker Hand #HD1738743798: Hold'em No Limit ($0.02/$0.05) - 2024/04/20 14:35:35
Table 'NLHBlue13' 6-max Seat #5 is the button
Seat 1: Hero ($7.33 in chips)
Seat 2: fa716687 ($5.22 in chips)
Seat 3: 9d71d622 ($1.98 in chips)
Seat 4: b14d35ee ($6.86 in chips)
Seat 5: 33cf6203 ($5.97 in chips)
Seat 6: 6fa75dc0 ($4.3 in chips)
6fa75dc0: posts small blind $0.02
Hero: posts big blind $0.05
*** HOLE CARDS ***
Dealt to Hero [3s 7d]
Dealt to fa716687 
Dealt to 9d71d622 
Dealt to b14d35ee 
Dealt to 33cf6203 
Dealt to 6fa75dc0 
fa716687: raises $0.08 to $0.13
9d71d622: folds
b14d35ee: folds
33cf6203: folds
6fa75dc0: calls $0.11
Hero: folds
*** FLOP *** [6c 5d Ac]
6fa75dc0: checks
fa716687: checks
*** TURN *** [6c 5d Ac] [3c]
6fa75dc0: checks
fa716687: checks
*** RIVER *** [6c 5d Ac 3c] [Kh]
6fa75dc0: checks
fa716687: checks
6fa75dc0: shows [8s 6s] (Pair of Sixes)
fa716687: shows [2d 2h] (Pair of Twos)
*** SHOWDOWN ***
6fa75dc0 collected $0.3 from pot
*** SUMMARY ***
Total pot $0.31 | Rake $0.01 | Jackpot $0 | Bingo $0 | Fortune $0 | Tax $0
Board [6c 5d Ac 3c Kh]
Seat 1: Hero (big blind) folded before Flop
Seat 2: fa716687 showed [2d 2h] and lost with Pair of Twos
Seat 3: 9d71d622 folded before Flop (didn't bet)
Seat 4: b14d35ee folded before Flop (didn't bet)
Seat 5: 33cf6203 (button) folded before Flop (didn't bet)
Seat 6: 6fa75dc0 (small blind) showed [8s 6s] and won ($0.3) with Pair of Sixes


Poker Hand #HD1738743677: Hold'em No Limit ($0.02/$0.05) - 2024/04/20 14:34:29
Table 'NLHBlue13' 6-max Seat #4 is the button
Seat 1: Hero ($7.33 in chips)
Seat 2: fa716687 ($5.35 in chips)
Seat 3: 9d71d622 ($2.11 in chips)
Seat 4: b14d35ee ($6.86 in chips)
Seat 5: 33cf6203 ($5.68 in chips)
Seat 6: 6fa75dc0 ($4.35 in chips)
33cf6203: posts small blind $0.02
6fa75dc0: posts big blind $0.05
*** HOLE CARDS ***
Dealt to Hero [8c 3c]
Dealt to fa716687 
Dealt to 9d71d622 
Dealt to b14d35ee 
Dealt to 33cf6203 
Dealt to 6fa75dc0 
Hero: folds
fa716687: raises $0.08 to $0.13
9d71d622: calls $0.13
b14d35ee: folds
33cf6203: calls $0.11
6fa75dc0: folds
*** FLOP *** [5h 8h 2s]
33cf6203: checks
fa716687: checks
9d71d622: checks
*** TURN *** [5h 8h 2s] [4h]
33cf6203: bets $0.15
fa716687: folds
9d71d622: folds
Uncalled bet ($0.15) returned to 33cf6203
*** SHOWDOWN ***
33cf6203 collected $0.42 from pot
*** SUMMARY ***
Total pot $0.44 | Rake $0.02 | Jackpot $0 | Bingo $0 | Fortune $0 | Tax $0
Board [5h 8h 2s 4h]
Seat 1: Hero folded before Flop (didn't bet)
Seat 2: fa716687 folded on the Turn
Seat 3: 9d71d622 folded on the Turn
Seat 4: b14d35ee (button) folded before Flop (didn't bet)
Seat 5: 33cf6203 (small blind) won ($0.42)
Seat 6: 6fa75dc0 (big blind) folded before Flop


Poker Hand #HD1738743527: Hold'em No Limit ($0.02/$0.05) - 2024/04/20 14:33:04
Table 'NLHBlue13' 6-max Seat #3 is the button
Seat 1: Hero ($7.33 in chips)
Seat 2: fa716687 ($5.35 in chips)
Seat 3: 9d71d622 ($2.16 in chips)
Seat 4: b14d35ee ($7.51 in chips)
Seat 5: 33cf6203 ($5 in chips)
Seat 6: 6fa75dc0 ($4.4 in chips)
b14d35ee: posts small blind $0.02
33cf6203: posts big blind $0.05
*** HOLE CARDS ***
Dealt to Hero [3c Qh]
Dealt to fa716687 
Dealt to 9d71d622 
Dealt to b14d35ee 
Dealt to 33cf6203 
Dealt to 6fa75dc0 
6fa75dc0: calls $0.05
Hero: folds
fa716687: folds
9d71d622: calls $0.05
b14d35ee: raises $0.35 to $0.4
33cf6203: calls $0.35
6fa75dc0: folds
9d71d622: folds
*** FLOP *** [6c 6s Th]
b14d35ee: checks
33cf6203: checks
*** TURN *** [6c 6s Th] [8h]
b14d35ee: checks
33cf6203: checks
*** RIVER *** [6c 6s Th 8h] [4s]
b14d35ee: bets $0.25
33cf6203: raises $0.47 to $0.72
b14d35ee: folds
Uncalled bet ($0.47) returned to 33cf6203
33cf6203: shows [6h] (Three Sixes)
*** SHOWDOWN ***
33cf6203 collected $1.33 from pot
*** SUMMARY ***
Total pot $1.4 | Rake $0.07 | Jackpot $0 | Bingo $0 | Fortune $0 | Tax $0
Board [6c 6s Th 8h 4s]
Seat 1: Hero folded before Flop (didn't bet)
Seat 2: fa716687 folded before Flop (didn't bet)
Seat 3: 9d71d622 (button) folded before Flop
Seat 4: b14d35ee (small blind) folded on the River
Seat 5: 33cf6203 (big blind) showed [6h] and won ($1.33)
Seat 6: 6fa75dc0 folded before Flop


Poker Hand #HD1738743427: Hold'em No Limit ($0.02/$0.05) - 2024/04/20 14:32:06
Table 'NLHBlue13' 6-max Seat #2 is the button
Seat 1: Hero ($7.33 in chips)
Seat 2: fa716687 ($5.13 in chips)
Seat 3: 9d71d622 ($2.18 in chips)
Seat 4: b14d35ee ($7.56 in chips)
Seat 5: 4d9fee85 ($6.07 in chips)
Seat 6: 6fa75dc0 ($4.57 in chips)
9d71d622: posts small blind $0.02
b14d35ee: posts big blind $0.05
*** HOLE CARDS ***
Dealt to Hero [6d Jd]
Dealt to fa716687 
Dealt to 9d71d622 
Dealt to b14d35ee 
Dealt to 4d9fee85 
Dealt to 6fa75dc0 
4d9fee85: folds
6fa75dc0: calls $0.05
Hero: folds
fa716687: raises $0.12 to $0.17
9d71d622: folds
b14d35ee: folds
6fa75dc0: calls $0.12
*** FLOP *** [Ac 9c 2s]
6fa75dc0: checks
fa716687: checks
*** TURN *** [Ac 9c 2s] [Kd]
6fa75dc0: checks
fa716687: bets $0.23
6fa75dc0: folds
Uncalled bet ($0.23) returned to fa716687
*** SHOWDOWN ***
fa716687 collected $0.39 from pot
*** SUMMARY ***
Total pot $0.41 | Rake $0.02 | Jackpot $0 | Bingo $0 | Fortune $0 | Tax $0
Board [Ac 9c 2s Kd]
Seat 1: Hero folded before Flop (didn't bet)
Seat 2: fa716687 (button) won ($0.39)
Seat 3: 9d71d622 (small blind) folded before Flop
Seat 4: b14d35ee (big blind) folded before Flop
Seat 5: 4d9fee85 folded before Flop (didn't bet)
Seat 6: 6fa75dc0 folded on the Turn


Poker Hand #HD1738743331: Hold'em No Limit ($0.02/$0.05) - 2024/04/20 14:31:19
Table 'NLHBlue13' 6-max Seat #1 is the button
Seat 1: Hero ($6.94 in chips)
Seat 2: fa716687 ($5.15 in chips)
Seat 3: 9d71d622 ($2.23 in chips)
Seat 4: b14d35ee ($7.56 in chips)
Seat 5: 4d9fee85 ($6.07 in chips)
Seat 6: 6fa75dc0 ($4.92 in chips)
fa716687: posts small blind $0.02
9d71d622: posts big blind $0.05
*** HOLE CARDS ***
Dealt to Hero [Jh Ks]
Dealt to fa716687 
Dealt to 9d71d622 
Dealt to b14d35ee 
Dealt to 4d9fee85 
Dealt to 6fa75dc0 
b14d35ee: folds
4d9fee85: folds
6fa75dc0: calls $0.05
Hero: raises $0.15 to $0.2
fa716687: folds
9d71d622: folds
6fa75dc0: calls $0.15
*** FLOP *** [Qd 5c 3d]
6fa75dc0: checks
Hero: checks
*** TURN *** [Qd 5c 3d] [Qs]
6fa75dc0: checks
Hero: checks
*** RIVER *** [Qd 5c 3d Qs] [Kc]
6fa75dc0: checks
Hero: bets $0.15
6fa75dc0: calls $0.15
Hero: shows [Jh Ks] (Pair of Kings and Pair of Queens)
6fa75dc0: shows [9d 9h] (Pair of Queens and Pair of Nines)
*** SHOWDOWN ***
Hero collected $0.74 from pot
*** SUMMARY ***
Total pot $0.77 | Rake $0.03 | Jackpot $0 | Bingo $0 | Fortune $0 | Tax $0
Board [Qd 5c 3d Qs Kc]
Seat 1: Hero (button) showed [Jh Ks] and won ($0.74) with Pair of Kings and Pair of Queens
Seat 2: fa716687 (small blind) folded before Flop
Seat 3: 9d71d622 (big blind) folded before Flop
Seat 4: b14d35ee folded before Flop (didn't bet)
Seat 5: 4d9fee85 folded before Flop (didn't bet)
Seat 6: 6fa75dc0 showed [9d 9h] and lost with Pair of Queens and Pair of Nines


Poker Hand #HD1738743242: Hold'em No Limit ($0.02/$0.05) - 2024/04/20 14:30:25
Table 'NLHBlue13' 6-max Seat #6 is the button
Seat 1: Hero ($6.96 in chips)
Seat 2: fa716687 ($5.08 in chips)
Seat 3: 9d71d622 ($2.28 in chips)
Seat 4: b14d35ee ($7.56 in chips)
Seat 5: 4d9fee85 ($6.07 in chips)
Seat 6: 6fa75dc0 ($4.92 in chips)
Hero: posts small blind $0.02
fa716687: posts big blind $0.05
*** HOLE CARDS ***
Dealt to Hero [7c 4d]
Dealt to fa716687 
Dealt to 9d71d622 
Dealt to b14d35ee 
Dealt to 4d9fee85 
Dealt to 6fa75dc0 
9d71d622: calls $0.05
b14d35ee: folds
4d9fee85: folds
6fa75dc0: folds
Hero: folds
fa716687: checks
*** FLOP *** [9d 2h 8h]
fa716687: checks
9d71d622: checks
*** TURN *** [9d 2h 8h] [Tc]
fa716687: bets $0.09
9d71d622: folds
Uncalled bet ($0.09) returned to fa716687
*** SHOWDOWN ***
fa716687 collected $0.12 from pot
*** SUMMARY ***
Total pot $0.12 | Rake $0 | Jackpot $0 | Bingo $0 | Fortune $0 | Tax $0
Board [9d 2h 8h Tc]
Seat 1: Hero (small blind) folded before Flop
Seat 2: fa716687 (big blind) won ($0.12)
Seat 3: 9d71d622 folded on the Turn
Seat 4: b14d35ee folded before Flop (didn't bet)
Seat 5: 4d9fee85 folded before Flop (didn't bet)
Seat 6: 6fa75dc0 (button) folded before Flop (didn't bet)


Poker Hand #HD1738743213: Hold'em No Limit ($0.02/$0.05) - 2024/04/20 14:30:11
Table 'NLHBlue13' 6-max Seat #5 is the button
Seat 1: Hero ($7.01 in chips)
Seat 3: 9d71d622 ($2.21 in chips)
Seat 4: b14d35ee ($7.56 in chips)
Seat 5: 4d9fee85 ($6.07 in chips)
Seat 6: 6fa75dc0 ($4.94 in chips)
6fa75dc0: posts small blind $0.02
Hero: posts big blind $0.05
*** HOLE CARDS ***
Dealt to Hero [6c Kh]
Dealt to 9d71d622 
Dealt to b14d35ee 
Dealt to 4d9fee85 
Dealt to 6fa75dc0 
9d71d622: calls $0.05
b14d35ee: folds
4d9fee85: folds
6fa75dc0: folds
Hero: checks
*** FLOP *** [2s Qd 8d]
Hero: checks
9d71d622: bets $0.06
Hero: folds
Uncalled bet ($0.06) returned to 9d71d622
*** SHOWDOWN ***
9d71d622 collected $0.12 from pot
*** SUMMARY ***
Total pot $0.12 | Rake $0 | Jackpot $0 | Bingo $0 | Fortune $0 | Tax $0
Board [2s Qd 8d]
Seat 1: Hero (big blind) folded on the Flop
Seat 3: 9d71d622 won ($0.12)
Seat 4: b14d35ee folded before Flop (didn't bet)
Seat 5: 4d9fee85 (button) folded before Flop (didn't bet)
Seat 6: 6fa75dc0 (small blind) folded before Flop


Poker Hand #HD1738743142: Hold'em No Limit ($0.02/$0.05) - 2024/04/20 14:29:33
Table 'NLHBlue13' 6-max Seat #4 is the button
Seat 1: Hero ($7.01 in chips)
Seat 3: 9d71d622 ($2.09 in chips)
Seat 4: b14d35ee ($7.56 in chips)
Seat 5: 4d9fee85 ($6.09 in chips)
Seat 6: 6fa75dc0 ($5.05 in chips)
4d9fee85: posts small blind $0.02
6fa75dc0: posts big blind $0.05
*** HOLE CARDS ***
Dealt to Hero [6h 8c]
Dealt to 9d71d622 
Dealt to b14d35ee 
Dealt to 4d9fee85 
Dealt to 6fa75dc0 
Hero: folds
9d71d622: calls $0.05
b14d35ee: folds
4d9fee85: folds
6fa75dc0: checks
*** FLOP *** [7s 4c 3d]
6fa75dc0: checks
9d71d622: bets $0.06
6fa75dc0: calls $0.06
*** TURN *** [7s 4c 3d] [2s]
6fa75dc0: checks
9d71d622: checks
*** RIVER *** [7s 4c 3d 2s] [4h]
6fa75dc0: checks
9d71d622: checks
6fa75dc0: shows [Ks Tc] (Pair of Fours)
9d71d622: shows [Kh Jh] (Pair of Fours)
*** SHOWDOWN ***
9d71d622 collected $0.23 from pot
*** SUMMARY ***
Total pot $0.24 | Rake $0.01 | Jackpot $0 | Bingo $0 | Fortune $0 | Tax $0
Board [7s 4c 3d 2s 4h]
Seat 1: Hero folded before Flop (didn't bet)
Seat 3: 9d71d622 showed [Kh Jh] and won ($0.23) with Pair of Fours
Seat 4: b14d35ee (button) folded before Flop (didn't bet)
Seat 5: 4d9fee85 (small blind) folded before Flop
Seat 6: 6fa75dc0 (big blind) showed [Ks Tc] and lost with Pair of Fours


Poker Hand #HD1738743111: Hold'em No Limit ($0.02/$0.05) - 2024/04/20 14:29:17
Table 'NLHBlue13' 6-max Seat #3 is the button
Seat 1: Hero ($7.01 in chips)
Seat 3: 9d71d622 ($2.09 in chips)
Seat 4: b14d35ee ($7.51 in chips)
Seat 5: 4d9fee85 ($6.14 in chips)
Seat 6: 6fa75dc0 ($5.05 in chips)
b14d35ee: posts small blind $0.02
4d9fee85: posts big blind $0.05
*** HOLE CARDS ***
Dealt to Hero [7c Qc]
Dealt to 9d71d622 
Dealt to b14d35ee 
Dealt to 4d9fee85 
Dealt to 6fa75dc0 
6fa75dc0: folds
Hero: folds
9d71d622: folds
b14d35ee: raises $0.08 to $0.13
4d9fee85: folds
Uncalled bet ($0.08) returned to b14d35ee
*** SHOWDOWN ***
b14d35ee collected $0.1 from pot
*** SUMMARY ***
Total pot $0.1 | Rake $0 | Jackpot $0 | Bingo $0 | Fortune $0 | Tax $0
Seat 1: Hero folded before Flop (didn't bet)
Seat 3: 9d71d622 (button) folded before Flop (didn't bet)
Seat 4: b14d35ee (small blind) collected ($0.1)
Seat 5: 4d9fee85 (big blind) folded before Flop
Seat 6: 6fa75dc0 folded before Flop (didn't bet)


Poker Hand #HD1738743085: Hold'em No Limit ($0.02/$0.05) - 2024/04/20 14:29:05
Table 'NLHBlue13' 6-max Seat #1 is the button
Seat 1: Hero ($7.01 in chips)
Seat 3: 9d71d622 ($2.04 in chips)
Seat 4: b14d35ee ($7.56 in chips)
Seat 5: 4d9fee85 ($6.14 in chips)
Seat 6: 6fa75dc0 ($5.05 in chips)
9d71d622: posts small blind $0.02
b14d35ee: posts big blind $0.05
*** HOLE CARDS ***
Dealt to Hero [Jc 7s]
Dealt to 9d71d622 
Dealt to b14d35ee 
Dealt to 4d9fee85 
Dealt to 6fa75dc0 
4d9fee85: folds
6fa75dc0: folds
Hero: folds
9d71d622: raises $0.05 to $0.1
b14d35ee: folds
Uncalled bet ($0.05) returned to 9d71d622
*** SHOWDOWN ***
9d71d622 collected $0.1 from pot
*** SUMMARY ***
Total pot $0.1 | Rake $0 | Jackpot $0 | Bingo $0 | Fortune $0 | Tax $0
Seat 1: Hero (button) folded before Flop (didn't bet)
Seat 3: 9d71d622 (small blind) collected ($0.1)
Seat 4: b14d35ee (big blind) folded before Flop
Seat 5: 4d9fee85 folded before Flop (didn't bet)
Seat 6: 6fa75dc0 folded before Flop (didn't bet)


Poker Hand #HD1738743035: Hold'em No Limit ($0.02/$0.05) - 2024/04/20 14:28:35
Table 'NLHBlue13' 6-max Seat #6 is the button
Seat 1: Hero ($7.03 in chips)
Seat 3: 9d71d622 ($2.17 in chips)
Seat 4: b14d35ee ($7.42 in chips)
Seat 5: 4d9fee85 ($6.14 in chips)
Seat 6: 6fa75dc0 ($5.05 in chips)
Hero: posts small blind $0.02
9d71d622: posts big blind $0.05
*** HOLE CARDS ***
Dealt to Hero [Qc 5d]
Dealt to 9d71d622 
Dealt to b14d35ee 
Dealt to 4d9fee85 
Dealt to 6fa75dc0 
b14d35ee: raises $0.08 to $0.13
4d9fee85: folds
6fa75dc0: folds
Hero: folds
9d71d622: calls $0.08
*** FLOP *** [9s 9c 9d]
9d71d622: checks
b14d35ee: bets $0.1
9d71d622: folds
Uncalled bet ($0.1) returned to b14d35ee
*** SHOWDOWN ***
b14d35ee collected $0.27 from pot
*** SUMMARY ***
Total pot $0.28 | Rake $0.01 | Jackpot $0 | Bingo $0 | Fortune $0 | Tax $0
Board [9s 9c 9d]
Seat 1: Hero (small blind) folded before Flop
Seat 3: 9d71d622 (big blind) folded on the Flop
Seat 4: b14d35ee won ($0.27)
Seat 5: 4d9fee85 folded before Flop (didn't bet)
Seat 6: 6fa75dc0 (button) folded before Flop (didn't bet)


Poker Hand #HD1738742990: Hold'em No Limit ($0.02/$0.05) - 2024/04/20 14:28:03
Table 'NLHBlue13' 6-max Seat #5 is the button
Seat 1: Hero ($7.08 in chips)
Seat 2: cffc4953 ($6.16 in chips)
Seat 3: 9d71d622 ($2.17 in chips)
Seat 4: b14d35ee ($7.7 in chips)
Seat 5: 4d9fee85 ($6.14 in chips)
Seat 6: 6fa75dc0 ($4.75 in chips)
6fa75dc0: posts small blind $0.02
Hero: posts big blind $0.05
*** HOLE CARDS ***
Dealt to Hero [8c 6s]
Dealt to cffc4953 
Dealt to 9d71d622 
Dealt to b14d35ee 
Dealt to 4d9fee85 
Dealt to 6fa75dc0 
cffc4953: folds
9d71d622: folds
b14d35ee: raises $0.08 to $0.13
4d9fee85: folds
6fa75dc0: calls $0.11
Hero: folds
*** FLOP *** [Jc 3d 9c]
6fa75dc0: checks
b14d35ee: checks
*** TURN *** [Jc 3d 9c] [Ah]
6fa75dc0: checks
b14d35ee: bets $0.15
6fa75dc0: calls $0.15
*** RIVER *** [Jc 3d 9c Ah] [7c]
6fa75dc0: checks
b14d35ee: checks
6fa75dc0: shows [9d Ks] (Pair of Nines)
b14d35ee: shows [2h 2d] (Pair of Twos)
*** SHOWDOWN ***
6fa75dc0 collected $0.58 from pot
*** SUMMARY ***
Total pot $0.61 | Rake $0.03 | Jackpot $0 | Bingo $0 | Fortune $0 | Tax $0
Board [Jc 3d 9c Ah 7c]
Seat 1: Hero (big blind) folded before Flop
Seat 2: cffc4953 folded before Flop (didn't bet)
Seat 3: 9d71d622 folded before Flop (didn't bet)
Seat 4: b14d35ee showed [2h 2d] and lost with Pair of Twos
Seat 5: 4d9fee85 (button) folded before Flop (didn't bet)
Seat 6: 6fa75dc0 (small blind) showed [9d Ks] and won ($0.58) with Pair of Nines


Poker Hand #HD1738742946: Hold'em No Limit ($0.02/$0.05) - 2024/04/20 14:27:41
Table 'NLHBlue13' 6-max Seat #4 is the button
Seat 1: Hero ($7.08 in chips)
Seat 2: cffc4953 ($6.16 in chips)
Seat 3: 9d71d622 ($2.17 in chips)
Seat 4: b14d35ee ($7.83 in chips)
Seat 5: 4d9fee85 ($5.97 in chips)
Seat 6: 6fa75dc0 ($4.8 in chips)
4d9fee85: posts small blind $0.02
6fa75dc0: posts big blind $0.05
*** HOLE CARDS ***
Dealt to Hero [Qd 5s]
Dealt to cffc4953 
Dealt to 9d71d622 
Dealt to b14d35ee 
Dealt to 4d9fee85 
Dealt to 6fa75dc0 
Hero: folds
cffc4953: folds
9d71d622: folds
b14d35ee: raises $0.08 to $0.13
4d9fee85: raises $0.24 to $0.37
6fa75dc0: folds
b14d35ee: folds
Uncalled bet ($0.24) returned to 4d9fee85
*** SHOWDOWN ***
4d9fee85 collected $0.3 from pot
*** SUMMARY ***
Total pot $0.31 | Rake $0.01 | Jackpot $0 | Bingo $0 | Fortune $0 | Tax $0
Seat 1: Hero folded before Flop (didn't bet)
Seat 2: cffc4953 folded before Flop (didn't bet)
Seat 3: 9d71d622 folded before Flop (didn't bet)
Seat 4: b14d35ee (button) folded before Flop
Seat 5: 4d9fee85 (small blind) collected ($0.3)
Seat 6: 6fa75dc0 (big blind) folded before Flop


Poker Hand #HD1738742870: Hold'em No Limit ($0.02/$0.05) - 2024/04/20 14:26:53
Table 'NLHBlue13' 6-max Seat #3 is the button
Seat 1: Hero ($7.08 in chips)
Seat 2: cffc4953 ($6.26 in chips)
Seat 3: 9d71d622 ($3.04 in chips)
Seat 4: b14d35ee ($6.95 in chips)
Seat 5: 4d9fee85 ($6.02 in chips)
Seat 6: 6fa75dc0 ($4.8 in chips)
b14d35ee: posts small blind $0.02
4d9fee85: posts big blind $0.05
*** HOLE CARDS ***
Dealt to Hero [9h 5d]
Dealt to cffc4953 
Dealt to 9d71d622 
Dealt to b14d35ee 
Dealt to 4d9fee85 
Dealt to 6fa75dc0 
6fa75dc0: folds
Hero: folds
cffc4953: raises $0.05 to $0.1
9d71d622: raises $0.14 to $0.24
b14d35ee: calls $0.22
4d9fee85: folds
cffc4953: folds
*** FLOP *** [Qd 7h Js]
b14d35ee: checks
9d71d622: checks
*** TURN *** [Qd 7h Js] [4s]
b14d35ee: checks
9d71d622: checks
*** RIVER *** [Qd 7h Js 4s] [8c]
b14d35ee: bets $0.63
9d71d622: calls $0.63
b14d35ee: shows [Jc Jd] (Three Jacks)
9d71d622: shows [9c 9d] (Pair of Nines)
*** SHOWDOWN ***
b14d35ee collected $1.75 from pot
*** SUMMARY ***
Total pot $1.89 | Rake $0.09 | Jackpot $0.05 | Bingo $0 | Fortune $0 | Tax $0
Board [Qd 7h Js 4s 8c]
Seat 1: Hero folded before Flop (didn't bet)
Seat 2: cffc4953 folded before Flop
Seat 3: 9d71d622 (button) showed [9c 9d] and lost with Pair of Nines
Seat 4: b14d35ee (small blind) showed [Jc Jd] and won ($1.75) with Three Jacks
Seat 5: 4d9fee85 (big blind) folded before Flop
Seat 6: 6fa75dc0 folded before Flop (didn't bet)


Poker Hand #HD1738742803: Hold'em No Limit ($0.02/$0.05) - 2024/04/20 14:26:19
Table 'NLHBlue13' 6-max Seat #2 is the button
Seat 1: Hero ($7.08 in chips)
Seat 2: cffc4953 ($6.26 in chips)
Seat 3: 9d71d622 ($3.06 in chips)
Seat 4: b14d35ee ($7 in chips)
Seat 5: 4d9fee85 ($6.02 in chips)
Seat 6: 6fa75dc0 ($4.73 in chips)
9d71d622: posts small blind $0.02
b14d35ee: posts big blind $0.05
*** HOLE CARDS ***
Dealt to Hero [As 3s]
Dealt to cffc4953 
Dealt to 9d71d622 
Dealt to b14d35ee 
Dealt to 4d9fee85 
Dealt to 6fa75dc0 
4d9fee85: folds
6fa75dc0: calls $0.05
Hero: folds
cffc4953: folds
9d71d622: folds
b14d35ee: checks
*** FLOP *** [Ks 3h 2s]
b14d35ee: checks
6fa75dc0: checks
*** TURN *** [Ks 3h 2s] [6s]
b14d35ee: checks
6fa75dc0: checks
*** RIVER *** [Ks 3h 2s 6s] [Ah]
b14d35ee: checks
6fa75dc0: checks
b14d35ee: shows [7d Td] (Ace-High)
6fa75dc0: shows [4d 2d] (Pair of Twos)
*** SHOWDOWN ***
6fa75dc0 collected $0.12 from pot
*** SUMMARY ***
Total pot $0.12 | Rake $0 | Jackpot $0 | Bingo $0 | Fortune $0 | Tax $0
Board [Ks 3h 2s 6s Ah]
Seat 1: Hero folded before Flop (didn't bet)
Seat 2: cffc4953 (button) folded before Flop (didn't bet)
Seat 3: 9d71d622 (small blind) folded before Flop
Seat 4: b14d35ee (big blind) showed [7d Td] and lost with Ace-High
Seat 5: 4d9fee85 folded before Flop (didn't bet)
Seat 6: 6fa75dc0 showed [4d 2d] and won ($0.12) with Pair of Twos


Poker Hand #HD1738742783: Hold'em No Limit ($0.02/$0.05) - 2024/04/20 14:26:08
Table 'NLHBlue13' 6-max Seat #1 is the button
Seat 1: Hero ($7.08 in chips)
Seat 2: cffc4953 ($6.28 in chips)
Seat 3: 9d71d622 ($3.11 in chips)
Seat 4: b14d35ee ($7 in chips)
Seat 5: 4d9fee85 ($5.95 in chips)
Seat 6: 6fa75dc0 ($4.73 in chips)
cffc4953: posts small blind $0.02
9d71d622: posts big blind $0.05
*** HOLE CARDS ***
Dealt to Hero [2s Jc]
Dealt to cffc4953 
Dealt to 9d71d622 
Dealt to b14d35ee 
Dealt to 4d9fee85 
Dealt to 6fa75dc0 
b14d35ee: folds
4d9fee85: raises $0.08 to $0.13
6fa75dc0: folds
Hero: folds
cffc4953: folds
9d71d622: folds
Uncalled bet ($0.08) returned to 4d9fee85
*** SHOWDOWN ***
4d9fee85 collected $0.12 from pot
*** SUMMARY ***
Total pot $0.12 | Rake $0 | Jackpot $0 | Bingo $0 | Fortune $0 | Tax $0
Seat 1: Hero (button) folded before Flop (didn't bet)
Seat 2: cffc4953 (small blind) folded before Flop
Seat 3: 9d71d622 (big blind) folded before Flop
Seat 4: b14d35ee folded before Flop (didn't bet)
Seat 5: 4d9fee85 collected ($0.12)
Seat 6: 6fa75dc0 folded before Flop (didn't bet)


Poker Hand #HD1738742739: Hold'em No Limit ($0.02/$0.05) - 2024/04/20 14:25:46
Table 'NLHBlue13' 6-max Seat #6 is the button
Seat 1: Hero ($7.1 in chips)
Seat 2: cffc4953 ($6.33 in chips)
Seat 3: 9d71d622 ($3.11 in chips)
Seat 4: b14d35ee ($6.93 in chips)
Seat 5: 4d9fee85 ($5.95 in chips)
Seat 6: 6fa75dc0 ($4.73 in chips)
Hero: posts small blind $0.02
cffc4953: posts big blind $0.05
*** HOLE CARDS ***
Dealt to Hero [Td 4h]
Dealt to cffc4953 
Dealt to 9d71d622 
Dealt to b14d35ee 
Dealt to 4d9fee85 
Dealt to 6fa75dc0 
9d71d622: folds
b14d35ee: raises $0.08 to $0.13
4d9fee85: folds
6fa75dc0: folds
Hero: folds
cffc4953: folds
Uncalled bet ($0.08) returned to b14d35ee
*** SHOWDOWN ***
b14d35ee collected $0.12 from pot
*** SUMMARY ***
Total pot $0.12 | Rake $0 | Jackpot $0 | Bingo $0 | Fortune $0 | Tax $0
Seat 1: Hero (small blind) folded before Flop
Seat 2: cffc4953 (big blind) folded before Flop
Seat 3: 9d71d622 folded before Flop (didn't bet)
Seat 4: b14d35ee collected ($0.12)
Seat 5: 4d9fee85 folded before Flop (didn't bet)
Seat 6: 6fa75dc0 (button) folded before Flop (didn't bet)


Poker Hand #HD1738742715: Hold'em No Limit ($0.02/$0.05) - 2024/04/20 14:25:33
Table 'NLHBlue13' 6-max Seat #5 is the button
Seat 1: Hero ($7.15 in chips)
Seat 2: cffc4953 ($6.33 in chips)
Seat 3: 9d71d622 ($3.11 in chips)
Seat 4: b14d35ee ($6.86 in chips)
Seat 5: 4d9fee85 ($5.95 in chips)
Seat 6: 6fa75dc0 ($4.75 in chips)
6fa75dc0: posts small blind $0.02
Hero: posts big blind $0.05
*** HOLE CARDS ***
Dealt to Hero [Ts 3d]
Dealt to cffc4953 
Dealt to 9d71d622 
Dealt to b14d35ee 
Dealt to 4d9fee85 
Dealt to 6fa75dc0 
cffc4953: folds
9d71d622: folds
b14d35ee: raises $0.08 to $0.13
4d9fee85: folds
6fa75dc0: folds
Hero: folds
Uncalled bet ($0.08) returned to b14d35ee
*** SHOWDOWN ***
b14d35ee collected $0.12 from pot
*** SUMMARY ***
Total pot $0.12 | Rake $0 | Jackpot $0 | Bingo $0 | Fortune $0 | Tax $0
Seat 1: Hero (big blind) folded before Flop
Seat 2: cffc4953 folded before Flop (didn't bet)
Seat 3: 9d71d622 folded before Flop (didn't bet)
Seat 4: b14d35ee collected ($0.12)
Seat 5: 4d9fee85 (button) folded before Flop (didn't bet)
Seat 6: 6fa75dc0 (small blind) folded before Flop


Poker Hand #HD1738742689: Hold'em No Limit ($0.02/$0.05) - 2024/04/20 14:25:20
Table 'NLHBlue13' 6-max Seat #4 is the button
Seat 1: Hero ($7.15 in chips)
Seat 2: cffc4953 ($6.33 in chips)
Seat 3: 9d71d622 ($3.11 in chips)
Seat 4: b14d35ee ($6.86 in chips)
Seat 5: 4d9fee85 ($5.9 in chips)
Seat 6: 6fa75dc0 ($4.8 in chips)
4d9fee85: posts small blind $0.02
6fa75dc0: posts big blind $0.05
*** HOLE CARDS ***
Dealt to Hero [8s Kh]
Dealt to cffc4953 
Dealt to 9d71d622 
Dealt to b14d35ee 
Dealt to 4d9fee85 
Dealt to 6fa75dc0 
Hero: folds
cffc4953: folds
9d71d622: folds
b14d35ee: folds
4d9fee85: raises $0.1 to $0.15
6fa75dc0: folds
Uncalled bet ($0.1) returned to 4d9fee85
*** SHOWDOWN ***
4d9fee85 collected $0.1 from pot
*** SUMMARY ***
Total pot $0.1 | Rake $0 | Jackpot $0 | Bingo $0 | Fortune $0 | Tax $0
Seat 1: Hero folded before Flop (didn't bet)
Seat 2: cffc4953 folded before Flop (didn't bet)
Seat 3: 9d71d622 folded before Flop (didn't bet)
Seat 4: b14d35ee (button) folded before Flop (didn't bet)
Seat 5: 4d9fee85 (small blind) collected ($0.1)
Seat 6: 6fa75dc0 (big blind) folded before Flop


Poker Hand #HD1738742671: Hold'em No Limit ($0.02/$0.05) - 2024/04/20 14:25:08
Table 'NLHBlue13' 6-max Seat #3 is the button
Seat 1: Hero ($7.15 in chips)
Seat 2: cffc4953 ($6.33 in chips)
Seat 3: 9d71d622 ($3.11 in chips)
Seat 4: b14d35ee ($6.88 in chips)
Seat 5: 4d9fee85 ($5.88 in chips)
Seat 6: 6fa75dc0 ($4.8 in chips)
b14d35ee: posts small blind $0.02
4d9fee85: posts big blind $0.05
*** HOLE CARDS ***
Dealt to Hero [Ah 9s]
Dealt to cffc4953 
Dealt to 9d71d622 
Dealt to b14d35ee 
Dealt to 4d9fee85 
Dealt to 6fa75dc0 
6fa75dc0: folds
Hero: folds
cffc4953: folds
9d71d622: folds
b14d35ee: folds
Uncalled bet ($0.03) returned to 4d9fee85
*** SHOWDOWN ***
4d9fee85 collected $0.04 from pot
*** SUMMARY ***
Total pot $0.04 | Rake $0 | Jackpot $0 | Bingo $0 | Fortune $0 | Tax $0
Seat 1: Hero folded before Flop (didn't bet)
Seat 2: cffc4953 folded before Flop (didn't bet)
Seat 3: 9d71d622 (button) folded before Flop (didn't bet)
Seat 4: b14d35ee (small blind) folded before Flop
Seat 5: 4d9fee85 (big blind) collected ($0.04)
Seat 6: 6fa75dc0 folded before Flop (didn't bet)


Poker Hand #HD1738742607: Hold'em No Limit ($0.02/$0.05) - 2024/04/20 14:24:31
Table 'NLHBlue13' 6-max Seat #2 is the button
Seat 1: Hero ($7.15 in chips)
Seat 2: cffc4953 ($6.33 in chips)
Seat 3: 9d71d622 ($3.13 in chips)
Seat 4: b14d35ee ($6.68 in chips)
Seat 5: 4d9fee85 ($5.88 in chips)
Seat 6: 6fa75dc0 ($5 in chips)
9d71d622: posts small blind $0.02
b14d35ee: posts big blind $0.05
6fa75dc0: posts big blind $0.05
*** HOLE CARDS ***
Dealt to Hero [2d 8h]
Dealt to cffc4953 
Dealt to 9d71d622 
Dealt to b14d35ee 
Dealt to 4d9fee85 
Dealt to 6fa75dc0 
4d9fee85: folds
6fa75dc0: checks
Hero: folds
cffc4953: folds
9d71d622: folds
b14d35ee: checks
*** FLOP *** [7h Qs Jd]
b14d35ee: bets $0.05
6fa75dc0: calls $0.05
*** TURN *** [7h Qs Jd] [Ac]
b14d35ee: bets $0.1
6fa75dc0: calls $0.1
*** RIVER *** [7h Qs Jd Ac] [6s]
b14d35ee: checks
6fa75dc0: checks
b14d35ee: shows [Qh 5d] (Pair of Queens)
6fa75dc0: shows [8c Th] (Ace-High)
*** SHOWDOWN ***
b14d35ee collected $0.4 from pot
*** SUMMARY ***
Total pot $0.42 | Rake $0.02 | Jackpot $0 | Bingo $0 | Fortune $0 | Tax $0
Board [7h Qs Jd Ac 6s]
Seat 1: Hero folded before Flop (didn't bet)
Seat 2: cffc4953 (button) folded before Flop (didn't bet)
Seat 3: 9d71d622 (small blind) folded before Flop
Seat 4: b14d35ee (big blind) showed [Qh 5d] and won ($0.4) with Pair of Queens
Seat 5: 4d9fee85 folded before Flop (didn't bet)
Seat 6: 6fa75dc0 showed [8c Th] and lost with Ace-High


Poker Hand #HD1738742540: Hold'em No Limit ($0.02/$0.05) - 2024/04/20 14:23:56
Table 'NLHBlue13' 6-max Seat #1 is the button
Seat 1: Hero ($7.15 in chips)
Seat 2: cffc4953 ($6.35 in chips)
Seat 3: 9d71d622 ($2.99 in chips)
Seat 4: b14d35ee ($6.68 in chips)
Seat 5: 4d9fee85 ($6.01 in chips)
cffc4953: posts small blind $0.02
9d71d622: posts big blind $0.05
*** HOLE CARDS ***
Dealt to Hero [6d 9d]
Dealt to cffc4953 
Dealt to 9d71d622 
Dealt to b14d35ee 
Dealt to 4d9fee85 
b14d35ee: folds
4d9fee85: raises $0.08 to $0.13
Hero: folds
cffc4953: folds
9d71d622: raises $0.28 to $0.41
4d9fee85: folds
Uncalled bet ($0.28) returned to 9d71d622
*** SHOWDOWN ***
9d71d622 collected $0.27 from pot
*** SUMMARY ***
Total pot $0.28 | Rake $0.01 | Jackpot $0 | Bingo $0 | Fortune $0 | Tax $0
Seat 1: Hero (button) folded before Flop (didn't bet)
Seat 2: cffc4953 (small blind) folded before Flop
Seat 3: 9d71d622 (big blind) collected ($0.27)
Seat 4: b14d35ee folded before Flop (didn't bet)
Seat 5: 4d9fee85 folded before Flop


Poker Hand #HD1738742518: Hold'em No Limit ($0.02/$0.05) - 2024/04/20 14:23:45
Table 'NLHBlue13' 6-max Seat #5 is the button
Seat 1: Hero ($7.17 in chips)
Seat 2: cffc4953 ($6.4 in chips)
Seat 3: 9d71d622 ($2.99 in chips)
Seat 4: b14d35ee ($6.61 in chips)
Seat 5: 4d9fee85 ($6.01 in chips)
Hero: posts small blind $0.02
cffc4953: posts big blind $0.05
*** HOLE CARDS ***
Dealt to Hero [5c 8s]
Dealt to cffc4953 
Dealt to 9d71d622 
Dealt to b14d35ee 
Dealt to 4d9fee85 
9d71d622: folds
b14d35ee: raises $0.08 to $0.13
4d9fee85: folds
Hero: folds
cffc4953: folds
Uncalled bet ($0.08) returned to b14d35ee
*** SHOWDOWN ***
b14d35ee collected $0.12 from pot
*** SUMMARY ***
Total pot $0.12 | Rake $0 | Jackpot $0 | Bingo $0 | Fortune $0 | Tax $0
Seat 1: Hero (small blind) folded before Flop
Seat 2: cffc4953 (big blind) folded before Flop
Seat 3: 9d71d622 folded before Flop (didn't bet)
Seat 4: b14d35ee collected ($0.12)
Seat 5: 4d9fee85 (button) folded before Flop (didn't bet)


Poker Hand #HD1738742477: Hold'em No Limit ($0.02/$0.05) - 2024/04/20 14:23:23
Table 'NLHBlue13' 6-max Seat #4 is the button
Seat 1: Hero ($7.22 in chips)
Seat 2: cffc4953 ($6.4 in chips)
Seat 3: 9d71d622 ($3.04 in chips)
Seat 4: b14d35ee ($6.61 in chips)
Seat 5: 4d9fee85 ($5.91 in chips)
4d9fee85: posts small blind $0.02
Hero: posts big blind $0.05
*** HOLE CARDS ***
Dealt to Hero [3h 4d]
Dealt to cffc4953 
Dealt to 9d71d622 
Dealt to b14d35ee 
Dealt to 4d9fee85 
cffc4953: folds
9d71d622: calls $0.05
b14d35ee: folds
4d9fee85: raises $0.15 to $0.2
Hero: folds
9d71d622: folds
Uncalled bet ($0.15) returned to 4d9fee85
*** SHOWDOWN ***
4d9fee85 collected $0.15 from pot
*** SUMMARY ***
Total pot $0.15 | Rake $0 | Jackpot $0 | Bingo $0 | Fortune $0 | Tax $0
Seat 1: Hero (big blind) folded before Flop
Seat 2: cffc4953 folded before Flop (didn't bet)
Seat 3: 9d71d622 folded before Flop
Seat 4: b14d35ee (button) folded before Flop (didn't bet)
Seat 5: 4d9fee85 (small blind) collected ($0.15)


Poker Hand #HD1738742440: Hold'em No Limit ($0.02/$0.05) - 2024/04/20 14:23:03
Table 'NLHBlue13' 6-max Seat #3 is the button
Seat 1: Hero ($7.32 in chips)
Seat 2: cffc4953 ($6.4 in chips)
Seat 3: 9d71d622 ($3.04 in chips)
Seat 4: b14d35ee ($6.63 in chips)
Seat 5: 4d9fee85 ($5.8 in chips)
Seat 6: b638e924 ($6.05 in chips)
b14d35ee: posts small blind $0.02
4d9fee85: posts big blind $0.05
*** HOLE CARDS ***
Dealt to Hero [9s Ts]
Dealt to cffc4953 
Dealt to 9d71d622 
Dealt to b14d35ee 
Dealt to 4d9fee85 
Dealt to b638e924 
b638e924: folds
Hero: raises $0.05 to $0.1
cffc4953: folds
9d71d622: folds
b14d35ee: folds
4d9fee85: raises $0.32 to $0.42
Hero: folds
Uncalled bet ($0.32) returned to 4d9fee85
*** SHOWDOWN ***
4d9fee85 collected $0.21 from pot
*** SUMMARY ***
Total pot $0.22 | Rake $0.01 | Jackpot $0 | Bingo $0 | Fortune $0 | Tax $0
Seat 1: Hero folded before Flop
Seat 2: cffc4953 folded before Flop (didn't bet)
Seat 3: 9d71d622 (button) folded before Flop (didn't bet)
Seat 4: b14d35ee (small blind) folded before Flop
Seat 5: 4d9fee85 (big blind) collected ($0.21)
Seat 6: b638e924 folded before Flop (didn't bet)


Poker Hand #HD1738742400: Hold'em No Limit ($0.02/$0.05) - 2024/04/20 14:22:40
Table 'NLHBlue13' 6-max Seat #2 is the button
Seat 1: Hero ($7.32 in chips)
Seat 2: cffc4953 ($6.4 in chips)
Seat 3: 9d71d622 ($3.19 in chips)
Seat 4: b14d35ee ($6.68 in chips)
Seat 5: 4d9fee85 ($5.8 in chips)
Seat 6: b638e924 ($5.86 in chips)
9d71d622: posts small blind $0.02
b14d35ee: posts big blind $0.05
*** HOLE CARDS ***
Dealt to Hero [Kc 9h]
Dealt to cffc4953 
Dealt to 9d71d622 
Dealt to b14d35ee 
Dealt to 4d9fee85 
Dealt to b638e924 
4d9fee85: folds
b638e924: raises $0.1 to $0.15
Hero: folds
cffc4953: folds
9d71d622: calls $0.13
b14d35ee: folds
*** FLOP *** [7s 3d Jc]
9d71d622: checks
b638e924: bets $0.18
9d71d622: folds
Uncalled bet ($0.18) returned to b638e924
*** SHOWDOWN ***
b638e924 collected $0.34 from pot
*** SUMMARY ***
Total pot $0.35 | Rake $0.01 | Jackpot $0 | Bingo $0 | Fortune $0 | Tax $0
Board [7s 3d Jc]
Seat 1: Hero folded before Flop (didn't bet)
Seat 2: cffc4953 (button) folded before Flop (didn't bet)
Seat 3: 9d71d622 (small blind) folded on the Flop
Seat 4: b14d35ee (big blind) folded before Flop
Seat 5: 4d9fee85 folded before Flop (didn't bet)
Seat 6: b638e924 won ($0.34)


Poker Hand #HD1738742369: Hold'em No Limit ($0.02/$0.05) - 2024/04/20 14:22:21
Table 'NLHBlue13' 6-max Seat #1 is the button
Seat 1: Hero ($7.32 in chips)
Seat 2: cffc4953 ($6.42 in chips)
Seat 3: 9d71d622 ($3.24 in chips)
Seat 4: b14d35ee ($6.68 in chips)
Seat 5: 4d9fee85 ($5.8 in chips)
Seat 6: b638e924 ($5.79 in chips)
cffc4953: posts small blind $0.02
9d71d622: posts big blind $0.05
*** HOLE CARDS ***
Dealt to Hero [9c Th]
Dealt to cffc4953 
Dealt to 9d71d622 
Dealt to b14d35ee 
Dealt to 4d9fee85 
Dealt to b638e924 
b14d35ee: folds
4d9fee85: folds
b638e924: raises $0.1 to $0.15
Hero: folds
cffc4953: folds
9d71d622: folds
Uncalled bet ($0.1) returned to b638e924
*** SHOWDOWN ***
b638e924 collected $0.12 from pot
*** SUMMARY ***
Total pot $0.12 | Rake $0 | Jackpot $0 | Bingo $0 | Fortune $0 | Tax $0
Seat 1: Hero (button) folded before Flop (didn't bet)
Seat 2: cffc4953 (small blind) folded before Flop
Seat 3: 9d71d622 (big blind) folded before Flop
Seat 4: b14d35ee folded before Flop (didn't bet)
Seat 5: 4d9fee85 folded before Flop (didn't bet)
Seat 6: b638e924 collected ($0.12)


Poker Hand #HD1738742285: Hold'em No Limit ($0.02/$0.05) - 2024/04/20 14:21:34
Table 'NLHBlue13' 6-max Seat #6 is the button
Seat 1: Hero ($7.34 in chips)
Seat 2: cffc4953 ($6.47 in chips)
Seat 3: 9d71d622 ($3.24 in chips)
Seat 4: b14d35ee ($6.68 in chips)
Seat 5: 4d9fee85 ($5.61 in chips)
Seat 6: b638e924 ($5.92 in chips)
Hero: posts small blind $0.02
cffc4953: posts big blind $0.05
*** HOLE CARDS ***
Dealt to Hero [6d 7h]
Dealt to cffc4953 
Dealt to 9d71d622 
Dealt to b14d35ee 
Dealt to 4d9fee85 
Dealt to b638e924 
9d71d622: folds
b14d35ee: folds
4d9fee85: raises $0.08 to $0.13
b638e924: calls $0.13
Hero: folds
cffc4953: folds
*** FLOP *** [Kc Ks 8s]
4d9fee85: checks
b638e924: checks
*** TURN *** [Kc Ks 8s] [Jd]
4d9fee85: checks
b638e924: checks
*** RIVER *** [Kc Ks 8s Jd] [4h]
4d9fee85: bets $0.79
b638e924: folds
Uncalled bet ($0.79) returned to 4d9fee85
*** SHOWDOWN ***
4d9fee85 collected $0.32 from pot
*** SUMMARY ***
Total pot $0.33 | Rake $0.01 | Jackpot $0 | Bingo $0 | Fortune $0 | Tax $0
Board [Kc Ks 8s Jd 4h]
Seat 1: Hero (small blind) folded before Flop
Seat 2: cffc4953 (big blind) folded before Flop
Seat 3: 9d71d622 folded before Flop (didn't bet)
Seat 4: b14d35ee folded before Flop (didn't bet)
Seat 5: 4d9fee85 won ($0.32)
Seat 6: b638e924 (button) folded on the River


Poker Hand #HD1738742173: Hold'em No Limit ($0.02/$0.05) - 2024/04/20 14:20:37
Table 'NLHBlue13' 6-max Seat #5 is the button
Seat 1: Hero ($7.39 in chips)
Seat 2: cffc4953 ($6.47 in chips)
Seat 3: 9d71d622 ($3.51 in chips)
Seat 4: b14d35ee ($6.68 in chips)
Seat 5: 4d9fee85 ($5.3 in chips)
Seat 6: b638e924 ($5.94 in chips)
b638e924: posts small blind $0.02
Hero: posts big blind $0.05
*** HOLE CARDS ***
Dealt to Hero [8h 4h]
Dealt to cffc4953 
Dealt to 9d71d622 
Dealt to b14d35ee 
Dealt to 4d9fee85 
Dealt to b638e924 
cffc4953: folds
9d71d622: calls $0.05
b14d35ee: folds
4d9fee85: calls $0.05
b638e924: folds
Hero: checks
*** FLOP *** [Ts 3c 5s]
Hero: checks
9d71d622: bets $0.06
4d9fee85: calls $0.06
Hero: folds
*** TURN *** [Ts 3c 5s] [4d]
9d71d622: checks
4d9fee85: bets $0.16
9d71d622: calls $0.16
*** RIVER *** [Ts 3c 5s 4d] [5c]
9d71d622: checks
4d9fee85: checks
9d71d622: shows [Ks 6s] (Pair of Fives)
4d9fee85: shows [Th Jc] (Pair of Tens and Pair of Fives)
*** SHOWDOWN ***
4d9fee85 collected $0.58 from pot
*** SUMMARY ***
Total pot $0.61 | Rake $0.03 | Jackpot $0 | Bingo $0 | Fortune $0 | Tax $0
Board [Ts 3c 5s 4d 5c]
Seat 1: Hero (big blind) folded on the Flop
Seat 2: cffc4953 folded before Flop (didn't bet)
Seat 3: 9d71d622 showed [Ks 6s] and lost with Pair of Fives
Seat 4: b14d35ee folded before Flop (didn't bet)
Seat 5: 4d9fee85 (button) showed [Th Jc] and won ($0.58) with Pair of Tens and Pair of Fives
Seat 6: b638e924 (small blind) folded before Flop


Poker Hand #HD1738742096: Hold'em No Limit ($0.02/$0.05) - 2024/04/20 14:19:56
Table 'NLHBlue13' 6-max Seat #4 is the button
Seat 1: Hero ($7.39 in chips)
Seat 2: cffc4953 ($6.57 in chips)
Seat 3: 9d71d622 ($3.51 in chips)
Seat 4: b14d35ee ($6.68 in chips)
Seat 5: 4d9fee85 ($5.11 in chips)
Seat 6: b638e924 ($6.04 in chips)
4d9fee85: posts small blind $0.02
b638e924: posts big blind $0.05
*** HOLE CARDS ***
Dealt to Hero [9c 7c]
Dealt to cffc4953 
Dealt to 9d71d622 
Dealt to b14d35ee 
Dealt to 4d9fee85 
Dealt to b638e924 
Hero: folds
cffc4953: raises $0.05 to $0.1
9d71d622: folds
b14d35ee: folds
4d9fee85: calls $0.08
b638e924: calls $0.05
*** FLOP *** [2h 5c Jh]
4d9fee85: checks
b638e924: checks
cffc4953: checks
*** TURN *** [2h 5c Jh] [8d]
4d9fee85: checks
b638e924: checks
cffc4953: checks
*** RIVER *** [2h 5c Jh 8d] [4d]
4d9fee85: bets $0.3
b638e924: folds
cffc4953: folds
Uncalled bet ($0.3) returned to 4d9fee85
*** SHOWDOWN ***
4d9fee85 collected $0.29 from pot
*** SUMMARY ***
Total pot $0.3 | Rake $0.01 | Jackpot $0 | Bingo $0 | Fortune $0 | Tax $0
Board [2h 5c Jh 8d 4d]
Seat 1: Hero folded before Flop (didn't bet)
Seat 2: cffc4953 folded on the River
Seat 3: 9d71d622 folded before Flop (didn't bet)
Seat 4: b14d35ee (button) folded before Flop (didn't bet)
Seat 5: 4d9fee85 (small blind) won ($0.29)
Seat 6: b638e924 (big blind) folded on the River


Poker Hand #HD1738742045: Hold'em No Limit ($0.02/$0.05) - 2024/04/20 14:19:25
Table 'NLHBlue13' 6-max Seat #3 is the button
Seat 1: Hero ($7.39 in chips)
Seat 2: cffc4953 ($6.57 in chips)
Seat 3: 9d71d622 ($3.51 in chips)
Seat 4: b14d35ee ($6.7 in chips)
Seat 5: 4d9fee85 ($5.26 in chips)
Seat 6: b638e924 ($5.88 in chips)
b14d35ee: posts small blind $0.02
4d9fee85: posts big blind $0.05
*** HOLE CARDS ***
Dealt to Hero [Qs 6d]
Dealt to cffc4953 
Dealt to 9d71d622 
Dealt to b14d35ee 
Dealt to 4d9fee85 
Dealt to b638e924 
b638e924: calls $0.05
Hero: folds
cffc4953: folds
9d71d622: folds
b14d35ee: folds
4d9fee85: checks
*** FLOP *** [Td Qd Jd]
4d9fee85: checks
b638e924: checks
*** TURN *** [Td Qd Jd] [As]
4d9fee85: checks
b638e924: bets $0.05
4d9fee85: calls $0.05
*** RIVER *** [Td Qd Jd As] [Tc]
4d9fee85: checks
b638e924: bets $0.05
4d9fee85: calls $0.05
b638e924: shows [Kh Th] (Aces-High Straight)
4d9fee85: shows [Ac 3h] (Pair of Aces and Pair of Tens)
*** SHOWDOWN ***
b638e924 collected $0.31 from pot
*** SUMMARY ***
Total pot $0.32 | Rake $0.01 | Jackpot $0 | Bingo $0 | Fortune $0 | Tax $0
Board [Td Qd Jd As Tc]
Seat 1: Hero folded before Flop (didn't bet)
Seat 2: cffc4953 folded before Flop (didn't bet)
Seat 3: 9d71d622 (button) folded before Flop (didn't bet)
Seat 4: b14d35ee (small blind) folded before Flop
Seat 5: 4d9fee85 (big blind) showed [Ac 3h] and lost with Pair of Aces and Pair of Tens
Seat 6: b638e924 showed [Kh Th] and won ($0.31) with Aces-High Straight


Poker Hand #HD1738741995: Hold'em No Limit ($0.02/$0.05) - 2024/04/20 14:18:57
Table 'NLHBlue13' 6-max Seat #2 is the button
Seat 1: Hero ($7.39 in chips)
Seat 2: cffc4953 ($6.43 in chips)
Seat 3: 9d71d622 ($3.61 in chips)
Seat 4: b14d35ee ($6.75 in chips)
Seat 5: 4d9fee85 ($5.26 in chips)
Seat 6: b638e924 ($5.88 in chips)
9d71d622: posts small blind $0.02
b14d35ee: posts big blind $0.05
*** HOLE CARDS ***
Dealt to Hero [2c 5d]
Dealt to cffc4953 
Dealt to 9d71d622 
Dealt to b14d35ee 
Dealt to 4d9fee85 
Dealt to b638e924 
4d9fee85: folds
b638e924: folds
Hero: folds
cffc4953: raises $0.05 to $0.1
9d71d622: calls $0.08
b14d35ee: folds
*** FLOP *** [2h Ah 7h]
9d71d622: checks
cffc4953: bets $0.13
9d71d622: folds
Uncalled bet ($0.13) returned to cffc4953
*** SHOWDOWN ***
cffc4953 collected $0.24 from pot
*** SUMMARY ***
Total pot $0.25 | Rake $0.01 | Jackpot $0 | Bingo $0 | Fortune $0 | Tax $0
Board [2h Ah 7h]
Seat 1: Hero folded before Flop (didn't bet)
Seat 2: cffc4953 (button) won ($0.24)
Seat 3: 9d71d622 (small blind) folded on the Flop
Seat 4: b14d35ee (big blind) folded before Flop
Seat 5: 4d9fee85 folded before Flop (didn't bet)
Seat 6: b638e924 folded before Flop (didn't bet)


Poker Hand #HD1738741969: Hold'em No Limit ($0.02/$0.05) - 2024/04/20 14:18:45
Table 'NLHBlue13' 6-max Seat #1 is the button
Seat 1: Hero ($7.39 in chips)
Seat 2: cffc4953 ($6.45 in chips)
Seat 3: 9d71d622 ($3.59 in chips)
Seat 4: b14d35ee ($6.75 in chips)
Seat 5: 4d9fee85 ($5.26 in chips)
Seat 6: b638e924 ($5.88 in chips)
cffc4953: posts small blind $0.02
9d71d622: posts big blind $0.05
*** HOLE CARDS ***
Dealt to Hero [8d 3s]
Dealt to cffc4953 
Dealt to 9d71d622 
Dealt to b14d35ee 
Dealt to 4d9fee85 
Dealt to b638e924 
b14d35ee: folds
4d9fee85: folds
b638e924: folds
Hero: folds
cffc4953: folds
Uncalled bet ($0.03) returned to 9d71d622
*** SHOWDOWN ***
9d71d622 collected $0.04 from pot
*** SUMMARY ***
Total pot $0.04 | Rake $0 | Jackpot $0 | Bingo $0 | Fortune $0 | Tax $0
Seat 1: Hero (button) folded before Flop (didn't bet)
Seat 2: cffc4953 (small blind) folded before Flop
Seat 3: 9d71d622 (big blind) collected ($0.04)
Seat 4: b14d35ee folded before Flop (didn't bet)
Seat 5: 4d9fee85 folded before Flop (didn't bet)
Seat 6: b638e924 folded before Flop (didn't bet)


Poker Hand #HD1738741899: Hold'em No Limit ($0.02/$0.05) - 2024/04/20 14:17:59
Table 'NLHBlue13' 6-max Seat #6 is the button
Seat 1: Hero ($7.41 in chips)
Seat 2: cffc4953 ($6.5 in chips)
Seat 3: 9d71d622 ($3.39 in chips)
Seat 4: b14d35ee ($6.75 in chips)
Seat 5: 4d9fee85 ($5.26 in chips)
Seat 6: b638e924 ($6.02 in chips)
Hero: posts small blind $0.02
cffc4953: posts big blind $0.05
*** HOLE CARDS ***
Dealt to Hero [Ts 8s]
Dealt to cffc4953 
Dealt to 9d71d622 
Dealt to b14d35ee 
Dealt to 4d9fee85 
Dealt to b638e924 
9d71d622: calls $0.05
b14d35ee: folds
4d9fee85: folds
b638e924: raises $0.09 to $0.14
Hero: folds
cffc4953: folds
9d71d622: calls $0.09
*** FLOP *** [5c 3h 4c]
9d71d622: checks
b638e924: checks
*** TURN *** [5c 3h 4c] [Qc]
9d71d622: checks
b638e924: checks
*** RIVER *** [5c 3h 4c Qc] [6h]
9d71d622: bets $0.12
b638e924: folds
Uncalled bet ($0.12) returned to 9d71d622
*** SHOWDOWN ***
9d71d622 collected $0.34 from pot
*** SUMMARY ***
Total pot $0.35 | Rake $0.01 | Jackpot $0 | Bingo $0 | Fortune $0 | Tax $0
Board [5c 3h 4c Qc 6h]
Seat 1: Hero (small blind) folded before Flop
Seat 2: cffc4953 (big blind) folded before Flop
Seat 3: 9d71d622 won ($0.34)
Seat 4: b14d35ee folded before Flop (didn't bet)
Seat 5: 4d9fee85 folded before Flop (didn't bet)
Seat 6: b638e924 (button) folded on the River


Poker Hand #HD1738741873: Hold'em No Limit ($0.02/$0.05) - 2024/04/20 14:17:45
Table 'NLHBlue13' 6-max Seat #5 is the button
Seat 1: Hero ($7.46 in chips)
Seat 2: cffc4953 ($6.5 in chips)
Seat 3: 9d71d622 ($3.39 in chips)
Seat 4: b14d35ee ($6.75 in chips)
Seat 5: 4d9fee85 ($5.26 in chips)
Seat 6: b638e924 ($5.97 in chips)
b638e924: posts small blind $0.02
Hero: posts big blind $0.05
*** HOLE CARDS ***
Dealt to Hero [Ks 5c]
Dealt to cffc4953 
Dealt to 9d71d622 
Dealt to b14d35ee 
Dealt to 4d9fee85 
Dealt to b638e924 
cffc4953: folds
9d71d622: folds
b14d35ee: folds
4d9fee85: folds
b638e924: raises $0.05 to $0.1
Hero: folds
Uncalled bet ($0.05) returned to b638e924
*** SHOWDOWN ***
b638e924 collected $0.1 from pot
*** SUMMARY ***
Total pot $0.1 | Rake $0 | Jackpot $0 | Bingo $0 | Fortune $0 | Tax $0
Seat 1: Hero (big blind) folded before Flop
Seat 2: cffc4953 folded before Flop (didn't bet)
Seat 3: 9d71d622 folded before Flop (didn't bet)
Seat 4: b14d35ee folded before Flop (didn't bet)
Seat 5: 4d9fee85 (button) folded before Flop (didn't bet)
Seat 6: b638e924 (small blind) collected ($0.1)


Poker Hand #HD1738741849: Hold'em No Limit ($0.02/$0.05) - 2024/04/20 14:17:35
Table 'NLHBlue13' 6-max Seat #4 is the button
Seat 1: Hero ($7.46 in chips)
Seat 2: cffc4953 ($6.5 in chips)
Seat 3: 9d71d622 ($3.39 in chips)
Seat 4: b14d35ee ($6.75 in chips)
Seat 5: 4d9fee85 ($5.28 in chips)
Seat 6: b638e924 ($5.95 in chips)
4d9fee85: posts small blind $0.02
b638e924: posts big blind $0.05
*** HOLE CARDS ***
Dealt to Hero [Jd 5s]
Dealt to cffc4953 
Dealt to 9d71d622 
Dealt to b14d35ee 
Dealt to 4d9fee85 
Dealt to b638e924 
Hero: folds
cffc4953: folds
9d71d622: folds
b14d35ee: folds
4d9fee85: folds
Uncalled bet ($0.03) returned to b638e924
*** SHOWDOWN ***
b638e924 collected $0.04 from pot
*** SUMMARY ***
Total pot $0.04 | Rake $0 | Jackpot $0 | Bingo $0 | Fortune $0 | Tax $0
Seat 1: Hero folded before Flop (didn't bet)
Seat 2: cffc4953 folded before Flop (didn't bet)
Seat 3: 9d71d622 folded before Flop (didn't bet)
Seat 4: b14d35ee (button) folded before Flop (didn't bet)
Seat 5: 4d9fee85 (small blind) folded before Flop
Seat 6: b638e924 (big blind) collected ($0.04)


Poker Hand #HD1738741811: Hold'em No Limit ($0.02/$0.05) - 2024/04/20 14:17:07
Table 'NLHBlue13' 6-max Seat #3 is the button
Seat 1: Hero ($7.46 in chips)
Seat 2: cffc4953 ($6.5 in chips)
Seat 3: 9d71d622 ($3.32 in chips)
Seat 4: b14d35ee ($6.77 in chips)
Seat 5: 4d9fee85 ($5.33 in chips)
Seat 6: b638e924 ($5.95 in chips)
b14d35ee: posts small blind $0.02
4d9fee85: posts big blind $0.05
*** HOLE CARDS ***
Dealt to Hero [6h Qs]
Dealt to cffc4953 
Dealt to 9d71d622 
Dealt to b14d35ee 
Dealt to 4d9fee85 
Dealt to b638e924 
b638e924: folds
Hero: folds
cffc4953: folds
9d71d622: calls $0.05
b14d35ee: folds
4d9fee85: checks
*** FLOP *** [Td 7h Jd]
4d9fee85: checks
9d71d622: bets $0.06
4d9fee85: folds
Uncalled bet ($0.06) returned to 9d71d622
*** SHOWDOWN ***
9d71d622 collected $0.12 from pot
*** SUMMARY ***
Total pot $0.12 | Rake $0 | Jackpot $0 | Bingo $0 | Fortune $0 | Tax $0
Board [Td 7h Jd]
Seat 1: Hero folded before Flop (didn't bet)
Seat 2: cffc4953 folded before Flop (didn't bet)
Seat 3: 9d71d622 (button) won ($0.12)
Seat 4: b14d35ee (small blind) folded before Flop
Seat 5: 4d9fee85 (big blind) folded on the Flop
Seat 6: b638e924 folded before Flop (didn't bet)


Poker Hand #HD1738741742: Hold'em No Limit ($0.02/$0.05) - 2024/04/20 14:16:26
Table 'NLHBlue13' 6-max Seat #2 is the button
Seat 1: Hero ($7.46 in chips)
Seat 2: cffc4953 ($6.5 in chips)
Seat 3: 9d71d622 ($4.09 in chips)
Seat 4: b14d35ee ($6.12 in chips)
Seat 5: 4d9fee85 ($5.33 in chips)
Seat 6: b638e924 ($5.95 in chips)
9d71d622: posts small blind $0.02
b14d35ee: posts big blind $0.05
*** HOLE CARDS ***
Dealt to Hero [Jc 6c]
Dealt to cffc4953 
Dealt to 9d71d622 
Dealt to b14d35ee 
Dealt to 4d9fee85 
Dealt to b638e924 
4d9fee85: folds
b638e924: folds
Hero: folds
cffc4953: folds
9d71d622: calls $0.03
b14d35ee: checks
*** FLOP *** [9s 4c 4d]
9d71d622: bets $0.05
b14d35ee: calls $0.05
*** TURN *** [9s 4c 4d] [2h]
9d71d622: bets $0.07
b14d35ee: calls $0.07
*** RIVER *** [9s 4c 4d 2h] [5d]
9d71d622: checks
b14d35ee: bets $0.6
9d71d622: calls $0.6
b14d35ee: shows [Qs 4h] (Three Fours)
9d71d622: shows [7c 9c] (Pair of Nines and Pair of Fours)
*** SHOWDOWN ***
b14d35ee collected $1.42 from pot
*** SUMMARY ***
Total pot $1.54 | Rake $0.07 | Jackpot $0.05 | Bingo $0 | Fortune $0 | Tax $0
Board [9s 4c 4d 2h 5d]
Seat 1: Hero folded before Flop (didn't bet)
Seat 2: cffc4953 (button) folded before Flop (didn't bet)
Seat 3: 9d71d622 (small blind) showed [7c 9c] and lost with Pair of Nines and Pair of Fours
Seat 4: b14d35ee (big blind) showed [Qs 4h] and won ($1.42) with Three Fours
Seat 5: 4d9fee85 folded before Flop (didn't bet)
Seat 6: b638e924 folded before Flop (didn't bet)


Poker Hand #HD1738741719: Hold'em No Limit ($0.02/$0.05) - 2024/04/20 14:16:16
Table 'NLHBlue13' 6-max Seat #1 is the button
Seat 1: Hero ($7.46 in chips)
Seat 2: cffc4953 ($6.52 in chips)
Seat 3: 9d71d622 ($4.07 in chips)
Seat 4: b14d35ee ($6.12 in chips)
Seat 5: 4d9fee85 ($5.33 in chips)
Seat 6: b638e924 ($5.95 in chips)
cffc4953: posts small blind $0.02
9d71d622: posts big blind $0.05
*** HOLE CARDS ***
Dealt to Hero [Kd 2c]
Dealt to cffc4953 
Dealt to 9d71d622 
Dealt to b14d35ee 
Dealt to 4d9fee85 
Dealt to b638e924 
b14d35ee: folds
4d9fee85: folds
b638e924: folds
Hero: folds
cffc4953: folds
Uncalled bet ($0.03) returned to 9d71d622
*** SHOWDOWN ***
9d71d622 collected $0.04 from pot
*** SUMMARY ***
Total pot $0.04 | Rake $0 | Jackpot $0 | Bingo $0 | Fortune $0 | Tax $0
Seat 1: Hero (button) folded before Flop (didn't bet)
Seat 2: cffc4953 (small blind) folded before Flop
Seat 3: 9d71d622 (big blind) collected ($0.04)
Seat 4: b14d35ee folded before Flop (didn't bet)
Seat 5: 4d9fee85 folded before Flop (didn't bet)
Seat 6: b638e924 folded before Flop (didn't bet)


Poker Hand #HD1738741695: Hold'em No Limit ($0.02/$0.05) - 2024/04/20 14:15:57
Table 'NLHBlue13' 6-max Seat #6 is the button
Seat 1: Hero ($7.48 in chips)
Seat 2: cffc4953 ($6.57 in chips)
Seat 3: 9d71d622 ($4.07 in chips)
Seat 4: b14d35ee ($6.12 in chips)
Seat 5: 4d9fee85 ($5.33 in chips)
Seat 6: b638e924 ($5.88 in chips)
Hero: posts small blind $0.02
cffc4953: posts big blind $0.05
*** HOLE CARDS ***
Dealt to Hero [9d Ac]
Dealt to cffc4953 
Dealt to 9d71d622 
Dealt to b14d35ee 
Dealt to 4d9fee85 
Dealt to b638e924 
9d71d622: folds
b14d35ee: folds
4d9fee85: folds
b638e924: raises $0.05 to $0.1
Hero: folds
cffc4953: folds
Uncalled bet ($0.05) returned to b638e924
*** SHOWDOWN ***
b638e924 collected $0.12 from pot
*** SUMMARY ***
Total pot $0.12 | Rake $0 | Jackpot $0 | Bingo $0 | Fortune $0 | Tax $0
Seat 1: Hero (small blind) folded before Flop
Seat 2: cffc4953 (big blind) folded before Flop
Seat 3: 9d71d622 folded before Flop (didn't bet)
Seat 4: b14d35ee folded before Flop (didn't bet)
Seat 5: 4d9fee85 folded before Flop (didn't bet)
Seat 6: b638e924 (button) collected ($0.12)


Poker Hand #HD1738741657: Hold'em No Limit ($0.02/$0.05) - 2024/04/20 14:15:38
Table 'NLHBlue13' 6-max Seat #5 is the button
Seat 1: Hero ($7.53 in chips)
Seat 2: cffc4953 ($6.57 in chips)
Seat 3: 9d71d622 ($4.07 in chips)
Seat 4: b14d35ee ($6.05 in chips)
Seat 5: 4d9fee85 ($5.33 in chips)
Seat 6: b638e924 ($5.9 in chips)
b638e924: posts small blind $0.02
Hero: posts big blind $0.05
*** HOLE CARDS ***
Dealt to Hero [9d 4s]
Dealt to cffc4953 
Dealt to 9d71d622 
Dealt to b14d35ee 
Dealt to 4d9fee85 
Dealt to b638e924 
cffc4953: folds
9d71d622: folds
b14d35ee: raises $0.08 to $0.13
4d9fee85: folds
b638e924: folds
Hero: folds
Uncalled bet ($0.08) returned to b14d35ee
*** SHOWDOWN ***
b14d35ee collected $0.12 from pot
*** SUMMARY ***
Total pot $0.12 | Rake $0 | Jackpot $0 | Bingo $0 | Fortune $0 | Tax $0
Seat 1: Hero (big blind) folded before Flop
Seat 2: cffc4953 folded before Flop (didn't bet)
Seat 3: 9d71d622 folded before Flop (didn't bet)
Seat 4: b14d35ee collected ($0.12)
Seat 5: 4d9fee85 (button) folded before Flop (didn't bet)
Seat 6: b638e924 (small blind) folded before Flop


Poker Hand #HD1738741570: Hold'em No Limit ($0.02/$0.05) - 2024/04/20 14:14:41
Table 'NLHBlue13' 6-max Seat #4 is the button
Seat 1: Hero ($7.53 in chips)
Seat 3: 9d71d622 ($4.07 in chips)
Seat 4: b14d35ee ($6.18 in chips)
Seat 5: 4d9fee85 ($5.09 in chips)
Seat 6: b638e924 ($6.03 in chips)
4d9fee85: posts small blind $0.02
b638e924: posts big blind $0.05
*** HOLE CARDS ***
Dealt to Hero [Ks 8c]
Dealt to 9d71d622 
Dealt to b14d35ee 
Dealt to 4d9fee85 
Dealt to b638e924 
Hero: folds
9d71d622: folds
b14d35ee: raises $0.08 to $0.13
4d9fee85: calls $0.11
b638e924: calls $0.08
*** FLOP *** [8h Ts 9d]
4d9fee85: checks
b638e924: checks
b14d35ee: checks
*** TURN *** [8h Ts 9d] [5h]
4d9fee85: bets $0.26
b638e924: folds
b14d35ee: folds
Uncalled bet ($0.26) returned to 4d9fee85
*** SHOWDOWN ***
4d9fee85 collected $0.37 from pot
*** SUMMARY ***
Total pot $0.39 | Rake $0.02 | Jackpot $0 | Bingo $0 | Fortune $0 | Tax $0
Board [8h Ts 9d 5h]
Seat 1: Hero folded before Flop (didn't bet)
Seat 3: 9d71d622 folded before Flop (didn't bet)
Seat 4: b14d35ee (button) folded on the Turn
Seat 5: 4d9fee85 (small blind) won ($0.37)
Seat 6: b638e924 (big blind) folded on the Turn


Poker Hand #HD1738741551: Hold'em No Limit ($0.02/$0.05) - 2024/04/20 14:14:28
Table 'NLHBlue13' 6-max Seat #3 is the button
Seat 1: Hero ($7.53 in chips)
Seat 3: 9d71d622 ($4.07 in chips)
Seat 4: b14d35ee ($6.2 in chips)
Seat 5: 4d9fee85 ($5.07 in chips)
Seat 6: b638e924 ($6.03 in chips)
b14d35ee: posts small blind $0.02
4d9fee85: posts big blind $0.05
*** HOLE CARDS ***
Dealt to Hero [7c 3h]
Dealt to 9d71d622 
Dealt to b14d35ee 
Dealt to 4d9fee85 
Dealt to b638e924 
b638e924: folds
Hero: folds
9d71d622: folds
b14d35ee: folds
Uncalled bet ($0.03) returned to 4d9fee85
*** SHOWDOWN ***
4d9fee85 collected $0.04 from pot
*** SUMMARY ***
Total pot $0.04 | Rake $0 | Jackpot $0 | Bingo $0 | Fortune $0 | Tax $0
Seat 1: Hero folded before Flop (didn't bet)
Seat 3: 9d71d622 (button) folded before Flop (didn't bet)
Seat 4: b14d35ee (small blind) folded before Flop
Seat 5: 4d9fee85 (big blind) collected ($0.04)
Seat 6: b638e924 folded before Flop (didn't bet)


Poker Hand #HD1738741507: Hold'em No Limit ($0.02/$0.05) - 2024/04/20 14:13:58
Table 'NLHBlue13' 6-max Seat #1 is the button
Seat 1: Hero ($7.53 in chips)
Seat 2: cffc4953 ($6.59 in chips)
Seat 3: 9d71d622 ($4.05 in chips)
Seat 4: b14d35ee ($6.2 in chips)
Seat 5: 4d9fee85 ($5.07 in chips)
Seat 6: b638e924 ($6.03 in chips)
cffc4953: posts small blind $0.02
9d71d622: posts big blind $0.05
*** HOLE CARDS ***
Dealt to Hero [2d As]
Dealt to cffc4953 
Dealt to 9d71d622 
Dealt to b14d35ee 
Dealt to 4d9fee85 
Dealt to b638e924 
b14d35ee: folds
4d9fee85: folds
b638e924: folds
Hero: folds
cffc4953: folds
Uncalled bet ($0.03) returned to 9d71d622
*** SHOWDOWN ***
9d71d622 collected $0.04 from pot
*** SUMMARY ***
Total pot $0.04 | Rake $0 | Jackpot $0 | Bingo $0 | Fortune $0 | Tax $0
Seat 1: Hero (button) folded before Flop (didn't bet)
Seat 2: cffc4953 (small blind) folded before Flop
Seat 3: 9d71d622 (big blind) collected ($0.04)
Seat 4: b14d35ee folded before Flop (didn't bet)
Seat 5: 4d9fee85 folded before Flop (didn't bet)
Seat 6: b638e924 folded before Flop (didn't bet)


Poker Hand #HD1738741452: Hold'em No Limit ($0.02/$0.05) - 2024/04/20 14:13:25
Table 'NLHBlue13' 6-max Seat #6 is the button
Seat 1: Hero ($7.55 in chips)
Seat 2: cffc4953 ($6.64 in chips)
Seat 3: 9d71d622 ($3.89 in chips)
Seat 4: b14d35ee ($6.2 in chips)
Seat 5: 4d9fee85 ($5.07 in chips)
Seat 6: b638e924 ($6.13 in chips)
Hero: posts small blind $0.02
cffc4953: posts big blind $0.05
*** HOLE CARDS ***
Dealt to Hero [4h Jc]
Dealt to cffc4953 
Dealt to 9d71d622 
Dealt to b14d35ee 
Dealt to 4d9fee85 
Dealt to b638e924 
9d71d622: raises $0.05 to $0.1
b14d35ee: folds
4d9fee85: folds
b638e924: calls $0.1
Hero: folds
cffc4953: folds
*** FLOP *** [3h 8s 8d]
9d71d622: checks
b638e924: checks
*** TURN *** [3h 8s 8d] [7h]
9d71d622: checks
b638e924: checks
*** RIVER *** [3h 8s 8d 7h] [5d]
9d71d622: bets $0.09
b638e924: folds
Uncalled bet ($0.09) returned to 9d71d622
*** SHOWDOWN ***
9d71d622 collected $0.26 from pot
*** SUMMARY ***
Total pot $0.27 | Rake $0.01 | Jackpot $0 | Bingo $0 | Fortune $0 | Tax $0
Board [3h 8s 8d 7h 5d]
Seat 1: Hero (small blind) folded before Flop
Seat 2: cffc4953 (big blind) folded before Flop
Seat 3: 9d71d622 won ($0.26)
Seat 4: b14d35ee folded before Flop (didn't bet)
Seat 5: 4d9fee85 folded before Flop (didn't bet)
Seat 6: b638e924 (button) folded on the River


Poker Hand #HD1738741435: Hold'em No Limit ($0.02/$0.05) - 2024/04/20 14:13:13
Table 'NLHBlue13' 6-max Seat #5 is the button
Seat 1: Hero ($7.6 in chips)
Seat 2: cffc4953 ($6.64 in chips)
Seat 3: 9d71d622 ($3.89 in chips)
Seat 4: b14d35ee ($6.2 in chips)
Seat 5: 4d9fee85 ($5 in chips)
Seat 6: b638e924 ($6.15 in chips)
b638e924: posts small blind $0.02
Hero: posts big blind $0.05
*** HOLE CARDS ***
Dealt to Hero [Th 7c]
Dealt to cffc4953 
Dealt to 9d71d622 
Dealt to b14d35ee 
Dealt to 4d9fee85 
Dealt to b638e924 
cffc4953: folds
9d71d622: folds
b14d35ee: folds
4d9fee85: raises $0.08 to $0.13
b638e924: folds
Hero: folds
Uncalled bet ($0.08) returned to 4d9fee85
*** SHOWDOWN ***
4d9fee85 collected $0.12 from pot
*** SUMMARY ***
Total pot $0.12 | Rake $0 | Jackpot $0 | Bingo $0 | Fortune $0 | Tax $0
Seat 1: Hero (big blind) folded before Flop
Seat 2: cffc4953 folded before Flop (didn't bet)
Seat 3: 9d71d622 folded before Flop (didn't bet)
Seat 4: b14d35ee folded before Flop (didn't bet)
Seat 5: 4d9fee85 (button) collected ($0.12)
Seat 6: b638e924 (small blind) folded before Flop


Poker Hand #HD1738741417: Hold'em No Limit ($0.02/$0.05) - 2024/04/20 14:13:05
Table 'NLHBlue13' 6-max Seat #4 is the button
Seat 1: Hero ($7.6 in chips)
Seat 2: cffc4953 ($6.64 in chips)
Seat 3: 9d71d622 ($3.89 in chips)
Seat 4: b14d35ee ($6.2 in chips)
Seat 5: 4d9fee85 ($5.02 in chips)
Seat 6: b638e924 ($6.13 in chips)
4d9fee85: posts small blind $0.02
b638e924: posts big blind $0.05
*** HOLE CARDS ***
Dealt to Hero [3s Ts]
Dealt to cffc4953 
Dealt to 9d71d622 
Dealt to b14d35ee 
Dealt to 4d9fee85 
Dealt to b638e924 
Hero: folds
cffc4953: folds
9d71d622: folds
b14d35ee: folds
4d9fee85: folds
Uncalled bet ($0.03) returned to b638e924
*** SHOWDOWN ***
b638e924 collected $0.04 from pot
*** SUMMARY ***
Total pot $0.04 | Rake $0 | Jackpot $0 | Bingo $0 | Fortune $0 | Tax $0
Seat 1: Hero folded before Flop (didn't bet)
Seat 2: cffc4953 folded before Flop (didn't bet)
Seat 3: 9d71d622 folded before Flop (didn't bet)
Seat 4: b14d35ee (button) folded before Flop (didn't bet)
Seat 5: 4d9fee85 (small blind) folded before Flop
Seat 6: b638e924 (big blind) collected ($0.04)


Poker Hand #HD1738741402: Hold'em No Limit ($0.02/$0.05) - 2024/04/20 14:12:56
Table 'NLHBlue13' 6-max Seat #3 is the button
Seat 1: Hero ($7.6 in chips)
Seat 2: cffc4953 ($6.64 in chips)
Seat 3: 9d71d622 ($3.89 in chips)
Seat 4: b14d35ee ($6.22 in chips)
Seat 5: 4d9fee85 ($5 in chips)
Seat 6: b638e924 ($6.13 in chips)
b14d35ee: posts small blind $0.02
4d9fee85: posts big blind $0.05
*** HOLE CARDS ***
Dealt to Hero [3d Jh]
Dealt to cffc4953 
Dealt to 9d71d622 
Dealt to b14d35ee 
Dealt to 4d9fee85 
Dealt to b638e924 
b638e924: folds
Hero: folds
cffc4953: folds
9d71d622: folds
b14d35ee: folds
Uncalled bet ($0.03) returned to 4d9fee85
*** SHOWDOWN ***
4d9fee85 collected $0.04 from pot
*** SUMMARY ***
Total pot $0.04 | Rake $0 | Jackpot $0 | Bingo $0 | Fortune $0 | Tax $0
Seat 1: Hero folded before Flop (didn't bet)
Seat 2: cffc4953 folded before Flop (didn't bet)
Seat 3: 9d71d622 (button) folded before Flop (didn't bet)
Seat 4: b14d35ee (small blind) folded before Flop
Seat 5: 4d9fee85 (big blind) collected ($0.04)
Seat 6: b638e924 folded before Flop (didn't bet)


Poker Hand #HD1738741365: Hold'em No Limit ($0.02/$0.05) - 2024/04/20 14:12:29
Table 'NLHBlue13' 6-max Seat #2 is the button
Seat 1: Hero ($7.6 in chips)
Seat 2: cffc4953 ($6.64 in chips)
Seat 3: 9d71d622 ($4.04 in chips)
Seat 4: b14d35ee ($6.08 in chips)
Seat 5: 4d9fee85 ($2.41 in chips)
Seat 6: b638e924 ($6.13 in chips)
9d71d622: posts small blind $0.02
b14d35ee: posts big blind $0.05
*** HOLE CARDS ***
Dealt to Hero [Qc 5c]
Dealt to cffc4953 
Dealt to 9d71d622 
Dealt to b14d35ee 
Dealt to 4d9fee85 
Dealt to b638e924 
4d9fee85: folds
b638e924: folds
Hero: folds
cffc4953: folds
9d71d622: raises $0.1 to $0.15
b14d35ee: raises $0.45 to $0.6
9d71d622: folds
Uncalled bet ($0.45) returned to b14d35ee
*** SHOWDOWN ***
b14d35ee collected $0.29 from pot
*** SUMMARY ***
Total pot $0.3 | Rake $0.01 | Jackpot $0 | Bingo $0 | Fortune $0 | Tax $0
Seat 1: Hero folded before Flop (didn't bet)
Seat 2: cffc4953 (button) folded before Flop (didn't bet)
Seat 3: 9d71d622 (small blind) folded before Flop
Seat 4: b14d35ee (big blind) collected ($0.29)
Seat 5: 4d9fee85 folded before Flop (didn't bet)
Seat 6: b638e924 folded before Flop (didn't bet)


Poker Hand #HD1738741333: Hold'em No Limit ($0.02/$0.05) - 2024/04/20 14:12:09
Table 'NLHBlue13' 6-max Seat #1 is the button
Seat 1: Hero ($7.6 in chips)
Seat 2: cffc4953 ($6.66 in chips)
Seat 3: 9d71d622 ($4.09 in chips)
Seat 4: b14d35ee ($6.01 in chips)
Seat 5: 4d9fee85 ($2.41 in chips)
Seat 6: b638e924 ($6.13 in chips)
cffc4953: posts small blind $0.02
9d71d622: posts big blind $0.05
*** HOLE CARDS ***
Dealt to Hero [2s Qs]
Dealt to cffc4953 
Dealt to 9d71d622 
Dealt to b14d35ee 
Dealt to 4d9fee85 
Dealt to b638e924 
b14d35ee: raises $0.08 to $0.13
4d9fee85: folds
b638e924: folds
Hero: folds
cffc4953: folds
9d71d622: folds
Uncalled bet ($0.08) returned to b14d35ee
*** SHOWDOWN ***
b14d35ee collected $0.12 from pot
*** SUMMARY ***
Total pot $0.12 | Rake $0 | Jackpot $0 | Bingo $0 | Fortune $0 | Tax $0
Seat 1: Hero (button) folded before Flop (didn't bet)
Seat 2: cffc4953 (small blind) folded before Flop
Seat 3: 9d71d622 (big blind) folded before Flop
Seat 4: b14d35ee collected ($0.12)
Seat 5: 4d9fee85 folded before Flop (didn't bet)
Seat 6: b638e924 folded before Flop (didn't bet)


Poker Hand #HD1738741311: Hold'em No Limit ($0.02/$0.05) - 2024/04/20 14:11:57
Table 'NLHBlue13' 6-max Seat #6 is the button
Seat 1: Hero ($7.62 in chips)
Seat 2: cffc4953 ($6.71 in chips)
Seat 3: 9d71d622 ($4.09 in chips)
Seat 4: b14d35ee ($6.01 in chips)
Seat 5: 4d9fee85 ($2.41 in chips)
Seat 6: b638e924 ($6.06 in chips)
Hero: posts small blind $0.02
cffc4953: posts big blind $0.05
*** HOLE CARDS ***
Dealt to Hero [3h 8h]
Dealt to cffc4953 
Dealt to 9d71d622 
Dealt to b14d35ee 
Dealt to 4d9fee85 
Dealt to b638e924 
9d71d622: folds
b14d35ee: folds
4d9fee85: folds
b638e924: raises $0.05 to $0.1
Hero: folds
cffc4953: folds
Uncalled bet ($0.05) returned to b638e924
*** SHOWDOWN ***
b638e924 collected $0.12 from pot
*** SUMMARY ***
Total pot $0.12 | Rake $0 | Jackpot $0 | Bingo $0 | Fortune $0 | Tax $0
Seat 1: Hero (small blind) folded before Flop
Seat 2: cffc4953 (big blind) folded before Flop
Seat 3: 9d71d622 folded before Flop (didn't bet)
Seat 4: b14d35ee folded before Flop (didn't bet)
Seat 5: 4d9fee85 folded before Flop (didn't bet)
Seat 6: b638e924 (button) collected ($0.12)


Poker Hand #HD1738741134: Hold'em No Limit ($0.02/$0.05) - 2024/04/20 14:10:06
Table 'NLHBlue13' 6-max Seat #5 is the button
Seat 1: Hero ($5.16 in chips)
Seat 2: cffc4953 ($6.71 in chips)
Seat 3: 9d71d622 ($4.09 in chips)
Seat 4: b14d35ee ($6.01 in chips)
Seat 5: 4d9fee85 ($5.17 in chips)
Seat 6: b638e924 ($6.08 in chips)
b638e924: posts small blind $0.02
Hero: posts big blind $0.05
*** HOLE CARDS ***
Dealt to Hero [Qc Jc]
Dealt to cffc4953 
Dealt to 9d71d622 
Dealt to b14d35ee 
Dealt to 4d9fee85 
Dealt to b638e924 
cffc4953: folds
9d71d622: folds
b14d35ee: folds
4d9fee85: raises $0.08 to $0.13
b638e924: folds
Hero: calls $0.08
*** FLOP *** [9c 4c 2h]
Hero: checks
4d9fee85: bets $0.14
Hero: raises $0.31 to $0.45
4d9fee85: calls $0.31
*** TURN *** [9c 4c 2h] [6c]
Hero: bets $0.6
4d9fee85: calls $0.6
*** RIVER *** [9c 4c 2h 6c] [9h]
Hero: bets $1.58
4d9fee85: calls $1.58
Hero: shows [Qc Jc] (Queen High Flush)
4d9fee85: shows [9s 7s] (Three Nines)
*** SHOWDOWN ***
Hero collected $5.22 from pot
*** SUMMARY ***
Total pot $5.54 | Rake $0.27 | Jackpot $0.05 | Bingo $0 | Fortune $0 | Tax $0
Board [9c 4c 2h 6c 9h]
Seat 1: Hero (big blind) showed [Qc Jc] and won ($5.22) with Queen High Flush
Seat 2: cffc4953 folded before Flop (didn't bet)
Seat 3: 9d71d622 folded before Flop (didn't bet)
Seat 4: b14d35ee folded before Flop (didn't bet)
Seat 5: 4d9fee85 (button) showed [9s 7s] and lost with Three Nines
Seat 6: b638e924 (small blind) folded before Flop


Poker Hand #HD1738741100: Hold'em No Limit ($0.02/$0.05) - 2024/04/20 14:09:52
Table 'NLHBlue13' 6-max Seat #4 is the button
Seat 1: Hero ($5.16 in chips)
Seat 2: cffc4953 ($6.71 in chips)
Seat 3: 9d71d622 ($4.09 in chips)
Seat 4: b14d35ee ($6.01 in chips)
Seat 5: 4d9fee85 ($5.12 in chips)
Seat 6: b638e924 ($6.13 in chips)
4d9fee85: posts small blind $0.02
b638e924: posts big blind $0.05
*** HOLE CARDS ***
Dealt to Hero [3c Jc]
Dealt to cffc4953 
Dealt to 9d71d622 
Dealt to b14d35ee 
Dealt to 4d9fee85 
Dealt to b638e924 
Hero: folds
cffc4953: folds
9d71d622: folds
b14d35ee: folds
4d9fee85: raises $0.1 to $0.15
b638e924: folds
Uncalled bet ($0.1) returned to 4d9fee85
*** SHOWDOWN ***
4d9fee85 collected $0.1 from pot
*** SUMMARY ***
Total pot $0.1 | Rake $0 | Jackpot $0 | Bingo $0 | Fortune $0 | Tax $0
Seat 1: Hero folded before Flop (didn't bet)
Seat 2: cffc4953 folded before Flop (didn't bet)
Seat 3: 9d71d622 folded before Flop (didn't bet)
Seat 4: b14d35ee (button) folded before Flop (didn't bet)
Seat 5: 4d9fee85 (small blind) collected ($0.1)
Seat 6: b638e924 (big blind) folded before Flop


Poker Hand #HD1738741011: Hold'em No Limit ($0.02/$0.05) - 2024/04/20 14:08:58
Table 'NLHBlue13' 6-max Seat #3 is the button
Seat 1: Hero ($5.16 in chips)
Seat 2: cffc4953 ($6.86 in chips)
Seat 3: 9d71d622 ($4.24 in chips)
Seat 4: b14d35ee ($6.03 in chips)
Seat 5: 4d9fee85 ($4.82 in chips)
Seat 6: b638e924 ($6.13 in chips)
b14d35ee: posts small blind $0.02
4d9fee85: posts big blind $0.05
*** HOLE CARDS ***
Dealt to Hero [Qd 2d]
Dealt to cffc4953 
Dealt to 9d71d622 
Dealt to b14d35ee 
Dealt to 4d9fee85 
Dealt to b638e924 
b638e924: folds
Hero: folds
cffc4953: raises $0.05 to $0.1
9d71d622: calls $0.1
b14d35ee: folds
4d9fee85: calls $0.05
*** FLOP *** [5h Tc 9d]
4d9fee85: checks
cffc4953: bets $0.05
9d71d622: calls $0.05
4d9fee85: calls $0.05
*** TURN *** [5h Tc 9d] [9s]
4d9fee85: checks
cffc4953: checks
9d71d622: checks
*** RIVER *** [5h Tc 9d 9s] [3c]
4d9fee85: bets $0.32
cffc4953: folds
9d71d622: folds
Uncalled bet ($0.32) returned to 4d9fee85
*** SHOWDOWN ***
4d9fee85 collected $0.45 from pot
*** SUMMARY ***
Total pot $0.47 | Rake $0.02 | Jackpot $0 | Bingo $0 | Fortune $0 | Tax $0
Board [5h Tc 9d 9s 3c]
Seat 1: Hero folded before Flop (didn't bet)
Seat 2: cffc4953 folded on the River
Seat 3: 9d71d622 (button) folded on the River
Seat 4: b14d35ee (small blind) folded before Flop
Seat 5: 4d9fee85 (big blind) won ($0.45)
Seat 6: b638e924 folded before Flop (didn't bet)


Poker Hand #HD1738740909: Hold'em No Limit ($0.02/$0.05) - 2024/04/20 14:08:01
Table 'NLHBlue13' 6-max Seat #2 is the button
Seat 1: Hero ($5 in chips)
Seat 2: cffc4953 ($6.86 in chips)
Seat 3: 9d71d622 ($4.36 in chips)
Seat 4: b14d35ee ($6.08 in chips)
Seat 5: 4d9fee85 ($4.82 in chips)
Seat 6: b638e924 ($6.13 in chips)
9d71d622: posts small blind $0.02
b14d35ee: posts big blind $0.05
*** HOLE CARDS ***
Dealt to Hero [As Ac]
Dealt to cffc4953 
Dealt to 9d71d622 
Dealt to b14d35ee 
Dealt to 4d9fee85 
Dealt to b638e924 
4d9fee85: folds
b638e924: folds
Hero: raises $0.07 to $0.12
cffc4953: folds
9d71d622: calls $0.1
b14d35ee: folds
*** FLOP *** [Ah 3s 8d]
9d71d622: checks
Hero: checks
*** TURN *** [Ah 3s 8d] [5s]
9d71d622: checks
Hero: bets $0.15
9d71d622: folds
Uncalled bet ($0.15) returned to Hero
*** SHOWDOWN ***
Hero collected $0.28 from pot
*** SUMMARY ***
Total pot $0.29 | Rake $0.01 | Jackpot $0 | Bingo $0 | Fortune $0 | Tax $0
Board [Ah 3s 8d 5s]
Seat 1: Hero won ($0.28)
Seat 2: cffc4953 (button) folded before Flop (didn't bet)
Seat 3: 9d71d622 (small blind) folded on the Turn
Seat 4: b14d35ee (big blind) folded before Flop
Seat 5: 4d9fee85 folded before Flop (didn't bet)
Seat 6: b638e924 folded before Flop (didn't bet)


Poker Hand #HD1738740858: Hold'em No Limit ($0.02/$0.05) - 2024/04/20 14:07:36
Table 'NLHBlue13' 6-max Seat #1 is the button
Seat 1: Hero ($5 in chips)
Seat 2: cffc4953 ($6.88 in chips)
Seat 3: 9d71d622 ($4.51 in chips)
Seat 4: b14d35ee ($6.08 in chips)
Seat 5: 4d9fee85 ($4.82 in chips)
Seat 6: b638e924 ($5.97 in chips)
cffc4953: posts small blind $0.02
9d71d622: posts big blind $0.05
*** HOLE CARDS ***
Dealt to Hero [4s 3s]
Dealt to cffc4953 
Dealt to 9d71d622 
Dealt to b14d35ee 
Dealt to 4d9fee85 
Dealt to b638e924 
b14d35ee: folds
4d9fee85: folds
b638e924: raises $0.1 to $0.15
Hero: folds
cffc4953: folds
9d71d622: calls $0.1
*** FLOP *** [As 7c Qs]
9d71d622: checks
b638e924: bets $0.16
9d71d622: folds
Uncalled bet ($0.16) returned to b638e924
*** SHOWDOWN ***
b638e924 collected $0.31 from pot
*** SUMMARY ***
Total pot $0.32 | Rake $0.01 | Jackpot $0 | Bingo $0 | Fortune $0 | Tax $0
Board [As 7c Qs]
Seat 1: Hero (button) folded before Flop (didn't bet)
Seat 2: cffc4953 (small blind) folded before Flop
Seat 3: 9d71d622 (big blind) folded on the Flop
Seat 4: b14d35ee folded before Flop (didn't bet)
Seat 5: 4d9fee85 folded before Flop (didn't bet)
Seat 6: b638e924 won ($0.31)


Poker Hand #HD1738740792: Hold'em No Limit ($0.02/$0.05) - 2024/04/20 14:06:52
Table 'NLHBlue13' 6-max Seat #6 is the button
Seat 1: Hero ($5 in chips)
Seat 2: cffc4953 ($6.93 in chips)
Seat 3: 9d71d622 ($4.3 in chips)
Seat 4: b14d35ee ($6.08 in chips)
Seat 5: 4d9fee85 ($4.82 in chips)
Seat 6: b638e924 ($6.12 in chips)
Hero: posts small blind $0.02
cffc4953: posts big blind $0.05
*** HOLE CARDS ***
Dealt to Hero [3h 2c]
Dealt to cffc4953 
Dealt to 9d71d622 
Dealt to b14d35ee 
Dealt to 4d9fee85 
Dealt to b638e924 
9d71d622: raises $0.1 to $0.15
b14d35ee: folds
4d9fee85: folds
b638e924: calls $0.15
Hero: folds
cffc4953: folds
*** FLOP *** [4d Kc 4s]
9d71d622: checks
b638e924: checks
*** TURN *** [4d Kc 4s] [Qd]
9d71d622: checks
b638e924: checks
*** RIVER *** [4d Kc 4s Qd] [Js]
9d71d622: bets $0.13
b638e924: folds
Uncalled bet ($0.13) returned to 9d71d622
*** SHOWDOWN ***
9d71d622 collected $0.36 from pot
*** SUMMARY ***
Total pot $0.37 | Rake $0.01 | Jackpot $0 | Bingo $0 | Fortune $0 | Tax $0
Board [4d Kc 4s Qd Js]
Seat 1: Hero (small blind) folded before Flop
Seat 2: cffc4953 (big blind) folded before Flop
Seat 3: 9d71d622 won ($0.36)
Seat 4: b14d35ee folded before Flop (didn't bet)
Seat 5: 4d9fee85 folded before Flop (didn't bet)
Seat 6: b638e924 (button) folded on the River


Poker Hand #HD1738740762: Hold'em No Limit ($0.02/$0.05) - 2024/04/20 14:06:33
Table 'NLHBlue13' 6-max Seat #5 is the button
Seat 1: Hero ($5 in chips)
Seat 2: cffc4953 ($6.86 in chips)
Seat 3: 9d71d622 ($4.3 in chips)
Seat 4: b14d35ee ($6.08 in chips)
Seat 5: 4d9fee85 ($4.82 in chips)
Seat 6: b638e924 ($6.14 in chips)
b638e924: posts small blind $0.02
Hero: posts big blind $0.05
*** HOLE CARDS ***
Dealt to Hero [8h Js]
Dealt to cffc4953 
Dealt to 9d71d622 
Dealt to b14d35ee 
Dealt to 4d9fee85 
Dealt to b638e924 
cffc4953: raises $0.05 to $0.1
9d71d622: folds
b14d35ee: folds
4d9fee85: folds
b638e924: folds
Hero: folds
Uncalled bet ($0.05) returned to cffc4953
*** SHOWDOWN ***
cffc4953 collected $0.12 from pot
*** SUMMARY ***
Total pot $0.12 | Rake $0 | Jackpot $0 | Bingo $0 | Fortune $0 | Tax $0
Seat 1: Hero (big blind) folded before Flop
Seat 2: cffc4953 collected ($0.12)
Seat 3: 9d71d622 folded before Flop (didn't bet)
Seat 4: b14d35ee folded before Flop (didn't bet)
Seat 5: 4d9fee85 (button) folded before Flop (didn't bet)
Seat 6: b638e924 (small blind) folded before Flop


