Poker Hand #HD1755423563: Hold'em No Limit ($0.05/$0.1) - 2024/05/02 14:17:57
Table 'NLHRed26' 6-max Seat #1 is the button
Seat 1: 3731169c ($10 in chips)
Seat 2: 32dabd01 ($16.56 in chips)
Seat 3: eb216520 ($12.84 in chips)
Seat 4: 2af8e2dc ($13.18 in chips)
Seat 5: 41f44c3d ($2 in chips)
Seat 6: Hero ($12.36 in chips)
32dabd01: posts small blind $0.05
eb216520: posts big blind $0.1
*** HOLE CARDS ***
Dealt to 3731169c 
Dealt to 32dabd01 
Dealt to eb216520 
Dealt to 2af8e2dc 
Dealt to 41f44c3d 
Dealt to Hero [6s 2d]
2af8e2dc: raises $0.12 to $0.22
41f44c3d: folds
Hero: folds
3731169c: folds
32dabd01: calls $0.17
eb216520: folds
*** FLOP *** [4d Ad As]
32dabd01: checks
2af8e2dc: bets $0.18
32dabd01: raises $0.3 to $0.48
2af8e2dc: raises $0.74 to $1.22
32dabd01: calls $0.74
*** TURN *** [4d Ad As] [Kh]
32dabd01: checks
2af8e2dc: bets $0.99
32dabd01: calls $0.99
*** RIVER *** [4d Ad As Kh] [9s]
32dabd01: checks
2af8e2dc: checks
32dabd01: shows [8d Jd] (Pair of Aces)
2af8e2dc: shows [Jh Kd] (Pair of Aces and Pair of Kings)
*** SHOWDOWN ***
2af8e2dc collected $4.62 from pot
*** SUMMARY ***
Total pot $4.96 | Rake $0.24 | Jackpot $0.1 | Bingo $0 | Fortune $0 | Tax $0
Board [4d Ad As Kh 9s]
Seat 1: 3731169c (button) folded before Flop (didn't bet)
Seat 2: 32dabd01 (small blind) showed [8d Jd] and lost with Pair of Aces
Seat 3: eb216520 (big blind) folded before Flop
Seat 4: 2af8e2dc showed [Jh Kd] and won ($4.62) with Pair of Aces and Pair of Kings
Seat 5: 41f44c3d folded before Flop (didn't bet)
Seat 6: Hero folded before Flop (didn't bet)


Poker Hand #HD1755423524: Hold'em No Limit ($0.05/$0.1) - 2024/05/02 14:17:32
Table 'NLHRed26' 6-max Seat #6 is the button
Seat 1: 3731169c ($10.05 in chips)
Seat 2: 32dabd01 ($16.51 in chips)
Seat 3: eb216520 ($12.84 in chips)
Seat 4: 2af8e2dc ($13.18 in chips)
Seat 5: 41f44c3d ($2 in chips)
Seat 6: Hero ($12.36 in chips)
3731169c: posts small blind $0.05
32dabd01: posts big blind $0.1
*** HOLE CARDS ***
Dealt to 3731169c 
Dealt to 32dabd01 
Dealt to eb216520 
Dealt to 2af8e2dc 
Dealt to 41f44c3d 
Dealt to Hero [7s Kh]
eb216520: folds
2af8e2dc: folds
41f44c3d: folds
Hero: folds
3731169c: folds
Uncalled bet ($0.05) returned to 32dabd01
*** SHOWDOWN ***
32dabd01 collected $0.1 from pot
*** SUMMARY ***
Total pot $0.1 | Rake $0 | Jackpot $0 | Bingo $0 | Fortune $0 | Tax $0
Seat 1: 3731169c (small blind) folded before Flop
Seat 2: 32dabd01 (big blind) collected ($0.1)
Seat 3: eb216520 folded before Flop (didn't bet)
Seat 4: 2af8e2dc folded before Flop (didn't bet)
Seat 5: 41f44c3d folded before Flop (didn't bet)
Seat 6: Hero (button) folded before Flop (didn't bet)


Poker Hand #HD1755423507: Hold'em No Limit ($0.05/$0.1) - 2024/05/02 14:17:18
Table 'NLHRed26' 6-max Seat #5 is the button
Seat 1: 3731169c ($10.15 in chips)
Seat 2: 32dabd01 ($16.51 in chips)
Seat 3: eb216520 ($12.69 in chips)
Seat 4: 2af8e2dc ($13.18 in chips)
Seat 5: 41f44c3d ($2 in chips)
Seat 6: Hero ($12.41 in chips)
Hero: posts small blind $0.05
3731169c: posts big blind $0.1
*** HOLE CARDS ***
Dealt to 3731169c 
Dealt to 32dabd01 
Dealt to eb216520 
Dealt to 2af8e2dc 
Dealt to 41f44c3d 
Dealt to Hero [9c 3s]
32dabd01: folds
eb216520: raises $0.2 to $0.3
2af8e2dc: folds
41f44c3d: folds
Hero: folds
3731169c: folds
Uncalled bet ($0.2) returned to eb216520
*** SHOWDOWN ***
eb216520 collected $0.25 from pot
*** SUMMARY ***
Total pot $0.25 | Rake $0 | Jackpot $0 | Bingo $0 | Fortune $0 | Tax $0
Seat 1: 3731169c (big blind) folded before Flop
Seat 2: 32dabd01 folded before Flop (didn't bet)
Seat 3: eb216520 collected ($0.25)
Seat 4: 2af8e2dc folded before Flop (didn't bet)
Seat 5: 41f44c3d (button) folded before Flop (didn't bet)
Seat 6: Hero (small blind) folded before Flop


Poker Hand #HD1755423486: Hold'em No Limit ($0.05/$0.1) - 2024/05/02 14:17:03
Table 'NLHRed26' 6-max Seat #4 is the button
Seat 1: 3731169c ($10 in chips)
Seat 2: 32dabd01 ($16.51 in chips)
Seat 3: eb216520 ($12.69 in chips)
Seat 4: 2af8e2dc ($13.18 in chips)
Seat 5: 41f44c3d ($1.96 in chips)
Seat 6: Hero ($12.51 in chips)
41f44c3d: posts small blind $0.05
Hero: posts big blind $0.1
*** HOLE CARDS ***
Dealt to 3731169c 
Dealt to 32dabd01 
Dealt to eb216520 
Dealt to 2af8e2dc 
Dealt to 41f44c3d 
Dealt to Hero [7d As]
3731169c: raises $0.2 to $0.3
32dabd01: folds
eb216520: folds
2af8e2dc: folds
41f44c3d: folds
Hero: folds
Uncalled bet ($0.2) returned to 3731169c
*** SHOWDOWN ***
3731169c collected $0.25 from pot
*** SUMMARY ***
Total pot $0.25 | Rake $0 | Jackpot $0 | Bingo $0 | Fortune $0 | Tax $0
Seat 1: 3731169c collected ($0.25)
Seat 2: 32dabd01 folded before Flop (didn't bet)
Seat 3: eb216520 folded before Flop (didn't bet)
Seat 4: 2af8e2dc (button) folded before Flop (didn't bet)
Seat 5: 41f44c3d (small blind) folded before Flop
Seat 6: Hero (big blind) folded before Flop


Poker Hand #HD1755423411: Hold'em No Limit ($0.05/$0.1) - 2024/05/02 14:16:17
Table 'NLHRed26' 6-max Seat #3 is the button
Seat 1: 3731169c ($10 in chips)
Seat 2: 32dabd01 ($16.64 in chips)
Seat 3: eb216520 ($12.69 in chips)
Seat 4: 2af8e2dc ($13.23 in chips)
Seat 5: 41f44c3d ($2.08 in chips)
Seat 6: Hero ($12.51 in chips)
2af8e2dc: posts small blind $0.05
41f44c3d: posts big blind $0.1
*** HOLE CARDS ***
Dealt to 3731169c 
Dealt to 32dabd01 
Dealt to eb216520 
Dealt to 2af8e2dc 
Dealt to 41f44c3d 
Dealt to Hero [Qd 2s]
Hero: folds
3731169c: folds
32dabd01: raises $0.15 to $0.25
eb216520: folds
2af8e2dc: folds
41f44c3d: raises $1.83 to $2.08 and is all-in
32dabd01: calls $1.83
41f44c3d: shows [Ks Ad]
32dabd01: shows [3d 3s]
*** FIRST FLOP *** [2c 9s 6d]
*** FIRST TURN *** [2c 9s 6d] [Kc]
*** FIRST RIVER *** [2c 9s 6d Kc] [8h]
*** SECOND FLOP *** [3c 6s Qc]
*** SECOND TURN *** [3c 6s Qc] [5d]
*** SECOND RIVER *** [3c 6s Qc 5d] [8c]
*** FIRST SHOWDOWN ***
41f44c3d collected $1.96 from pot
*** SECOND SHOWDOWN ***
32dabd01 collected $1.95 from pot
*** SUMMARY ***
Total pot $4.21 | Rake $0.2 | Jackpot $0.1 | Bingo $0 | Fortune $0 | Tax $0
Hand was run two times
FIRST Board [2c 9s 6d Kc 8h]
SECOND Board [3c 6s Qc 5d 8c]
Seat 1: 3731169c folded before Flop (didn't bet)
Seat 2: 32dabd01 showed [3d 3s] and lost with Pair of Treys, and won ($1.95) with Three Treys
Seat 3: eb216520 (button) folded before Flop (didn't bet)
Seat 4: 2af8e2dc (small blind) folded before Flop
Seat 5: 41f44c3d (big blind) showed [Ks Ad] and won ($1.96) with Pair of Kings, and lost with Ace-High
Seat 6: Hero folded before Flop (didn't bet)


Poker Hand #HD1755423370: Hold'em No Limit ($0.05/$0.1) - 2024/05/02 14:15:47
Table 'NLHRed26' 6-max Seat #2 is the button
Seat 1: 3731169c ($10 in chips)
Seat 2: 32dabd01 ($16.41 in chips)
Seat 3: eb216520 ($12.74 in chips)
Seat 4: 2af8e2dc ($13.43 in chips)
Seat 5: 41f44c3d ($2.08 in chips)
Seat 6: Hero ($12.51 in chips)
eb216520: posts small blind $0.05
2af8e2dc: posts big blind $0.1
*** HOLE CARDS ***
Dealt to 3731169c 
Dealt to 32dabd01 
Dealt to eb216520 
Dealt to 2af8e2dc 
Dealt to 41f44c3d 
Dealt to Hero [8s 3h]
41f44c3d: folds
Hero: folds
3731169c: folds
32dabd01: raises $0.1 to $0.2
eb216520: folds
2af8e2dc: calls $0.1
*** FLOP *** [Jh Th 3d]
2af8e2dc: checks
32dabd01: bets $0.2
2af8e2dc: folds
Uncalled bet ($0.2) returned to 32dabd01
*** SHOWDOWN ***
32dabd01 collected $0.43 from pot
*** SUMMARY ***
Total pot $0.45 | Rake $0.02 | Jackpot $0 | Bingo $0 | Fortune $0 | Tax $0
Board [Jh Th 3d]
Seat 1: 3731169c folded before Flop (didn't bet)
Seat 2: 32dabd01 (button) won ($0.43)
Seat 3: eb216520 (small blind) folded before Flop
Seat 4: 2af8e2dc (big blind) folded on the Flop
Seat 5: 41f44c3d folded before Flop (didn't bet)
Seat 6: Hero folded before Flop (didn't bet)


Poker Hand #HD1755423347: Hold'em No Limit ($0.05/$0.1) - 2024/05/02 14:15:33
Table 'NLHRed26' 6-max Seat #1 is the button
Seat 1: 3731169c ($10 in chips)
Seat 2: 32dabd01 ($16.46 in chips)
Seat 3: eb216520 ($12.69 in chips)
Seat 4: 2af8e2dc ($13.43 in chips)
Seat 5: 41f44c3d ($2.08 in chips)
Seat 6: Hero ($12.51 in chips)
32dabd01: posts small blind $0.05
eb216520: posts big blind $0.1
*** HOLE CARDS ***
Dealt to 3731169c 
Dealt to 32dabd01 
Dealt to eb216520 
Dealt to 2af8e2dc 
Dealt to 41f44c3d 
Dealt to Hero [6h 3c]
2af8e2dc: folds
41f44c3d: folds
Hero: folds
3731169c: folds
32dabd01: folds
Uncalled bet ($0.05) returned to eb216520
*** SHOWDOWN ***
eb216520 collected $0.1 from pot
*** SUMMARY ***
Total pot $0.1 | Rake $0 | Jackpot $0 | Bingo $0 | Fortune $0 | Tax $0
Seat 1: 3731169c (button) folded before Flop (didn't bet)
Seat 2: 32dabd01 (small blind) folded before Flop
Seat 3: eb216520 (big blind) collected ($0.1)
Seat 4: 2af8e2dc folded before Flop (didn't bet)
Seat 5: 41f44c3d folded before Flop (didn't bet)
Seat 6: Hero folded before Flop (didn't bet)


Poker Hand #HD1755423267: Hold'em No Limit ($0.05/$0.1) - 2024/05/02 14:14:44
Table 'NLHRed26' 6-max Seat #6 is the button
Seat 1: 3731169c ($10.1 in chips)
Seat 2: 32dabd01 ($14.06 in chips)
Seat 3: eb216520 ($12.69 in chips)
Seat 4: 2af8e2dc ($13.43 in chips)
Seat 5: 41f44c3d ($2.08 in chips)
Seat 6: Hero ($12.51 in chips)
3731169c: posts small blind $0.05
32dabd01: posts big blind $0.1
*** HOLE CARDS ***
Dealt to 3731169c 
Dealt to 32dabd01 
Dealt to eb216520 
Dealt to 2af8e2dc 
Dealt to 41f44c3d 
Dealt to Hero [4s 7s]
eb216520: folds
2af8e2dc: folds
41f44c3d: folds
Hero: folds
3731169c: raises $0.2 to $0.3
32dabd01: raises $0.6 to $0.9
3731169c: raises $1.27 to $2.17
32dabd01: calls $1.27
*** FLOP *** [8d As 6c]
3731169c: bets $0.6
32dabd01: raises $1.83 to $2.43
3731169c: folds
Uncalled bet ($1.83) returned to 32dabd01
*** SHOWDOWN ***
32dabd01 collected $5.17 from pot
*** SUMMARY ***
Total pot $5.54 | Rake $0.27 | Jackpot $0.1 | Bingo $0 | Fortune $0 | Tax $0
Board [8d As 6c]
Seat 1: 3731169c (small blind) folded on the Flop
Seat 2: 32dabd01 (big blind) won ($5.17)
Seat 3: eb216520 folded before Flop (didn't bet)
Seat 4: 2af8e2dc folded before Flop (didn't bet)
Seat 5: 41f44c3d folded before Flop (didn't bet)
Seat 6: Hero (button) folded before Flop (didn't bet)


Poker Hand #HD1755423242: Hold'em No Limit ($0.05/$0.1) - 2024/05/02 14:14:29
Table 'NLHRed26' 6-max Seat #5 is the button
Seat 1: 3731169c ($10.05 in chips)
Seat 2: 32dabd01 ($14.06 in chips)
Seat 3: eb216520 ($12.69 in chips)
Seat 4: 2af8e2dc ($13.43 in chips)
Seat 5: 41f44c3d ($2.08 in chips)
Seat 6: Hero ($12.56 in chips)
Hero: posts small blind $0.05
3731169c: posts big blind $0.1
*** HOLE CARDS ***
Dealt to 3731169c 
Dealt to 32dabd01 
Dealt to eb216520 
Dealt to 2af8e2dc 
Dealt to 41f44c3d 
Dealt to Hero [4d 3h]
32dabd01: folds
eb216520: folds
2af8e2dc: folds
41f44c3d: folds
Hero: folds
Uncalled bet ($0.05) returned to 3731169c
*** SHOWDOWN ***
3731169c collected $0.1 from pot
*** SUMMARY ***
Total pot $0.1 | Rake $0 | Jackpot $0 | Bingo $0 | Fortune $0 | Tax $0
Seat 1: 3731169c (big blind) collected ($0.1)
Seat 2: 32dabd01 folded before Flop (didn't bet)
Seat 3: eb216520 folded before Flop (didn't bet)
Seat 4: 2af8e2dc folded before Flop (didn't bet)
Seat 5: 41f44c3d (button) folded before Flop (didn't bet)
Seat 6: Hero (small blind) folded before Flop


Poker Hand #HD1755423213: Hold'em No Limit ($0.05/$0.1) - 2024/05/02 14:14:11
Table 'NLHRed26' 6-max Seat #4 is the button
Seat 1: 3731169c ($10.05 in chips)
Seat 2: 32dabd01 ($14.06 in chips)
Seat 3: eb216520 ($12.69 in chips)
Seat 4: 2af8e2dc ($13.28 in chips)
Seat 5: 41f44c3d ($2.13 in chips)
Seat 6: Hero ($12.66 in chips)
41f44c3d: posts small blind $0.05
Hero: posts big blind $0.1
*** HOLE CARDS ***
Dealt to 3731169c 
Dealt to 32dabd01 
Dealt to eb216520 
Dealt to 2af8e2dc 
Dealt to 41f44c3d 
Dealt to Hero [8c 9h]
3731169c: folds
32dabd01: folds
eb216520: folds
2af8e2dc: raises $0.12 to $0.22
41f44c3d: folds
Hero: folds
Uncalled bet ($0.12) returned to 2af8e2dc
*** SHOWDOWN ***
2af8e2dc collected $0.25 from pot
*** SUMMARY ***
Total pot $0.25 | Rake $0 | Jackpot $0 | Bingo $0 | Fortune $0 | Tax $0
Seat 1: 3731169c folded before Flop (didn't bet)
Seat 2: 32dabd01 folded before Flop (didn't bet)
Seat 3: eb216520 folded before Flop (didn't bet)
Seat 4: 2af8e2dc (button) collected ($0.25)
Seat 5: 41f44c3d (small blind) folded before Flop
Seat 6: Hero (big blind) folded before Flop


Poker Hand #HD1755423138: Hold'em No Limit ($0.05/$0.1) - 2024/05/02 14:13:12
Table 'NLHRed26' 6-max Seat #3 is the button
Seat 1: 3731169c ($10.05 in chips)
Seat 2: 32dabd01 ($11.88 in chips)
Seat 3: eb216520 ($15.06 in chips)
Seat 4: 2af8e2dc ($13.33 in chips)
Seat 5: 41f44c3d ($2.23 in chips)
Seat 6: Hero ($12.66 in chips)
2af8e2dc: posts small blind $0.05
41f44c3d: posts big blind $0.1
*** HOLE CARDS ***
Dealt to 3731169c 
Dealt to 32dabd01 
Dealt to eb216520 
Dealt to 2af8e2dc 
Dealt to 41f44c3d 
Dealt to Hero [Kh 3c]
Hero: folds
3731169c: folds
32dabd01: raises $0.15 to $0.25
eb216520: raises $0.65 to $0.9
2af8e2dc: folds
41f44c3d: folds
32dabd01: calls $0.65
*** FLOP *** [Th Tc Qd]
32dabd01: checks
eb216520: checks
*** TURN *** [Th Tc Qd] [7d]
32dabd01: bets $1.47
eb216520: calls $1.47
*** RIVER *** [Th Tc Qd 7d] [3h]
32dabd01: bets $3.67
eb216520: folds
Uncalled bet ($3.67) returned to 32dabd01
*** SHOWDOWN ***
32dabd01 collected $4.55 from pot
*** SUMMARY ***
Total pot $4.89 | Rake $0.24 | Jackpot $0.1 | Bingo $0 | Fortune $0 | Tax $0
Board [Th Tc Qd 7d 3h]
Seat 1: 3731169c folded before Flop (didn't bet)
Seat 2: 32dabd01 won ($4.55)
Seat 3: eb216520 (button) folded on the River
Seat 4: 2af8e2dc (small blind) folded before Flop
Seat 5: 41f44c3d (big blind) folded before Flop
Seat 6: Hero folded before Flop (didn't bet)


Poker Hand #HD1755423097: Hold'em No Limit ($0.05/$0.1) - 2024/05/02 14:12:52
Table 'NLHRed26' 6-max Seat #2 is the button
Seat 1: 3731169c ($10.05 in chips)
Seat 2: 32dabd01 ($11.88 in chips)
Seat 3: eb216520 ($15.11 in chips)
Seat 4: 2af8e2dc ($13.28 in chips)
Seat 5: 41f44c3d ($2.23 in chips)
Seat 6: Hero ($12.66 in chips)
eb216520: posts small blind $0.05
2af8e2dc: posts big blind $0.1
*** HOLE CARDS ***
Dealt to 3731169c 
Dealt to 32dabd01 
Dealt to eb216520 
Dealt to 2af8e2dc 
Dealt to 41f44c3d 
Dealt to Hero [7c 3s]
41f44c3d: folds
Hero: folds
3731169c: folds
32dabd01: folds
eb216520: folds
Uncalled bet ($0.05) returned to 2af8e2dc
*** SHOWDOWN ***
2af8e2dc collected $0.1 from pot
*** SUMMARY ***
Total pot $0.1 | Rake $0 | Jackpot $0 | Bingo $0 | Fortune $0 | Tax $0
Seat 1: 3731169c folded before Flop (didn't bet)
Seat 2: 32dabd01 (button) folded before Flop (didn't bet)
Seat 3: eb216520 (small blind) folded before Flop
Seat 4: 2af8e2dc (big blind) collected ($0.1)
Seat 5: 41f44c3d folded before Flop (didn't bet)
Seat 6: Hero folded before Flop (didn't bet)


Poker Hand #HD1755423023: Hold'em No Limit ($0.05/$0.1) - 2024/05/02 14:12:04
Table 'NLHRed26' 6-max Seat #1 is the button
Seat 1: 3731169c ($10.05 in chips)
Seat 2: 32dabd01 ($12.83 in chips)
Seat 3: eb216520 ($14.25 in chips)
Seat 4: 2af8e2dc ($13.28 in chips)
Seat 5: 41f44c3d ($2.23 in chips)
Seat 6: Hero ($12.66 in chips)
32dabd01: posts small blind $0.05
eb216520: posts big blind $0.1
*** HOLE CARDS ***
Dealt to 3731169c 
Dealt to 32dabd01 
Dealt to eb216520 
Dealt to 2af8e2dc 
Dealt to 41f44c3d 
Dealt to Hero [7s 9c]
2af8e2dc: folds
41f44c3d: folds
Hero: folds
3731169c: folds
32dabd01: raises $0.15 to $0.25
eb216520: raises $0.7 to $0.95
32dabd01: calls $0.7
*** FLOP *** [5c As 6d]
32dabd01: checks
eb216520: bets $0.95
32dabd01: folds
Uncalled bet ($0.95) returned to eb216520
*** SHOWDOWN ***
eb216520 collected $1.81 from pot
*** SUMMARY ***
Total pot $1.9 | Rake $0.09 | Jackpot $0 | Bingo $0 | Fortune $0 | Tax $0
Board [5c As 6d]
Seat 1: 3731169c (button) folded before Flop (didn't bet)
Seat 2: 32dabd01 (small blind) folded on the Flop
Seat 3: eb216520 (big blind) won ($1.81)
Seat 4: 2af8e2dc folded before Flop (didn't bet)
Seat 5: 41f44c3d folded before Flop (didn't bet)
Seat 6: Hero folded before Flop (didn't bet)


Poker Hand #HD1755422988: Hold'em No Limit ($0.05/$0.1) - 2024/05/02 14:11:41
Table 'NLHRed26' 6-max Seat #6 is the button
Seat 1: 3731169c ($10.1 in chips)
Seat 2: 32dabd01 ($12.78 in chips)
Seat 3: eb216520 ($14.25 in chips)
Seat 4: 2af8e2dc ($13.28 in chips)
Seat 5: 41f44c3d ($2.23 in chips)
Seat 6: Hero ($12.66 in chips)
3731169c: posts small blind $0.05
32dabd01: posts big blind $0.1
*** HOLE CARDS ***
Dealt to 3731169c 
Dealt to 32dabd01 
Dealt to eb216520 
Dealt to 2af8e2dc 
Dealt to 41f44c3d 
Dealt to Hero [3h Jd]
eb216520: folds
2af8e2dc: folds
41f44c3d: folds
Hero: folds
3731169c: folds
Uncalled bet ($0.05) returned to 32dabd01
*** SHOWDOWN ***
32dabd01 collected $0.1 from pot
*** SUMMARY ***
Total pot $0.1 | Rake $0 | Jackpot $0 | Bingo $0 | Fortune $0 | Tax $0
Seat 1: 3731169c (small blind) folded before Flop
Seat 2: 32dabd01 (big blind) collected ($0.1)
Seat 3: eb216520 folded before Flop (didn't bet)
Seat 4: 2af8e2dc folded before Flop (didn't bet)
Seat 5: 41f44c3d folded before Flop (didn't bet)
Seat 6: Hero (button) folded before Flop (didn't bet)


Poker Hand #HD1755422921: Hold'em No Limit ($0.05/$0.1) - 2024/05/02 14:10:57
Table 'NLHRed26' 6-max Seat #5 is the button
Seat 1: 3731169c ($10.3 in chips)
Seat 2: 32dabd01 ($12.78 in chips)
Seat 3: eb216520 ($14.25 in chips)
Seat 4: 2af8e2dc ($13.28 in chips)
Seat 5: 41f44c3d ($2 in chips)
Seat 6: Hero ($12.71 in chips)
Hero: posts small blind $0.05
3731169c: posts big blind $0.1
*** HOLE CARDS ***
Dealt to 3731169c 
Dealt to 32dabd01 
Dealt to eb216520 
Dealt to 2af8e2dc 
Dealt to 41f44c3d 
Dealt to Hero [5c Qd]
32dabd01: folds
eb216520: folds
2af8e2dc: folds
41f44c3d: raises $0.1 to $0.2
Hero: folds
3731169c: calls $0.1
*** FLOP *** [Qc Ts Kc]
3731169c: checks
41f44c3d: bets $0.29
3731169c: folds
Uncalled bet ($0.29) returned to 41f44c3d
*** SHOWDOWN ***
41f44c3d collected $0.43 from pot
*** SUMMARY ***
Total pot $0.45 | Rake $0.02 | Jackpot $0 | Bingo $0 | Fortune $0 | Tax $0
Board [Qc Ts Kc]
Seat 1: 3731169c (big blind) folded on the Flop
Seat 2: 32dabd01 folded before Flop (didn't bet)
Seat 3: eb216520 folded before Flop (didn't bet)
Seat 4: 2af8e2dc folded before Flop (didn't bet)
Seat 5: 41f44c3d (button) won ($0.43)
Seat 6: Hero (small blind) folded before Flop


Poker Hand #HD1755422890: Hold'em No Limit ($0.05/$0.1) - 2024/05/02 14:10:37
Table 'NLHRed26' 6-max Seat #4 is the button
Seat 1: 3731169c ($10.3 in chips)
Seat 2: 32dabd01 ($12.78 in chips)
Seat 3: eb216520 ($14.25 in chips)
Seat 4: 2af8e2dc ($13.13 in chips)
Seat 5: 41f44c3d ($1.85 in chips)
Seat 6: Hero ($12.81 in chips)
41f44c3d: posts small blind $0.05
Hero: posts big blind $0.1
*** HOLE CARDS ***
Dealt to 3731169c 
Dealt to 32dabd01 
Dealt to eb216520 
Dealt to 2af8e2dc 
Dealt to 41f44c3d 
Dealt to Hero [Jc Td]
3731169c: folds
32dabd01: folds
eb216520: folds
2af8e2dc: raises $0.12 to $0.22
41f44c3d: folds
Hero: folds
Uncalled bet ($0.12) returned to 2af8e2dc
*** SHOWDOWN ***
2af8e2dc collected $0.25 from pot
*** SUMMARY ***
Total pot $0.25 | Rake $0 | Jackpot $0 | Bingo $0 | Fortune $0 | Tax $0
Seat 1: 3731169c folded before Flop (didn't bet)
Seat 2: 32dabd01 folded before Flop (didn't bet)
Seat 3: eb216520 folded before Flop (didn't bet)
Seat 4: 2af8e2dc (button) collected ($0.25)
Seat 5: 41f44c3d (small blind) folded before Flop
Seat 6: Hero (big blind) folded before Flop


Poker Hand #HD1755422857: Hold'em No Limit ($0.05/$0.1) - 2024/05/02 14:10:14
Table 'NLHRed26' 6-max Seat #3 is the button
Seat 1: 3731169c ($10.3 in chips)
Seat 2: 32dabd01 ($12.78 in chips)
Seat 3: eb216520 ($14.1 in chips)
Seat 4: 2af8e2dc ($13.18 in chips)
Seat 5: 41f44c3d ($1.95 in chips)
Seat 6: Hero ($12.81 in chips)
2af8e2dc: posts small blind $0.05
41f44c3d: posts big blind $0.1
*** HOLE CARDS ***
Dealt to 3731169c 
Dealt to 32dabd01 
Dealt to eb216520 
Dealt to 2af8e2dc 
Dealt to 41f44c3d 
Dealt to Hero [Td 5s]
Hero: folds
3731169c: folds
32dabd01: folds
eb216520: raises $0.2 to $0.3
2af8e2dc: folds
41f44c3d: folds
Uncalled bet ($0.2) returned to eb216520
*** SHOWDOWN ***
eb216520 collected $0.25 from pot
*** SUMMARY ***
Total pot $0.25 | Rake $0 | Jackpot $0 | Bingo $0 | Fortune $0 | Tax $0
Seat 1: 3731169c folded before Flop (didn't bet)
Seat 2: 32dabd01 folded before Flop (didn't bet)
Seat 3: eb216520 (button) collected ($0.25)
Seat 4: 2af8e2dc (small blind) folded before Flop
Seat 5: 41f44c3d (big blind) folded before Flop
Seat 6: Hero folded before Flop (didn't bet)


Poker Hand #HD1755422826: Hold'em No Limit ($0.05/$0.1) - 2024/05/02 14:09:56
Table 'NLHRed26' 6-max Seat #2 is the button
Seat 1: 3731169c ($10.15 in chips)
Seat 2: 32dabd01 ($12.78 in chips)
Seat 3: eb216520 ($14.15 in chips)
Seat 4: 2af8e2dc ($13.28 in chips)
Seat 5: 41f44c3d ($1.95 in chips)
Seat 6: Hero ($12.81 in chips)
eb216520: posts small blind $0.05
2af8e2dc: posts big blind $0.1
*** HOLE CARDS ***
Dealt to 3731169c 
Dealt to 32dabd01 
Dealt to eb216520 
Dealt to 2af8e2dc 
Dealt to 41f44c3d 
Dealt to Hero [9s Jc]
41f44c3d: folds
Hero: folds
3731169c: raises $0.15 to $0.25
32dabd01: folds
eb216520: folds
2af8e2dc: folds
Uncalled bet ($0.15) returned to 3731169c
*** SHOWDOWN ***
3731169c collected $0.25 from pot
*** SUMMARY ***
Total pot $0.25 | Rake $0 | Jackpot $0 | Bingo $0 | Fortune $0 | Tax $0
Seat 1: 3731169c collected ($0.25)
Seat 2: 32dabd01 (button) folded before Flop (didn't bet)
Seat 3: eb216520 (small blind) folded before Flop
Seat 4: 2af8e2dc (big blind) folded before Flop
Seat 5: 41f44c3d folded before Flop (didn't bet)
Seat 6: Hero folded before Flop (didn't bet)


Poker Hand #HD1755422666: Hold'em No Limit ($0.05/$0.1) - 2024/05/02 14:08:07
Table 'NLHRed26' 6-max Seat #1 is the button
Seat 1: 3731169c ($10.15 in chips)
Seat 2: 32dabd01 ($12.83 in chips)
Seat 3: eb216520 ($11.6 in chips)
Seat 4: 2af8e2dc ($13.28 in chips)
Seat 5: 41f44c3d ($1.95 in chips)
Seat 6: Hero ($15.69 in chips)
32dabd01: posts small blind $0.05
eb216520: posts big blind $0.1
*** HOLE CARDS ***
Dealt to 3731169c 
Dealt to 32dabd01 
Dealt to eb216520 
Dealt to 2af8e2dc 
Dealt to 41f44c3d 
Dealt to Hero [Qc As]
2af8e2dc: folds
41f44c3d: folds
Hero: raises $0.14 to $0.24
3731169c: folds
32dabd01: folds
eb216520: calls $0.14
*** FLOP *** [Th Kc Td]
eb216520: checks
Hero: bets $0.3
eb216520: calls $0.3
*** TURN *** [Th Kc Td] [7h]
eb216520: bets $0.6
Hero: calls $0.6
*** RIVER *** [Th Kc Td 7h] [4h]
eb216520: checks
Hero: bets $1.74
eb216520: raises $2.91 to $4.65
Hero: folds
Uncalled bet ($2.91) returned to eb216520
eb216520: shows [Ks] (Pair of Kings and Pair of Tens)
*** SHOWDOWN ***
eb216520 collected $5.43 from pot
*** SUMMARY ***
Total pot $5.81 | Rake $0.28 | Jackpot $0.1 | Bingo $0 | Fortune $0 | Tax $0
Board [Th Kc Td 7h 4h]
Seat 1: 3731169c (button) folded before Flop (didn't bet)
Seat 2: 32dabd01 (small blind) folded before Flop
Seat 3: eb216520 (big blind) showed [Ks] and won ($5.43)
Seat 4: 2af8e2dc folded before Flop (didn't bet)
Seat 5: 41f44c3d folded before Flop (didn't bet)
Seat 6: Hero folded on the River


Poker Hand #HD1755422626: Hold'em No Limit ($0.05/$0.1) - 2024/05/02 14:07:44
Table 'NLHRed26' 6-max Seat #6 is the button
Seat 1: 3731169c ($10.2 in chips)
Seat 2: 32dabd01 ($12.78 in chips)
Seat 3: eb216520 ($11.6 in chips)
Seat 4: 2af8e2dc ($13.28 in chips)
Seat 5: 41f44c3d ($1.95 in chips)
Seat 6: Hero ($15.69 in chips)
3731169c: posts small blind $0.05
32dabd01: posts big blind $0.1
*** HOLE CARDS ***
Dealt to 3731169c 
Dealt to 32dabd01 
Dealt to eb216520 
Dealt to 2af8e2dc 
Dealt to 41f44c3d 
Dealt to Hero [4s 6d]
eb216520: folds
2af8e2dc: folds
41f44c3d: folds
Hero: folds
3731169c: folds
Uncalled bet ($0.05) returned to 32dabd01
*** SHOWDOWN ***
32dabd01 collected $0.1 from pot
*** SUMMARY ***
Total pot $0.1 | Rake $0 | Jackpot $0 | Bingo $0 | Fortune $0 | Tax $0
Seat 1: 3731169c (small blind) folded before Flop
Seat 2: 32dabd01 (big blind) collected ($0.1)
Seat 3: eb216520 folded before Flop (didn't bet)
Seat 4: 2af8e2dc folded before Flop (didn't bet)
Seat 5: 41f44c3d folded before Flop (didn't bet)
Seat 6: Hero (button) folded before Flop (didn't bet)


Poker Hand #HD1755422601: Hold'em No Limit ($0.05/$0.1) - 2024/05/02 14:07:27
Table 'NLHRed26' 6-max Seat #5 is the button
Seat 1: 3731169c ($10.15 in chips)
Seat 2: 32dabd01 ($12.78 in chips)
Seat 3: eb216520 ($11.6 in chips)
Seat 4: 2af8e2dc ($13.28 in chips)
Seat 5: 41f44c3d ($1.95 in chips)
Seat 6: Hero ($15.74 in chips)
Hero: posts small blind $0.05
3731169c: posts big blind $0.1
*** HOLE CARDS ***
Dealt to 3731169c 
Dealt to 32dabd01 
Dealt to eb216520 
Dealt to 2af8e2dc 
Dealt to 41f44c3d 
Dealt to Hero [4h 6s]
32dabd01: folds
eb216520: folds
2af8e2dc: folds
41f44c3d: folds
Hero: folds
Uncalled bet ($0.05) returned to 3731169c
*** SHOWDOWN ***
3731169c collected $0.1 from pot
*** SUMMARY ***
Total pot $0.1 | Rake $0 | Jackpot $0 | Bingo $0 | Fortune $0 | Tax $0
Seat 1: 3731169c (big blind) collected ($0.1)
Seat 2: 32dabd01 folded before Flop (didn't bet)
Seat 3: eb216520 folded before Flop (didn't bet)
Seat 4: 2af8e2dc folded before Flop (didn't bet)
Seat 5: 41f44c3d (button) folded before Flop (didn't bet)
Seat 6: Hero (small blind) folded before Flop


Poker Hand #HD1755422562: Hold'em No Limit ($0.05/$0.1) - 2024/05/02 14:07:08
Table 'NLHRed26' 6-max Seat #4 is the button
Seat 1: 3731169c ($10.15 in chips)
Seat 2: 32dabd01 ($12.78 in chips)
Seat 3: eb216520 ($11.45 in chips)
Seat 4: 2af8e2dc ($13.28 in chips)
Seat 5: 41f44c3d ($2 in chips)
Seat 6: Hero ($15.84 in chips)
41f44c3d: posts small blind $0.05
Hero: posts big blind $0.1
*** HOLE CARDS ***
Dealt to 3731169c 
Dealt to 32dabd01 
Dealt to eb216520 
Dealt to 2af8e2dc 
Dealt to 41f44c3d 
Dealt to Hero [8s Jc]
3731169c: folds
32dabd01: folds
eb216520: raises $0.3 to $0.4
2af8e2dc: folds
41f44c3d: folds
Hero: folds
Uncalled bet ($0.3) returned to eb216520
*** SHOWDOWN ***
eb216520 collected $0.25 from pot
*** SUMMARY ***
Total pot $0.25 | Rake $0 | Jackpot $0 | Bingo $0 | Fortune $0 | Tax $0
Seat 1: 3731169c folded before Flop (didn't bet)
Seat 2: 32dabd01 folded before Flop (didn't bet)
Seat 3: eb216520 collected ($0.25)
Seat 4: 2af8e2dc (button) folded before Flop (didn't bet)
Seat 5: 41f44c3d (small blind) folded before Flop
Seat 6: Hero (big blind) folded before Flop


Poker Hand #HD1755422534: Hold'em No Limit ($0.05/$0.1) - 2024/05/02 14:06:51
Table 'NLHRed26' 6-max Seat #3 is the button
Seat 1: 3731169c ($10 in chips)
Seat 2: 32dabd01 ($12.78 in chips)
Seat 3: eb216520 ($11.45 in chips)
Seat 4: 2af8e2dc ($13.33 in chips)
Seat 5: 41f44c3d ($2.1 in chips)
Seat 6: Hero ($15.84 in chips)
2af8e2dc: posts small blind $0.05
41f44c3d: posts big blind $0.1
*** HOLE CARDS ***
Dealt to 3731169c 
Dealt to 32dabd01 
Dealt to eb216520 
Dealt to 2af8e2dc 
Dealt to 41f44c3d 
Dealt to Hero [5h 8s]
Hero: folds
3731169c: raises $0.15 to $0.25
32dabd01: folds
eb216520: folds
2af8e2dc: folds
41f44c3d: folds
Uncalled bet ($0.15) returned to 3731169c
*** SHOWDOWN ***
3731169c collected $0.25 from pot
*** SUMMARY ***
Total pot $0.25 | Rake $0 | Jackpot $0 | Bingo $0 | Fortune $0 | Tax $0
Seat 1: 3731169c collected ($0.25)
Seat 2: 32dabd01 folded before Flop (didn't bet)
Seat 3: eb216520 (button) folded before Flop (didn't bet)
Seat 4: 2af8e2dc (small blind) folded before Flop
Seat 5: 41f44c3d (big blind) folded before Flop
Seat 6: Hero folded before Flop (didn't bet)


Poker Hand #HD1755422463: Hold'em No Limit ($0.05/$0.1) - 2024/05/02 14:06:08
Table 'NLHRed26' 6-max Seat #2 is the button
Seat 1: 3731169c ($10 in chips)
Seat 2: 32dabd01 ($12.5 in chips)
Seat 3: eb216520 ($11.5 in chips)
Seat 4: 2af8e2dc ($13.58 in chips)
Seat 5: 41f44c3d ($2.1 in chips)
Seat 6: Hero ($15.84 in chips)
eb216520: posts small blind $0.05
2af8e2dc: posts big blind $0.1
*** HOLE CARDS ***
Dealt to 3731169c 
Dealt to 32dabd01 
Dealt to eb216520 
Dealt to 2af8e2dc 
Dealt to 41f44c3d 
Dealt to Hero [6c 2h]
41f44c3d: folds
Hero: folds
3731169c: folds
32dabd01: raises $0.15 to $0.25
eb216520: folds
2af8e2dc: calls $0.15
*** FLOP *** [Js 4c Ah]
2af8e2dc: checks
32dabd01: bets $0.19
2af8e2dc: folds
Uncalled bet ($0.19) returned to 32dabd01
*** SHOWDOWN ***
32dabd01 collected $0.53 from pot
*** SUMMARY ***
Total pot $0.55 | Rake $0.02 | Jackpot $0 | Bingo $0 | Fortune $0 | Tax $0
Board [Js 4c Ah]
Seat 1: 3731169c folded before Flop (didn't bet)
Seat 2: 32dabd01 (button) won ($0.53)
Seat 3: eb216520 (small blind) folded before Flop
Seat 4: 2af8e2dc (big blind) folded on the Flop
Seat 5: 41f44c3d folded before Flop (didn't bet)
Seat 6: Hero folded before Flop (didn't bet)


Poker Hand #HD1755422389: Hold'em No Limit ($0.05/$0.1) - 2024/05/02 14:05:22
Table 'NLHRed26' 6-max Seat #1 is the button
Seat 1: 3731169c ($10 in chips)
Seat 2: 32dabd01 ($12.55 in chips)
Seat 3: eb216520 ($11.72 in chips)
Seat 4: 2af8e2dc ($13.33 in chips)
Seat 5: 41f44c3d ($2.1 in chips)
Seat 6: Hero ($15.84 in chips)
32dabd01: posts small blind $0.05
eb216520: posts big blind $0.1
*** HOLE CARDS ***
Dealt to 3731169c 
Dealt to 32dabd01 
Dealt to eb216520 
Dealt to 2af8e2dc 
Dealt to 41f44c3d 
Dealt to Hero [6c 4d]
2af8e2dc: raises $0.12 to $0.22
41f44c3d: folds
Hero: folds
3731169c: folds
32dabd01: folds
eb216520: calls $0.12
*** FLOP *** [4s 2d Qd]
eb216520: checks
2af8e2dc: bets $0.17
eb216520: folds
Uncalled bet ($0.17) returned to 2af8e2dc
*** SHOWDOWN ***
2af8e2dc collected $0.47 from pot
*** SUMMARY ***
Total pot $0.49 | Rake $0.02 | Jackpot $0 | Bingo $0 | Fortune $0 | Tax $0
Board [4s 2d Qd]
Seat 1: 3731169c (button) folded before Flop (didn't bet)
Seat 2: 32dabd01 (small blind) folded before Flop
Seat 3: eb216520 (big blind) folded on the Flop
Seat 4: 2af8e2dc won ($0.47)
Seat 5: 41f44c3d folded before Flop (didn't bet)
Seat 6: Hero folded before Flop (didn't bet)


Poker Hand #HD1755422367: Hold'em No Limit ($0.05/$0.1) - 2024/05/02 14:05:07
Table 'NLHRed26' 6-max Seat #6 is the button
Seat 1: 3731169c ($10 in chips)
Seat 2: 32dabd01 ($12.65 in chips)
Seat 3: eb216520 ($11.57 in chips)
Seat 4: 2af8e2dc ($13.33 in chips)
Seat 5: 41f44c3d ($2.1 in chips)
Seat 6: Hero ($15.84 in chips)
3731169c: posts small blind $0.05
32dabd01: posts big blind $0.1
*** HOLE CARDS ***
Dealt to 3731169c 
Dealt to 32dabd01 
Dealt to eb216520 
Dealt to 2af8e2dc 
Dealt to 41f44c3d 
Dealt to Hero [As 5c]
eb216520: raises $0.1 to $0.2
2af8e2dc: folds
41f44c3d: folds
Hero: folds
3731169c: folds
32dabd01: folds
Uncalled bet ($0.1) returned to eb216520
*** SHOWDOWN ***
eb216520 collected $0.25 from pot
*** SUMMARY ***
Total pot $0.25 | Rake $0 | Jackpot $0 | Bingo $0 | Fortune $0 | Tax $0
Seat 1: 3731169c (small blind) folded before Flop
Seat 2: 32dabd01 (big blind) folded before Flop
Seat 3: eb216520 collected ($0.25)
Seat 4: 2af8e2dc folded before Flop (didn't bet)
Seat 5: 41f44c3d folded before Flop (didn't bet)
Seat 6: Hero (button) folded before Flop (didn't bet)


Poker Hand #HD1755422328: Hold'em No Limit ($0.05/$0.1) - 2024/05/02 14:04:47
Table 'NLHRed26' 6-max Seat #5 is the button
Seat 1: 3731169c ($10 in chips)
Seat 2: 32dabd01 ($12.65 in chips)
Seat 3: eb216520 ($11.57 in chips)
Seat 4: 2af8e2dc ($13.33 in chips)
Seat 5: 41f44c3d ($1.95 in chips)
Seat 6: Hero ($15.89 in chips)
Hero: posts small blind $0.05
3731169c: posts big blind $0.1
*** HOLE CARDS ***
Dealt to 3731169c 
Dealt to 32dabd01 
Dealt to eb216520 
Dealt to 2af8e2dc 
Dealt to 41f44c3d 
Dealt to Hero [4d 2c]
32dabd01: folds
eb216520: folds
2af8e2dc: folds
41f44c3d: raises $0.1 to $0.2
Hero: folds
3731169c: folds
Uncalled bet ($0.1) returned to 41f44c3d
*** SHOWDOWN ***
41f44c3d collected $0.25 from pot
*** SUMMARY ***
Total pot $0.25 | Rake $0 | Jackpot $0 | Bingo $0 | Fortune $0 | Tax $0
Seat 1: 3731169c (big blind) folded before Flop
Seat 2: 32dabd01 folded before Flop (didn't bet)
Seat 3: eb216520 folded before Flop (didn't bet)
Seat 4: 2af8e2dc folded before Flop (didn't bet)
Seat 5: 41f44c3d (button) collected ($0.25)
Seat 6: Hero (small blind) folded before Flop


Poker Hand #HD1755422287: Hold'em No Limit ($0.05/$0.1) - 2024/05/02 14:04:16
Table 'NLHRed26' 6-max Seat #4 is the button
Seat 1: 3731169c ($10 in chips)
Seat 2: 32dabd01 ($12.65 in chips)
Seat 3: eb216520 ($11.57 in chips)
Seat 4: 2af8e2dc ($13.33 in chips)
Seat 5: 41f44c3d ($2 in chips)
Seat 6: Hero ($15.84 in chips)
41f44c3d: posts small blind $0.05
Hero: posts big blind $0.1
*** HOLE CARDS ***
Dealt to 3731169c 
Dealt to 32dabd01 
Dealt to eb216520 
Dealt to 2af8e2dc 
Dealt to 41f44c3d 
Dealt to Hero [9d Qs]
3731169c: folds
32dabd01: folds
eb216520: folds
2af8e2dc: folds
41f44c3d: folds
Uncalled bet ($0.05) returned to Hero
*** SHOWDOWN ***
Hero collected $0.1 from pot
*** SUMMARY ***
Total pot $0.1 | Rake $0 | Jackpot $0 | Bingo $0 | Fortune $0 | Tax $0
Seat 1: 3731169c folded before Flop (didn't bet)
Seat 2: 32dabd01 folded before Flop (didn't bet)
Seat 3: eb216520 folded before Flop (didn't bet)
Seat 4: 2af8e2dc (button) folded before Flop (didn't bet)
Seat 5: 41f44c3d (small blind) folded before Flop
Seat 6: Hero (big blind) collected ($0.1)


Poker Hand #HD1755422197: Hold'em No Limit ($0.05/$0.1) - 2024/05/02 14:03:27
Table 'NLHRed26' 6-max Seat #3 is the button
Seat 1: 3731169c ($10 in chips)
Seat 2: 32dabd01 ($12.37 in chips)
Seat 3: eb216520 ($11.57 in chips)
Seat 4: 2af8e2dc ($13.38 in chips)
Seat 5: 41f44c3d ($2 in chips)
Seat 6: Hero ($15.84 in chips)
2af8e2dc: posts small blind $0.05
41f44c3d: posts big blind $0.1
*** HOLE CARDS ***
Dealt to 3731169c 
Dealt to 32dabd01 
Dealt to eb216520 
Dealt to 2af8e2dc 
Dealt to 41f44c3d 
Dealt to Hero [Js 8h]
Hero: folds
3731169c: folds
32dabd01: raises $0.15 to $0.25
eb216520: folds
2af8e2dc: folds
41f44c3d: calls $0.15
*** FLOP *** [4d Qc 8c]
41f44c3d: checks
32dabd01: bets $0.42
41f44c3d: folds
Uncalled bet ($0.42) returned to 32dabd01
*** SHOWDOWN ***
32dabd01 collected $0.53 from pot
*** SUMMARY ***
Total pot $0.55 | Rake $0.02 | Jackpot $0 | Bingo $0 | Fortune $0 | Tax $0
Board [4d Qc 8c]
Seat 1: 3731169c folded before Flop (didn't bet)
Seat 2: 32dabd01 won ($0.53)
Seat 3: eb216520 (button) folded before Flop (didn't bet)
Seat 4: 2af8e2dc (small blind) folded before Flop
Seat 5: 41f44c3d (big blind) folded on the Flop
Seat 6: Hero folded before Flop (didn't bet)


Poker Hand #HD1755422146: Hold'em No Limit ($0.05/$0.1) - 2024/05/02 14:02:56
Table 'NLHRed26' 6-max Seat #2 is the button
Seat 1: 3731169c ($10 in chips)
Seat 2: 32dabd01 ($12.22 in chips)
Seat 3: eb216520 ($11.62 in chips)
Seat 4: 2af8e2dc ($13.48 in chips)
Seat 6: Hero ($15.84 in chips)
eb216520: posts small blind $0.05
2af8e2dc: posts big blind $0.1
*** HOLE CARDS ***
Dealt to 3731169c 
Dealt to 32dabd01 
Dealt to eb216520 
Dealt to 2af8e2dc 
Dealt to Hero [9s Qc]
Hero: folds
3731169c: folds
32dabd01: raises $0.1 to $0.2
eb216520: folds
2af8e2dc: folds
Uncalled bet ($0.1) returned to 32dabd01
*** SHOWDOWN ***
32dabd01 collected $0.25 from pot
*** SUMMARY ***
Total pot $0.25 | Rake $0 | Jackpot $0 | Bingo $0 | Fortune $0 | Tax $0
Seat 1: 3731169c folded before Flop (didn't bet)
Seat 2: 32dabd01 (button) collected ($0.25)
Seat 3: eb216520 (small blind) folded before Flop
Seat 4: 2af8e2dc (big blind) folded before Flop
Seat 6: Hero folded before Flop (didn't bet)


Poker Hand #HD1755422068: Hold'em No Limit ($0.05/$0.1) - 2024/05/02 14:02:06
Table 'NLHRed26' 6-max Seat #1 is the button
Seat 1: 3731169c ($10 in chips)
Seat 2: 32dabd01 ($12.27 in chips)
Seat 3: eb216520 ($11.37 in chips)
Seat 4: 2af8e2dc ($13.7 in chips)
Seat 6: Hero ($15.84 in chips)
32dabd01: posts small blind $0.05
eb216520: posts big blind $0.1
*** HOLE CARDS ***
Dealt to 3731169c 
Dealt to 32dabd01 
Dealt to eb216520 
Dealt to 2af8e2dc 
Dealt to Hero [Qh 2d]
2af8e2dc: raises $0.12 to $0.22
Hero: folds
3731169c: folds
32dabd01: folds
eb216520: calls $0.12
*** FLOP *** [2c 6c 8s]
eb216520: checks
2af8e2dc: checks
*** TURN *** [2c 6c 8s] [9c]
eb216520: bets $0.25
2af8e2dc: folds
Uncalled bet ($0.25) returned to eb216520
*** SHOWDOWN ***
eb216520 collected $0.47 from pot
*** SUMMARY ***
Total pot $0.49 | Rake $0.02 | Jackpot $0 | Bingo $0 | Fortune $0 | Tax $0
Board [2c 6c 8s 9c]
Seat 1: 3731169c (button) folded before Flop (didn't bet)
Seat 2: 32dabd01 (small blind) folded before Flop
Seat 3: eb216520 (big blind) won ($0.47)
Seat 4: 2af8e2dc folded on the Turn
Seat 6: Hero folded before Flop (didn't bet)


Poker Hand #HD1755421959: Hold'em No Limit ($0.05/$0.1) - 2024/05/02 14:01:05
Table 'NLHRed26' 6-max Seat #6 is the button
Seat 1: 3731169c ($10 in chips)
Seat 2: 32dabd01 ($12.37 in chips)
Seat 3: eb216520 ($11.37 in chips)
Seat 4: 2af8e2dc ($11.29 in chips)
Seat 5: 5e68a340 ($2.62 in chips)
Seat 6: Hero ($15.84 in chips)
3731169c: posts small blind $0.05
32dabd01: posts big blind $0.1
*** HOLE CARDS ***
Dealt to 3731169c 
Dealt to 32dabd01 
Dealt to eb216520 
Dealt to 2af8e2dc 
Dealt to 5e68a340 
Dealt to Hero [7c 2c]
eb216520: folds
2af8e2dc: raises $0.12 to $0.22
5e68a340: raises $0.45 to $0.67
Hero: folds
3731169c: folds
32dabd01: folds
2af8e2dc: raises $2.02 to $2.69
5e68a340: calls $1.95 and is all-in
Uncalled bet ($0.07) returned to 2af8e2dc
2af8e2dc: shows [Kh Kc]
5e68a340: shows [As Jh]
*** FLOP *** [4s 9d Qc]
*** TURN *** [4s 9d Qc] [9c]
*** RIVER *** [4s 9d Qc 9c] [Js]
*** SHOWDOWN ***
2af8e2dc collected $5.03 from pot
*** SUMMARY ***
Total pot $5.39 | Rake $0.26 | Jackpot $0.1 | Bingo $0 | Fortune $0 | Tax $0
Board [4s 9d Qc 9c Js]
Seat 1: 3731169c (small blind) folded before Flop
Seat 2: 32dabd01 (big blind) folded before Flop
Seat 3: eb216520 folded before Flop (didn't bet)
Seat 4: 2af8e2dc showed [Kh Kc] and won ($5.03) with Pair of Kings and Pair of Nines
Seat 5: 5e68a340 showed [As Jh] and lost with Pair of Jacks and Pair of Nines
Seat 6: Hero (button) folded before Flop (didn't bet)


Poker Hand #HD1755421924: Hold'em No Limit ($0.05/$0.1) - 2024/05/02 14:00:42
Table 'NLHRed26' 6-max Seat #5 is the button
Seat 1: 3731169c ($10 in chips)
Seat 2: 32dabd01 ($12.22 in chips)
Seat 3: eb216520 ($11.37 in chips)
Seat 4: 2af8e2dc ($11.29 in chips)
Seat 5: 5e68a340 ($2.62 in chips)
Seat 6: Hero ($15.89 in chips)
Hero: posts small blind $0.05
3731169c: posts big blind $0.1
*** HOLE CARDS ***
Dealt to 3731169c 
Dealt to 32dabd01 
Dealt to eb216520 
Dealt to 2af8e2dc 
Dealt to 5e68a340 
Dealt to Hero [9d 7c]
32dabd01: raises $0.2 to $0.3
eb216520: folds
2af8e2dc: folds
5e68a340: folds
Hero: folds
3731169c: folds
Uncalled bet ($0.2) returned to 32dabd01
*** SHOWDOWN ***
32dabd01 collected $0.25 from pot
*** SUMMARY ***
Total pot $0.25 | Rake $0 | Jackpot $0 | Bingo $0 | Fortune $0 | Tax $0
Seat 1: 3731169c (big blind) folded before Flop
Seat 2: 32dabd01 collected ($0.25)
Seat 3: eb216520 folded before Flop (didn't bet)
Seat 4: 2af8e2dc folded before Flop (didn't bet)
Seat 5: 5e68a340 (button) folded before Flop (didn't bet)
Seat 6: Hero (small blind) folded before Flop


Poker Hand #HD1755421909: Hold'em No Limit ($0.05/$0.1) - 2024/05/02 14:00:31
Table 'NLHRed26' 6-max Seat #4 is the button
Seat 2: 32dabd01 ($12.22 in chips)
Seat 3: eb216520 ($11.37 in chips)
Seat 4: 2af8e2dc ($11.29 in chips)
Seat 5: 5e68a340 ($2.67 in chips)
Seat 6: Hero ($15.84 in chips)
5e68a340: posts small blind $0.05
Hero: posts big blind $0.1
*** HOLE CARDS ***
Dealt to 32dabd01 
Dealt to eb216520 
Dealt to 2af8e2dc 
Dealt to 5e68a340 
Dealt to Hero [5c Ks]
32dabd01: folds
eb216520: folds
2af8e2dc: folds
5e68a340: folds
Uncalled bet ($0.05) returned to Hero
*** SHOWDOWN ***
Hero collected $0.1 from pot
*** SUMMARY ***
Total pot $0.1 | Rake $0 | Jackpot $0 | Bingo $0 | Fortune $0 | Tax $0
Seat 2: 32dabd01 folded before Flop (didn't bet)
Seat 3: eb216520 folded before Flop (didn't bet)
Seat 4: 2af8e2dc (button) folded before Flop (didn't bet)
Seat 5: 5e68a340 (small blind) folded before Flop
Seat 6: Hero (big blind) collected ($0.1)


Poker Hand #HD1755421791: Hold'em No Limit ($0.05/$0.1) - 2024/05/02 13:59:15
Table 'NLHRed26' 6-max Seat #3 is the button
Seat 2: 32dabd01 ($12.22 in chips)
Seat 3: eb216520 ($11.62 in chips)
Seat 4: 2af8e2dc ($12.57 in chips)
Seat 5: 5e68a340 ($1.28 in chips)
Seat 6: Hero ($15.84 in chips)
2af8e2dc: posts small blind $0.05
5e68a340: posts big blind $0.1
*** HOLE CARDS ***
Dealt to 32dabd01 
Dealt to eb216520 
Dealt to 2af8e2dc 
Dealt to 5e68a340 
Dealt to Hero [4d 3d]
Hero: folds
32dabd01: folds
eb216520: raises $0.15 to $0.25
2af8e2dc: raises $0.8 to $1.05
5e68a340: raises $0.23 to $1.28 and is all-in
eb216520: folds
2af8e2dc: calls $0.23
5e68a340: shows [Ac Jc]
2af8e2dc: shows [Kc 9c]
*** FLOP *** [Th 3s As]
*** TURN *** [Th 3s As] [4h]
*** RIVER *** [Th 3s As 4h] [Js]
*** SHOWDOWN ***
5e68a340 collected $2.67 from pot
*** SUMMARY ***
Total pot $2.81 | Rake $0.14 | Jackpot $0 | Bingo $0 | Fortune $0 | Tax $0
Board [Th 3s As 4h Js]
Seat 2: 32dabd01 folded before Flop (didn't bet)
Seat 3: eb216520 (button) folded before Flop
Seat 4: 2af8e2dc (small blind) showed [Kc 9c] and lost with Ace-High
Seat 5: 5e68a340 (big blind) showed [Ac Jc] and won ($2.67) with Pair of Aces and Pair of Jacks
Seat 6: Hero folded before Flop (didn't bet)


Poker Hand #HD1755421755: Hold'em No Limit ($0.05/$0.1) - 2024/05/02 13:58:55
Table 'NLHRed26' 6-max Seat #2 is the button
Seat 2: 32dabd01 ($12.22 in chips)
Seat 3: eb216520 ($11.67 in chips)
Seat 4: 2af8e2dc ($12.67 in chips)
Seat 5: 5e68a340 ($1.13 in chips)
Seat 6: Hero ($15.84 in chips)
eb216520: posts small blind $0.05
2af8e2dc: posts big blind $0.1
*** HOLE CARDS ***
Dealt to 32dabd01 
Dealt to eb216520 
Dealt to 2af8e2dc 
Dealt to 5e68a340 
Dealt to Hero [Ac 8d]
5e68a340: raises $0.2 to $0.3
Hero: folds
32dabd01: folds
eb216520: folds
2af8e2dc: folds
Uncalled bet ($0.2) returned to 5e68a340
*** SHOWDOWN ***
5e68a340 collected $0.25 from pot
*** SUMMARY ***
Total pot $0.25 | Rake $0 | Jackpot $0 | Bingo $0 | Fortune $0 | Tax $0
Seat 2: 32dabd01 (button) folded before Flop (didn't bet)
Seat 3: eb216520 (small blind) folded before Flop
Seat 4: 2af8e2dc (big blind) folded before Flop
Seat 5: 5e68a340 collected ($0.25)
Seat 6: Hero folded before Flop (didn't bet)


Poker Hand #HD1755421705: Hold'em No Limit ($0.05/$0.1) - 2024/05/02 13:58:26
Table 'NLHRed26' 6-max Seat #6 is the button
Seat 2: 32dabd01 ($12.04 in chips)
Seat 3: eb216520 ($11.87 in chips)
Seat 4: 2af8e2dc ($12.67 in chips)
Seat 5: 5e68a340 ($1.13 in chips)
Seat 6: Hero ($15.84 in chips)
32dabd01: posts small blind $0.05
eb216520: posts big blind $0.1
*** HOLE CARDS ***
Dealt to 32dabd01 
Dealt to eb216520 
Dealt to 2af8e2dc 
Dealt to 5e68a340 
Dealt to Hero [2s 7s]
2af8e2dc: folds
5e68a340: folds
Hero: folds
32dabd01: raises $0.1 to $0.2
eb216520: calls $0.1
*** FLOP *** [6d Kc 2h]
32dabd01: bets $0.2
eb216520: folds
Uncalled bet ($0.2) returned to 32dabd01
*** SHOWDOWN ***
32dabd01 collected $0.38 from pot
*** SUMMARY ***
Total pot $0.4 | Rake $0.02 | Jackpot $0 | Bingo $0 | Fortune $0 | Tax $0
Board [6d Kc 2h]
Seat 2: 32dabd01 (small blind) won ($0.38)
Seat 3: eb216520 (big blind) folded on the Flop
Seat 4: 2af8e2dc folded before Flop (didn't bet)
Seat 5: 5e68a340 folded before Flop (didn't bet)
Seat 6: Hero (button) folded before Flop (didn't bet)


Poker Hand #HD1755421608: Hold'em No Limit ($0.05/$0.1) - 2024/05/02 13:57:26
Table 'NLHRed26' 6-max Seat #5 is the button
Seat 1: e9fd34d8 ($6.59 in chips)
Seat 2: 32dabd01 ($12.04 in chips)
Seat 3: eb216520 ($11.87 in chips)
Seat 4: 2af8e2dc ($12.67 in chips)
Seat 5: 5e68a340 ($1.13 in chips)
Seat 6: Hero ($10 in chips)
Hero: posts small blind $0.05
e9fd34d8: posts big blind $0.1
*** HOLE CARDS ***
Dealt to e9fd34d8 
Dealt to 32dabd01 
Dealt to eb216520 
Dealt to 2af8e2dc 
Dealt to 5e68a340 
Dealt to Hero [Ks Ad]
32dabd01: folds
eb216520: folds
2af8e2dc: folds
5e68a340: folds
Hero: raises $0.2 to $0.3
e9fd34d8: calls $0.2
*** FLOP *** [Jc 7c Qd]
Hero: bets $0.2
e9fd34d8: calls $0.2
*** TURN *** [Jc 7c Qd] [9h]
Hero: checks
e9fd34d8: checks
*** RIVER *** [Jc 7c Qd 9h] [Ts]
Hero: bets $0.43
e9fd34d8: raises $0.53 to $0.96
Hero: raises $8.54 to $9.5 and is all-in
e9fd34d8: calls $5.13 and is all-in
Uncalled bet ($3.41) returned to Hero
Hero: shows [Ks Ad] (Aces-High Straight)
e9fd34d8: shows [Td Kc] (Kings-High Straight)
*** SHOWDOWN ***
Hero collected $12.43 from pot
*** SUMMARY ***
Total pot $13.18 | Rake $0.65 | Jackpot $0.1 | Bingo $0 | Fortune $0 | Tax $0
Board [Jc 7c Qd 9h Ts]
Seat 1: e9fd34d8 (big blind) showed [Td Kc] and lost with Kings-High Straight
Seat 2: 32dabd01 folded before Flop (didn't bet)
Seat 3: eb216520 folded before Flop (didn't bet)
Seat 4: 2af8e2dc folded before Flop (didn't bet)
Seat 5: 5e68a340 (button) folded before Flop (didn't bet)
Seat 6: Hero (small blind) showed [Ks Ad] and won ($12.43) with Aces-High Straight


Poker Hand #HD1755421528: Hold'em No Limit ($0.05/$0.1) - 2024/05/02 13:56:34
Table 'NLHRed26' 6-max Seat #4 is the button
Seat 1: e9fd34d8 ($6.59 in chips)
Seat 2: 32dabd01 ($12.04 in chips)
Seat 3: eb216520 ($11.87 in chips)
Seat 4: 2af8e2dc ($12.24 in chips)
Seat 5: 5e68a340 ($1.18 in chips)
Seat 6: Hero ($10 in chips)
5e68a340: posts small blind $0.05
Hero: posts big blind $0.1
*** HOLE CARDS ***
Dealt to e9fd34d8 
Dealt to 32dabd01 
Dealt to eb216520 
Dealt to 2af8e2dc 
Dealt to 5e68a340 
Dealt to Hero [Th Jc]
e9fd34d8: folds
32dabd01: folds
eb216520: folds
2af8e2dc: raises $0.12 to $0.22
5e68a340: folds
Hero: calls $0.12
*** FLOP *** [8s Ac 4c]
Hero: checks
2af8e2dc: checks
*** TURN *** [8s Ac 4c] [7h]
Hero: checks
2af8e2dc: checks
*** RIVER *** [8s Ac 4c 7h] [5h]
Hero: bets $0.2
2af8e2dc: calls $0.2
Hero: shows [Th Jc] (Ace-High)
2af8e2dc: shows [Js 7s] (Pair of Sevens)
*** SHOWDOWN ***
2af8e2dc collected $0.85 from pot
*** SUMMARY ***
Total pot $0.89 | Rake $0.04 | Jackpot $0 | Bingo $0 | Fortune $0 | Tax $0
Board [8s Ac 4c 7h 5h]
Seat 1: e9fd34d8 folded before Flop (didn't bet)
Seat 2: 32dabd01 folded before Flop (didn't bet)
Seat 3: eb216520 folded before Flop (didn't bet)
Seat 4: 2af8e2dc (button) showed [Js 7s] and won ($0.85) with Pair of Sevens
Seat 5: 5e68a340 (small blind) folded before Flop
Seat 6: Hero (big blind) showed [Th Jc] and lost with Ace-High


Poker Hand #HD1755421479: Hold'em No Limit ($0.05/$0.1) - 2024/05/02 13:55:59
Table 'NLHRed26' 6-max Seat #3 is the button
Seat 1: e9fd34d8 ($6.59 in chips)
Seat 2: 32dabd01 ($12.04 in chips)
Seat 3: eb216520 ($11.41 in chips)
Seat 4: 2af8e2dc ($12.64 in chips)
Seat 5: 5e68a340 ($1.28 in chips)
Seat 6: Hero ($10 in chips)
2af8e2dc: posts small blind $0.05
5e68a340: posts big blind $0.1
*** HOLE CARDS ***
Dealt to e9fd34d8 
Dealt to 32dabd01 
Dealt to eb216520 
Dealt to 2af8e2dc 
Dealt to 5e68a340 
Dealt to Hero [3d Ts]
Hero: folds
e9fd34d8: folds
32dabd01: folds
eb216520: raises $0.3 to $0.4
2af8e2dc: calls $0.35
5e68a340: folds
*** FLOP *** [2s 6c As]
2af8e2dc: checks
eb216520: bets $0.45
2af8e2dc: folds
Uncalled bet ($0.45) returned to eb216520
*** SHOWDOWN ***
eb216520 collected $0.86 from pot
*** SUMMARY ***
Total pot $0.9 | Rake $0.04 | Jackpot $0 | Bingo $0 | Fortune $0 | Tax $0
Board [2s 6c As]
Seat 1: e9fd34d8 folded before Flop (didn't bet)
Seat 2: 32dabd01 folded before Flop (didn't bet)
Seat 3: eb216520 (button) won ($0.86)
Seat 4: 2af8e2dc (small blind) folded on the Flop
Seat 5: 5e68a340 (big blind) folded before Flop
Seat 6: Hero folded before Flop (didn't bet)


Poker Hand #HD1755421437: Hold'em No Limit ($0.05/$0.1) - 2024/05/02 13:55:40
Table 'NLHRed26' 6-max Seat #2 is the button
Seat 1: e9fd34d8 ($6.59 in chips)
Seat 2: 32dabd01 ($12.04 in chips)
Seat 3: eb216520 ($11.31 in chips)
Seat 4: 2af8e2dc ($12.74 in chips)
Seat 5: 5e68a340 ($1.28 in chips)
Seat 6: Hero ($10 in chips)
eb216520: posts small blind $0.05
2af8e2dc: posts big blind $0.1
*** HOLE CARDS ***
Dealt to e9fd34d8 
Dealt to 32dabd01 
Dealt to eb216520 
Dealt to 2af8e2dc 
Dealt to 5e68a340 
Dealt to Hero [9d 5c]
5e68a340: folds
Hero: folds
e9fd34d8: folds
32dabd01: folds
eb216520: raises $0.2 to $0.3
2af8e2dc: folds
Uncalled bet ($0.2) returned to eb216520
*** SHOWDOWN ***
eb216520 collected $0.2 from pot
*** SUMMARY ***
Total pot $0.2 | Rake $0 | Jackpot $0 | Bingo $0 | Fortune $0 | Tax $0
Seat 1: e9fd34d8 folded before Flop (didn't bet)
Seat 2: 32dabd01 (button) folded before Flop (didn't bet)
Seat 3: eb216520 (small blind) collected ($0.2)
Seat 4: 2af8e2dc (big blind) folded before Flop
Seat 5: 5e68a340 folded before Flop (didn't bet)
Seat 6: Hero folded before Flop (didn't bet)


Poker Hand #HD1755421420: Hold'em No Limit ($0.05/$0.1) - 2024/05/02 13:55:25
Table 'NLHRed26' 6-max Seat #1 is the button
Seat 1: e9fd34d8 ($6.59 in chips)
Seat 2: 32dabd01 ($12.09 in chips)
Seat 3: eb216520 ($11.41 in chips)
Seat 4: 2af8e2dc ($12.59 in chips)
Seat 5: 5e68a340 ($1.28 in chips)
Seat 6: Hero ($10 in chips)
32dabd01: posts small blind $0.05
eb216520: posts big blind $0.1
*** HOLE CARDS ***
Dealt to e9fd34d8 
Dealt to 32dabd01 
Dealt to eb216520 
Dealt to 2af8e2dc 
Dealt to 5e68a340 
Dealt to Hero [9c 4c]
2af8e2dc: raises $0.12 to $0.22
5e68a340: folds
Hero: folds
e9fd34d8: folds
32dabd01: folds
eb216520: folds
Uncalled bet ($0.12) returned to 2af8e2dc
*** SHOWDOWN ***
2af8e2dc collected $0.25 from pot
*** SUMMARY ***
Total pot $0.25 | Rake $0 | Jackpot $0 | Bingo $0 | Fortune $0 | Tax $0
Seat 1: e9fd34d8 (button) folded before Flop (didn't bet)
Seat 2: 32dabd01 (small blind) folded before Flop
Seat 3: eb216520 (big blind) folded before Flop
Seat 4: 2af8e2dc collected ($0.25)
Seat 5: 5e68a340 folded before Flop (didn't bet)
Seat 6: Hero folded before Flop (didn't bet)


Poker Hand #HD1755421400: Hold'em No Limit ($0.05/$0.1) - 2024/05/02 13:55:12
Table 'NLHRed26' 6-max Seat #6 is the button
Seat 1: e9fd34d8 ($6.64 in chips)
Seat 2: 32dabd01 ($12.19 in chips)
Seat 3: eb216520 ($11.41 in chips)
Seat 4: 2af8e2dc ($12.44 in chips)
Seat 5: 5e68a340 ($1.28 in chips)
Seat 6: Hero ($10 in chips)
e9fd34d8: posts small blind $0.05
32dabd01: posts big blind $0.1
*** HOLE CARDS ***
Dealt to e9fd34d8 
Dealt to 32dabd01 
Dealt to eb216520 
Dealt to 2af8e2dc 
Dealt to 5e68a340 
Dealt to Hero [4h Jd]
eb216520: folds
2af8e2dc: raises $0.12 to $0.22
5e68a340: folds
Hero: folds
e9fd34d8: folds
32dabd01: folds
Uncalled bet ($0.12) returned to 2af8e2dc
*** SHOWDOWN ***
2af8e2dc collected $0.25 from pot
*** SUMMARY ***
Total pot $0.25 | Rake $0 | Jackpot $0 | Bingo $0 | Fortune $0 | Tax $0
Seat 1: e9fd34d8 (small blind) folded before Flop
Seat 2: 32dabd01 (big blind) folded before Flop
Seat 3: eb216520 folded before Flop (didn't bet)
Seat 4: 2af8e2dc collected ($0.25)
Seat 5: 5e68a340 folded before Flop (didn't bet)
Seat 6: Hero (button) folded before Flop (didn't bet)


Poker Hand #HD1755421382: Hold'em No Limit ($0.05/$0.1) - 2024/05/02 13:54:59
Table 'NLHRed26' 6-max Seat #5 is the button
Seat 1: e9fd34d8 ($6.74 in chips)
Seat 2: 32dabd01 ($12.19 in chips)
Seat 3: eb216520 ($11.41 in chips)
Seat 4: 2af8e2dc ($12.44 in chips)
Seat 5: 5e68a340 ($1.13 in chips)
Seat 6: Hero ($10.05 in chips)
Hero: posts small blind $0.05
e9fd34d8: posts big blind $0.1
*** HOLE CARDS ***
Dealt to e9fd34d8 
Dealt to 32dabd01 
Dealt to eb216520 
Dealt to 2af8e2dc 
Dealt to 5e68a340 
Dealt to Hero [4d 9d]
32dabd01: folds
eb216520: folds
2af8e2dc: folds
5e68a340: raises $0.25 to $0.35
Hero: folds
e9fd34d8: folds
Uncalled bet ($0.25) returned to 5e68a340
*** SHOWDOWN ***
5e68a340 collected $0.25 from pot
*** SUMMARY ***
Total pot $0.25 | Rake $0 | Jackpot $0 | Bingo $0 | Fortune $0 | Tax $0
Seat 1: e9fd34d8 (big blind) folded before Flop
Seat 2: 32dabd01 folded before Flop (didn't bet)
Seat 3: eb216520 folded before Flop (didn't bet)
Seat 4: 2af8e2dc folded before Flop (didn't bet)
Seat 5: 5e68a340 (button) collected ($0.25)
Seat 6: Hero (small blind) folded before Flop


Poker Hand #HD1755421366: Hold'em No Limit ($0.05/$0.1) - 2024/05/02 13:54:50
Table 'NLHRed26' 6-max Seat #4 is the button
Seat 1: e9fd34d8 ($6.74 in chips)
Seat 2: 32dabd01 ($12.19 in chips)
Seat 3: eb216520 ($11.41 in chips)
Seat 4: 2af8e2dc ($12.44 in chips)
Seat 5: 5e68a340 ($1.18 in chips)
Seat 6: Hero ($10 in chips)
5e68a340: posts small blind $0.05
Hero: posts big blind $0.1
*** HOLE CARDS ***
Dealt to e9fd34d8 
Dealt to 32dabd01 
Dealt to eb216520 
Dealt to 2af8e2dc 
Dealt to 5e68a340 
Dealt to Hero [9d 3h]
e9fd34d8: folds
32dabd01: folds
eb216520: folds
2af8e2dc: folds
5e68a340: folds
Uncalled bet ($0.05) returned to Hero
*** SHOWDOWN ***
Hero collected $0.1 from pot
*** SUMMARY ***
Total pot $0.1 | Rake $0 | Jackpot $0 | Bingo $0 | Fortune $0 | Tax $0
Seat 1: e9fd34d8 folded before Flop (didn't bet)
Seat 2: 32dabd01 folded before Flop (didn't bet)
Seat 3: eb216520 folded before Flop (didn't bet)
Seat 4: 2af8e2dc (button) folded before Flop (didn't bet)
Seat 5: 5e68a340 (small blind) folded before Flop
Seat 6: Hero (big blind) collected ($0.1)


Poker Hand #HD1755421294: Hold'em No Limit ($0.05/$0.1) - 2024/05/02 13:54:04
Table 'NLHRed26' 6-max Seat #3 is the button
Seat 1: e9fd34d8 ($6.74 in chips)
Seat 2: 32dabd01 ($12.19 in chips)
Seat 3: eb216520 ($10.4 in chips)
Seat 4: 2af8e2dc ($12.49 in chips)
Seat 5: 5e68a340 ($2.03 in chips)
Seat 6: Hero ($10 in chips)
2af8e2dc: posts small blind $0.05
5e68a340: posts big blind $0.1
*** HOLE CARDS ***
Dealt to e9fd34d8 
Dealt to 32dabd01 
Dealt to eb216520 
Dealt to 2af8e2dc 
Dealt to 5e68a340 
Dealt to Hero [Ks Qc]
Hero: raises $0.1 to $0.2
e9fd34d8: folds
32dabd01: folds
eb216520: raises $0.65 to $0.85
2af8e2dc: folds
5e68a340: calls $0.75
Hero: folds
*** FLOP *** [Ac 7s 2c]
5e68a340: checks
eb216520: bets $1.5
5e68a340: folds
Uncalled bet ($1.5) returned to eb216520
*** SHOWDOWN ***
eb216520 collected $1.86 from pot
*** SUMMARY ***
Total pot $1.95 | Rake $0.09 | Jackpot $0 | Bingo $0 | Fortune $0 | Tax $0
Board [Ac 7s 2c]
Seat 1: e9fd34d8 folded before Flop (didn't bet)
Seat 2: 32dabd01 folded before Flop (didn't bet)
Seat 3: eb216520 (button) won ($1.86)
Seat 4: 2af8e2dc (small blind) folded before Flop
Seat 5: 5e68a340 (big blind) folded on the Flop
Seat 6: Hero folded before Flop


Poker Hand #HD1755421246: Hold'em No Limit ($0.05/$0.1) - 2024/05/02 13:53:30
Table 'NLHRed26' 6-max Seat #2 is the button
Seat 1: e9fd34d8 ($6.46 in chips)
Seat 2: 32dabd01 ($12.19 in chips)
Seat 3: eb216520 ($10.45 in chips)
Seat 4: 2af8e2dc ($12.74 in chips)
Seat 6: Hero ($10 in chips)
eb216520: posts small blind $0.05
2af8e2dc: posts big blind $0.1
*** HOLE CARDS ***
Dealt to e9fd34d8 
Dealt to 32dabd01 
Dealt to eb216520 
Dealt to 2af8e2dc 
Dealt to Hero [3c 4s]
Hero: folds
e9fd34d8: raises $0.15 to $0.25
32dabd01: folds
eb216520: folds
2af8e2dc: calls $0.15
*** FLOP *** [6s 4c Qd]
2af8e2dc: checks
e9fd34d8: bets $0.15
2af8e2dc: folds
Uncalled bet ($0.15) returned to e9fd34d8
*** SHOWDOWN ***
e9fd34d8 collected $0.53 from pot
*** SUMMARY ***
Total pot $0.55 | Rake $0.02 | Jackpot $0 | Bingo $0 | Fortune $0 | Tax $0
Board [6s 4c Qd]
Seat 1: e9fd34d8 won ($0.53)
Seat 2: 32dabd01 (button) folded before Flop (didn't bet)
Seat 3: eb216520 (small blind) folded before Flop
Seat 4: 2af8e2dc (big blind) folded on the Flop
Seat 6: Hero folded before Flop (didn't bet)


Poker Hand #HD1755421234: Hold'em No Limit ($0.05/$0.1) - 2024/05/02 13:53:22
Table 'NLHRed26' 6-max Seat #1 is the button
Seat 1: e9fd34d8 ($6.46 in chips)
Seat 2: 32dabd01 ($12.24 in chips)
Seat 3: eb216520 ($10.4 in chips)
Seat 4: 2af8e2dc ($12.74 in chips)
Seat 6: Hero ($10 in chips)
32dabd01: posts small blind $0.05
eb216520: posts big blind $0.1
*** HOLE CARDS ***
Dealt to e9fd34d8 
Dealt to 32dabd01 
Dealt to eb216520 
Dealt to 2af8e2dc 
Dealt to Hero [Js 5c]
2af8e2dc: folds
Hero: folds
e9fd34d8: folds
32dabd01: folds
Uncalled bet ($0.05) returned to eb216520
*** SHOWDOWN ***
eb216520 collected $0.1 from pot
*** SUMMARY ***
Total pot $0.1 | Rake $0 | Jackpot $0 | Bingo $0 | Fortune $0 | Tax $0
Seat 1: e9fd34d8 (button) folded before Flop (didn't bet)
Seat 2: 32dabd01 (small blind) folded before Flop
Seat 3: eb216520 (big blind) collected ($0.1)
Seat 4: 2af8e2dc folded before Flop (didn't bet)
Seat 6: Hero folded before Flop (didn't bet)


Poker Hand #HD1755421153: Hold'em No Limit ($0.05/$0.1) - 2024/05/02 13:52:36
Table 'NLHRed26' 6-max Seat #6 is the button
Seat 1: e9fd34d8 ($6.05 in chips)
Seat 2: 32dabd01 ($12.69 in chips)
Seat 4: 2af8e2dc ($12.74 in chips)
Seat 6: Hero ($10 in chips)
e9fd34d8: posts small blind $0.05
32dabd01: posts big blind $0.1
*** HOLE CARDS ***
Dealt to e9fd34d8 
Dealt to 32dabd01 
Dealt to 2af8e2dc 
Dealt to Hero [5d 9s]
2af8e2dc: folds
Hero: folds
e9fd34d8: raises $0.15 to $0.25
32dabd01: calls $0.15
*** FLOP *** [5h Qh 6d]
e9fd34d8: checks
32dabd01: bets $0.2
e9fd34d8: calls $0.2
*** TURN *** [5h Qh 6d] [Jc]
e9fd34d8: checks
32dabd01: checks
*** RIVER *** [5h Qh 6d Jc] [4d]
e9fd34d8: bets $0.24
32dabd01: folds
Uncalled bet ($0.24) returned to e9fd34d8
*** SHOWDOWN ***
e9fd34d8 collected $0.86 from pot
*** SUMMARY ***
Total pot $0.9 | Rake $0.04 | Jackpot $0 | Bingo $0 | Fortune $0 | Tax $0
Board [5h Qh 6d Jc 4d]
Seat 1: e9fd34d8 (small blind) won ($0.86)
Seat 2: 32dabd01 (big blind) folded on the River
Seat 4: 2af8e2dc folded before Flop (didn't bet)
Seat 6: Hero (button) folded before Flop (didn't bet)


Poker Hand #HD1755421121: Hold'em No Limit ($0.05/$0.1) - 2024/05/02 13:52:19
Table 'NLHRed26' 6-max Seat #4 is the button
Seat 1: e9fd34d8 ($6 in chips)
Seat 2: 32dabd01 ($12.69 in chips)
Seat 4: 2af8e2dc ($12.74 in chips)
Seat 6: Hero ($10 in chips)
Hero: posts small blind $0.05
e9fd34d8: posts big blind $0.1
*** HOLE CARDS ***
Dealt to e9fd34d8 
Dealt to 32dabd01 
Dealt to 2af8e2dc 
Dealt to Hero [Td 6h]
32dabd01: folds
2af8e2dc: folds
Hero: folds
Uncalled bet ($0.05) returned to e9fd34d8
*** SHOWDOWN ***
e9fd34d8 collected $0.1 from pot
*** SUMMARY ***
Total pot $0.1 | Rake $0 | Jackpot $0 | Bingo $0 | Fortune $0 | Tax $0
Seat 1: e9fd34d8 (big blind) collected ($0.1)
Seat 2: 32dabd01 folded before Flop (didn't bet)
Seat 4: 2af8e2dc (button) folded before Flop (didn't bet)
Seat 6: Hero (small blind) folded before Flop


Poker Hand #HD1755421086: Hold'em No Limit ($0.05/$0.1) - 2024/05/02 13:52:00
Table 'NLHRed26' 6-max Seat #2 is the button
Seat 1: e9fd34d8 ($5.85 in chips)
Seat 2: 32dabd01 ($12.69 in chips)
Seat 4: 2af8e2dc ($12.79 in chips)
Seat 6: Hero ($10 in chips)
2af8e2dc: posts small blind $0.05
Hero: posts big blind $0.1
*** HOLE CARDS ***
Dealt to e9fd34d8 
Dealt to 32dabd01 
Dealt to 2af8e2dc 
Dealt to Hero [2s 4h]
e9fd34d8: raises $0.15 to $0.25
32dabd01: folds
2af8e2dc: folds
Hero: folds
Uncalled bet ($0.15) returned to e9fd34d8
*** SHOWDOWN ***
e9fd34d8 collected $0.25 from pot
*** SUMMARY ***
Total pot $0.25 | Rake $0 | Jackpot $0 | Bingo $0 | Fortune $0 | Tax $0
Seat 1: e9fd34d8 collected ($0.25)
Seat 2: 32dabd01 (button) folded before Flop (didn't bet)
Seat 4: 2af8e2dc (small blind) folded before Flop
Seat 6: Hero (big blind) folded before Flop


Poker Hand #HD1755421073: Hold'em No Limit ($0.05/$0.1) - 2024/05/02 13:51:50
Table 'NLHRed26' 6-max Seat #1 is the button
Seat 1: e9fd34d8 ($5.85 in chips)
Seat 2: 32dabd01 ($12.59 in chips)
Seat 4: 2af8e2dc ($12.89 in chips)
Seat 6: Hero ($10 in chips)
32dabd01: posts small blind $0.05
2af8e2dc: posts big blind $0.1
*** HOLE CARDS ***
Dealt to e9fd34d8 
Dealt to 32dabd01 
Dealt to 2af8e2dc 
Dealt to Hero [5s Qh]
Hero: folds
e9fd34d8: folds
32dabd01: raises $0.15 to $0.25
2af8e2dc: folds
Uncalled bet ($0.15) returned to 32dabd01
*** SHOWDOWN ***
32dabd01 collected $0.2 from pot
*** SUMMARY ***
Total pot $0.2 | Rake $0 | Jackpot $0 | Bingo $0 | Fortune $0 | Tax $0
Seat 1: e9fd34d8 (button) folded before Flop (didn't bet)
Seat 2: 32dabd01 (small blind) collected ($0.2)
Seat 4: 2af8e2dc (big blind) folded before Flop
Seat 6: Hero folded before Flop (didn't bet)


Poker Hand #HD1755421018: Hold'em No Limit ($0.05/$0.1) - 2024/05/02 13:51:19
Table 'NLHRed26' 6-max Seat #6 is the button
Seat 1: e9fd34d8 ($6.6 in chips)
Seat 2: 32dabd01 ($11.91 in chips)
Seat 4: 2af8e2dc ($12.89 in chips)
Seat 6: Hero ($10 in chips)
e9fd34d8: posts small blind $0.05
32dabd01: posts big blind $0.1
*** HOLE CARDS ***
Dealt to e9fd34d8 
Dealt to 32dabd01 
Dealt to 2af8e2dc 
Dealt to Hero [5d Kc]
2af8e2dc: folds
Hero: folds
e9fd34d8: raises $0.2 to $0.3
32dabd01: raises $0.45 to $0.75
e9fd34d8: calls $0.45
*** FLOP *** [Ts 2d Ks]
e9fd34d8: checks
32dabd01: bets $0.75
e9fd34d8: folds
Uncalled bet ($0.75) returned to 32dabd01
*** SHOWDOWN ***
32dabd01 collected $1.43 from pot
*** SUMMARY ***
Total pot $1.5 | Rake $0.07 | Jackpot $0 | Bingo $0 | Fortune $0 | Tax $0
Board [Ts 2d Ks]
Seat 1: e9fd34d8 (small blind) folded on the Flop
Seat 2: 32dabd01 (big blind) won ($1.43)
Seat 4: 2af8e2dc folded before Flop (didn't bet)
Seat 6: Hero (button) folded before Flop (didn't bet)


Poker Hand #HD1755421000: Hold'em No Limit ($0.05/$0.1) - 2024/05/02 13:51:09
Table 'NLHRed26' 6-max Seat #4 is the button
Seat 1: e9fd34d8 ($6.55 in chips)
Seat 2: 32dabd01 ($11.91 in chips)
Seat 4: 2af8e2dc ($12.89 in chips)
Seat 6: Hero ($10 in chips)
Hero: posts small blind $0.05
e9fd34d8: posts big blind $0.1
*** HOLE CARDS ***
Dealt to e9fd34d8 
Dealt to 32dabd01 
Dealt to 2af8e2dc 
Dealt to Hero [As 3d]
32dabd01: folds
2af8e2dc: folds
Hero: folds
Uncalled bet ($0.05) returned to e9fd34d8
*** SHOWDOWN ***
e9fd34d8 collected $0.1 from pot
*** SUMMARY ***
Total pot $0.1 | Rake $0 | Jackpot $0 | Bingo $0 | Fortune $0 | Tax $0
Seat 1: e9fd34d8 (big blind) collected ($0.1)
Seat 2: 32dabd01 folded before Flop (didn't bet)
Seat 4: 2af8e2dc (button) folded before Flop (didn't bet)
Seat 6: Hero (small blind) folded before Flop


Poker Hand #HD1755420977: Hold'em No Limit ($0.05/$0.1) - 2024/05/02 13:50:54
Table 'NLHRed26' 6-max Seat #2 is the button
Seat 1: e9fd34d8 ($6.55 in chips)
Seat 2: 32dabd01 ($11.91 in chips)
Seat 4: 2af8e2dc ($12.79 in chips)
Seat 6: Hero ($10 in chips)
2af8e2dc: posts small blind $0.05
Hero: posts big blind $0.1
*** HOLE CARDS ***
Dealt to e9fd34d8 
Dealt to 32dabd01 
Dealt to 2af8e2dc 
Dealt to Hero [5d 3h]
e9fd34d8: folds
32dabd01: folds
2af8e2dc: raises $0.2 to $0.3
Hero: folds
Uncalled bet ($0.2) returned to 2af8e2dc
*** SHOWDOWN ***
2af8e2dc collected $0.2 from pot
*** SUMMARY ***
Total pot $0.2 | Rake $0 | Jackpot $0 | Bingo $0 | Fortune $0 | Tax $0
Seat 1: e9fd34d8 folded before Flop (didn't bet)
Seat 2: 32dabd01 (button) folded before Flop (didn't bet)
Seat 4: 2af8e2dc (small blind) collected ($0.2)
Seat 6: Hero (big blind) folded before Flop


