Poker Hand #HD1731664789: Hold'em No Limit ($0.02/$0.05) - 2024/04/15 18:50:57
Table 'NLHBlue46' 6-max Seat #6 is the button
Seat 1: fbe3ab3e ($4.79 in chips)
Seat 2: 9d2171ac ($13.14 in chips)
Seat 3: fb6f6634 ($5.5 in chips)
Seat 5: 386f37ff ($4.72 in chips)
Seat 6: Hero ($5.05 in chips)
fbe3ab3e: posts small blind $0.02
9d2171ac: posts big blind $0.05
*** HOLE CARDS ***
Dealt to fbe3ab3e 
Dealt to 9d2171ac 
Dealt to fb6f6634 
Dealt to 386f37ff 
Dealt to Hero [4h 6s]
fb6f6634: calls $0.05
386f37ff: raises $0.14 to $0.19
Hero: folds
fbe3ab3e: calls $0.17
9d2171ac: folds
fb6f6634: folds
*** FLOP *** [4c 8c 3d]
fbe3ab3e: checks
386f37ff: bets $0.32
fbe3ab3e: calls $0.32
*** TURN *** [4c 8c 3d] [8s]
fbe3ab3e: checks
386f37ff: checks
*** RIVER *** [4c 8c 3d 8s] [3c]
fbe3ab3e: bets $0.56
386f37ff: folds
Uncalled bet ($0.56) returned to fbe3ab3e
*** SHOWDOWN ***
fbe3ab3e collected $1.07 from pot
*** SUMMARY ***
Total pot $1.12 | Rake $0.05 | Jackpot $0 | Bingo $0 | Fortune $0 | Tax $0
Board [4c 8c 3d 8s 3c]
Seat 1: fbe3ab3e (small blind) won ($1.07)
Seat 2: 9d2171ac (big blind) folded before Flop
Seat 3: fb6f6634 folded before Flop
Seat 5: 386f37ff folded on the River
Seat 6: Hero (button) folded before Flop (didn't bet)


Poker Hand #HD1731664746: Hold'em No Limit ($0.02/$0.05) - 2024/04/15 18:50:42
Table 'NLHBlue46' 6-max Seat #5 is the button
Seat 1: fbe3ab3e ($4.84 in chips)
Seat 2: 9d2171ac ($13.14 in chips)
Seat 3: fb6f6634 ($5.5 in chips)
Seat 5: 386f37ff ($4.72 in chips)
Seat 6: Hero ($5 in chips)
Hero: posts small blind $0.02
fbe3ab3e: posts big blind $0.05
*** HOLE CARDS ***
Dealt to fbe3ab3e 
Dealt to 9d2171ac 
Dealt to fb6f6634 
Dealt to 386f37ff 
Dealt to Hero [3d 3h]
9d2171ac: folds
fb6f6634: folds
386f37ff: folds
Hero: raises $0.1 to $0.15
fbe3ab3e: folds
Uncalled bet ($0.1) returned to Hero
*** SHOWDOWN ***
Hero collected $0.1 from pot
*** SUMMARY ***
Total pot $0.1 | Rake $0 | Jackpot $0 | Bingo $0 | Fortune $0 | Tax $0
Seat 1: fbe3ab3e (big blind) folded before Flop
Seat 2: 9d2171ac folded before Flop (didn't bet)
Seat 3: fb6f6634 folded before Flop (didn't bet)
Seat 5: 386f37ff (button) folded before Flop (didn't bet)
Seat 6: Hero (small blind) collected ($0.1)


Poker Hand #HD1731664707: Hold'em No Limit ($0.02/$0.05) - 2024/04/15 18:50:24
Table 'NLHBlue46' 6-max Seat #3 is the button
Seat 1: fbe3ab3e ($4.77 in chips)
Seat 2: 9d2171ac ($13.14 in chips)
Seat 3: fb6f6634 ($5.5 in chips)
Seat 5: 386f37ff ($4.74 in chips)
Seat 6: Hero ($5 in chips)
386f37ff: posts small blind $0.02
Hero: posts big blind $0.05
*** HOLE CARDS ***
Dealt to fbe3ab3e 
Dealt to 9d2171ac 
Dealt to fb6f6634 
Dealt to 386f37ff 
Dealt to Hero [Ad 2h]
fbe3ab3e: raises $0.1 to $0.15
9d2171ac: folds
fb6f6634: folds
386f37ff: folds
Hero: folds
Uncalled bet ($0.1) returned to fbe3ab3e
*** SHOWDOWN ***
fbe3ab3e collected $0.12 from pot
*** SUMMARY ***
Total pot $0.12 | Rake $0 | Jackpot $0 | Bingo $0 | Fortune $0 | Tax $0
Seat 1: fbe3ab3e collected ($0.12)
Seat 2: 9d2171ac folded before Flop (didn't bet)
Seat 3: fb6f6634 (button) folded before Flop (didn't bet)
Seat 5: 386f37ff (small blind) folded before Flop
Seat 6: Hero (big blind) folded before Flop


Poker Hand #HD1731664527: Hold'em No Limit ($0.02/$0.05) - 2024/04/15 18:49:15
Table 'NLHBlue46' 6-max Seat #2 is the button
Seat 1: fbe3ab3e ($5.33 in chips)
Seat 2: 9d2171ac ($12.14 in chips)
Seat 3: fb6f6634 ($5.52 in chips)
Seat 4: 36f6e35b ($0.56 in chips)
Seat 5: 386f37ff ($4.74 in chips)
Seat 6: Hero ($5 in chips)
fb6f6634: posts small blind $0.02
36f6e35b: posts big blind $0.05
*** HOLE CARDS ***
Dealt to fbe3ab3e 
Dealt to 9d2171ac 
Dealt to fb6f6634 
Dealt to 36f6e35b 
Dealt to 386f37ff 
Dealt to Hero [2d 3h]
386f37ff: folds
Hero: folds
fbe3ab3e: raises $0.1 to $0.15
9d2171ac: raises $0.3 to $0.45
fb6f6634: folds
36f6e35b: calls $0.4
fbe3ab3e: calls $0.3
*** FLOP *** [6d 5c 7s]
36f6e35b: bets $0.11 and is all-in
fbe3ab3e: calls $0.11
9d2171ac: raises $0.62 to $0.73
fbe3ab3e: folds
Uncalled bet ($0.62) returned to 9d2171ac
9d2171ac: shows [Ac Ad] (Pair of Aces)
36f6e35b: shows [5s 4c] (Pair of Fives)
*** TURN *** [6d 5c 7s] [Th]
*** RIVER *** [6d 5c 7s Th] [Qc]
*** SHOWDOWN ***
9d2171ac collected $1.56 from pot
*** SUMMARY ***
Total pot $1.7 | Rake $0.09 | Jackpot $0.05 | Bingo $0 | Fortune $0 | Tax $0
Board [6d 5c 7s Th Qc]
Seat 1: fbe3ab3e folded on the Flop
Seat 2: 9d2171ac (button) showed [Ac Ad] and won ($1.56) with Pair of Aces
Seat 3: fb6f6634 (small blind) folded before Flop
Seat 4: 36f6e35b (big blind) showed [5s 4c] and lost with Pair of Fives
Seat 5: 386f37ff folded before Flop (didn't bet)
Seat 6: Hero folded before Flop (didn't bet)


Poker Hand #HD1731664495: Hold'em No Limit ($0.02/$0.05) - 2024/04/15 18:49:02
Table 'NLHBlue46' 6-max Seat #1 is the button
Seat 1: fbe3ab3e ($5.33 in chips)
Seat 2: 9d2171ac ($12.09 in chips)
Seat 3: fb6f6634 ($5.57 in chips)
Seat 4: 36f6e35b ($0.56 in chips)
Seat 5: 386f37ff ($4.74 in chips)
Seat 6: Hero ($5 in chips)
9d2171ac: posts small blind $0.02
fb6f6634: posts big blind $0.05
*** HOLE CARDS ***
Dealt to fbe3ab3e 
Dealt to 9d2171ac 
Dealt to fb6f6634 
Dealt to 36f6e35b 
Dealt to 386f37ff 
Dealt to Hero [9h Qd]
36f6e35b: folds
386f37ff: folds
Hero: folds
fbe3ab3e: folds
9d2171ac: raises $0.1 to $0.15
fb6f6634: folds
Uncalled bet ($0.1) returned to 9d2171ac
*** SHOWDOWN ***
9d2171ac collected $0.1 from pot
*** SUMMARY ***
Total pot $0.1 | Rake $0 | Jackpot $0 | Bingo $0 | Fortune $0 | Tax $0
Seat 1: fbe3ab3e (button) folded before Flop (didn't bet)
Seat 2: 9d2171ac (small blind) collected ($0.1)
Seat 3: fb6f6634 (big blind) folded before Flop
Seat 4: 36f6e35b folded before Flop (didn't bet)
Seat 5: 386f37ff folded before Flop (didn't bet)
Seat 6: Hero folded before Flop (didn't bet)


Poker Hand #HD1731664430: Hold'em No Limit ($0.02/$0.05) - 2024/04/15 18:48:38
Table 'NLHBlue46' 6-max Seat #6 is the button
Seat 1: fbe3ab3e ($5.35 in chips)
Seat 2: 9d2171ac ($12.14 in chips)
Seat 3: fb6f6634 ($5.5 in chips)
Seat 4: 36f6e35b ($0.56 in chips)
Seat 5: 386f37ff ($4.74 in chips)
Seat 6: Hero ($5 in chips)
fbe3ab3e: posts small blind $0.02
9d2171ac: posts big blind $0.05
*** HOLE CARDS ***
Dealt to fbe3ab3e 
Dealt to 9d2171ac 
Dealt to fb6f6634 
Dealt to 36f6e35b 
Dealt to 386f37ff 
Dealt to Hero [3s 9d]
fb6f6634: calls $0.05
36f6e35b: folds
386f37ff: folds
Hero: folds
fbe3ab3e: folds
9d2171ac: checks
*** FLOP *** [Ad Ks 5h]
9d2171ac: checks
fb6f6634: bets $0.05
9d2171ac: folds
Uncalled bet ($0.05) returned to fb6f6634
*** SHOWDOWN ***
fb6f6634 collected $0.12 from pot
*** SUMMARY ***
Total pot $0.12 | Rake $0 | Jackpot $0 | Bingo $0 | Fortune $0 | Tax $0
Board [Ad Ks 5h]
Seat 1: fbe3ab3e (small blind) folded before Flop
Seat 2: 9d2171ac (big blind) folded on the Flop
Seat 3: fb6f6634 won ($0.12)
Seat 4: 36f6e35b folded before Flop (didn't bet)
Seat 5: 386f37ff folded before Flop (didn't bet)
Seat 6: Hero (button) folded before Flop (didn't bet)


Poker Hand #HD1731664407: Hold'em No Limit ($0.02/$0.05) - 2024/04/15 18:48:30
Table 'NLHBlue46' 6-max Seat #5 is the button
Seat 1: fbe3ab3e ($5.33 in chips)
Seat 2: 9d2171ac ($12.14 in chips)
Seat 3: fb6f6634 ($5.5 in chips)
Seat 4: 36f6e35b ($0.56 in chips)
Seat 5: 386f37ff ($4.74 in chips)
Seat 6: Hero ($5.02 in chips)
Hero: posts small blind $0.02
fbe3ab3e: posts big blind $0.05
*** HOLE CARDS ***
Dealt to fbe3ab3e 
Dealt to 9d2171ac 
Dealt to fb6f6634 
Dealt to 36f6e35b 
Dealt to 386f37ff 
Dealt to Hero [2d Tc]
9d2171ac: folds
fb6f6634: folds
36f6e35b: folds
386f37ff: folds
Hero: folds
Uncalled bet ($0.03) returned to fbe3ab3e
*** SHOWDOWN ***
fbe3ab3e collected $0.04 from pot
*** SUMMARY ***
Total pot $0.04 | Rake $0 | Jackpot $0 | Bingo $0 | Fortune $0 | Tax $0
Seat 1: fbe3ab3e (big blind) collected ($0.04)
Seat 2: 9d2171ac folded before Flop (didn't bet)
Seat 3: fb6f6634 folded before Flop (didn't bet)
Seat 4: 36f6e35b folded before Flop (didn't bet)
Seat 5: 386f37ff (button) folded before Flop (didn't bet)
Seat 6: Hero (small blind) folded before Flop


Poker Hand #HD1731664374: Hold'em No Limit ($0.02/$0.05) - 2024/04/15 18:48:18
Table 'NLHBlue46' 6-max Seat #4 is the button
Seat 1: fbe3ab3e ($5.33 in chips)
Seat 2: 9d2171ac ($12.14 in chips)
Seat 3: fb6f6634 ($5.5 in chips)
Seat 4: 36f6e35b ($0.56 in chips)
Seat 5: 386f37ff ($4.76 in chips)
Seat 6: Hero ($5 in chips)
386f37ff: posts small blind $0.02
Hero: posts big blind $0.05
*** HOLE CARDS ***
Dealt to fbe3ab3e 
Dealt to 9d2171ac 
Dealt to fb6f6634 
Dealt to 36f6e35b 
Dealt to 386f37ff 
Dealt to Hero [Js 5d]
fbe3ab3e: folds
9d2171ac: folds
fb6f6634: folds
36f6e35b: folds
386f37ff: folds
Uncalled bet ($0.03) returned to Hero
*** SHOWDOWN ***
Hero collected $0.04 from pot
*** SUMMARY ***
Total pot $0.04 | Rake $0 | Jackpot $0 | Bingo $0 | Fortune $0 | Tax $0
Seat 1: fbe3ab3e folded before Flop (didn't bet)
Seat 2: 9d2171ac folded before Flop (didn't bet)
Seat 3: fb6f6634 folded before Flop (didn't bet)
Seat 4: 36f6e35b (button) folded before Flop (didn't bet)
Seat 5: 386f37ff (small blind) folded before Flop
Seat 6: Hero (big blind) collected ($0.04)


Poker Hand #HD1731664182: Hold'em No Limit ($0.02/$0.05) - 2024/04/15 18:47:02
Table 'NLHBlue46' 6-max Seat #3 is the button
Seat 1: fbe3ab3e ($4.95 in chips)
Seat 2: 9d2171ac ($12.14 in chips)
Seat 3: fb6f6634 ($5.84 in chips)
Seat 4: 36f6e35b ($0.58 in chips)
Seat 5: 386f37ff ($4.81 in chips)
Seat 6: Hero ($5 in chips)
36f6e35b: posts small blind $0.02
386f37ff: posts big blind $0.05
*** HOLE CARDS ***
Dealt to fbe3ab3e 
Dealt to 9d2171ac 
Dealt to fb6f6634 
Dealt to 36f6e35b 
Dealt to 386f37ff 
Dealt to Hero [5s 8s]
Hero: folds
fbe3ab3e: raises $0.1 to $0.15
9d2171ac: folds
fb6f6634: raises $0.19 to $0.34
36f6e35b: folds
386f37ff: folds
fbe3ab3e: calls $0.19
*** FLOP *** [Kh 5d Ac]
fbe3ab3e: checks
fb6f6634: checks
*** TURN *** [Kh 5d Ac] [Td]
fbe3ab3e: checks
fb6f6634: checks
*** RIVER *** [Kh 5d Ac Td] [Ts]
fbe3ab3e: checks
fb6f6634: checks
fbe3ab3e: shows [Kc Jc] (Pair of Kings and Pair of Tens)
fb6f6634: shows [Jd Js] (Pair of Jacks and Pair of Tens)
*** SHOWDOWN ***
fbe3ab3e collected $0.72 from pot
*** SUMMARY ***
Total pot $0.75 | Rake $0.03 | Jackpot $0 | Bingo $0 | Fortune $0 | Tax $0
Board [Kh 5d Ac Td Ts]
Seat 1: fbe3ab3e showed [Kc Jc] and won ($0.72) with Pair of Kings and Pair of Tens
Seat 2: 9d2171ac folded before Flop (didn't bet)
Seat 3: fb6f6634 (button) showed [Jd Js] and lost with Pair of Jacks and Pair of Tens
Seat 4: 36f6e35b (small blind) folded before Flop
Seat 5: 386f37ff (big blind) folded before Flop
Seat 6: Hero folded before Flop (didn't bet)


Poker Hand #HD1731664111: Hold'em No Limit ($0.02/$0.05) - 2024/04/15 18:46:32
Table 'NLHBlue46' 6-max Seat #2 is the button
Seat 1: fbe3ab3e ($4.95 in chips)
Seat 2: 9d2171ac ($12.01 in chips)
Seat 3: fb6f6634 ($5.86 in chips)
Seat 4: 36f6e35b ($0.7 in chips)
Seat 5: 386f37ff ($4.81 in chips)
Seat 6: Hero ($5 in chips)
fb6f6634: posts small blind $0.02
36f6e35b: posts big blind $0.05
*** HOLE CARDS ***
Dealt to fbe3ab3e 
Dealt to 9d2171ac 
Dealt to fb6f6634 
Dealt to 36f6e35b 
Dealt to 386f37ff 
Dealt to Hero [2s 4d]
386f37ff: folds
Hero: folds
fbe3ab3e: folds
9d2171ac: raises $0.07 to $0.12
fb6f6634: folds
36f6e35b: calls $0.07
*** FLOP *** [2d Td 7h]
36f6e35b: checks
9d2171ac: bets $0.14
36f6e35b: folds
Uncalled bet ($0.14) returned to 9d2171ac
*** SHOWDOWN ***
9d2171ac collected $0.25 from pot
*** SUMMARY ***
Total pot $0.26 | Rake $0.01 | Jackpot $0 | Bingo $0 | Fortune $0 | Tax $0
Board [2d Td 7h]
Seat 1: fbe3ab3e folded before Flop (didn't bet)
Seat 2: 9d2171ac (button) won ($0.25)
Seat 3: fb6f6634 (small blind) folded before Flop
Seat 4: 36f6e35b (big blind) folded on the Flop
Seat 5: 386f37ff folded before Flop (didn't bet)
Seat 6: Hero folded before Flop (didn't bet)


Poker Hand #HD1731664060: Hold'em No Limit ($0.02/$0.05) - 2024/04/15 18:46:13
Table 'NLHBlue46' 6-max Seat #1 is the button
Seat 1: fbe3ab3e ($4.95 in chips)
Seat 2: 9d2171ac ($12.03 in chips)
Seat 3: fb6f6634 ($5.84 in chips)
Seat 4: 36f6e35b ($0.7 in chips)
Seat 5: 386f37ff ($4.81 in chips)
Seat 6: Hero ($5 in chips)
9d2171ac: posts small blind $0.02
fb6f6634: posts big blind $0.05
*** HOLE CARDS ***
Dealt to fbe3ab3e 
Dealt to 9d2171ac 
Dealt to fb6f6634 
Dealt to 36f6e35b 
Dealt to 386f37ff 
Dealt to Hero [6h Jc]
36f6e35b: folds
386f37ff: folds
Hero: folds
fbe3ab3e: folds
9d2171ac: folds
Uncalled bet ($0.03) returned to fb6f6634
*** SHOWDOWN ***
fb6f6634 collected $0.04 from pot
*** SUMMARY ***
Total pot $0.04 | Rake $0 | Jackpot $0 | Bingo $0 | Fortune $0 | Tax $0
Seat 1: fbe3ab3e (button) folded before Flop (didn't bet)
Seat 2: 9d2171ac (small blind) folded before Flop
Seat 3: fb6f6634 (big blind) collected ($0.04)
Seat 4: 36f6e35b folded before Flop (didn't bet)
Seat 5: 386f37ff folded before Flop (didn't bet)
Seat 6: Hero folded before Flop (didn't bet)


Poker Hand #HD1731663955: Hold'em No Limit ($0.02/$0.05) - 2024/04/15 18:45:27
Table 'NLHBlue46' 6-max Seat #6 is the button
Seat 1: fbe3ab3e ($5 in chips)
Seat 2: 9d2171ac ($11.71 in chips)
Seat 3: fb6f6634 ($5.84 in chips)
Seat 4: 36f6e35b ($0.95 in chips)
Seat 5: 386f37ff ($4.86 in chips)
Seat 6: Hero ($5 in chips)
fbe3ab3e: posts small blind $0.02
9d2171ac: posts big blind $0.05
*** HOLE CARDS ***
Dealt to fbe3ab3e 
Dealt to 9d2171ac 
Dealt to fb6f6634 
Dealt to 36f6e35b 
Dealt to 386f37ff 
Dealt to Hero [Qs 4d]
fb6f6634: folds
36f6e35b: calls $0.05
386f37ff: calls $0.05
Hero: folds
fbe3ab3e: calls $0.03
9d2171ac: raises $0.2 to $0.25
36f6e35b: calls $0.2
386f37ff: folds
fbe3ab3e: folds
*** FLOP *** [3c 4h 4c]
9d2171ac: bets $0.35
36f6e35b: folds
Uncalled bet ($0.35) returned to 9d2171ac
*** SHOWDOWN ***
9d2171ac collected $0.57 from pot
*** SUMMARY ***
Total pot $0.6 | Rake $0.03 | Jackpot $0 | Bingo $0 | Fortune $0 | Tax $0
Board [3c 4h 4c]
Seat 1: fbe3ab3e (small blind) folded before Flop
Seat 2: 9d2171ac (big blind) won ($0.57)
Seat 3: fb6f6634 folded before Flop (didn't bet)
Seat 4: 36f6e35b folded on the Flop
Seat 5: 386f37ff folded before Flop
Seat 6: Hero (button) folded before Flop (didn't bet)


Poker Hand #HD1731663823: Hold'em No Limit ($0.02/$0.05) - 2024/04/15 18:44:30
Table 'NLHBlue46' 6-max Seat #5 is the button
Seat 1: fbe3ab3e ($4.48 in chips)
Seat 2: 9d2171ac ($11.71 in chips)
Seat 3: fb6f6634 ($5.84 in chips)
Seat 4: 36f6e35b ($1 in chips)
Seat 5: 386f37ff ($4.74 in chips)
Seat 6: Hero ($5.02 in chips)
Hero: posts small blind $0.02
fbe3ab3e: posts big blind $0.05
36f6e35b: posts big blind $0.05
*** HOLE CARDS ***
Dealt to fbe3ab3e 
Dealt to 9d2171ac 
Dealt to fb6f6634 
Dealt to 36f6e35b 
Dealt to 386f37ff 
Dealt to Hero [Jc 9s]
9d2171ac: folds
fb6f6634: folds
36f6e35b: checks
386f37ff: calls $0.05
Hero: folds
fbe3ab3e: checks
*** FLOP *** [8d 5c 6d]
fbe3ab3e: checks
36f6e35b: checks
386f37ff: checks
*** TURN *** [8d 5c 6d] [Ad]
fbe3ab3e: checks
36f6e35b: checks
386f37ff: checks
*** RIVER *** [8d 5c 6d Ad] [Qh]
fbe3ab3e: checks
36f6e35b: checks
386f37ff: bets $0.12
fbe3ab3e: folds
36f6e35b: folds
Uncalled bet ($0.12) returned to 386f37ff
*** SHOWDOWN ***
386f37ff collected $0.17 from pot
*** SUMMARY ***
Total pot $0.17 | Rake $0 | Jackpot $0 | Bingo $0 | Fortune $0 | Tax $0
Board [8d 5c 6d Ad Qh]
Seat 1: fbe3ab3e (big blind) folded on the River
Seat 2: 9d2171ac folded before Flop (didn't bet)
Seat 3: fb6f6634 folded before Flop (didn't bet)
Seat 4: 36f6e35b folded on the River
Seat 5: 386f37ff (button) won ($0.17)
Seat 6: Hero (small blind) folded before Flop


Poker Hand #HD1731663471: Hold'em No Limit ($0.02/$0.05) - 2024/04/15 18:42:15
Table 'NLHBlue46' 6-max Seat #3 is the button
Seat 1: fbe3ab3e ($5.23 in chips)
Seat 2: 9d2171ac ($11.86 in chips)
Seat 3: fb6f6634 ($5 in chips)
Seat 5: 386f37ff ($4.76 in chips)
Seat 6: Hero ($5.07 in chips)
386f37ff: posts small blind $0.02
Hero: posts big blind $0.05
*** HOLE CARDS ***
Dealt to fbe3ab3e 
Dealt to 9d2171ac 
Dealt to fb6f6634 
Dealt to 386f37ff 
Dealt to Hero [Ks 5c]
fbe3ab3e: raises $0.1 to $0.15
9d2171ac: calls $0.15
fb6f6634: raises $0.6 to $0.75
386f37ff: folds
Hero: folds
fbe3ab3e: calls $0.6
9d2171ac: folds
*** FLOP *** [5s Kh Qs]
fbe3ab3e: checks
fb6f6634: checks
*** TURN *** [5s Kh Qs] [Kd]
fbe3ab3e: checks
fb6f6634: checks
*** RIVER *** [5s Kh Qs Kd] [3h]
fbe3ab3e: checks
fb6f6634: bets $1.29
fbe3ab3e: folds
Uncalled bet ($1.29) returned to fb6f6634
*** SHOWDOWN ***
fb6f6634 collected $1.59 from pot
*** SUMMARY ***
Total pot $1.72 | Rake $0.08 | Jackpot $0.05 | Bingo $0 | Fortune $0 | Tax $0
Board [5s Kh Qs Kd 3h]
Seat 1: fbe3ab3e folded on the River
Seat 2: 9d2171ac folded before Flop
Seat 3: fb6f6634 (button) won ($1.59)
Seat 5: 386f37ff (small blind) folded before Flop
Seat 6: Hero (big blind) folded before Flop


Poker Hand #HD1731663432: Hold'em No Limit ($0.02/$0.05) - 2024/04/15 18:41:58
Table 'NLHBlue46' 6-max Seat #2 is the button
Seat 1: fbe3ab3e ($5.23 in chips)
Seat 2: 9d2171ac ($11.79 in chips)
Seat 3: fb6f6634 ($5 in chips)
Seat 5: 386f37ff ($4.81 in chips)
Seat 6: Hero ($5.07 in chips)
fb6f6634: posts small blind $0.02
386f37ff: posts big blind $0.05
*** HOLE CARDS ***
Dealt to fbe3ab3e 
Dealt to 9d2171ac 
Dealt to fb6f6634 
Dealt to 386f37ff 
Dealt to Hero [Ks 9h]
Hero: folds
fbe3ab3e: folds
9d2171ac: raises $0.07 to $0.12
fb6f6634: folds
386f37ff: folds
Uncalled bet ($0.07) returned to 9d2171ac
*** SHOWDOWN ***
9d2171ac collected $0.12 from pot
*** SUMMARY ***
Total pot $0.12 | Rake $0 | Jackpot $0 | Bingo $0 | Fortune $0 | Tax $0
Seat 1: fbe3ab3e folded before Flop (didn't bet)
Seat 2: 9d2171ac (button) collected ($0.12)
Seat 3: fb6f6634 (small blind) folded before Flop
Seat 5: 386f37ff (big blind) folded before Flop
Seat 6: Hero folded before Flop (didn't bet)


Poker Hand #HD1731663395: Hold'em No Limit ($0.02/$0.05) - 2024/04/15 18:41:39
Table 'NLHBlue46' 6-max Seat #1 is the button
Seat 1: fbe3ab3e ($5.16 in chips)
Seat 2: 9d2171ac ($11.81 in chips)
Seat 3: fb6f6634 ($5 in chips)
Seat 5: 386f37ff ($4.81 in chips)
Seat 6: Hero ($5.07 in chips)
9d2171ac: posts small blind $0.02
fb6f6634: posts big blind $0.05
*** HOLE CARDS ***
Dealt to fbe3ab3e 
Dealt to 9d2171ac 
Dealt to fb6f6634 
Dealt to 386f37ff 
Dealt to Hero [Ks 3s]
386f37ff: folds
Hero: folds
fbe3ab3e: raises $0.1 to $0.15
9d2171ac: folds
fb6f6634: folds
Uncalled bet ($0.1) returned to fbe3ab3e
*** SHOWDOWN ***
fbe3ab3e collected $0.12 from pot
*** SUMMARY ***
Total pot $0.12 | Rake $0 | Jackpot $0 | Bingo $0 | Fortune $0 | Tax $0
Seat 1: fbe3ab3e (button) collected ($0.12)
Seat 2: 9d2171ac (small blind) folded before Flop
Seat 3: fb6f6634 (big blind) folded before Flop
Seat 5: 386f37ff folded before Flop (didn't bet)
Seat 6: Hero folded before Flop (didn't bet)


Poker Hand #HD1731663354: Hold'em No Limit ($0.02/$0.05) - 2024/04/15 18:41:22
Table 'NLHBlue46' 6-max Seat #6 is the button
Seat 1: fbe3ab3e ($5.18 in chips)
Seat 2: 9d2171ac ($11.79 in chips)
Seat 3: fb6f6634 ($5 in chips)
Seat 4: 5b3b6b45 ($5.06 in chips)
Seat 5: 386f37ff ($4.81 in chips)
Seat 6: Hero ($5.07 in chips)
fbe3ab3e: posts small blind $0.02
9d2171ac: posts big blind $0.05
*** HOLE CARDS ***
Dealt to fbe3ab3e 
Dealt to 9d2171ac 
Dealt to fb6f6634 
Dealt to 5b3b6b45 
Dealt to 386f37ff 
Dealt to Hero [Qh 6s]
fb6f6634: folds
5b3b6b45: folds
386f37ff: folds
Hero: folds
fbe3ab3e: folds
Uncalled bet ($0.03) returned to 9d2171ac
*** SHOWDOWN ***
9d2171ac collected $0.04 from pot
*** SUMMARY ***
Total pot $0.04 | Rake $0 | Jackpot $0 | Bingo $0 | Fortune $0 | Tax $0
Seat 1: fbe3ab3e (small blind) folded before Flop
Seat 2: 9d2171ac (big blind) collected ($0.04)
Seat 3: fb6f6634 folded before Flop (didn't bet)
Seat 4: 5b3b6b45 folded before Flop (didn't bet)
Seat 5: 386f37ff folded before Flop (didn't bet)
Seat 6: Hero (button) folded before Flop (didn't bet)


Poker Hand #HD1731663293: Hold'em No Limit ($0.02/$0.05) - 2024/04/15 18:40:51
Table 'NLHBlue46' 6-max Seat #5 is the button
Seat 1: fbe3ab3e ($5 in chips)
Seat 2: 9d2171ac ($11.79 in chips)
Seat 3: fb6f6634 ($5.14 in chips)
Seat 4: 5b3b6b45 ($5.06 in chips)
Seat 5: 386f37ff ($4.81 in chips)
Seat 6: Hero ($5.09 in chips)
Hero: posts small blind $0.02
fbe3ab3e: posts big blind $0.05
*** HOLE CARDS ***
Dealt to fbe3ab3e 
Dealt to 9d2171ac 
Dealt to fb6f6634 
Dealt to 5b3b6b45 
Dealt to 386f37ff 
Dealt to Hero [5d 6s]
9d2171ac: folds
fb6f6634: calls $0.05
5b3b6b45: folds
386f37ff: folds
Hero: folds
fbe3ab3e: raises $0.12 to $0.17
fb6f6634: calls $0.12
*** FLOP *** [8d Js 2h]
fbe3ab3e: bets $0.18
fb6f6634: folds
Uncalled bet ($0.18) returned to fbe3ab3e
*** SHOWDOWN ***
fbe3ab3e collected $0.35 from pot
*** SUMMARY ***
Total pot $0.36 | Rake $0.01 | Jackpot $0 | Bingo $0 | Fortune $0 | Tax $0
Board [8d Js 2h]
Seat 1: fbe3ab3e (big blind) won ($0.35)
Seat 2: 9d2171ac folded before Flop (didn't bet)
Seat 3: fb6f6634 folded on the Flop
Seat 4: 5b3b6b45 folded before Flop (didn't bet)
Seat 5: 386f37ff (button) folded before Flop (didn't bet)
Seat 6: Hero (small blind) folded before Flop


Poker Hand #HD1731663249: Hold'em No Limit ($0.02/$0.05) - 2024/04/15 18:40:34
Table 'NLHBlue46' 6-max Seat #4 is the button
Seat 2: 9d2171ac ($11.79 in chips)
Seat 3: fb6f6634 ($5.14 in chips)
Seat 4: 5b3b6b45 ($5.06 in chips)
Seat 5: 386f37ff ($4.83 in chips)
Seat 6: Hero ($5.07 in chips)
386f37ff: posts small blind $0.02
Hero: posts big blind $0.05
*** HOLE CARDS ***
Dealt to 9d2171ac 
Dealt to fb6f6634 
Dealt to 5b3b6b45 
Dealt to 386f37ff 
Dealt to Hero [Qs 8c]
9d2171ac: folds
fb6f6634: folds
5b3b6b45: folds
386f37ff: folds
Uncalled bet ($0.03) returned to Hero
*** SHOWDOWN ***
Hero collected $0.04 from pot
*** SUMMARY ***
Total pot $0.04 | Rake $0 | Jackpot $0 | Bingo $0 | Fortune $0 | Tax $0
Seat 2: 9d2171ac folded before Flop (didn't bet)
Seat 3: fb6f6634 folded before Flop (didn't bet)
Seat 4: 5b3b6b45 (button) folded before Flop (didn't bet)
Seat 5: 386f37ff (small blind) folded before Flop
Seat 6: Hero (big blind) collected ($0.04)


Poker Hand #HD1731663198: Hold'em No Limit ($0.02/$0.05) - 2024/04/15 18:40:18
Table 'NLHBlue46' 6-max Seat #3 is the button
Seat 2: 9d2171ac ($11.79 in chips)
Seat 3: fb6f6634 ($5.14 in chips)
Seat 4: 5b3b6b45 ($5.08 in chips)
Seat 5: 386f37ff ($4.81 in chips)
Seat 6: Hero ($5.07 in chips)
5b3b6b45: posts small blind $0.02
386f37ff: posts big blind $0.05
*** HOLE CARDS ***
Dealt to 9d2171ac 
Dealt to fb6f6634 
Dealt to 5b3b6b45 
Dealt to 386f37ff 
Dealt to Hero [3h 3s]
Hero: folds
9d2171ac: folds
fb6f6634: folds
5b3b6b45: folds
Uncalled bet ($0.03) returned to 386f37ff
*** SHOWDOWN ***
386f37ff collected $0.04 from pot
*** SUMMARY ***
Total pot $0.04 | Rake $0 | Jackpot $0 | Bingo $0 | Fortune $0 | Tax $0
Seat 2: 9d2171ac folded before Flop (didn't bet)
Seat 3: fb6f6634 (button) folded before Flop (didn't bet)
Seat 4: 5b3b6b45 (small blind) folded before Flop
Seat 5: 386f37ff (big blind) collected ($0.04)
Seat 6: Hero folded before Flop (didn't bet)


Poker Hand #HD1731663156: Hold'em No Limit ($0.02/$0.05) - 2024/04/15 18:39:58
Table 'NLHBlue46' 6-max Seat #2 is the button
Seat 2: 9d2171ac ($11.79 in chips)
Seat 3: fb6f6634 ($5.16 in chips)
Seat 4: 5b3b6b45 ($5.13 in chips)
Seat 5: 386f37ff ($4.81 in chips)
Seat 6: Hero ($5 in chips)
fb6f6634: posts small blind $0.02
5b3b6b45: posts big blind $0.05
*** HOLE CARDS ***
Dealt to 9d2171ac 
Dealt to fb6f6634 
Dealt to 5b3b6b45 
Dealt to 386f37ff 
Dealt to Hero [9h 9c]
386f37ff: folds
Hero: raises $0.07 to $0.12
9d2171ac: folds
fb6f6634: folds
5b3b6b45: folds
Uncalled bet ($0.07) returned to Hero
*** SHOWDOWN ***
Hero collected $0.12 from pot
*** SUMMARY ***
Total pot $0.12 | Rake $0 | Jackpot $0 | Bingo $0 | Fortune $0 | Tax $0
Seat 2: 9d2171ac (button) folded before Flop (didn't bet)
Seat 3: fb6f6634 (small blind) folded before Flop
Seat 4: 5b3b6b45 (big blind) folded before Flop
Seat 5: 386f37ff folded before Flop (didn't bet)
Seat 6: Hero collected ($0.12)


Poker Hand #HD1731663050: Hold'em No Limit ($0.02/$0.05) - 2024/04/15 18:39:20
Table 'NLHBlue46' 6-max Seat #6 is the button
Seat 1: 4a106898 ($9.07 in chips)
Seat 2: 9d2171ac ($11.57 in chips)
Seat 3: fb6f6634 ($5.16 in chips)
Seat 4: 5b3b6b45 ($5.13 in chips)
Seat 5: 386f37ff ($4.81 in chips)
Seat 6: Hero ($5 in chips)
4a106898: posts small blind $0.02
9d2171ac: posts big blind $0.05
*** HOLE CARDS ***
Dealt to 4a106898 
Dealt to 9d2171ac 
Dealt to fb6f6634 
Dealt to 5b3b6b45 
Dealt to 386f37ff 
Dealt to Hero [Th 9h]
fb6f6634: folds
5b3b6b45: folds
386f37ff: folds
Hero: raises $0.07 to $0.12
4a106898: calls $0.1
9d2171ac: raises $0.48 to $0.6
Hero: folds
4a106898: folds
Uncalled bet ($0.48) returned to 9d2171ac
*** SHOWDOWN ***
9d2171ac collected $0.34 from pot
*** SUMMARY ***
Total pot $0.36 | Rake $0.02 | Jackpot $0 | Bingo $0 | Fortune $0 | Tax $0
Seat 1: 4a106898 (small blind) folded before Flop
Seat 2: 9d2171ac (big blind) collected ($0.34)
Seat 3: fb6f6634 folded before Flop (didn't bet)
Seat 4: 5b3b6b45 folded before Flop (didn't bet)
Seat 5: 386f37ff folded before Flop (didn't bet)
Seat 6: Hero (button) folded before Flop


Poker Hand #HD1731662965: Hold'em No Limit ($0.02/$0.05) - 2024/04/15 18:38:45
Table 'NLHBlue46' 6-max Seat #5 is the button
Seat 1: 4a106898 ($9.12 in chips)
Seat 2: 9d2171ac ($11.39 in chips)
Seat 3: fb6f6634 ($5.16 in chips)
Seat 4: 5b3b6b45 ($5.13 in chips)
Seat 5: 386f37ff ($4.93 in chips)
Seat 6: Hero ($5.02 in chips)
Hero: posts small blind $0.02
4a106898: posts big blind $0.05
*** HOLE CARDS ***
Dealt to 4a106898 
Dealt to 9d2171ac 
Dealt to fb6f6634 
Dealt to 5b3b6b45 
Dealt to 386f37ff 
Dealt to Hero [4h Tc]
9d2171ac: raises $0.07 to $0.12
fb6f6634: folds
5b3b6b45: folds
386f37ff: calls $0.12
Hero: folds
4a106898: folds
*** FLOP *** [2h Kh Kd]
9d2171ac: bets $0.1
386f37ff: folds
Uncalled bet ($0.1) returned to 9d2171ac
*** SHOWDOWN ***
9d2171ac collected $0.3 from pot
*** SUMMARY ***
Total pot $0.31 | Rake $0.01 | Jackpot $0 | Bingo $0 | Fortune $0 | Tax $0
Board [2h Kh Kd]
Seat 1: 4a106898 (big blind) folded before Flop
Seat 2: 9d2171ac won ($0.3)
Seat 3: fb6f6634 folded before Flop (didn't bet)
Seat 4: 5b3b6b45 folded before Flop (didn't bet)
Seat 5: 386f37ff (button) folded on the Flop
Seat 6: Hero (small blind) folded before Flop


Poker Hand #HD1731662916: Hold'em No Limit ($0.02/$0.05) - 2024/04/15 18:38:25
Table 'NLHBlue46' 6-max Seat #4 is the button
Seat 1: 4a106898 ($9.12 in chips)
Seat 2: 9d2171ac ($11.39 in chips)
Seat 3: fb6f6634 ($5.16 in chips)
Seat 4: 5b3b6b45 ($5.13 in chips)
Seat 5: 386f37ff ($4.95 in chips)
Seat 6: Hero ($5 in chips)
386f37ff: posts small blind $0.02
Hero: posts big blind $0.05
*** HOLE CARDS ***
Dealt to 4a106898 
Dealt to 9d2171ac 
Dealt to fb6f6634 
Dealt to 5b3b6b45 
Dealt to 386f37ff 
Dealt to Hero [6d 7h]
4a106898: folds
9d2171ac: folds
fb6f6634: folds
5b3b6b45: folds
386f37ff: folds
Uncalled bet ($0.03) returned to Hero
*** SHOWDOWN ***
Hero collected $0.04 from pot
*** SUMMARY ***
Total pot $0.04 | Rake $0 | Jackpot $0 | Bingo $0 | Fortune $0 | Tax $0
Seat 1: 4a106898 folded before Flop (didn't bet)
Seat 2: 9d2171ac folded before Flop (didn't bet)
Seat 3: fb6f6634 folded before Flop (didn't bet)
Seat 4: 5b3b6b45 (button) folded before Flop (didn't bet)
Seat 5: 386f37ff (small blind) folded before Flop
Seat 6: Hero (big blind) collected ($0.04)


Poker Hand #HD1731662841: Hold'em No Limit ($0.02/$0.05) - 2024/04/15 18:37:55
Table 'NLHBlue46' 6-max Seat #3 is the button
Seat 1: 4a106898 ($9.12 in chips)
Seat 2: 9d2171ac ($11.39 in chips)
Seat 3: fb6f6634 ($5 in chips)
Seat 4: 5b3b6b45 ($5.15 in chips)
Seat 5: 386f37ff ($5 in chips)
Seat 6: Hero ($5 in chips)
5b3b6b45: posts small blind $0.02
386f37ff: posts big blind $0.05
*** HOLE CARDS ***
Dealt to 4a106898 
Dealt to 9d2171ac 
Dealt to fb6f6634 
Dealt to 5b3b6b45 
Dealt to 386f37ff 
Dealt to Hero [8d Ad]
Hero: raises $0.05 to $0.1
4a106898: folds
9d2171ac: folds
fb6f6634: raises $0.1 to $0.2
5b3b6b45: folds
386f37ff: folds
Hero: folds
Uncalled bet ($0.1) returned to fb6f6634
*** SHOWDOWN ***
fb6f6634 collected $0.26 from pot
*** SUMMARY ***
Total pot $0.27 | Rake $0.01 | Jackpot $0 | Bingo $0 | Fortune $0 | Tax $0
Seat 1: 4a106898 folded before Flop (didn't bet)
Seat 2: 9d2171ac folded before Flop (didn't bet)
Seat 3: fb6f6634 (button) collected ($0.26)
Seat 4: 5b3b6b45 (small blind) folded before Flop
Seat 5: 386f37ff (big blind) folded before Flop
Seat 6: Hero folded before Flop


Poker Hand #HD1731662803: Hold'em No Limit ($0.02/$0.05) - 2024/04/15 18:37:40
Table 'NLHBlue46' 6-max Seat #2 is the button
Seat 1: 4a106898 ($9.12 in chips)
Seat 2: 9d2171ac ($11.39 in chips)
Seat 3: fb6f6634 ($5.02 in chips)
Seat 4: 5b3b6b45 ($5.13 in chips)
Seat 6: Hero ($5 in chips)
fb6f6634: posts small blind $0.02
5b3b6b45: posts big blind $0.05
*** HOLE CARDS ***
Dealt to 4a106898 
Dealt to 9d2171ac 
Dealt to fb6f6634 
Dealt to 5b3b6b45 
Dealt to Hero [Ts 9c]
Hero: folds
4a106898: folds
9d2171ac: folds
fb6f6634: folds
Uncalled bet ($0.03) returned to 5b3b6b45
*** SHOWDOWN ***
5b3b6b45 collected $0.04 from pot
*** SUMMARY ***
Total pot $0.04 | Rake $0 | Jackpot $0 | Bingo $0 | Fortune $0 | Tax $0
Seat 1: 4a106898 folded before Flop (didn't bet)
Seat 2: 9d2171ac (button) folded before Flop (didn't bet)
Seat 3: fb6f6634 (small blind) folded before Flop
Seat 4: 5b3b6b45 (big blind) collected ($0.04)
Seat 6: Hero folded before Flop (didn't bet)


Poker Hand #HD1731662770: Hold'em No Limit ($0.02/$0.05) - 2024/04/15 18:37:28
Table 'NLHBlue46' 6-max Seat #1 is the button
Seat 1: 4a106898 ($9.12 in chips)
Seat 2: 9d2171ac ($11.41 in chips)
Seat 3: fb6f6634 ($5 in chips)
Seat 4: 5b3b6b45 ($5.13 in chips)
Seat 5: 1727b941 ($5.04 in chips)
Seat 6: Hero ($5 in chips)
9d2171ac: posts small blind $0.02
fb6f6634: posts big blind $0.05
*** HOLE CARDS ***
Dealt to 4a106898 
Dealt to 9d2171ac 
Dealt to fb6f6634 
Dealt to 5b3b6b45 
Dealt to 1727b941 
Dealt to Hero [Kd 9c]
5b3b6b45: folds
1727b941: folds
Hero: folds
4a106898: folds
9d2171ac: folds
Uncalled bet ($0.03) returned to fb6f6634
*** SHOWDOWN ***
fb6f6634 collected $0.04 from pot
*** SUMMARY ***
Total pot $0.04 | Rake $0 | Jackpot $0 | Bingo $0 | Fortune $0 | Tax $0
Seat 1: 4a106898 (button) folded before Flop (didn't bet)
Seat 2: 9d2171ac (small blind) folded before Flop
Seat 3: fb6f6634 (big blind) collected ($0.04)
Seat 4: 5b3b6b45 folded before Flop (didn't bet)
Seat 5: 1727b941 folded before Flop (didn't bet)
Seat 6: Hero folded before Flop (didn't bet)


Poker Hand #HD1731662689: Hold'em No Limit ($0.02/$0.05) - 2024/04/15 18:37:01
Table 'NLHBlue46' 6-max Seat #6 is the button
Seat 1: 4a106898 ($9.07 in chips)
Seat 2: 9d2171ac ($11.46 in chips)
Seat 3: fb6f6634 ($5 in chips)
Seat 4: 5b3b6b45 ($5.13 in chips)
Seat 5: 1727b941 ($5.04 in chips)
Seat 6: Hero ($5 in chips)
4a106898: posts small blind $0.02
9d2171ac: posts big blind $0.05
*** HOLE CARDS ***
Dealt to 4a106898 
Dealt to 9d2171ac 
Dealt to fb6f6634 
Dealt to 5b3b6b45 
Dealt to 1727b941 
Dealt to Hero [4d 2d]
fb6f6634: folds
5b3b6b45: folds
1727b941: folds
Hero: folds
4a106898: raises $0.1 to $0.15
9d2171ac: folds
Uncalled bet ($0.1) returned to 4a106898
*** SHOWDOWN ***
4a106898 collected $0.1 from pot
*** SUMMARY ***
Total pot $0.1 | Rake $0 | Jackpot $0 | Bingo $0 | Fortune $0 | Tax $0
Seat 1: 4a106898 (small blind) collected ($0.1)
Seat 2: 9d2171ac (big blind) folded before Flop
Seat 3: fb6f6634 folded before Flop (didn't bet)
Seat 4: 5b3b6b45 folded before Flop (didn't bet)
Seat 5: 1727b941 folded before Flop (didn't bet)
Seat 6: Hero (button) folded before Flop (didn't bet)


Poker Hand #HD1731662569: Hold'em No Limit ($0.02/$0.05) - 2024/04/15 18:36:13
Table 'NLHBlue46' 6-max Seat #5 is the button
Seat 1: 4a106898 ($8.95 in chips)
Seat 2: 9d2171ac ($11.46 in chips)
Seat 3: fb6f6634 ($5.05 in chips)
Seat 4: 5b3b6b45 ($5.13 in chips)
Seat 5: 1727b941 ($5.04 in chips)
Seat 6: Hero ($5.02 in chips)
Hero: posts small blind $0.02
4a106898: posts big blind $0.05
*** HOLE CARDS ***
Dealt to 4a106898 
Dealt to 9d2171ac 
Dealt to fb6f6634 
Dealt to 5b3b6b45 
Dealt to 1727b941 
Dealt to Hero [Jc 2s]
9d2171ac: folds
fb6f6634: calls $0.05
5b3b6b45: folds
1727b941: folds
Hero: folds
4a106898: checks
*** FLOP *** [7s Th Kh]
4a106898: checks
fb6f6634: bets $0.06
4a106898: calls $0.06
*** TURN *** [7s Th Kh] [Ac]
4a106898: checks
fb6f6634: checks
*** RIVER *** [7s Th Kh Ac] [Qd]
4a106898: checks
fb6f6634: checks
4a106898: shows [3c Ts] (Pair of Tens)
fb6f6634: shows [8h 9h] (Ace-High)
*** SHOWDOWN ***
4a106898 collected $0.23 from pot
*** SUMMARY ***
Total pot $0.24 | Rake $0.01 | Jackpot $0 | Bingo $0 | Fortune $0 | Tax $0
Board [7s Th Kh Ac Qd]
Seat 1: 4a106898 (big blind) showed [3c Ts] and won ($0.23) with Pair of Tens
Seat 2: 9d2171ac folded before Flop (didn't bet)
Seat 3: fb6f6634 showed [8h 9h] and lost with Ace-High
Seat 4: 5b3b6b45 folded before Flop (didn't bet)
Seat 5: 1727b941 (button) folded before Flop (didn't bet)
Seat 6: Hero (small blind) folded before Flop


Poker Hand #HD1731662522: Hold'em No Limit ($0.02/$0.05) - 2024/04/15 18:35:53
Table 'NLHBlue46' 6-max Seat #4 is the button
Seat 1: 4a106898 ($8.88 in chips)
Seat 2: 9d2171ac ($11.46 in chips)
Seat 3: fb6f6634 ($5.05 in chips)
Seat 4: 5b3b6b45 ($5.13 in chips)
Seat 5: 1727b941 ($5.06 in chips)
Seat 6: Hero ($5.07 in chips)
1727b941: posts small blind $0.02
Hero: posts big blind $0.05
*** HOLE CARDS ***
Dealt to 4a106898 
Dealt to 9d2171ac 
Dealt to fb6f6634 
Dealt to 5b3b6b45 
Dealt to 1727b941 
Dealt to Hero [8s 4h]
4a106898: raises $0.1 to $0.15
9d2171ac: folds
fb6f6634: folds
5b3b6b45: folds
1727b941: folds
Hero: folds
Uncalled bet ($0.1) returned to 4a106898
*** SHOWDOWN ***
4a106898 collected $0.12 from pot
*** SUMMARY ***
Total pot $0.12 | Rake $0 | Jackpot $0 | Bingo $0 | Fortune $0 | Tax $0
Seat 1: 4a106898 collected ($0.12)
Seat 2: 9d2171ac folded before Flop (didn't bet)
Seat 3: fb6f6634 folded before Flop (didn't bet)
Seat 4: 5b3b6b45 (button) folded before Flop (didn't bet)
Seat 5: 1727b941 (small blind) folded before Flop
Seat 6: Hero (big blind) folded before Flop


Poker Hand #HD1731662485: Hold'em No Limit ($0.02/$0.05) - 2024/04/15 18:35:37
Table 'NLHBlue46' 6-max Seat #3 is the button
Seat 1: 4a106898 ($8.88 in chips)
Seat 2: 9d2171ac ($11.46 in chips)
Seat 3: fb6f6634 ($5.05 in chips)
Seat 4: 5b3b6b45 ($5.15 in chips)
Seat 5: 1727b941 ($5.04 in chips)
Seat 6: Hero ($5.07 in chips)
5b3b6b45: posts small blind $0.02
1727b941: posts big blind $0.05
*** HOLE CARDS ***
Dealt to 4a106898 
Dealt to 9d2171ac 
Dealt to fb6f6634 
Dealt to 5b3b6b45 
Dealt to 1727b941 
Dealt to Hero [As 9h]
Hero: folds
4a106898: folds
9d2171ac: folds
fb6f6634: folds
5b3b6b45: folds
Uncalled bet ($0.03) returned to 1727b941
*** SHOWDOWN ***
1727b941 collected $0.04 from pot
*** SUMMARY ***
Total pot $0.04 | Rake $0 | Jackpot $0 | Bingo $0 | Fortune $0 | Tax $0
Seat 1: 4a106898 folded before Flop (didn't bet)
Seat 2: 9d2171ac folded before Flop (didn't bet)
Seat 3: fb6f6634 (button) folded before Flop (didn't bet)
Seat 4: 5b3b6b45 (small blind) folded before Flop
Seat 5: 1727b941 (big blind) collected ($0.04)
Seat 6: Hero folded before Flop (didn't bet)


Poker Hand #HD1731662453: Hold'em No Limit ($0.02/$0.05) - 2024/04/15 18:35:23
Table 'NLHBlue46' 6-max Seat #2 is the button
Seat 1: 4a106898 ($8.88 in chips)
Seat 2: 9d2171ac ($11.46 in chips)
Seat 3: fb6f6634 ($5 in chips)
Seat 4: 5b3b6b45 ($5.2 in chips)
Seat 5: 1727b941 ($5.04 in chips)
Seat 6: Hero ($5.07 in chips)
fb6f6634: posts small blind $0.02
5b3b6b45: posts big blind $0.05
*** HOLE CARDS ***
Dealt to 4a106898 
Dealt to 9d2171ac 
Dealt to fb6f6634 
Dealt to 5b3b6b45 
Dealt to 1727b941 
Dealt to Hero [Kc 8d]
1727b941: folds
Hero: folds
4a106898: folds
9d2171ac: folds
fb6f6634: raises $0.05 to $0.1
5b3b6b45: folds
Uncalled bet ($0.05) returned to fb6f6634
*** SHOWDOWN ***
fb6f6634 collected $0.1 from pot
*** SUMMARY ***
Total pot $0.1 | Rake $0 | Jackpot $0 | Bingo $0 | Fortune $0 | Tax $0
Seat 1: 4a106898 folded before Flop (didn't bet)
Seat 2: 9d2171ac (button) folded before Flop (didn't bet)
Seat 3: fb6f6634 (small blind) collected ($0.1)
Seat 4: 5b3b6b45 (big blind) folded before Flop
Seat 5: 1727b941 folded before Flop (didn't bet)
Seat 6: Hero folded before Flop (didn't bet)


Poker Hand #HD1731662414: Hold'em No Limit ($0.02/$0.05) - 2024/04/15 18:35:08
Table 'NLHBlue46' 6-max Seat #1 is the button
Seat 1: 4a106898 ($8.88 in chips)
Seat 2: 9d2171ac ($11.48 in chips)
Seat 3: fb6f6634 ($5.05 in chips)
Seat 4: 5b3b6b45 ($5.2 in chips)
Seat 5: 1727b941 ($5.04 in chips)
Seat 6: Hero ($5 in chips)
9d2171ac: posts small blind $0.02
fb6f6634: posts big blind $0.05
*** HOLE CARDS ***
Dealt to 4a106898 
Dealt to 9d2171ac 
Dealt to fb6f6634 
Dealt to 5b3b6b45 
Dealt to 1727b941 
Dealt to Hero [Ad 9s]
5b3b6b45: folds
1727b941: folds
Hero: raises $0.07 to $0.12
4a106898: folds
9d2171ac: folds
fb6f6634: folds
Uncalled bet ($0.07) returned to Hero
*** SHOWDOWN ***
Hero collected $0.12 from pot
*** SUMMARY ***
Total pot $0.12 | Rake $0 | Jackpot $0 | Bingo $0 | Fortune $0 | Tax $0
Seat 1: 4a106898 (button) folded before Flop (didn't bet)
Seat 2: 9d2171ac (small blind) folded before Flop
Seat 3: fb6f6634 (big blind) folded before Flop
Seat 4: 5b3b6b45 folded before Flop (didn't bet)
Seat 5: 1727b941 folded before Flop (didn't bet)
Seat 6: Hero collected ($0.12)


Poker Hand #HD1731662354: Hold'em No Limit ($0.02/$0.05) - 2024/04/15 18:34:43
Table 'NLHBlue46' 6-max Seat #6 is the button
Seat 1: 4a106898 ($9.03 in chips)
Seat 2: 9d2171ac ($11.34 in chips)
Seat 3: fb6f6634 ($5.05 in chips)
Seat 4: 5b3b6b45 ($5.2 in chips)
Seat 5: 1727b941 ($5.04 in chips)
Seat 6: Hero ($5 in chips)
4a106898: posts small blind $0.02
9d2171ac: posts big blind $0.05
*** HOLE CARDS ***
Dealt to 4a106898 
Dealt to 9d2171ac 
Dealt to fb6f6634 
Dealt to 5b3b6b45 
Dealt to 1727b941 
Dealt to Hero [5c 8s]
fb6f6634: folds
5b3b6b45: folds
1727b941: folds
Hero: folds
4a106898: raises $0.1 to $0.15
9d2171ac: raises $0.3 to $0.45
4a106898: folds
Uncalled bet ($0.3) returned to 9d2171ac
*** SHOWDOWN ***
9d2171ac collected $0.29 from pot
*** SUMMARY ***
Total pot $0.3 | Rake $0.01 | Jackpot $0 | Bingo $0 | Fortune $0 | Tax $0
Seat 1: 4a106898 (small blind) folded before Flop
Seat 2: 9d2171ac (big blind) collected ($0.29)
Seat 3: fb6f6634 folded before Flop (didn't bet)
Seat 4: 5b3b6b45 folded before Flop (didn't bet)
Seat 5: 1727b941 folded before Flop (didn't bet)
Seat 6: Hero (button) folded before Flop (didn't bet)


Poker Hand #HD1731662093: Hold'em No Limit ($0.02/$0.05) - 2024/04/15 18:32:57
Table 'NLHBlue46' 6-max Seat #5 is the button
Seat 1: 4a106898 ($8.47 in chips)
Seat 2: 9d2171ac ($11.34 in chips)
Seat 3: fb6f6634 ($5.3 in chips)
Seat 4: 5b3b6b45 ($5.2 in chips)
Seat 5: 1727b941 ($5.14 in chips)
Seat 6: Hero ($5 in chips)
Hero: posts small blind $0.02
4a106898: posts big blind $0.05
*** HOLE CARDS ***
Dealt to 4a106898 
Dealt to 9d2171ac 
Dealt to fb6f6634 
Dealt to 5b3b6b45 
Dealt to 1727b941 
Dealt to Hero [8d 8c]
9d2171ac: folds
fb6f6634: raises $0.05 to $0.1
5b3b6b45: folds
1727b941: calls $0.1
Hero: calls $0.08
4a106898: calls $0.05
*** FLOP *** [4c 7h 4h]
Hero: checks
4a106898: checks
fb6f6634: checks
1727b941: checks
*** TURN *** [4c 7h 4h] [2s]
Hero: checks
4a106898: checks
fb6f6634: bets $0.15
1727b941: folds
Hero: calls $0.15
4a106898: calls $0.15
*** RIVER *** [4c 7h 4h 2s] [2h]
Hero: checks
4a106898: checks
fb6f6634: checks
Hero: shows [8d 8c] (Pair of Eights and Pair of Fours)
4a106898: shows [Kh Qh] (King High Flush)
fb6f6634: shows [Ac Qs] (Pair of Fours and Pair of Twos)
*** SHOWDOWN ***
4a106898 collected $0.81 from pot
*** SUMMARY ***
Total pot $0.85 | Rake $0.04 | Jackpot $0 | Bingo $0 | Fortune $0 | Tax $0
Board [4c 7h 4h 2s 2h]
Seat 1: 4a106898 (big blind) showed [Kh Qh] and won ($0.81) with King High Flush
Seat 2: 9d2171ac folded before Flop (didn't bet)
Seat 3: fb6f6634 showed [Ac Qs] and lost with Pair of Fours and Pair of Twos
Seat 4: 5b3b6b45 folded before Flop (didn't bet)
Seat 5: 1727b941 (button) folded on the Turn
Seat 6: Hero (small blind) showed [8d 8c] and lost with Pair of Eights and Pair of Fours


Poker Hand #HD1731662034: Hold'em No Limit ($0.02/$0.05) - 2024/04/15 18:32:37
Table 'NLHBlue46' 6-max Seat #4 is the button
Seat 1: 4a106898 ($8.4 in chips)
Seat 2: 9d2171ac ($11.34 in chips)
Seat 3: fb6f6634 ($5.3 in chips)
Seat 4: 5b3b6b45 ($5.2 in chips)
Seat 5: 1727b941 ($5.16 in chips)
Seat 6: Hero ($5 in chips)
1727b941: posts small blind $0.02
Hero: posts big blind $0.05
*** HOLE CARDS ***
Dealt to 4a106898 
Dealt to 9d2171ac 
Dealt to fb6f6634 
Dealt to 5b3b6b45 
Dealt to 1727b941 
Dealt to Hero [9s 4h]
4a106898: raises $0.1 to $0.15
9d2171ac: folds
fb6f6634: folds
5b3b6b45: folds
1727b941: folds
Hero: folds
Uncalled bet ($0.1) returned to 4a106898
*** SHOWDOWN ***
4a106898 collected $0.12 from pot
*** SUMMARY ***
Total pot $0.12 | Rake $0 | Jackpot $0 | Bingo $0 | Fortune $0 | Tax $0
Seat 1: 4a106898 collected ($0.12)
Seat 2: 9d2171ac folded before Flop (didn't bet)
Seat 3: fb6f6634 folded before Flop (didn't bet)
Seat 4: 5b3b6b45 (button) folded before Flop (didn't bet)
Seat 5: 1727b941 (small blind) folded before Flop
Seat 6: Hero (big blind) folded before Flop


Poker Hand #HD1731661901: Hold'em No Limit ($0.02/$0.05) - 2024/04/15 18:31:46
Table 'NLHBlue46' 6-max Seat #3 is the button
Seat 1: 4a106898 ($8.4 in chips)
Seat 2: 9d2171ac ($11.34 in chips)
Seat 3: fb6f6634 ($5 in chips)
Seat 4: 5b3b6b45 ($5.22 in chips)
Seat 5: 1727b941 ($5.21 in chips)
Seat 6: Hero ($5 in chips)
5b3b6b45: posts small blind $0.02
1727b941: posts big blind $0.05
*** HOLE CARDS ***
Dealt to 4a106898 
Dealt to 9d2171ac 
Dealt to fb6f6634 
Dealt to 5b3b6b45 
Dealt to 1727b941 
Dealt to Hero [Ah Kc]
Hero: raises $0.05 to $0.1
4a106898: folds
9d2171ac: folds
fb6f6634: calls $0.1
5b3b6b45: folds
1727b941: folds
*** FLOP *** [6c Qc 7d]
Hero: bets $0.15
fb6f6634: calls $0.15
*** TURN *** [6c Qc 7d] [2s]
Hero: checks
fb6f6634: bets $0.43
Hero: folds
Uncalled bet ($0.43) returned to fb6f6634
*** SHOWDOWN ***
fb6f6634 collected $0.55 from pot
*** SUMMARY ***
Total pot $0.57 | Rake $0.02 | Jackpot $0 | Bingo $0 | Fortune $0 | Tax $0
Board [6c Qc 7d 2s]
Seat 1: 4a106898 folded before Flop (didn't bet)
Seat 2: 9d2171ac folded before Flop (didn't bet)
Seat 3: fb6f6634 (button) won ($0.55)
Seat 4: 5b3b6b45 (small blind) folded before Flop
Seat 5: 1727b941 (big blind) folded before Flop
Seat 6: Hero folded on the Turn


Poker Hand #HD1731661731: Hold'em No Limit ($0.02/$0.05) - 2024/04/15 18:30:39
Table 'NLHBlue46' 6-max Seat #2 is the button
Seat 1: 4a106898 ($8.4 in chips)
Seat 2: 9d2171ac ($10.48 in chips)
Seat 3: fb6f6634 ($4.81 in chips)
Seat 4: 5b3b6b45 ($5.27 in chips)
Seat 5: 1727b941 ($5.21 in chips)
Seat 6: Hero ($5.62 in chips)
fb6f6634: posts small blind $0.02
5b3b6b45: posts big blind $0.05
*** HOLE CARDS ***
Dealt to 4a106898 
Dealt to 9d2171ac 
Dealt to fb6f6634 
Dealt to 5b3b6b45 
Dealt to 1727b941 
Dealt to Hero [Kh Ac]
1727b941: folds
Hero: raises $0.05 to $0.1
4a106898: folds
9d2171ac: raises $0.22 to $0.32
fb6f6634: folds
5b3b6b45: folds
Hero: raises $0.63 to $0.95
9d2171ac: calls $0.63
*** FLOP *** [Js 8s 4s]
Hero: checks
9d2171ac: bets $0.6
Hero: folds
Uncalled bet ($0.6) returned to 9d2171ac
*** SHOWDOWN ***
9d2171ac collected $1.81 from pot
*** SUMMARY ***
Total pot $1.97 | Rake $0.11 | Jackpot $0.05 | Bingo $0 | Fortune $0 | Tax $0
Board [Js 8s 4s]
Seat 1: 4a106898 folded before Flop (didn't bet)
Seat 2: 9d2171ac (button) won ($1.81)
Seat 3: fb6f6634 (small blind) folded before Flop
Seat 4: 5b3b6b45 (big blind) folded before Flop
Seat 5: 1727b941 folded before Flop (didn't bet)
Seat 6: Hero folded on the Flop


Poker Hand #HD1731661700: Hold'em No Limit ($0.02/$0.05) - 2024/04/15 18:30:28
Table 'NLHBlue46' 6-max Seat #1 is the button
Seat 1: 4a106898 ($8.4 in chips)
Seat 2: 9d2171ac ($10.5 in chips)
Seat 3: fb6f6634 ($4.86 in chips)
Seat 4: 5b3b6b45 ($5.2 in chips)
Seat 5: 1727b941 ($5.21 in chips)
Seat 6: Hero ($5.62 in chips)
9d2171ac: posts small blind $0.02
fb6f6634: posts big blind $0.05
*** HOLE CARDS ***
Dealt to 4a106898 
Dealt to 9d2171ac 
Dealt to fb6f6634 
Dealt to 5b3b6b45 
Dealt to 1727b941 
Dealt to Hero [Kh 3s]
5b3b6b45: raises $0.08 to $0.13
1727b941: folds
Hero: folds
4a106898: folds
9d2171ac: folds
fb6f6634: folds
Uncalled bet ($0.08) returned to 5b3b6b45
*** SHOWDOWN ***
5b3b6b45 collected $0.12 from pot
*** SUMMARY ***
Total pot $0.12 | Rake $0 | Jackpot $0 | Bingo $0 | Fortune $0 | Tax $0
Seat 1: 4a106898 (button) folded before Flop (didn't bet)
Seat 2: 9d2171ac (small blind) folded before Flop
Seat 3: fb6f6634 (big blind) folded before Flop
Seat 4: 5b3b6b45 collected ($0.12)
Seat 5: 1727b941 folded before Flop (didn't bet)
Seat 6: Hero folded before Flop (didn't bet)


Poker Hand #HD1731661617: Hold'em No Limit ($0.02/$0.05) - 2024/04/15 18:29:58
Table 'NLHBlue46' 6-max Seat #6 is the button
Seat 1: 4a106898 ($8.42 in chips)
Seat 2: 9d2171ac ($10.55 in chips)
Seat 3: fb6f6634 ($4.86 in chips)
Seat 4: 5b3b6b45 ($5.2 in chips)
Seat 5: 1727b941 ($5.14 in chips)
Seat 6: Hero ($5.62 in chips)
4a106898: posts small blind $0.02
9d2171ac: posts big blind $0.05
*** HOLE CARDS ***
Dealt to 4a106898 
Dealt to 9d2171ac 
Dealt to fb6f6634 
Dealt to 5b3b6b45 
Dealt to 1727b941 
Dealt to Hero [8d 9h]
fb6f6634: folds
5b3b6b45: folds
1727b941: raises $0.08 to $0.13
Hero: folds
4a106898: folds
9d2171ac: folds
Uncalled bet ($0.08) returned to 1727b941
*** SHOWDOWN ***
1727b941 collected $0.12 from pot
*** SUMMARY ***
Total pot $0.12 | Rake $0 | Jackpot $0 | Bingo $0 | Fortune $0 | Tax $0
Seat 1: 4a106898 (small blind) folded before Flop
Seat 2: 9d2171ac (big blind) folded before Flop
Seat 3: fb6f6634 folded before Flop (didn't bet)
Seat 4: 5b3b6b45 folded before Flop (didn't bet)
Seat 5: 1727b941 collected ($0.12)
Seat 6: Hero (button) folded before Flop (didn't bet)


Poker Hand #HD1731661532: Hold'em No Limit ($0.02/$0.05) - 2024/04/15 18:29:25
Table 'NLHBlue46' 6-max Seat #5 is the button
Seat 1: 4a106898 ($8.55 in chips)
Seat 2: 9d2171ac ($10.55 in chips)
Seat 3: fb6f6634 ($4.86 in chips)
Seat 4: 5b3b6b45 ($5.2 in chips)
Seat 5: 1727b941 ($5 in chips)
Seat 6: Hero ($5.64 in chips)
Hero: posts small blind $0.02
4a106898: posts big blind $0.05
*** HOLE CARDS ***
Dealt to 4a106898 
Dealt to 9d2171ac 
Dealt to fb6f6634 
Dealt to 5b3b6b45 
Dealt to 1727b941 
Dealt to Hero [As 9c]
9d2171ac: folds
fb6f6634: folds
5b3b6b45: folds
1727b941: raises $0.08 to $0.13
Hero: folds
4a106898: calls $0.08
*** FLOP *** [7h 9d 6d]
4a106898: checks
1727b941: bets $0.28
4a106898: folds
Uncalled bet ($0.28) returned to 1727b941
*** SHOWDOWN ***
1727b941 collected $0.27 from pot
*** SUMMARY ***
Total pot $0.28 | Rake $0.01 | Jackpot $0 | Bingo $0 | Fortune $0 | Tax $0
Board [7h 9d 6d]
Seat 1: 4a106898 (big blind) folded on the Flop
Seat 2: 9d2171ac folded before Flop (didn't bet)
Seat 3: fb6f6634 folded before Flop (didn't bet)
Seat 4: 5b3b6b45 folded before Flop (didn't bet)
Seat 5: 1727b941 (button) won ($0.27)
Seat 6: Hero (small blind) folded before Flop


Poker Hand #HD1731661502: Hold'em No Limit ($0.02/$0.05) - 2024/04/15 18:29:12
Table 'NLHBlue46' 6-max Seat #4 is the button
Seat 1: 4a106898 ($8.55 in chips)
Seat 2: 9d2171ac ($10.55 in chips)
Seat 3: fb6f6634 ($4.86 in chips)
Seat 4: 5b3b6b45 ($5.13 in chips)
Seat 5: 1727b941 ($5 in chips)
Seat 6: Hero ($5.69 in chips)
1727b941: posts small blind $0.02
Hero: posts big blind $0.05
*** HOLE CARDS ***
Dealt to 4a106898 
Dealt to 9d2171ac 
Dealt to fb6f6634 
Dealt to 5b3b6b45 
Dealt to 1727b941 
Dealt to Hero [7d Kc]
4a106898: folds
9d2171ac: folds
fb6f6634: folds
5b3b6b45: raises $0.08 to $0.13
1727b941: folds
Hero: folds
Uncalled bet ($0.08) returned to 5b3b6b45
*** SHOWDOWN ***
5b3b6b45 collected $0.12 from pot
*** SUMMARY ***
Total pot $0.12 | Rake $0 | Jackpot $0 | Bingo $0 | Fortune $0 | Tax $0
Seat 1: 4a106898 folded before Flop (didn't bet)
Seat 2: 9d2171ac folded before Flop (didn't bet)
Seat 3: fb6f6634 folded before Flop (didn't bet)
Seat 4: 5b3b6b45 (button) collected ($0.12)
Seat 5: 1727b941 (small blind) folded before Flop
Seat 6: Hero (big blind) folded before Flop


Poker Hand #HD1731661391: Hold'em No Limit ($0.02/$0.05) - 2024/04/15 18:28:29
Table 'NLHBlue46' 6-max Seat #3 is the button
Seat 1: 4a106898 ($8.18 in chips)
Seat 2: 9d2171ac ($10.55 in chips)
Seat 3: fb6f6634 ($4.86 in chips)
Seat 4: 5b3b6b45 ($5.15 in chips)
Seat 5: 1727b941 ($5 in chips)
Seat 6: Hero ($5.69 in chips)
5b3b6b45: posts small blind $0.02
1727b941: posts big blind $0.05
*** HOLE CARDS ***
Dealt to 4a106898 
Dealt to 9d2171ac 
Dealt to fb6f6634 
Dealt to 5b3b6b45 
Dealt to 1727b941 
Dealt to Hero [Kd 7d]
Hero: folds
4a106898: raises $0.1 to $0.15
9d2171ac: folds
fb6f6634: folds
5b3b6b45: folds
1727b941: calls $0.1
*** FLOP *** [5h Th 4d]
1727b941: checks
4a106898: checks
*** TURN *** [5h Th 4d] [Jh]
1727b941: checks
4a106898: checks
*** RIVER *** [5h Th 4d Jh] [Ah]
1727b941: bets $0.24
4a106898: calls $0.24
1727b941: shows [Ks Ts] (Pair of Tens)
4a106898: shows [Kc 8h] (Ace High Flush)
*** SHOWDOWN ***
4a106898 collected $0.76 from pot
*** SUMMARY ***
Total pot $0.8 | Rake $0.04 | Jackpot $0 | Bingo $0 | Fortune $0 | Tax $0
Board [5h Th 4d Jh Ah]
Seat 1: 4a106898 showed [Kc 8h] and won ($0.76) with Ace High Flush
Seat 2: 9d2171ac folded before Flop (didn't bet)
Seat 3: fb6f6634 (button) folded before Flop (didn't bet)
Seat 4: 5b3b6b45 (small blind) folded before Flop
Seat 5: 1727b941 (big blind) showed [Ks Ts] and lost with Pair of Tens
Seat 6: Hero folded before Flop (didn't bet)


Poker Hand #HD1731661346: Hold'em No Limit ($0.02/$0.05) - 2024/04/15 18:28:14
Table 'NLHBlue46' 6-max Seat #2 is the button
Seat 1: 4a106898 ($8.11 in chips)
Seat 2: 9d2171ac ($10.55 in chips)
Seat 3: fb6f6634 ($4.88 in chips)
Seat 4: 5b3b6b45 ($5.2 in chips)
Seat 6: Hero ($5.69 in chips)
fb6f6634: posts small blind $0.02
5b3b6b45: posts big blind $0.05
*** HOLE CARDS ***
Dealt to 4a106898 
Dealt to 9d2171ac 
Dealt to fb6f6634 
Dealt to 5b3b6b45 
Dealt to Hero [Kd 3s]
Hero: folds
4a106898: raises $0.1 to $0.15
9d2171ac: folds
fb6f6634: folds
5b3b6b45: folds
Uncalled bet ($0.1) returned to 4a106898
*** SHOWDOWN ***
4a106898 collected $0.12 from pot
*** SUMMARY ***
Total pot $0.12 | Rake $0 | Jackpot $0 | Bingo $0 | Fortune $0 | Tax $0
Seat 1: 4a106898 collected ($0.12)
Seat 2: 9d2171ac (button) folded before Flop (didn't bet)
Seat 3: fb6f6634 (small blind) folded before Flop
Seat 4: 5b3b6b45 (big blind) folded before Flop
Seat 6: Hero folded before Flop (didn't bet)


Poker Hand #HD1731661278: Hold'em No Limit ($0.02/$0.05) - 2024/04/15 18:27:51
Table 'NLHBlue46' 6-max Seat #1 is the button
Seat 1: 4a106898 ($8.11 in chips)
Seat 2: 9d2171ac ($10.5 in chips)
Seat 3: fb6f6634 ($4.93 in chips)
Seat 4: 5b3b6b45 ($5.2 in chips)
Seat 6: Hero ($5.69 in chips)
9d2171ac: posts small blind $0.02
fb6f6634: posts big blind $0.05
*** HOLE CARDS ***
Dealt to 4a106898 
Dealt to 9d2171ac 
Dealt to fb6f6634 
Dealt to 5b3b6b45 
Dealt to Hero [6d 9c]
5b3b6b45: folds
Hero: folds
4a106898: folds
9d2171ac: raises $0.1 to $0.15
fb6f6634: folds
Uncalled bet ($0.1) returned to 9d2171ac
*** SHOWDOWN ***
9d2171ac collected $0.1 from pot
*** SUMMARY ***
Total pot $0.1 | Rake $0 | Jackpot $0 | Bingo $0 | Fortune $0 | Tax $0
Seat 1: 4a106898 (button) folded before Flop (didn't bet)
Seat 2: 9d2171ac (small blind) collected ($0.1)
Seat 3: fb6f6634 (big blind) folded before Flop
Seat 4: 5b3b6b45 folded before Flop (didn't bet)
Seat 6: Hero folded before Flop (didn't bet)


Poker Hand #HD1731661130: Hold'em No Limit ($0.02/$0.05) - 2024/04/15 18:26:58
Table 'NLHBlue46' 6-max Seat #6 is the button
Seat 1: 4a106898 ($7.5 in chips)
Seat 2: 9d2171ac ($10.55 in chips)
Seat 4: 5b3b6b45 ($5.2 in chips)
Seat 6: Hero ($6.31 in chips)
4a106898: posts small blind $0.02
9d2171ac: posts big blind $0.05
*** HOLE CARDS ***
Dealt to 4a106898 
Dealt to 9d2171ac 
Dealt to 5b3b6b45 
Dealt to Hero [Jc Qd]
5b3b6b45: folds
Hero: raises $0.07 to $0.12
4a106898: calls $0.1
9d2171ac: folds
*** FLOP *** [9s Ts 7h]
4a106898: checks
Hero: bets $0.15
4a106898: calls $0.15
*** TURN *** [9s Ts 7h] [Qh]
4a106898: checks
Hero: bets $0.35
4a106898: calls $0.35
*** RIVER *** [9s Ts 7h Qh] [9c]
4a106898: checks
Hero: checks
4a106898: shows [9d Jd] (Three Nines)
Hero: shows [Jc Qd] (Pair of Queens and Pair of Nines)
*** SHOWDOWN ***
4a106898 collected $1.23 from pot
*** SUMMARY ***
Total pot $1.29 | Rake $0.06 | Jackpot $0 | Bingo $0 | Fortune $0 | Tax $0
Board [9s Ts 7h Qh 9c]
Seat 1: 4a106898 (small blind) showed [9d Jd] and won ($1.23) with Three Nines
Seat 2: 9d2171ac (big blind) folded before Flop
Seat 4: 5b3b6b45 folded before Flop (didn't bet)
Seat 6: Hero (button) showed [Jc Qd] and lost with Pair of Queens and Pair of Nines


Poker Hand #HD1731661036: Hold'em No Limit ($0.02/$0.05) - 2024/04/15 18:26:23
Table 'NLHBlue46' 6-max Seat #4 is the button
Seat 1: 4a106898 ($7.55 in chips)
Seat 2: 9d2171ac ($10.67 in chips)
Seat 4: 5b3b6b45 ($5.02 in chips)
Seat 6: Hero ($6.33 in chips)
Hero: posts small blind $0.02
4a106898: posts big blind $0.05
*** HOLE CARDS ***
Dealt to 4a106898 
Dealt to 9d2171ac 
Dealt to 5b3b6b45 
Dealt to Hero [Tc 4s]
9d2171ac: raises $0.07 to $0.12
5b3b6b45: raises $0.38 to $0.5
Hero: folds
4a106898: folds
9d2171ac: folds
Uncalled bet ($0.38) returned to 5b3b6b45
*** SHOWDOWN ***
5b3b6b45 collected $0.3 from pot
*** SUMMARY ***
Total pot $0.31 | Rake $0.01 | Jackpot $0 | Bingo $0 | Fortune $0 | Tax $0
Seat 1: 4a106898 (big blind) folded before Flop
Seat 2: 9d2171ac folded before Flop
Seat 4: 5b3b6b45 (button) collected ($0.3)
Seat 6: Hero (small blind) folded before Flop


Poker Hand #HD1731660925: Hold'em No Limit ($0.02/$0.05) - 2024/04/15 18:25:39
Table 'NLHBlue46' 6-max Seat #2 is the button
Seat 1: 4a106898 ($7.68 in chips)
Seat 2: 9d2171ac ($10.36 in chips)
Seat 3: fb6f6634 ($4.95 in chips)
Seat 4: 5b3b6b45 ($5.07 in chips)
Seat 5: 82796794 ($6.31 in chips)
Seat 6: Hero ($6.33 in chips)
fb6f6634: posts small blind $0.02
5b3b6b45: posts big blind $0.05
*** HOLE CARDS ***
Dealt to 4a106898 
Dealt to 9d2171ac 
Dealt to fb6f6634 
Dealt to 5b3b6b45 
Dealt to 82796794 
Dealt to Hero [Kd 4c]
82796794: raises $0.08 to $0.13
Hero: folds
4a106898: calls $0.13
9d2171ac: raises $0.37 to $0.5
fb6f6634: folds
5b3b6b45: folds
82796794: folds
4a106898: folds
Uncalled bet ($0.37) returned to 9d2171ac
*** SHOWDOWN ***
9d2171ac collected $0.44 from pot
*** SUMMARY ***
Total pot $0.46 | Rake $0.02 | Jackpot $0 | Bingo $0 | Fortune $0 | Tax $0
Seat 1: 4a106898 folded before Flop
Seat 2: 9d2171ac (button) collected ($0.44)
Seat 3: fb6f6634 (small blind) folded before Flop
Seat 4: 5b3b6b45 (big blind) folded before Flop
Seat 5: 82796794 folded before Flop
Seat 6: Hero folded before Flop (didn't bet)


Poker Hand #HD1731660866: Hold'em No Limit ($0.02/$0.05) - 2024/04/15 18:25:18
Table 'NLHBlue46' 6-max Seat #1 is the button
Seat 1: 4a106898 ($7.68 in chips)
Seat 2: 9d2171ac ($10.38 in chips)
Seat 3: fb6f6634 ($5 in chips)
Seat 4: 5b3b6b45 ($5 in chips)
Seat 5: 82796794 ($6.31 in chips)
Seat 6: Hero ($6.33 in chips)
9d2171ac: posts small blind $0.02
fb6f6634: posts big blind $0.05
*** HOLE CARDS ***
Dealt to 4a106898 
Dealt to 9d2171ac 
Dealt to fb6f6634 
Dealt to 5b3b6b45 
Dealt to 82796794 
Dealt to Hero [3d 6c]
5b3b6b45: raises $0.08 to $0.13
82796794: folds
Hero: folds
4a106898: folds
9d2171ac: folds
fb6f6634: folds
Uncalled bet ($0.08) returned to 5b3b6b45
*** SHOWDOWN ***
5b3b6b45 collected $0.12 from pot
*** SUMMARY ***
Total pot $0.12 | Rake $0 | Jackpot $0 | Bingo $0 | Fortune $0 | Tax $0
Seat 1: 4a106898 (button) folded before Flop (didn't bet)
Seat 2: 9d2171ac (small blind) folded before Flop
Seat 3: fb6f6634 (big blind) folded before Flop
Seat 4: 5b3b6b45 collected ($0.12)
Seat 5: 82796794 folded before Flop (didn't bet)
Seat 6: Hero folded before Flop (didn't bet)


Poker Hand #HD1731660716: Hold'em No Limit ($0.02/$0.05) - 2024/04/15 18:24:17
Table 'NLHBlue46' 6-max Seat #6 is the button
Seat 1: 4a106898 ($8.07 in chips)
Seat 2: 9d2171ac ($10.03 in chips)
Seat 4: 5b3b6b45 ($5 in chips)
Seat 5: 82796794 ($6.31 in chips)
Seat 6: Hero ($6.33 in chips)
4a106898: posts small blind $0.02
9d2171ac: posts big blind $0.05
*** HOLE CARDS ***
Dealt to 4a106898 
Dealt to 9d2171ac 
Dealt to 5b3b6b45 
Dealt to 82796794 
Dealt to Hero [5h Td]
5b3b6b45: folds
82796794: folds
Hero: folds
4a106898: raises $0.1 to $0.15
9d2171ac: calls $0.1
*** FLOP *** [Jc 8d 3d]
4a106898: bets $0.24
9d2171ac: calls $0.24
*** TURN *** [Jc 8d 3d] [9d]
4a106898: checks
9d2171ac: checks
*** RIVER *** [Jc 8d 3d 9d] [Tc]
4a106898: checks
9d2171ac: bets $0.78
4a106898: folds
Uncalled bet ($0.78) returned to 9d2171ac
*** SHOWDOWN ***
9d2171ac collected $0.74 from pot
*** SUMMARY ***
Total pot $0.78 | Rake $0.04 | Jackpot $0 | Bingo $0 | Fortune $0 | Tax $0
Board [Jc 8d 3d 9d Tc]
Seat 1: 4a106898 (small blind) folded on the River
Seat 2: 9d2171ac (big blind) won ($0.74)
Seat 4: 5b3b6b45 folded before Flop (didn't bet)
Seat 5: 82796794 folded before Flop (didn't bet)
Seat 6: Hero (button) folded before Flop (didn't bet)


Poker Hand #HD1731660677: Hold'em No Limit ($0.02/$0.05) - 2024/04/15 18:24:04
Table 'NLHBlue46' 6-max Seat #5 is the button
Seat 1: 4a106898 ($8.05 in chips)
Seat 2: 9d2171ac ($10.03 in chips)
Seat 4: 5b3b6b45 ($5 in chips)
Seat 5: 82796794 ($6.31 in chips)
Seat 6: Hero ($6.35 in chips)
Hero: posts small blind $0.02
4a106898: posts big blind $0.05
*** HOLE CARDS ***
Dealt to 4a106898 
Dealt to 9d2171ac 
Dealt to 5b3b6b45 
Dealt to 82796794 
Dealt to Hero [Kh 7s]
9d2171ac: folds
5b3b6b45: folds
82796794: folds
Hero: folds
Uncalled bet ($0.03) returned to 4a106898
*** SHOWDOWN ***
4a106898 collected $0.04 from pot
*** SUMMARY ***
Total pot $0.04 | Rake $0 | Jackpot $0 | Bingo $0 | Fortune $0 | Tax $0
Seat 1: 4a106898 (big blind) collected ($0.04)
Seat 2: 9d2171ac folded before Flop (didn't bet)
Seat 4: 5b3b6b45 folded before Flop (didn't bet)
Seat 5: 82796794 (button) folded before Flop (didn't bet)
Seat 6: Hero (small blind) folded before Flop


Poker Hand #HD1731660656: Hold'em No Limit ($0.02/$0.05) - 2024/04/15 18:23:54
Table 'NLHBlue46' 6-max Seat #4 is the button
Seat 1: 4a106898 ($7.98 in chips)
Seat 2: 9d2171ac ($10.03 in chips)
Seat 4: 5b3b6b45 ($5 in chips)
Seat 5: 82796794 ($6.33 in chips)
Seat 6: Hero ($6.4 in chips)
82796794: posts small blind $0.02
Hero: posts big blind $0.05
*** HOLE CARDS ***
Dealt to 4a106898 
Dealt to 9d2171ac 
Dealt to 5b3b6b45 
Dealt to 82796794 
Dealt to Hero [8d 9h]
4a106898: raises $0.1 to $0.15
9d2171ac: folds
5b3b6b45: folds
82796794: folds
Hero: folds
Uncalled bet ($0.1) returned to 4a106898
*** SHOWDOWN ***
4a106898 collected $0.12 from pot
*** SUMMARY ***
Total pot $0.12 | Rake $0 | Jackpot $0 | Bingo $0 | Fortune $0 | Tax $0
Seat 1: 4a106898 collected ($0.12)
Seat 2: 9d2171ac folded before Flop (didn't bet)
Seat 4: 5b3b6b45 (button) folded before Flop (didn't bet)
Seat 5: 82796794 (small blind) folded before Flop
Seat 6: Hero (big blind) folded before Flop


Poker Hand #HD1731660635: Hold'em No Limit ($0.02/$0.05) - 2024/04/15 18:23:43
Table 'NLHBlue46' 6-max Seat #2 is the button
Seat 1: 4a106898 ($7.98 in chips)
Seat 2: 9d2171ac ($9.96 in chips)
Seat 4: 5b3b6b45 ($5 in chips)
Seat 5: 82796794 ($6.38 in chips)
Seat 6: Hero ($6.4 in chips)
5b3b6b45: posts small blind $0.02
82796794: posts big blind $0.05
*** HOLE CARDS ***
Dealt to 4a106898 
Dealt to 9d2171ac 
Dealt to 5b3b6b45 
Dealt to 82796794 
Dealt to Hero [6s Tc]
Hero: folds
4a106898: folds
9d2171ac: raises $0.07 to $0.12
5b3b6b45: folds
82796794: folds
Uncalled bet ($0.07) returned to 9d2171ac
*** SHOWDOWN ***
9d2171ac collected $0.12 from pot
*** SUMMARY ***
Total pot $0.12 | Rake $0 | Jackpot $0 | Bingo $0 | Fortune $0 | Tax $0
Seat 1: 4a106898 folded before Flop (didn't bet)
Seat 2: 9d2171ac (button) collected ($0.12)
Seat 4: 5b3b6b45 (small blind) folded before Flop
Seat 5: 82796794 (big blind) folded before Flop
Seat 6: Hero folded before Flop (didn't bet)


Poker Hand #HD1731660529: Hold'em No Limit ($0.02/$0.05) - 2024/04/15 18:23:02
Table 'NLHBlue46' 6-max Seat #1 is the button
Seat 1: 4a106898 ($7.98 in chips)
Seat 2: 9d2171ac ($9.45 in chips)
Seat 4: 5b3b6b45 ($5.02 in chips)
Seat 5: 82796794 ($6.9 in chips)
Seat 6: Hero ($6.4 in chips)
9d2171ac: posts small blind $0.02
5b3b6b45: posts big blind $0.05
*** HOLE CARDS ***
Dealt to 4a106898 
Dealt to 9d2171ac 
Dealt to 5b3b6b45 
Dealt to 82796794 
Dealt to Hero [9s Kc]
82796794: raises $0.08 to $0.13
Hero: folds
4a106898: folds
9d2171ac: raises $0.39 to $0.52
5b3b6b45: folds
82796794: calls $0.39
*** FLOP *** [Jc 4c 3s]
9d2171ac: bets $0.36
82796794: folds
Uncalled bet ($0.36) returned to 9d2171ac
*** SHOWDOWN ***
9d2171ac collected $1.03 from pot
*** SUMMARY ***
Total pot $1.09 | Rake $0.06 | Jackpot $0 | Bingo $0 | Fortune $0 | Tax $0
Board [Jc 4c 3s]
Seat 1: 4a106898 (button) folded before Flop (didn't bet)
Seat 2: 9d2171ac (small blind) won ($1.03)
Seat 4: 5b3b6b45 (big blind) folded before Flop
Seat 5: 82796794 folded on the Flop
Seat 6: Hero folded before Flop (didn't bet)


Poker Hand #HD1731660366: Hold'em No Limit ($0.02/$0.05) - 2024/04/15 18:21:49
Table 'NLHBlue46' 6-max Seat #6 is the button
Seat 1: 4a106898 ($8.08 in chips)
Seat 2: 9d2171ac ($5 in chips)
Seat 3: c666d6e0 ($5.37 in chips)
Seat 4: 5b3b6b45 ($5.02 in chips)
Seat 5: 82796794 ($6.9 in chips)
Seat 6: Hero ($6.4 in chips)
4a106898: posts small blind $0.02
9d2171ac: posts big blind $0.05
*** HOLE CARDS ***
Dealt to 4a106898 
Dealt to 9d2171ac 
Dealt to c666d6e0 
Dealt to 5b3b6b45 
Dealt to 82796794 
Dealt to Hero [Ks 2c]
c666d6e0: raises $0.05 to $0.1
5b3b6b45: folds
82796794: folds
Hero: folds
4a106898: calls $0.08
9d2171ac: calls $0.05
*** FLOP *** [8h 2d Qs]
4a106898: checks
9d2171ac: checks
c666d6e0: bets $0.23
4a106898: folds
9d2171ac: calls $0.23
*** TURN *** [8h 2d Qs] [6s]
9d2171ac: checks
c666d6e0: bets $0.76
9d2171ac: raises $1.43 to $2.19
c666d6e0: raises $2.85 to $5.04 and is all-in
9d2171ac: calls $2.48 and is all-in
Uncalled bet ($0.37) returned to c666d6e0
c666d6e0: shows [Kh Jd] (King-High)
9d2171ac: shows [8c 8s] (Three Eights)
*** RIVER *** [8h 2d Qs 6s] [4c]
*** SHOWDOWN ***
9d2171ac collected $9.45 from pot
*** SUMMARY ***
Total pot $10.1 | Rake $0.6 | Jackpot $0.05 | Bingo $0 | Fortune $0 | Tax $0
Board [8h 2d Qs 6s 4c]
Seat 1: 4a106898 (small blind) folded on the Flop
Seat 2: 9d2171ac (big blind) showed [8c 8s] and won ($9.45) with Three Eights
Seat 3: c666d6e0 showed [Kh Jd] and lost with King-High
Seat 4: 5b3b6b45 folded before Flop (didn't bet)
Seat 5: 82796794 folded before Flop (didn't bet)
Seat 6: Hero (button) folded before Flop (didn't bet)


Poker Hand #HD1731660262: Hold'em No Limit ($0.02/$0.05) - 2024/04/15 18:21:09
Table 'NLHBlue46' 6-max Seat #5 is the button
Seat 1: 4a106898 ($8.23 in chips)
Seat 2: 9d2171ac ($5 in chips)
Seat 3: c666d6e0 ($5.21 in chips)
Seat 4: 5b3b6b45 ($5.02 in chips)
Seat 5: 82796794 ($6.9 in chips)
Seat 6: Hero ($6.42 in chips)
Hero: posts small blind $0.02
4a106898: posts big blind $0.05
*** HOLE CARDS ***
Dealt to 4a106898 
Dealt to 9d2171ac 
Dealt to c666d6e0 
Dealt to 5b3b6b45 
Dealt to 82796794 
Dealt to Hero [9c 3s]
9d2171ac: folds
c666d6e0: raises $0.1 to $0.15
5b3b6b45: folds
82796794: folds
Hero: folds
4a106898: calls $0.1
*** FLOP *** [4d Kc 2h]
4a106898: checks
c666d6e0: checks
*** TURN *** [4d Kc 2h] [5h]
4a106898: checks
c666d6e0: checks
*** RIVER *** [4d Kc 2h 5h] [5s]
4a106898: checks
c666d6e0: checks
4a106898: shows [Ts 9h] (Pair of Fives)
c666d6e0: shows [8c Ad] (Pair of Fives)
*** SHOWDOWN ***
c666d6e0 collected $0.31 from pot
*** SUMMARY ***
Total pot $0.32 | Rake $0.01 | Jackpot $0 | Bingo $0 | Fortune $0 | Tax $0
Board [4d Kc 2h 5h 5s]
Seat 1: 4a106898 (big blind) showed [Ts 9h] and lost with Pair of Fives
Seat 2: 9d2171ac folded before Flop (didn't bet)
Seat 3: c666d6e0 showed [8c Ad] and won ($0.31) with Pair of Fives
Seat 4: 5b3b6b45 folded before Flop (didn't bet)
Seat 5: 82796794 (button) folded before Flop (didn't bet)
Seat 6: Hero (small blind) folded before Flop


Poker Hand #HD1731660237: Hold'em No Limit ($0.02/$0.05) - 2024/04/15 18:20:57
Table 'NLHBlue46' 6-max Seat #4 is the button
Seat 1: 4a106898 ($8.16 in chips)
Seat 2: 9d2171ac ($5 in chips)
Seat 3: c666d6e0 ($5.21 in chips)
Seat 4: 5b3b6b45 ($5.02 in chips)
Seat 5: 82796794 ($6.92 in chips)
Seat 6: Hero ($6.47 in chips)
82796794: posts small blind $0.02
Hero: posts big blind $0.05
*** HOLE CARDS ***
Dealt to 4a106898 
Dealt to 9d2171ac 
Dealt to c666d6e0 
Dealt to 5b3b6b45 
Dealt to 82796794 
Dealt to Hero [8d 6s]
4a106898: raises $0.1 to $0.15
9d2171ac: folds
c666d6e0: folds
5b3b6b45: folds
82796794: folds
Hero: folds
Uncalled bet ($0.1) returned to 4a106898
*** SHOWDOWN ***
4a106898 collected $0.12 from pot
*** SUMMARY ***
Total pot $0.12 | Rake $0 | Jackpot $0 | Bingo $0 | Fortune $0 | Tax $0
Seat 1: 4a106898 collected ($0.12)
Seat 2: 9d2171ac folded before Flop (didn't bet)
Seat 3: c666d6e0 folded before Flop (didn't bet)
Seat 4: 5b3b6b45 (button) folded before Flop (didn't bet)
Seat 5: 82796794 (small blind) folded before Flop
Seat 6: Hero (big blind) folded before Flop


Poker Hand #HD1731660103: Hold'em No Limit ($0.02/$0.05) - 2024/04/15 18:20:01
Table 'NLHBlue46' 6-max Seat #3 is the button
Seat 1: 4a106898 ($8.16 in chips)
Seat 2: 9d2171ac ($5 in chips)
Seat 3: c666d6e0 ($5.29 in chips)
Seat 4: 5b3b6b45 ($5.04 in chips)
Seat 5: 82796794 ($6.97 in chips)
Seat 6: Hero ($6.55 in chips)
5b3b6b45: posts small blind $0.02
82796794: posts big blind $0.05
*** HOLE CARDS ***
Dealt to 4a106898 
Dealt to 9d2171ac 
Dealt to c666d6e0 
Dealt to 5b3b6b45 
Dealt to 82796794 
Dealt to Hero [9h Ah]
Hero: raises $0.05 to $0.1
4a106898: folds
9d2171ac: folds
c666d6e0: raises $0.05 to $0.15
5b3b6b45: folds
82796794: folds
Hero: calls $0.05
*** FLOP *** [Jd Ac 5s]
Hero: checks
c666d6e0: bets $0.28
Hero: calls $0.28
*** TURN *** [Jd Ac 5s] [Ad]
Hero: checks
c666d6e0: bets $0.7
Hero: calls $0.7
*** RIVER *** [Jd Ac 5s Ad] [6d]
Hero: checks
c666d6e0: bets $0.77
Hero: calls $0.77
c666d6e0: shows [As 9c] (Three Aces)
Hero: shows [9h Ah] (Three Aces)
*** SHOWDOWN ***
Hero collected $1.82 from pot
c666d6e0 collected $1.82 from pot
*** SUMMARY ***
Total pot $3.87 | Rake $0.18 | Jackpot $0.05 | Bingo $0 | Fortune $0 | Tax $0
Board [Jd Ac 5s Ad 6d]
Seat 1: 4a106898 folded before Flop (didn't bet)
Seat 2: 9d2171ac folded before Flop (didn't bet)
Seat 3: c666d6e0 (button) showed [As 9c] and won ($1.82) with Three Aces
Seat 4: 5b3b6b45 (small blind) folded before Flop
Seat 5: 82796794 (big blind) folded before Flop
Seat 6: Hero showed [9h Ah] and won ($1.82) with Three Aces


Poker Hand #HD1731660065: Hold'em No Limit ($0.02/$0.05) - 2024/04/15 18:19:42
Table 'NLHBlue46' 6-max Seat #2 is the button
Seat 1: 4a106898 ($8.16 in chips)
Seat 2: 9d2171ac ($4.93 in chips)
Seat 3: c666d6e0 ($5.31 in chips)
Seat 4: 5b3b6b45 ($5.09 in chips)
Seat 5: 82796794 ($6.97 in chips)
Seat 6: Hero ($6.55 in chips)
c666d6e0: posts small blind $0.02
5b3b6b45: posts big blind $0.05
*** HOLE CARDS ***
Dealt to 4a106898 
Dealt to 9d2171ac 
Dealt to c666d6e0 
Dealt to 5b3b6b45 
Dealt to 82796794 
Dealt to Hero [Kd 7d]
82796794: folds
Hero: folds
4a106898: folds
9d2171ac: raises $0.07 to $0.12
c666d6e0: folds
5b3b6b45: folds
Uncalled bet ($0.07) returned to 9d2171ac
*** SHOWDOWN ***
9d2171ac collected $0.12 from pot
*** SUMMARY ***
Total pot $0.12 | Rake $0 | Jackpot $0 | Bingo $0 | Fortune $0 | Tax $0
Seat 1: 4a106898 folded before Flop (didn't bet)
Seat 2: 9d2171ac (button) collected ($0.12)
Seat 3: c666d6e0 (small blind) folded before Flop
Seat 4: 5b3b6b45 (big blind) folded before Flop
Seat 5: 82796794 folded before Flop (didn't bet)
Seat 6: Hero folded before Flop (didn't bet)


Poker Hand #HD1731659966: Hold'em No Limit ($0.02/$0.05) - 2024/04/15 18:18:58
Table 'NLHBlue46' 6-max Seat #1 is the button
Seat 1: 4a106898 ($8.35 in chips)
Seat 2: 9d2171ac ($4.95 in chips)
Seat 3: c666d6e0 ($5 in chips)
Seat 4: 5b3b6b45 ($5.09 in chips)
Seat 5: 82796794 ($6.97 in chips)
Seat 6: Hero ($6.67 in chips)
9d2171ac: posts small blind $0.02
c666d6e0: posts big blind $0.05
*** HOLE CARDS ***
Dealt to 4a106898 
Dealt to 9d2171ac 
Dealt to c666d6e0 
Dealt to 5b3b6b45 
Dealt to 82796794 
Dealt to Hero [Ad Js]
5b3b6b45: folds
82796794: folds
Hero: raises $0.07 to $0.12
4a106898: calls $0.12
9d2171ac: folds
c666d6e0: raises $0.07 to $0.19
Hero: folds
4a106898: calls $0.07
*** FLOP *** [4d 9d 5d]
c666d6e0: bets $0.52
4a106898: folds
Uncalled bet ($0.52) returned to c666d6e0
*** SHOWDOWN ***
c666d6e0 collected $0.5 from pot
*** SUMMARY ***
Total pot $0.52 | Rake $0.02 | Jackpot $0 | Bingo $0 | Fortune $0 | Tax $0
Board [4d 9d 5d]
Seat 1: 4a106898 (button) folded on the Flop
Seat 2: 9d2171ac (small blind) folded before Flop
Seat 3: c666d6e0 (big blind) won ($0.5)
Seat 4: 5b3b6b45 folded before Flop (didn't bet)
Seat 5: 82796794 folded before Flop (didn't bet)
Seat 6: Hero folded before Flop


Poker Hand #HD1731659774: Hold'em No Limit ($0.02/$0.05) - 2024/04/15 18:17:37
Table 'NLHBlue46' 6-max Seat #6 is the button
Seat 1: 4a106898 ($8.97 in chips)
Seat 2: 9d2171ac ($5 in chips)
Seat 4: 5b3b6b45 ($5.09 in chips)
Seat 5: 82796794 ($6.36 in chips)
Seat 6: Hero ($6.67 in chips)
4a106898: posts small blind $0.02
9d2171ac: posts big blind $0.05
*** HOLE CARDS ***
Dealt to 4a106898 
Dealt to 9d2171ac 
Dealt to 5b3b6b45 
Dealt to 82796794 
Dealt to Hero [4h Js]
5b3b6b45: folds
82796794: raises $0.08 to $0.13
Hero: folds
4a106898: calls $0.11
9d2171ac: folds
*** FLOP *** [Kh Jd 2d]
4a106898: checks
82796794: bets $0.11
4a106898: calls $0.11
*** TURN *** [Kh Jd 2d] [Ad]
4a106898: checks
82796794: bets $0.38
4a106898: calls $0.38
*** RIVER *** [Kh Jd 2d Ad] [9c]
4a106898: checks
82796794: bets $0.9
4a106898: folds
Uncalled bet ($0.9) returned to 82796794
*** SHOWDOWN ***
82796794 collected $1.23 from pot
*** SUMMARY ***
Total pot $1.29 | Rake $0.06 | Jackpot $0 | Bingo $0 | Fortune $0 | Tax $0
Board [Kh Jd 2d Ad 9c]
Seat 1: 4a106898 (small blind) folded on the River
Seat 2: 9d2171ac (big blind) folded before Flop
Seat 4: 5b3b6b45 folded before Flop (didn't bet)
Seat 5: 82796794 won ($1.23)
Seat 6: Hero (button) folded before Flop (didn't bet)


Poker Hand #HD1731659665: Hold'em No Limit ($0.02/$0.05) - 2024/04/15 18:16:51
Table 'NLHBlue46' 6-max Seat #5 is the button
Seat 1: 4a106898 ($8.7 in chips)
Seat 4: 5b3b6b45 ($5.09 in chips)
Seat 5: 82796794 ($6.63 in chips)
Seat 6: Hero ($6.69 in chips)
Hero: posts small blind $0.02
4a106898: posts big blind $0.05
*** HOLE CARDS ***
Dealt to 4a106898 
Dealt to 5b3b6b45 
Dealt to 82796794 
Dealt to Hero [Jc 9h]
5b3b6b45: folds
82796794: raises $0.08 to $0.13
Hero: folds
4a106898: calls $0.08
*** FLOP *** [6d Ad 8c]
4a106898: checks
82796794: bets $0.14
4a106898: calls $0.14
*** TURN *** [6d Ad 8c] [6c]
4a106898: checks
82796794: checks
*** RIVER *** [6d Ad 8c 6c] [3c]
4a106898: checks
82796794: checks
4a106898: shows [3d 4d] (Pair of Sixes and Pair of Treys)
82796794: shows [9c Qs] (Pair of Sixes)
*** SHOWDOWN ***
4a106898 collected $0.54 from pot
*** SUMMARY ***
Total pot $0.56 | Rake $0.02 | Jackpot $0 | Bingo $0 | Fortune $0 | Tax $0
Board [6d Ad 8c 6c 3c]
Seat 1: 4a106898 (big blind) showed [3d 4d] and won ($0.54) with Pair of Sixes and Pair of Treys
Seat 4: 5b3b6b45 folded before Flop (didn't bet)
Seat 5: 82796794 (button) showed [9c Qs] and lost with Pair of Sixes
Seat 6: Hero (small blind) folded before Flop


Poker Hand #HD1731659576: Hold'em No Limit ($0.02/$0.05) - 2024/04/15 18:16:05
Table 'NLHBlue46' 6-max Seat #4 is the button
Seat 1: 4a106898 ($8.7 in chips)
Seat 3: 63c0317c ($0.91 in chips)
Seat 4: 5b3b6b45 ($5.09 in chips)
Seat 5: 82796794 ($6.65 in chips)
Seat 6: Hero ($5.9 in chips)
82796794: posts small blind $0.02
Hero: posts big blind $0.05
*** HOLE CARDS ***
Dealt to 4a106898 
Dealt to 63c0317c 
Dealt to 5b3b6b45 
Dealt to 82796794 
Dealt to Hero [8d 5h]
4a106898: folds
63c0317c: calls $0.05
5b3b6b45: folds
82796794: folds
Hero: checks
*** FLOP *** [3h 6h 4c]
Hero: checks
63c0317c: bets $0.05
Hero: raises $0.1 to $0.15
63c0317c: calls $0.1
*** TURN *** [3h 6h 4c] [7s]
Hero: bets $0.2
63c0317c: raises $0.2 to $0.4
Hero: raises $1.22 to $1.62
63c0317c: calls $0.31 and is all-in
Uncalled bet ($0.91) returned to Hero
Hero: shows [8d 5h] (Eights-High Straight)
63c0317c: shows [Kc 5c] (Sevens-High Straight)
*** RIVER *** [3h 6h 4c 7s] [Ac]
*** SHOWDOWN ***
Hero collected $1.7 from pot
*** SUMMARY ***
Total pot $1.84 | Rake $0.09 | Jackpot $0.05 | Bingo $0 | Fortune $0 | Tax $0
Board [3h 6h 4c 7s Ac]
Seat 1: 4a106898 folded before Flop (didn't bet)
Seat 3: 63c0317c showed [Kc 5c] and lost with Sevens-High Straight
Seat 4: 5b3b6b45 (button) folded before Flop (didn't bet)
Seat 5: 82796794 (small blind) folded before Flop
Seat 6: Hero (big blind) showed [8d 5h] and won ($1.7) with Eights-High Straight


Poker Hand #HD1731659479: Hold'em No Limit ($0.02/$0.05) - 2024/04/15 18:15:27
Table 'NLHBlue46' 6-max Seat #3 is the button
Seat 1: 4a106898 ($8.7 in chips)
Seat 3: 63c0317c ($0.47 in chips)
Seat 4: 5b3b6b45 ($5.11 in chips)
Seat 5: 82796794 ($7.12 in chips)
Seat 6: Hero ($5.9 in chips)
5b3b6b45: posts small blind $0.02
82796794: posts big blind $0.05
*** HOLE CARDS ***
Dealt to 4a106898 
Dealt to 63c0317c 
Dealt to 5b3b6b45 
Dealt to 82796794 
Dealt to Hero [Js 5d]
Hero: folds
4a106898: folds
63c0317c: calls $0.05
5b3b6b45: folds
82796794: raises $6.2 to $6.25
63c0317c: calls $0.42 and is all-in
Uncalled bet ($5.78) returned to 82796794
82796794: shows [2h Ah]
63c0317c: shows [9h 5h]
*** FLOP *** [4s 5c Jc]
*** TURN *** [4s 5c Jc] [9d]
*** RIVER *** [4s 5c Jc 9d] [6s]
*** SHOWDOWN ***
63c0317c collected $0.91 from pot
*** SUMMARY ***
Total pot $0.96 | Rake $0.05 | Jackpot $0 | Bingo $0 | Fortune $0 | Tax $0
Board [4s 5c Jc 9d 6s]
Seat 1: 4a106898 folded before Flop (didn't bet)
Seat 3: 63c0317c (button) showed [9h 5h] and won ($0.91) with Pair of Nines and Pair of Fives
Seat 4: 5b3b6b45 (small blind) folded before Flop
Seat 5: 82796794 (big blind) showed [2h Ah] and lost with Ace-High
Seat 6: Hero folded before Flop (didn't bet)


Poker Hand #HD1731659401: Hold'em No Limit ($0.02/$0.05) - 2024/04/15 18:14:56
Table 'NLHBlue46' 6-max Seat #1 is the button
Seat 1: 4a106898 ($8.69 in chips)
Seat 3: 63c0317c ($0.45 in chips)
Seat 4: 5b3b6b45 ($5.16 in chips)
Seat 5: 82796794 ($7.12 in chips)
Seat 6: Hero ($5.9 in chips)
63c0317c: posts small blind $0.02
5b3b6b45: posts big blind $0.05
*** HOLE CARDS ***
Dealt to 4a106898 
Dealt to 63c0317c 
Dealt to 5b3b6b45 
Dealt to 82796794 
Dealt to Hero [7d 3h]
82796794: folds
Hero: folds
4a106898: raises $0.1 to $0.15
63c0317c: calls $0.13
5b3b6b45: folds
*** FLOP *** [7s Jh Kh]
63c0317c: checks
4a106898: checks
*** TURN *** [7s Jh Kh] [9d]
63c0317c: bets $0.05
4a106898: calls $0.05
*** RIVER *** [7s Jh Kh 9d] [6c]
63c0317c: bets $0.05
4a106898: calls $0.05
63c0317c: shows [5s 6s] (Pair of Sixes)
4a106898: shows [8h 6d] (Pair of Sixes)
*** SHOWDOWN ***
63c0317c collected $0.27 from pot
4a106898 collected $0.26 from pot
*** SUMMARY ***
Total pot $0.55 | Rake $0.02 | Jackpot $0 | Bingo $0 | Fortune $0 | Tax $0
Board [7s Jh Kh 9d 6c]
Seat 1: 4a106898 (button) showed [8h 6d] and won ($0.26) with Pair of Sixes
Seat 3: 63c0317c (small blind) showed [5s 6s] and won ($0.27) with Pair of Sixes
Seat 4: 5b3b6b45 (big blind) folded before Flop
Seat 5: 82796794 folded before Flop (didn't bet)
Seat 6: Hero folded before Flop (didn't bet)


Poker Hand #HD1731659276: Hold'em No Limit ($0.02/$0.05) - 2024/04/15 18:14:04
Table 'NLHBlue46' 6-max Seat #6 is the button
Seat 1: 4a106898 ($8.53 in chips)
Seat 3: 63c0317c ($0.5 in chips)
Seat 4: 5b3b6b45 ($5.16 in chips)
Seat 5: 82796794 ($7.12 in chips)
Seat 6: Hero ($6.02 in chips)
4a106898: posts small blind $0.02
63c0317c: posts big blind $0.05
*** HOLE CARDS ***
Dealt to 4a106898 
Dealt to 63c0317c 
Dealt to 5b3b6b45 
Dealt to 82796794 
Dealt to Hero [8h Ad]
5b3b6b45: folds
82796794: folds
Hero: raises $0.07 to $0.12
4a106898: calls $0.1
63c0317c: folds
*** FLOP *** [9d 3s 6s]
4a106898: checks
Hero: checks
*** TURN *** [9d 3s 6s] [4s]
4a106898: checks
Hero: checks
*** RIVER *** [9d 3s 6s 4s] [Kc]
4a106898: checks
Hero: checks
4a106898: shows [Th Ah] (Ace-High)
Hero: shows [8h Ad] (Ace-High)
*** SHOWDOWN ***
4a106898 collected $0.28 from pot
*** SUMMARY ***
Total pot $0.29 | Rake $0.01 | Jackpot $0 | Bingo $0 | Fortune $0 | Tax $0
Board [9d 3s 6s 4s Kc]
Seat 1: 4a106898 (small blind) showed [Th Ah] and won ($0.28) with Ace-High
Seat 3: 63c0317c (big blind) folded before Flop
Seat 4: 5b3b6b45 folded before Flop (didn't bet)
Seat 5: 82796794 folded before Flop (didn't bet)
Seat 6: Hero (button) showed [8h Ad] and lost with Ace-High


Poker Hand #HD1731659245: Hold'em No Limit ($0.02/$0.05) - 2024/04/15 18:13:50
Table 'NLHBlue46' 6-max Seat #5 is the button
Seat 1: 4a106898 ($8.58 in chips)
Seat 3: 63c0317c ($0.5 in chips)
Seat 4: 5b3b6b45 ($5.16 in chips)
Seat 5: 82796794 ($7.12 in chips)
Seat 6: Hero ($5.97 in chips)
Hero: posts small blind $0.02
4a106898: posts big blind $0.05
*** HOLE CARDS ***
Dealt to 4a106898 
Dealt to 63c0317c 
Dealt to 5b3b6b45 
Dealt to 82796794 
Dealt to Hero [Qs Ac]
63c0317c: folds
5b3b6b45: folds
82796794: folds
Hero: raises $0.1 to $0.15
4a106898: folds
Uncalled bet ($0.1) returned to Hero
*** SHOWDOWN ***
Hero collected $0.1 from pot
*** SUMMARY ***
Total pot $0.1 | Rake $0 | Jackpot $0 | Bingo $0 | Fortune $0 | Tax $0
Seat 1: 4a106898 (big blind) folded before Flop
Seat 3: 63c0317c folded before Flop (didn't bet)
Seat 4: 5b3b6b45 folded before Flop (didn't bet)
Seat 5: 82796794 (button) folded before Flop (didn't bet)
Seat 6: Hero (small blind) collected ($0.1)


Poker Hand #HD1731659172: Hold'em No Limit ($0.02/$0.05) - 2024/04/15 18:13:15
Table 'NLHBlue46' 6-max Seat #4 is the button
Seat 1: 4a106898 ($8.58 in chips)
Seat 3: 63c0317c ($0.75 in chips)
Seat 4: 5b3b6b45 ($5.16 in chips)
Seat 5: 82796794 ($7.14 in chips)
Seat 6: Hero ($5.72 in chips)
82796794: posts small blind $0.02
Hero: posts big blind $0.05
*** HOLE CARDS ***
Dealt to 4a106898 
Dealt to 63c0317c 
Dealt to 5b3b6b45 
Dealt to 82796794 
Dealt to Hero [8s Ac]
4a106898: folds
63c0317c: calls $0.05
5b3b6b45: folds
82796794: folds
Hero: checks
*** FLOP *** [Ts Td 4c]
Hero: checks
63c0317c: checks
*** TURN *** [Ts Td 4c] [Ad]
Hero: checks
63c0317c: bets $0.05
Hero: calls $0.05
*** RIVER *** [Ts Td 4c Ad] [7c]
Hero: checks
63c0317c: bets $0.15
Hero: calls $0.15
63c0317c: shows [4h 7h] (Pair of Tens and Pair of Sevens)
Hero: shows [8s Ac] (Pair of Aces and Pair of Tens)
*** SHOWDOWN ***
Hero collected $0.5 from pot
*** SUMMARY ***
Total pot $0.52 | Rake $0.02 | Jackpot $0 | Bingo $0 | Fortune $0 | Tax $0
Board [Ts Td 4c Ad 7c]
Seat 1: 4a106898 folded before Flop (didn't bet)
Seat 3: 63c0317c showed [4h 7h] and lost with Pair of Tens and Pair of Sevens
Seat 4: 5b3b6b45 (button) folded before Flop (didn't bet)
Seat 5: 82796794 (small blind) folded before Flop
Seat 6: Hero (big blind) showed [8s Ac] and won ($0.5) with Pair of Aces and Pair of Tens


Poker Hand #HD1731659089: Hold'em No Limit ($0.02/$0.05) - 2024/04/15 18:12:38
Table 'NLHBlue46' 6-max Seat #3 is the button
Seat 1: 4a106898 ($8.58 in chips)
Seat 3: 63c0317c ($0.68 in chips)
Seat 4: 5b3b6b45 ($5.18 in chips)
Seat 5: 82796794 ($7.19 in chips)
Seat 6: Hero ($5.72 in chips)
5b3b6b45: posts small blind $0.02
82796794: posts big blind $0.05
*** HOLE CARDS ***
Dealt to 4a106898 
Dealt to 63c0317c 
Dealt to 5b3b6b45 
Dealt to 82796794 
Dealt to Hero [Qc Th]
Hero: folds
4a106898: folds
63c0317c: calls $0.05
5b3b6b45: folds
82796794: checks
*** FLOP *** [8s 8d 8c]
82796794: checks
63c0317c: bets $0.12
82796794: folds
Uncalled bet ($0.12) returned to 63c0317c
*** SHOWDOWN ***
63c0317c collected $0.12 from pot
*** SUMMARY ***
Total pot $0.12 | Rake $0 | Jackpot $0 | Bingo $0 | Fortune $0 | Tax $0
Board [8s 8d 8c]
Seat 1: 4a106898 folded before Flop (didn't bet)
Seat 3: 63c0317c (button) won ($0.12)
Seat 4: 5b3b6b45 (small blind) folded before Flop
Seat 5: 82796794 (big blind) folded on the Flop
Seat 6: Hero folded before Flop (didn't bet)


Poker Hand #HD1731658993: Hold'em No Limit ($0.02/$0.05) - 2024/04/15 18:11:57
Table 'NLHBlue46' 6-max Seat #1 is the button
Seat 1: 4a106898 ($8.3 in chips)
Seat 3: 63c0317c ($0.93 in chips)
Seat 4: 5b3b6b45 ($5.23 in chips)
Seat 5: 82796794 ($7.19 in chips)
Seat 6: Hero ($5.72 in chips)
63c0317c: posts small blind $0.02
5b3b6b45: posts big blind $0.05
*** HOLE CARDS ***
Dealt to 4a106898 
Dealt to 63c0317c 
Dealt to 5b3b6b45 
Dealt to 82796794 
Dealt to Hero [3c Jd]
82796794: folds
Hero: folds
4a106898: raises $0.1 to $0.15
63c0317c: calls $0.13
5b3b6b45: folds
*** FLOP *** [2s Qc 8s]
63c0317c: checks
4a106898: checks
*** TURN *** [2s Qc 8s] [8c]
63c0317c: bets $0.05
4a106898: calls $0.05
*** RIVER *** [2s Qc 8s 8c] [9d]
63c0317c: bets $0.05
4a106898: calls $0.05
63c0317c: shows [Th Ad] (Pair of Eights)
4a106898: shows [5d 5h] (Pair of Eights and Pair of Fives)
*** SHOWDOWN ***
4a106898 collected $0.53 from pot
*** SUMMARY ***
Total pot $0.55 | Rake $0.02 | Jackpot $0 | Bingo $0 | Fortune $0 | Tax $0
Board [2s Qc 8s 8c 9d]
Seat 1: 4a106898 (button) showed [5d 5h] and won ($0.53) with Pair of Eights and Pair of Fives
Seat 3: 63c0317c (small blind) showed [Th Ad] and lost with Pair of Eights
Seat 4: 5b3b6b45 (big blind) folded before Flop
Seat 5: 82796794 folded before Flop (didn't bet)
Seat 6: Hero folded before Flop (didn't bet)


Poker Hand #HD1731658923: Hold'em No Limit ($0.02/$0.05) - 2024/04/15 18:11:27
Table 'NLHBlue46' 6-max Seat #6 is the button
Seat 1: 4a106898 ($8.16 in chips)
Seat 3: 63c0317c ($1.08 in chips)
Seat 4: 5b3b6b45 ($5.23 in chips)
Seat 5: 82796794 ($7.19 in chips)
Seat 6: Hero ($5.72 in chips)
4a106898: posts small blind $0.02
63c0317c: posts big blind $0.05
*** HOLE CARDS ***
Dealt to 4a106898 
Dealt to 63c0317c 
Dealt to 5b3b6b45 
Dealt to 82796794 
Dealt to Hero [3s 8c]
5b3b6b45: folds
82796794: folds
Hero: folds
4a106898: raises $0.1 to $0.15
63c0317c: calls $0.1
*** FLOP *** [4d 3d Ac]
4a106898: checks
63c0317c: checks
*** TURN *** [4d 3d Ac] [Qh]
4a106898: checks
63c0317c: checks
*** RIVER *** [4d 3d Ac Qh] [4s]
4a106898: bets $0.24
63c0317c: folds
Uncalled bet ($0.24) returned to 4a106898
*** SHOWDOWN ***
4a106898 collected $0.29 from pot
*** SUMMARY ***
Total pot $0.3 | Rake $0.01 | Jackpot $0 | Bingo $0 | Fortune $0 | Tax $0
Board [4d 3d Ac Qh 4s]
Seat 1: 4a106898 (small blind) won ($0.29)
Seat 3: 63c0317c (big blind) folded on the River
Seat 4: 5b3b6b45 folded before Flop (didn't bet)
Seat 5: 82796794 folded before Flop (didn't bet)
Seat 6: Hero (button) folded before Flop (didn't bet)


Poker Hand #HD1731658882: Hold'em No Limit ($0.02/$0.05) - 2024/04/15 18:11:13
Table 'NLHBlue46' 6-max Seat #5 is the button
Seat 1: 4a106898 ($8.21 in chips)
Seat 3: 63c0317c ($1.01 in chips)
Seat 4: 5b3b6b45 ($5.23 in chips)
Seat 5: 82796794 ($7.19 in chips)
Seat 6: Hero ($5.74 in chips)
Hero: posts small blind $0.02
4a106898: posts big blind $0.05
*** HOLE CARDS ***
Dealt to 4a106898 
Dealt to 63c0317c 
Dealt to 5b3b6b45 
Dealt to 82796794 
Dealt to Hero [6h Qh]
63c0317c: raises $0.05 to $0.1
5b3b6b45: folds
82796794: folds
Hero: folds
4a106898: folds
Uncalled bet ($0.05) returned to 63c0317c
*** SHOWDOWN ***
63c0317c collected $0.12 from pot
*** SUMMARY ***
Total pot $0.12 | Rake $0 | Jackpot $0 | Bingo $0 | Fortune $0 | Tax $0
Seat 1: 4a106898 (big blind) folded before Flop
Seat 3: 63c0317c collected ($0.12)
Seat 4: 5b3b6b45 folded before Flop (didn't bet)
Seat 5: 82796794 (button) folded before Flop (didn't bet)
Seat 6: Hero (small blind) folded before Flop


Poker Hand #HD1731658814: Hold'em No Limit ($0.02/$0.05) - 2024/04/15 18:10:45
Table 'NLHBlue46' 6-max Seat #4 is the button
Seat 1: 4a106898 ($8.21 in chips)
Seat 3: 63c0317c ($1.16 in chips)
Seat 4: 5b3b6b45 ($5.23 in chips)
Seat 5: 82796794 ($7.21 in chips)
Seat 6: Hero ($5.58 in chips)
82796794: posts small blind $0.02
Hero: posts big blind $0.05
*** HOLE CARDS ***
Dealt to 4a106898 
Dealt to 63c0317c 
Dealt to 5b3b6b45 
Dealt to 82796794 
Dealt to Hero [6d 6c]
4a106898: folds
63c0317c: calls $0.05
5b3b6b45: folds
82796794: folds
Hero: raises $0.1 to $0.15
63c0317c: calls $0.1
*** FLOP *** [9s 5d Jh]
Hero: checks
63c0317c: checks
*** TURN *** [9s 5d Jh] [As]
Hero: bets $0.15
63c0317c: folds
Uncalled bet ($0.15) returned to Hero
*** SHOWDOWN ***
Hero collected $0.31 from pot
*** SUMMARY ***
Total pot $0.32 | Rake $0.01 | Jackpot $0 | Bingo $0 | Fortune $0 | Tax $0
Board [9s 5d Jh As]
Seat 1: 4a106898 folded before Flop (didn't bet)
Seat 3: 63c0317c folded on the Turn
Seat 4: 5b3b6b45 (button) folded before Flop (didn't bet)
Seat 5: 82796794 (small blind) folded before Flop
Seat 6: Hero (big blind) won ($0.31)


Poker Hand #HD1731658717: Hold'em No Limit ($0.02/$0.05) - 2024/04/15 18:10:07
Table 'NLHBlue46' 6-max Seat #3 is the button
Seat 1: 4a106898 ($8.21 in chips)
Seat 3: 63c0317c ($0.78 in chips)
Seat 4: 5b3b6b45 ($5.25 in chips)
Seat 5: 82796794 ($7.31 in chips)
Seat 6: Hero ($5.88 in chips)
5b3b6b45: posts small blind $0.02
82796794: posts big blind $0.05
*** HOLE CARDS ***
Dealt to 4a106898 
Dealt to 63c0317c 
Dealt to 5b3b6b45 
Dealt to 82796794 
Dealt to Hero [4s 4c]
Hero: raises $0.05 to $0.1
4a106898: folds
63c0317c: calls $0.1
5b3b6b45: folds
82796794: calls $0.05
*** FLOP *** [Qs 3h Qd]
82796794: checks
Hero: checks
63c0317c: bets $0.05
82796794: folds
Hero: calls $0.05
*** TURN *** [Qs 3h Qd] [9c]
Hero: checks
63c0317c: bets $0.15
Hero: calls $0.15
*** RIVER *** [Qs 3h Qd 9c] [5s]
Hero: checks
63c0317c: checks
Hero: shows [4s 4c] (Pair of Queens and Pair of Fours)
63c0317c: shows [9s Ks] (Pair of Queens and Pair of Nines)
*** SHOWDOWN ***
63c0317c collected $0.68 from pot
*** SUMMARY ***
Total pot $0.72 | Rake $0.04 | Jackpot $0 | Bingo $0 | Fortune $0 | Tax $0
Board [Qs 3h Qd 9c 5s]
Seat 1: 4a106898 folded before Flop (didn't bet)
Seat 3: 63c0317c (button) showed [9s Ks] and won ($0.68) with Pair of Queens and Pair of Nines
Seat 4: 5b3b6b45 (small blind) folded before Flop
Seat 5: 82796794 (big blind) folded on the Flop
Seat 6: Hero showed [4s 4c] and lost with Pair of Queens and Pair of Fours


Poker Hand #HD1731658681: Hold'em No Limit ($0.02/$0.05) - 2024/04/15 18:09:53
Table 'NLHBlue46' 6-max Seat #1 is the button
Seat 1: 4a106898 ($8.21 in chips)
Seat 3: 63c0317c ($0.8 in chips)
Seat 4: 5b3b6b45 ($5.3 in chips)
Seat 5: 82796794 ($7.31 in chips)
Seat 6: Hero ($5.81 in chips)
63c0317c: posts small blind $0.02
5b3b6b45: posts big blind $0.05
*** HOLE CARDS ***
Dealt to 4a106898 
Dealt to 63c0317c 
Dealt to 5b3b6b45 
Dealt to 82796794 
Dealt to Hero [Ac 4c]
82796794: folds
Hero: raises $0.07 to $0.12
4a106898: folds
63c0317c: folds
5b3b6b45: folds
Uncalled bet ($0.07) returned to Hero
*** SHOWDOWN ***
Hero collected $0.12 from pot
*** SUMMARY ***
Total pot $0.12 | Rake $0 | Jackpot $0 | Bingo $0 | Fortune $0 | Tax $0
Seat 1: 4a106898 (button) folded before Flop (didn't bet)
Seat 3: 63c0317c (small blind) folded before Flop
Seat 4: 5b3b6b45 (big blind) folded before Flop
Seat 5: 82796794 folded before Flop (didn't bet)
Seat 6: Hero collected ($0.12)


Poker Hand #HD1731658661: Hold'em No Limit ($0.02/$0.05) - 2024/04/15 18:09:44
Table 'NLHBlue46' 6-max Seat #6 is the button
Seat 1: 4a106898 ($8.16 in chips)
Seat 3: 63c0317c ($0.85 in chips)
Seat 4: 5b3b6b45 ($5.3 in chips)
Seat 5: 82796794 ($7.31 in chips)
Seat 6: Hero ($5.81 in chips)
4a106898: posts small blind $0.02
63c0317c: posts big blind $0.05
*** HOLE CARDS ***
Dealt to 4a106898 
Dealt to 63c0317c 
Dealt to 5b3b6b45 
Dealt to 82796794 
Dealt to Hero [4h Qd]
5b3b6b45: folds
82796794: folds
Hero: folds
4a106898: raises $0.1 to $0.15
63c0317c: folds
Uncalled bet ($0.1) returned to 4a106898
*** SHOWDOWN ***
4a106898 collected $0.1 from pot
*** SUMMARY ***
Total pot $0.1 | Rake $0 | Jackpot $0 | Bingo $0 | Fortune $0 | Tax $0
Seat 1: 4a106898 (small blind) collected ($0.1)
Seat 3: 63c0317c (big blind) folded before Flop
Seat 4: 5b3b6b45 folded before Flop (didn't bet)
Seat 5: 82796794 folded before Flop (didn't bet)
Seat 6: Hero (button) folded before Flop (didn't bet)


Poker Hand #HD1731658580: Hold'em No Limit ($0.02/$0.05) - 2024/04/15 18:09:11
Table 'NLHBlue46' 6-max Seat #5 is the button
Seat 1: 4a106898 ($8 in chips)
Seat 3: 63c0317c ($1 in chips)
Seat 4: 5b3b6b45 ($5.3 in chips)
Seat 5: 82796794 ($7.31 in chips)
Seat 6: Hero ($5.83 in chips)
Hero: posts small blind $0.02
4a106898: posts big blind $0.05
63c0317c: posts big blind $0.05
*** HOLE CARDS ***
Dealt to 4a106898 
Dealt to 63c0317c 
Dealt to 5b3b6b45 
Dealt to 82796794 
Dealt to Hero [3s As]
63c0317c: checks
5b3b6b45: folds
82796794: folds
Hero: folds
4a106898: checks
*** FLOP *** [5d 8d 2c]
4a106898: checks
63c0317c: bets $0.05
4a106898: calls $0.05
*** TURN *** [5d 8d 2c] [7s]
4a106898: checks
63c0317c: checks
*** RIVER *** [5d 8d 2c 7s] [5s]
4a106898: checks
63c0317c: bets $0.05
4a106898: calls $0.05
63c0317c: shows [Qd Ts] (Pair of Fives)
4a106898: shows [4h 2h] (Pair of Fives and Pair of Twos)
*** SHOWDOWN ***
4a106898 collected $0.31 from pot
*** SUMMARY ***
Total pot $0.32 | Rake $0.01 | Jackpot $0 | Bingo $0 | Fortune $0 | Tax $0
Board [5d 8d 2c 7s 5s]
Seat 1: 4a106898 (big blind) showed [4h 2h] and won ($0.31) with Pair of Fives and Pair of Twos
Seat 3: 63c0317c showed [Qd Ts] and lost with Pair of Fives
Seat 4: 5b3b6b45 folded before Flop (didn't bet)
Seat 5: 82796794 (button) folded before Flop (didn't bet)
Seat 6: Hero (small blind) folded before Flop


Poker Hand #HD1731658519: Hold'em No Limit ($0.02/$0.05) - 2024/04/15 18:08:44
Table 'NLHBlue46' 6-max Seat #4 is the button
Seat 1: 4a106898 ($8.15 in chips)
Seat 4: 5b3b6b45 ($5.3 in chips)
Seat 5: 82796794 ($7.33 in chips)
Seat 6: Hero ($5.67 in chips)
82796794: posts small blind $0.02
Hero: posts big blind $0.05
*** HOLE CARDS ***
Dealt to 4a106898 
Dealt to 5b3b6b45 
Dealt to 82796794 
Dealt to Hero [Kc Ac]
4a106898: raises $0.1 to $0.15
5b3b6b45: folds
82796794: folds
Hero: raises $0.45 to $0.6
4a106898: folds
Uncalled bet ($0.45) returned to Hero
*** SHOWDOWN ***
Hero collected $0.31 from pot
*** SUMMARY ***
Total pot $0.32 | Rake $0.01 | Jackpot $0 | Bingo $0 | Fortune $0 | Tax $0
Seat 1: 4a106898 folded before Flop
Seat 4: 5b3b6b45 (button) folded before Flop (didn't bet)
Seat 5: 82796794 (small blind) folded before Flop
Seat 6: Hero (big blind) collected ($0.31)


Poker Hand #HD1731658439: Hold'em No Limit ($0.02/$0.05) - 2024/04/15 18:08:14
Table 'NLHBlue46' 6-max Seat #3 is the button
Seat 1: 4a106898 ($8.15 in chips)
Seat 3: 4939468 ($5.12 in chips)
Seat 4: 5b3b6b45 ($5.32 in chips)
Seat 5: 82796794 ($7.12 in chips)
Seat 6: Hero ($5.77 in chips)
5b3b6b45: posts small blind $0.02
82796794: posts big blind $0.05
*** HOLE CARDS ***
Dealt to 4a106898 
Dealt to 4939468 
Dealt to 5b3b6b45 
Dealt to 82796794 
Dealt to Hero [9s Ts]
Hero: raises $0.05 to $0.1
4a106898: folds
4939468: calls $0.1
5b3b6b45: folds
82796794: raises $0.4 to $0.5
Hero: folds
4939468: folds
Uncalled bet ($0.4) returned to 82796794
*** SHOWDOWN ***
82796794 collected $0.31 from pot
*** SUMMARY ***
Total pot $0.32 | Rake $0.01 | Jackpot $0 | Bingo $0 | Fortune $0 | Tax $0
Seat 1: 4a106898 folded before Flop (didn't bet)
Seat 3: 4939468 (button) folded before Flop
Seat 4: 5b3b6b45 (small blind) folded before Flop
Seat 5: 82796794 (big blind) collected ($0.31)
Seat 6: Hero folded before Flop


Poker Hand #HD1731658324: Hold'em No Limit ($0.02/$0.05) - 2024/04/15 18:07:29
Table 'NLHBlue46' 6-max Seat #1 is the button
Seat 1: 4a106898 ($8.15 in chips)
Seat 3: 4939468 ($5.14 in chips)
Seat 4: 5b3b6b45 ($5.05 in chips)
Seat 5: 82796794 ($7.12 in chips)
Seat 6: Hero ($6.04 in chips)
4939468: posts small blind $0.02
5b3b6b45: posts big blind $0.05
*** HOLE CARDS ***
Dealt to 4a106898 
Dealt to 4939468 
Dealt to 5b3b6b45 
Dealt to 82796794 
Dealt to Hero [Kc 9c]
82796794: folds
Hero: raises $0.07 to $0.12
4a106898: folds
4939468: folds
5b3b6b45: calls $0.07
*** FLOP *** [Qh Ac 9h]
5b3b6b45: checks
Hero: checks
*** TURN *** [Qh Ac 9h] [4c]
5b3b6b45: bets $0.15
Hero: calls $0.15
*** RIVER *** [Qh Ac 9h 4c] [6s]
5b3b6b45: bets $0.42
Hero: folds
Uncalled bet ($0.42) returned to 5b3b6b45
*** SHOWDOWN ***
5b3b6b45 collected $0.54 from pot
*** SUMMARY ***
Total pot $0.56 | Rake $0.02 | Jackpot $0 | Bingo $0 | Fortune $0 | Tax $0
Board [Qh Ac 9h 4c 6s]
Seat 1: 4a106898 (button) folded before Flop (didn't bet)
Seat 3: 4939468 (small blind) folded before Flop
Seat 4: 5b3b6b45 (big blind) won ($0.54)
Seat 5: 82796794 folded before Flop (didn't bet)
Seat 6: Hero folded on the River


Poker Hand #HD1731658284: Hold'em No Limit ($0.02/$0.05) - 2024/04/15 18:07:14
Table 'NLHBlue46' 6-max Seat #6 is the button
Seat 1: 4a106898 ($8.17 in chips)
Seat 3: 4939468 ($5.19 in chips)
Seat 4: 5b3b6b45 ($5.05 in chips)
Seat 5: 82796794 ($7.05 in chips)
Seat 6: Hero ($6.04 in chips)
4a106898: posts small blind $0.02
4939468: posts big blind $0.05
*** HOLE CARDS ***
Dealt to 4a106898 
Dealt to 4939468 
Dealt to 5b3b6b45 
Dealt to 82796794 
Dealt to Hero [9c Qc]
5b3b6b45: folds
82796794: raises $0.08 to $0.13
Hero: folds
4a106898: folds
4939468: folds
Uncalled bet ($0.08) returned to 82796794
*** SHOWDOWN ***
82796794 collected $0.12 from pot
*** SUMMARY ***
Total pot $0.12 | Rake $0 | Jackpot $0 | Bingo $0 | Fortune $0 | Tax $0
Seat 1: 4a106898 (small blind) folded before Flop
Seat 3: 4939468 (big blind) folded before Flop
Seat 4: 5b3b6b45 folded before Flop (didn't bet)
Seat 5: 82796794 collected ($0.12)
Seat 6: Hero (button) folded before Flop (didn't bet)


Poker Hand #HD1731658265: Hold'em No Limit ($0.02/$0.05) - 2024/04/15 18:07:07
Table 'NLHBlue46' 6-max Seat #5 is the button
Seat 1: 4a106898 ($8.15 in chips)
Seat 3: 4939468 ($5.19 in chips)
Seat 4: 5b3b6b45 ($5.05 in chips)
Seat 5: 82796794 ($7.05 in chips)
Seat 6: Hero ($6.06 in chips)
Hero: posts small blind $0.02
4a106898: posts big blind $0.05
*** HOLE CARDS ***
Dealt to 4a106898 
Dealt to 4939468 
Dealt to 5b3b6b45 
Dealt to 82796794 
Dealt to Hero [6s 8s]
4939468: folds
5b3b6b45: folds
82796794: folds
Hero: folds
Uncalled bet ($0.03) returned to 4a106898
*** SHOWDOWN ***
4a106898 collected $0.04 from pot
*** SUMMARY ***
Total pot $0.04 | Rake $0 | Jackpot $0 | Bingo $0 | Fortune $0 | Tax $0
Seat 1: 4a106898 (big blind) collected ($0.04)
Seat 3: 4939468 folded before Flop (didn't bet)
Seat 4: 5b3b6b45 folded before Flop (didn't bet)
Seat 5: 82796794 (button) folded before Flop (didn't bet)
Seat 6: Hero (small blind) folded before Flop


Poker Hand #HD1731658131: Hold'em No Limit ($0.02/$0.05) - 2024/04/15 18:06:09
Table 'NLHBlue46' 6-max Seat #4 is the button
Seat 1: 4a106898 ($6.94 in chips)
Seat 3: 4939468 ($5.34 in chips)
Seat 4: 5b3b6b45 ($5.05 in chips)
Seat 5: 82796794 ($8.23 in chips)
Seat 6: Hero ($6.11 in chips)
82796794: posts small blind $0.02
Hero: posts big blind $0.05
*** HOLE CARDS ***
Dealt to 4a106898 
Dealt to 4939468 
Dealt to 5b3b6b45 
Dealt to 82796794 
Dealt to Hero [Jc Qc]
4a106898: raises $0.1 to $0.15
4939468: calls $0.15
5b3b6b45: folds
82796794: raises $0.52 to $0.67
Hero: folds
4a106898: calls $0.52
4939468: folds
*** FLOP *** [5c Ks 9s]
82796794: bets $0.51
4a106898: calls $0.51
*** TURN *** [5c Ks 9s] [Js]
82796794: checks
4a106898: bets $1.57
82796794: folds
Uncalled bet ($1.57) returned to 4a106898
*** SHOWDOWN ***
4a106898 collected $2.39 from pot
*** SUMMARY ***
Total pot $2.56 | Rake $0.12 | Jackpot $0.05 | Bingo $0 | Fortune $0 | Tax $0
Board [5c Ks 9s Js]
Seat 1: 4a106898 won ($2.39)
Seat 3: 4939468 folded before Flop
Seat 4: 5b3b6b45 (button) folded before Flop (didn't bet)
Seat 5: 82796794 (small blind) folded on the Turn
Seat 6: Hero (big blind) folded before Flop


Poker Hand #HD1731658099: Hold'em No Limit ($0.02/$0.05) - 2024/04/15 18:05:53
Table 'NLHBlue46' 6-max Seat #3 is the button
Seat 1: 4a106898 ($6.94 in chips)
Seat 3: 4939468 ($5.34 in chips)
Seat 4: 5b3b6b45 ($5 in chips)
Seat 5: 82796794 ($8.28 in chips)
Seat 6: Hero ($6.11 in chips)
5b3b6b45: posts small blind $0.02
82796794: posts big blind $0.05
*** HOLE CARDS ***
Dealt to 4a106898 
Dealt to 4939468 
Dealt to 5b3b6b45 
Dealt to 82796794 
Dealt to Hero [3s 4s]
Hero: folds
4a106898: folds
4939468: folds
5b3b6b45: raises $0.1 to $0.15
82796794: folds
Uncalled bet ($0.1) returned to 5b3b6b45
*** SHOWDOWN ***
5b3b6b45 collected $0.1 from pot
*** SUMMARY ***
Total pot $0.1 | Rake $0 | Jackpot $0 | Bingo $0 | Fortune $0 | Tax $0
Seat 1: 4a106898 folded before Flop (didn't bet)
Seat 3: 4939468 (button) folded before Flop (didn't bet)
Seat 4: 5b3b6b45 (small blind) collected ($0.1)
Seat 5: 82796794 (big blind) folded before Flop
Seat 6: Hero folded before Flop (didn't bet)


Poker Hand #HD1731658046: Hold'em No Limit ($0.02/$0.05) - 2024/04/15 18:05:34
Table 'NLHBlue46' 6-max Seat #1 is the button
Seat 1: 4a106898 ($6.94 in chips)
Seat 3: 4939468 ($5.36 in chips)
Seat 4: 5b3b6b45 ($5 in chips)
Seat 5: 82796794 ($8.28 in chips)
Seat 6: Hero ($6.04 in chips)
4939468: posts small blind $0.02
5b3b6b45: posts big blind $0.05
*** HOLE CARDS ***
Dealt to 4a106898 
Dealt to 4939468 
Dealt to 5b3b6b45 
Dealt to 82796794 
Dealt to Hero [Ts Ks]
82796794: folds
Hero: raises $0.07 to $0.12
4a106898: folds
4939468: folds
5b3b6b45: folds
Uncalled bet ($0.07) returned to Hero
*** SHOWDOWN ***
Hero collected $0.12 from pot
*** SUMMARY ***
Total pot $0.12 | Rake $0 | Jackpot $0 | Bingo $0 | Fortune $0 | Tax $0
Seat 1: 4a106898 (button) folded before Flop (didn't bet)
Seat 3: 4939468 (small blind) folded before Flop
Seat 4: 5b3b6b45 (big blind) folded before Flop
Seat 5: 82796794 folded before Flop (didn't bet)
Seat 6: Hero collected ($0.12)


Poker Hand #HD1731657998: Hold'em No Limit ($0.02/$0.05) - 2024/04/15 18:05:17
Table 'NLHBlue46' 6-max Seat #6 is the button
Seat 1: 4a106898 ($6.96 in chips)
Seat 3: 4939468 ($5.34 in chips)
Seat 5: 82796794 ($8.28 in chips)
Seat 6: Hero ($6.04 in chips)
4a106898: posts small blind $0.02
4939468: posts big blind $0.05
*** HOLE CARDS ***
Dealt to 4a106898 
Dealt to 4939468 
Dealt to 82796794 
Dealt to Hero [3h Jh]
82796794: folds
Hero: folds
4a106898: folds
Uncalled bet ($0.03) returned to 4939468
*** SHOWDOWN ***
4939468 collected $0.04 from pot
*** SUMMARY ***
Total pot $0.04 | Rake $0 | Jackpot $0 | Bingo $0 | Fortune $0 | Tax $0
Seat 1: 4a106898 (small blind) folded before Flop
Seat 3: 4939468 (big blind) collected ($0.04)
Seat 5: 82796794 folded before Flop (didn't bet)
Seat 6: Hero (button) folded before Flop (didn't bet)


Poker Hand #HD1731657889: Hold'em No Limit ($0.02/$0.05) - 2024/04/15 18:04:30
Table 'NLHBlue46' 6-max Seat #5 is the button
Seat 1: 4a106898 ($7.01 in chips)
Seat 3: 4939468 ($5.34 in chips)
Seat 5: 82796794 ($8.11 in chips)
Seat 6: Hero ($6.17 in chips)
Hero: posts small blind $0.02
4a106898: posts big blind $0.05
*** HOLE CARDS ***
Dealt to 4a106898 
Dealt to 4939468 
Dealt to 82796794 
Dealt to Hero [Qc Tc]
4939468: folds
82796794: raises $0.08 to $0.13
Hero: calls $0.11
4a106898: folds
*** FLOP *** [Ks Qs Ad]
Hero: checks
82796794: bets $0.16
Hero: folds
Uncalled bet ($0.16) returned to 82796794
*** SHOWDOWN ***
82796794 collected $0.3 from pot
*** SUMMARY ***
Total pot $0.31 | Rake $0.01 | Jackpot $0 | Bingo $0 | Fortune $0 | Tax $0
Board [Ks Qs Ad]
Seat 1: 4a106898 (big blind) folded before Flop
Seat 3: 4939468 folded before Flop (didn't bet)
Seat 5: 82796794 (button) won ($0.3)
Seat 6: Hero (small blind) folded on the Flop


Poker Hand #HD1731657805: Hold'em No Limit ($0.02/$0.05) - 2024/04/15 18:04:00
Table 'NLHBlue46' 6-max Seat #3 is the button
Seat 1: 4a106898 ($7.01 in chips)
Seat 3: 4939468 ($5.34 in chips)
Seat 5: 82796794 ($7.97 in chips)
Seat 6: Hero ($6.32 in chips)
82796794: posts small blind $0.02
Hero: posts big blind $0.05
*** HOLE CARDS ***
Dealt to 4a106898 
Dealt to 4939468 
Dealt to 82796794 
Dealt to Hero [Td Qc]
4a106898: folds
4939468: folds
82796794: raises $0.1 to $0.15
Hero: calls $0.1
*** FLOP *** [3s Jc 7d]
82796794: bets $0.1
Hero: folds
Uncalled bet ($0.1) returned to 82796794
*** SHOWDOWN ***
82796794 collected $0.29 from pot
*** SUMMARY ***
Total pot $0.3 | Rake $0.01 | Jackpot $0 | Bingo $0 | Fortune $0 | Tax $0
Board [3s Jc 7d]
Seat 1: 4a106898 folded before Flop (didn't bet)
Seat 3: 4939468 (button) folded before Flop (didn't bet)
Seat 5: 82796794 (small blind) won ($0.29)
Seat 6: Hero (big blind) folded on the Flop


Poker Hand #HD1731657763: Hold'em No Limit ($0.02/$0.05) - 2024/04/15 18:03:40
Table 'NLHBlue46' 6-max Seat #1 is the button
Seat 1: 4a106898 ($7.01 in chips)
Seat 3: 4939468 ($5.29 in chips)
Seat 5: 82796794 ($8.02 in chips)
Seat 6: Hero ($6.32 in chips)
4939468: posts small blind $0.02
82796794: posts big blind $0.05
*** HOLE CARDS ***
Dealt to 4a106898 
Dealt to 4939468 
Dealt to 82796794 
Dealt to Hero [7h Qs]
Hero: folds
4a106898: folds
4939468: raises $0.09 to $0.14
82796794: folds
Uncalled bet ($0.09) returned to 4939468
*** SHOWDOWN ***
4939468 collected $0.1 from pot
*** SUMMARY ***
Total pot $0.1 | Rake $0 | Jackpot $0 | Bingo $0 | Fortune $0 | Tax $0
Seat 1: 4a106898 (button) folded before Flop (didn't bet)
Seat 3: 4939468 (small blind) collected ($0.1)
Seat 5: 82796794 (big blind) folded before Flop
Seat 6: Hero folded before Flop (didn't bet)


Poker Hand #HD1731657679: Hold'em No Limit ($0.02/$0.05) - 2024/04/15 18:03:08
Table 'NLHBlue46' 6-max Seat #6 is the button
Seat 1: 4a106898 ($7.13 in chips)
Seat 3: 4939468 ($5.34 in chips)
Seat 4: 7968ad27 ($6.04 in chips)
Seat 5: 82796794 ($8.02 in chips)
Seat 6: Hero ($6.16 in chips)
4a106898: posts small blind $0.02
4939468: posts big blind $0.05
*** HOLE CARDS ***
Dealt to 4a106898 
Dealt to 4939468 
Dealt to 7968ad27 
Dealt to 82796794 
Dealt to Hero [Ks Qh]
7968ad27: folds
82796794: folds
Hero: raises $0.07 to $0.12
4a106898: calls $0.1
4939468: folds
*** FLOP *** [4c 2h 9c]
4a106898: checks
Hero: bets $0.15
4a106898: folds
Uncalled bet ($0.15) returned to Hero
*** SHOWDOWN ***
Hero collected $0.28 from pot
*** SUMMARY ***
Total pot $0.29 | Rake $0.01 | Jackpot $0 | Bingo $0 | Fortune $0 | Tax $0
Board [4c 2h 9c]
Seat 1: 4a106898 (small blind) folded on the Flop
Seat 3: 4939468 (big blind) folded before Flop
Seat 4: 7968ad27 folded before Flop (didn't bet)
Seat 5: 82796794 folded before Flop (didn't bet)
Seat 6: Hero (button) won ($0.28)


Poker Hand #HD1731657646: Hold'em No Limit ($0.02/$0.05) - 2024/04/15 18:02:51
Table 'NLHBlue46' 6-max Seat #5 is the button
Seat 1: 4a106898 ($7.18 in chips)
Seat 3: 4939468 ($5.34 in chips)
Seat 4: 7968ad27 ($6.04 in chips)
Seat 5: 82796794 ($7.95 in chips)
Seat 6: Hero ($6.18 in chips)
Hero: posts small blind $0.02
4a106898: posts big blind $0.05
*** HOLE CARDS ***
Dealt to 4a106898 
Dealt to 4939468 
Dealt to 7968ad27 
Dealt to 82796794 
Dealt to Hero [Td Qh]
4939468: folds
7968ad27: folds
82796794: raises $0.08 to $0.13
Hero: folds
4a106898: folds
Uncalled bet ($0.08) returned to 82796794
*** SHOWDOWN ***
82796794 collected $0.12 from pot
*** SUMMARY ***
Total pot $0.12 | Rake $0 | Jackpot $0 | Bingo $0 | Fortune $0 | Tax $0
Seat 1: 4a106898 (big blind) folded before Flop
Seat 3: 4939468 folded before Flop (didn't bet)
Seat 4: 7968ad27 folded before Flop (didn't bet)
Seat 5: 82796794 (button) collected ($0.12)
Seat 6: Hero (small blind) folded before Flop


Poker Hand #HD1731657611: Hold'em No Limit ($0.02/$0.05) - 2024/04/15 18:02:39
Table 'NLHBlue46' 6-max Seat #4 is the button
Seat 1: 4a106898 ($7.18 in chips)
Seat 3: 4939468 ($5.34 in chips)
Seat 4: 7968ad27 ($6.04 in chips)
Seat 5: 82796794 ($7.97 in chips)
Seat 6: Hero ($6.16 in chips)
82796794: posts small blind $0.02
Hero: posts big blind $0.05
*** HOLE CARDS ***
Dealt to 4a106898 
Dealt to 4939468 
Dealt to 7968ad27 
Dealt to 82796794 
Dealt to Hero [8s Js]
4a106898: folds
4939468: folds
7968ad27: folds
82796794: folds
Uncalled bet ($0.03) returned to Hero
*** SHOWDOWN ***
Hero collected $0.04 from pot
*** SUMMARY ***
Total pot $0.04 | Rake $0 | Jackpot $0 | Bingo $0 | Fortune $0 | Tax $0
Seat 1: 4a106898 folded before Flop (didn't bet)
Seat 3: 4939468 folded before Flop (didn't bet)
Seat 4: 7968ad27 (button) folded before Flop (didn't bet)
Seat 5: 82796794 (small blind) folded before Flop
Seat 6: Hero (big blind) collected ($0.04)


Poker Hand #HD1731657581: Hold'em No Limit ($0.02/$0.05) - 2024/04/15 18:02:28
Table 'NLHBlue46' 6-max Seat #3 is the button
Seat 1: 4a106898 ($7.18 in chips)
Seat 3: 4939468 ($5.34 in chips)
Seat 4: 7968ad27 ($6.06 in chips)
Seat 5: 82796794 ($8.02 in chips)
Seat 6: Hero ($6.09 in chips)
7968ad27: posts small blind $0.02
82796794: posts big blind $0.05
*** HOLE CARDS ***
Dealt to 4a106898 
Dealt to 4939468 
Dealt to 7968ad27 
Dealt to 82796794 
Dealt to Hero [Qd Ad]
Hero: raises $0.05 to $0.1
4a106898: folds
4939468: folds
7968ad27: folds
82796794: folds
Uncalled bet ($0.05) returned to Hero
*** SHOWDOWN ***
Hero collected $0.12 from pot
*** SUMMARY ***
Total pot $0.12 | Rake $0 | Jackpot $0 | Bingo $0 | Fortune $0 | Tax $0
Seat 1: 4a106898 folded before Flop (didn't bet)
Seat 3: 4939468 (button) folded before Flop (didn't bet)
Seat 4: 7968ad27 (small blind) folded before Flop
Seat 5: 82796794 (big blind) folded before Flop
Seat 6: Hero collected ($0.12)


Poker Hand #HD1731657551: Hold'em No Limit ($0.02/$0.05) - 2024/04/15 18:02:18
Table 'NLHBlue46' 6-max Seat #1 is the button
Seat 1: 4a106898 ($7.18 in chips)
Seat 3: 4939468 ($5.36 in chips)
Seat 4: 7968ad27 ($6.04 in chips)
Seat 5: 82796794 ($8.02 in chips)
Seat 6: Hero ($6.09 in chips)
4939468: posts small blind $0.02
7968ad27: posts big blind $0.05
*** HOLE CARDS ***
Dealt to 4a106898 
Dealt to 4939468 
Dealt to 7968ad27 
Dealt to 82796794 
Dealt to Hero [7c 5c]
82796794: folds
Hero: folds
4a106898: folds
4939468: folds
Uncalled bet ($0.03) returned to 7968ad27
*** SHOWDOWN ***
7968ad27 collected $0.04 from pot
*** SUMMARY ***
Total pot $0.04 | Rake $0 | Jackpot $0 | Bingo $0 | Fortune $0 | Tax $0
Seat 1: 4a106898 (button) folded before Flop (didn't bet)
Seat 3: 4939468 (small blind) folded before Flop
Seat 4: 7968ad27 (big blind) collected ($0.04)
Seat 5: 82796794 folded before Flop (didn't bet)
Seat 6: Hero folded before Flop (didn't bet)


Poker Hand #HD1731657514: Hold'em No Limit ($0.02/$0.05) - 2024/04/15 18:02:05
Table 'NLHBlue46' 6-max Seat #6 is the button
Seat 1: 4a106898 ($7.13 in chips)
Seat 3: 4939468 ($5.41 in chips)
Seat 4: 7968ad27 ($6.04 in chips)
Seat 5: 82796794 ($8.02 in chips)
Seat 6: Hero ($6.09 in chips)
4a106898: posts small blind $0.02
4939468: posts big blind $0.05
*** HOLE CARDS ***
Dealt to 4a106898 
Dealt to 4939468 
Dealt to 7968ad27 
Dealt to 82796794 
Dealt to Hero [9s 7d]
7968ad27: folds
82796794: folds
Hero: folds
4a106898: raises $0.1 to $0.15
4939468: folds
Uncalled bet ($0.1) returned to 4a106898
*** SHOWDOWN ***
4a106898 collected $0.1 from pot
*** SUMMARY ***
Total pot $0.1 | Rake $0 | Jackpot $0 | Bingo $0 | Fortune $0 | Tax $0
Seat 1: 4a106898 (small blind) collected ($0.1)
Seat 3: 4939468 (big blind) folded before Flop
Seat 4: 7968ad27 folded before Flop (didn't bet)
Seat 5: 82796794 folded before Flop (didn't bet)
Seat 6: Hero (button) folded before Flop (didn't bet)


Poker Hand #HD1731657463: Hold'em No Limit ($0.02/$0.05) - 2024/04/15 18:01:44
Table 'NLHBlue46' 6-max Seat #5 is the button
Seat 1: 4a106898 ($7.18 in chips)
Seat 3: 4939468 ($5.41 in chips)
Seat 4: 7968ad27 ($6.16 in chips)
Seat 5: 82796794 ($8.02 in chips)
Seat 6: Hero ($5.93 in chips)
Hero: posts small blind $0.02
4a106898: posts big blind $0.05
*** HOLE CARDS ***
Dealt to 4a106898 
Dealt to 4939468 
Dealt to 7968ad27 
Dealt to 82796794 
Dealt to Hero [Qh Th]
4939468: folds
7968ad27: raises $0.07 to $0.12
82796794: folds
Hero: raises $0.33 to $0.45
4a106898: folds
7968ad27: folds
Uncalled bet ($0.33) returned to Hero
*** SHOWDOWN ***
Hero collected $0.28 from pot
*** SUMMARY ***
Total pot $0.29 | Rake $0.01 | Jackpot $0 | Bingo $0 | Fortune $0 | Tax $0
Seat 1: 4a106898 (big blind) folded before Flop
Seat 3: 4939468 folded before Flop (didn't bet)
Seat 4: 7968ad27 folded before Flop
Seat 5: 82796794 (button) folded before Flop (didn't bet)
Seat 6: Hero (small blind) collected ($0.28)


Poker Hand #HD1731657308: Hold'em No Limit ($0.02/$0.05) - 2024/04/15 18:00:41
Table 'NLHBlue46' 6-max Seat #4 is the button
Seat 1: 4a106898 ($5.07 in chips)
Seat 2: 410e7333 ($1.96 in chips)
Seat 3: 4939468 ($5.41 in chips)
Seat 4: 7968ad27 ($6.5 in chips)
Seat 5: 82796794 ($8.04 in chips)
Seat 6: Hero ($5.98 in chips)
82796794: posts small blind $0.02
Hero: posts big blind $0.05
*** HOLE CARDS ***
Dealt to 4a106898 
Dealt to 410e7333 
Dealt to 4939468 
Dealt to 7968ad27 
Dealt to 82796794 
Dealt to Hero [9d 8h]
4a106898: raises $0.1 to $0.15
410e7333: raises $0.19 to $0.34
4939468: folds
7968ad27: calls $0.34
82796794: folds
Hero: folds
4a106898: calls $0.19
*** FLOP *** [3d Jc Td]
4a106898: checks
410e7333: bets $0.55
7968ad27: folds
4a106898: raises $4.18 to $4.73 and is all-in
410e7333: calls $1.07 and is all-in
Uncalled bet ($3.11) returned to 4a106898
4a106898: shows [Kd Jh] (Pair of Jacks)
410e7333: shows [As Ah] (Pair of Aces)
*** TURN *** [3d Jc Td] [8c]
*** RIVER *** [3d Jc Td 8c] [Js]
*** SHOWDOWN ***
4a106898 collected $4.07 from pot
*** SUMMARY ***
Total pot $4.33 | Rake $0.21 | Jackpot $0.05 | Bingo $0 | Fortune $0 | Tax $0
Board [3d Jc Td 8c Js]
Seat 1: 4a106898 showed [Kd Jh] and won ($4.07) with Three Jacks
Seat 2: 410e7333 showed [As Ah] and lost with Pair of Aces and Pair of Jacks
Seat 3: 4939468 folded before Flop (didn't bet)
Seat 4: 7968ad27 (button) folded on the Flop
Seat 5: 82796794 (small blind) folded before Flop
Seat 6: Hero (big blind) folded before Flop


Poker Hand #HD1731657152: Hold'em No Limit ($0.02/$0.05) - 2024/04/15 17:59:35
Table 'NLHBlue46' 6-max Seat #3 is the button
Seat 1: 4a106898 ($5.07 in chips)
Seat 2: 410e7333 ($1.7 in chips)
Seat 3: 4939468 ($5.41 in chips)
Seat 4: 7968ad27 ($6.52 in chips)
Seat 5: 82796794 ($8.3 in chips)
Seat 6: Hero ($5.98 in chips)
7968ad27: posts small blind $0.02
82796794: posts big blind $0.05
*** HOLE CARDS ***
Dealt to 4a106898 
Dealt to 410e7333 
Dealt to 4939468 
Dealt to 7968ad27 
Dealt to 82796794 
Dealt to Hero [9h 7d]
Hero: folds
4a106898: folds
410e7333: raises $0.05 to $0.1
4939468: folds
7968ad27: folds
82796794: calls $0.05
*** FLOP *** [7c Th 8c]
82796794: checks
410e7333: checks
*** TURN *** [7c Th 8c] [9s]
82796794: bets $0.16
410e7333: calls $0.16
*** RIVER *** [7c Th 8c 9s] [3h]
82796794: checks
410e7333: bets $0.27
82796794: folds
Uncalled bet ($0.27) returned to 410e7333
*** SHOWDOWN ***
410e7333 collected $0.52 from pot
*** SUMMARY ***
Total pot $0.54 | Rake $0.02 | Jackpot $0 | Bingo $0 | Fortune $0 | Tax $0
Board [7c Th 8c 9s 3h]
Seat 1: 4a106898 folded before Flop (didn't bet)
Seat 2: 410e7333 won ($0.52)
Seat 3: 4939468 (button) folded before Flop (didn't bet)
Seat 4: 7968ad27 (small blind) folded before Flop
Seat 5: 82796794 (big blind) folded on the River
Seat 6: Hero folded before Flop (didn't bet)


Poker Hand #HD1731656996: Hold'em No Limit ($0.02/$0.05) - 2024/04/15 17:58:37
Table 'NLHBlue46' 6-max Seat #2 is the button
Seat 1: 4a106898 ($5.07 in chips)
Seat 2: 410e7333 ($1.41 in chips)
Seat 3: 4939468 ($5.43 in chips)
Seat 4: 7968ad27 ($6.57 in chips)
Seat 5: 82796794 ($8.54 in chips)
Seat 6: Hero ($5.98 in chips)
4939468: posts small blind $0.02
7968ad27: posts big blind $0.05
*** HOLE CARDS ***
Dealt to 4a106898 
Dealt to 410e7333 
Dealt to 4939468 
Dealt to 7968ad27 
Dealt to 82796794 
Dealt to Hero [9h Qc]
82796794: raises $0.08 to $0.13
Hero: folds
4a106898: folds
410e7333: calls $0.13
4939468: folds
7968ad27: folds
*** FLOP *** [Tc 5s Jh]
82796794: bets $0.11
410e7333: calls $0.11
*** TURN *** [Tc 5s Jh] [2c]
82796794: checks
410e7333: checks
*** RIVER *** [Tc 5s Jh 2c] [3c]
82796794: checks
410e7333: bets $0.19
82796794: folds
Uncalled bet ($0.19) returned to 410e7333
*** SHOWDOWN ***
410e7333 collected $0.53 from pot
*** SUMMARY ***
Total pot $0.55 | Rake $0.02 | Jackpot $0 | Bingo $0 | Fortune $0 | Tax $0
Board [Tc 5s Jh 2c 3c]
Seat 1: 4a106898 folded before Flop (didn't bet)
Seat 2: 410e7333 (button) won ($0.53)
Seat 3: 4939468 (small blind) folded before Flop
Seat 4: 7968ad27 (big blind) folded before Flop
Seat 5: 82796794 folded on the River
Seat 6: Hero folded before Flop (didn't bet)


Poker Hand #HD1731656958: Hold'em No Limit ($0.02/$0.05) - 2024/04/15 17:58:21
Table 'NLHBlue46' 6-max Seat #1 is the button
Seat 1: 4a106898 ($5 in chips)
Seat 2: 410e7333 ($1.43 in chips)
Seat 3: 4939468 ($5.48 in chips)
Seat 4: 7968ad27 ($6.57 in chips)
Seat 5: 82796794 ($8.54 in chips)
Seat 6: Hero ($5.98 in chips)
410e7333: posts small blind $0.02
4939468: posts big blind $0.05
*** HOLE CARDS ***
Dealt to 4a106898 
Dealt to 410e7333 
Dealt to 4939468 
Dealt to 7968ad27 
Dealt to 82796794 
Dealt to Hero [3h 4d]
7968ad27: folds
82796794: folds
Hero: folds
4a106898: raises $0.1 to $0.15
410e7333: folds
4939468: folds
Uncalled bet ($0.1) returned to 4a106898
*** SHOWDOWN ***
4a106898 collected $0.12 from pot
*** SUMMARY ***
Total pot $0.12 | Rake $0 | Jackpot $0 | Bingo $0 | Fortune $0 | Tax $0
Seat 1: 4a106898 (button) collected ($0.12)
Seat 2: 410e7333 (small blind) folded before Flop
Seat 3: 4939468 (big blind) folded before Flop
Seat 4: 7968ad27 folded before Flop (didn't bet)
Seat 5: 82796794 folded before Flop (didn't bet)
Seat 6: Hero folded before Flop (didn't bet)


Poker Hand #HD1731656822: Hold'em No Limit ($0.02/$0.05) - 2024/04/15 17:57:26
Table 'NLHBlue46' 6-max Seat #6 is the button
Seat 1: 4a106898 ($5 in chips)
Seat 2: 410e7333 ($1.29 in chips)
Seat 3: 4939468 ($5.48 in chips)
Seat 4: 7968ad27 ($6.57 in chips)
Seat 5: 82796794 ($8.67 in chips)
Seat 6: Hero ($5.98 in chips)
4a106898: posts small blind $0.02
410e7333: posts big blind $0.05
*** HOLE CARDS ***
Dealt to 4a106898 
Dealt to 410e7333 
Dealt to 4939468 
Dealt to 7968ad27 
Dealt to 82796794 
Dealt to Hero [7s Js]
4939468: folds
7968ad27: folds
82796794: raises $0.08 to $0.13
Hero: folds
4a106898: folds
410e7333: calls $0.08
*** FLOP *** [7d 6c 5d]
410e7333: checks
82796794: checks
*** TURN *** [7d 6c 5d] [As]
410e7333: checks
82796794: checks
*** RIVER *** [7d 6c 5d As] [Jd]
410e7333: bets $0.14
82796794: folds
Uncalled bet ($0.14) returned to 410e7333
*** SHOWDOWN ***
410e7333 collected $0.27 from pot
*** SUMMARY ***
Total pot $0.28 | Rake $0.01 | Jackpot $0 | Bingo $0 | Fortune $0 | Tax $0
Board [7d 6c 5d As Jd]
Seat 1: 4a106898 (small blind) folded before Flop
Seat 2: 410e7333 (big blind) won ($0.27)
Seat 3: 4939468 folded before Flop (didn't bet)
Seat 4: 7968ad27 folded before Flop (didn't bet)
Seat 5: 82796794 folded on the River
Seat 6: Hero (button) folded before Flop (didn't bet)


Poker Hand #HD1731656747: Hold'em No Limit ($0.02/$0.05) - 2024/04/15 17:56:56
Table 'NLHBlue46' 6-max Seat #5 is the button
Seat 1: 4a106898 ($5 in chips)
Seat 2: 410e7333 ($1.29 in chips)
Seat 3: 4939468 ($5.48 in chips)
Seat 4: 7968ad27 ($6.15 in chips)
Seat 5: 82796794 ($9.06 in chips)
Seat 6: Hero ($6 in chips)
Hero: posts small blind $0.02
4a106898: posts big blind $0.05
*** HOLE CARDS ***
Dealt to 4a106898 
Dealt to 410e7333 
Dealt to 4939468 
Dealt to 7968ad27 
Dealt to 82796794 
Dealt to Hero [4s 9d]
410e7333: folds
4939468: folds
7968ad27: raises $0.07 to $0.12
82796794: raises $0.27 to $0.39
Hero: folds
4a106898: folds
7968ad27: raises $0.61 to $1
82796794: folds
Uncalled bet ($0.61) returned to 7968ad27
*** SHOWDOWN ***
7968ad27 collected $0.81 from pot
*** SUMMARY ***
Total pot $0.85 | Rake $0.04 | Jackpot $0 | Bingo $0 | Fortune $0 | Tax $0
Seat 1: 4a106898 (big blind) folded before Flop
Seat 2: 410e7333 folded before Flop (didn't bet)
Seat 3: 4939468 folded before Flop (didn't bet)
Seat 4: 7968ad27 collected ($0.81)
Seat 5: 82796794 (button) folded before Flop
Seat 6: Hero (small blind) folded before Flop


Poker Hand #HD1731656719: Hold'em No Limit ($0.02/$0.05) - 2024/04/15 17:56:44
Table 'NLHBlue46' 6-max Seat #4 is the button
Seat 1: 4a106898 ($5 in chips)
Seat 2: 410e7333 ($1.22 in chips)
Seat 3: 4939468 ($5.48 in chips)
Seat 4: 7968ad27 ($6.15 in chips)
Seat 5: 82796794 ($9.08 in chips)
Seat 6: Hero ($6.05 in chips)
82796794: posts small blind $0.02
Hero: posts big blind $0.05
*** HOLE CARDS ***
Dealt to 4a106898 
Dealt to 410e7333 
Dealt to 4939468 
Dealt to 7968ad27 
Dealt to 82796794 
Dealt to Hero [7h 8c]
4a106898: folds
410e7333: raises $0.1 to $0.15
4939468: folds
7968ad27: folds
82796794: folds
Hero: folds
Uncalled bet ($0.1) returned to 410e7333
*** SHOWDOWN ***
410e7333 collected $0.12 from pot
*** SUMMARY ***
Total pot $0.12 | Rake $0 | Jackpot $0 | Bingo $0 | Fortune $0 | Tax $0
Seat 1: 4a106898 folded before Flop (didn't bet)
Seat 2: 410e7333 collected ($0.12)
Seat 3: 4939468 folded before Flop (didn't bet)
Seat 4: 7968ad27 (button) folded before Flop (didn't bet)
Seat 5: 82796794 (small blind) folded before Flop
Seat 6: Hero (big blind) folded before Flop


Poker Hand #HD1731656668: Hold'em No Limit ($0.02/$0.05) - 2024/04/15 17:56:25
Table 'NLHBlue46' 6-max Seat #3 is the button
Seat 1: 4a106898 ($5 in chips)
Seat 2: 410e7333 ($1.01 in chips)
Seat 3: 4939468 ($5.48 in chips)
Seat 4: 7968ad27 ($6.17 in chips)
Seat 5: 82796794 ($9.13 in chips)
Seat 6: Hero ($6.05 in chips)
7968ad27: posts small blind $0.02
82796794: posts big blind $0.05
*** HOLE CARDS ***
Dealt to 4a106898 
Dealt to 410e7333 
Dealt to 4939468 
Dealt to 7968ad27 
Dealt to 82796794 
Dealt to Hero [4c 7c]
Hero: folds
4a106898: raises $0.1 to $0.15
410e7333: raises $0.28 to $0.43
4939468: folds
7968ad27: folds
82796794: folds
4a106898: folds
Uncalled bet ($0.28) returned to 410e7333
*** SHOWDOWN ***
410e7333 collected $0.36 from pot
*** SUMMARY ***
Total pot $0.37 | Rake $0.01 | Jackpot $0 | Bingo $0 | Fortune $0 | Tax $0
Seat 1: 4a106898 folded before Flop
Seat 2: 410e7333 collected ($0.36)
Seat 3: 4939468 (button) folded before Flop (didn't bet)
Seat 4: 7968ad27 (small blind) folded before Flop
Seat 5: 82796794 (big blind) folded before Flop
Seat 6: Hero folded before Flop (didn't bet)


Poker Hand #HD1731656556: Hold'em No Limit ($0.02/$0.05) - 2024/04/15 17:55:38
Table 'NLHBlue46' 6-max Seat #2 is the button
Seat 1: 4a106898 ($5 in chips)
Seat 2: 410e7333 ($1.4 in chips)
Seat 3: 4939468 ($5.09 in chips)
Seat 4: 7968ad27 ($6.22 in chips)
Seat 5: 82796794 ($9.13 in chips)
Seat 6: Hero ($6.05 in chips)
4939468: posts small blind $0.02
7968ad27: posts big blind $0.05
*** HOLE CARDS ***
Dealt to 4a106898 
Dealt to 410e7333 
Dealt to 4939468 
Dealt to 7968ad27 
Dealt to 82796794 
Dealt to Hero [Td 9s]
82796794: folds
Hero: folds
4a106898: folds
410e7333: raises $0.1 to $0.15
4939468: calls $0.13
7968ad27: folds
*** FLOP *** [8h 5h 6s]
4939468: bets $0.24
410e7333: calls $0.24
*** TURN *** [8h 5h 6s] [4d]
4939468: checks
410e7333: checks
*** RIVER *** [8h 5h 6s 4d] [Ts]
4939468: bets $0.55
410e7333: folds
Uncalled bet ($0.55) returned to 4939468
*** SHOWDOWN ***
4939468 collected $0.78 from pot
*** SUMMARY ***
Total pot $0.83 | Rake $0.05 | Jackpot $0 | Bingo $0 | Fortune $0 | Tax $0
Board [8h 5h 6s 4d Ts]
Seat 1: 4a106898 folded before Flop (didn't bet)
Seat 2: 410e7333 (button) folded on the River
Seat 3: 4939468 (small blind) won ($0.78)
Seat 4: 7968ad27 (big blind) folded before Flop
Seat 5: 82796794 folded before Flop (didn't bet)
Seat 6: Hero folded before Flop (didn't bet)


Poker Hand #HD1731656506: Hold'em No Limit ($0.02/$0.05) - 2024/04/15 17:55:19
Table 'NLHBlue46' 6-max Seat #1 is the button
Seat 1: 4a106898 ($5 in chips)
Seat 2: 410e7333 ($1.42 in chips)
Seat 3: 4939468 ($5.14 in chips)
Seat 4: 7968ad27 ($6.34 in chips)
Seat 5: 82796794 ($9.13 in chips)
Seat 6: Hero ($5.87 in chips)
410e7333: posts small blind $0.02
4939468: posts big blind $0.05
*** HOLE CARDS ***
Dealt to 4a106898 
Dealt to 410e7333 
Dealt to 4939468 
Dealt to 7968ad27 
Dealt to 82796794 
Dealt to Hero [Kc Ad]
7968ad27: raises $0.07 to $0.12
82796794: folds
Hero: raises $0.33 to $0.45
4a106898: folds
410e7333: folds
4939468: folds
7968ad27: folds
Uncalled bet ($0.33) returned to Hero
*** SHOWDOWN ***
Hero collected $0.3 from pot
*** SUMMARY ***
Total pot $0.31 | Rake $0.01 | Jackpot $0 | Bingo $0 | Fortune $0 | Tax $0
Seat 1: 4a106898 (button) folded before Flop (didn't bet)
Seat 2: 410e7333 (small blind) folded before Flop
Seat 3: 4939468 (big blind) folded before Flop
Seat 4: 7968ad27 folded before Flop
Seat 5: 82796794 folded before Flop (didn't bet)
Seat 6: Hero collected ($0.3)


Poker Hand #HD1731656391: Hold'em No Limit ($0.02/$0.05) - 2024/04/15 17:54:31
Table 'NLHBlue46' 6-max Seat #6 is the button
Seat 1: 4a106898 ($5 in chips)
Seat 2: 410e7333 ($1.63 in chips)
Seat 3: 4939468 ($5.14 in chips)
Seat 4: 7968ad27 ($6.13 in chips)
Seat 5: 82796794 ($9.13 in chips)
Seat 6: Hero ($5.87 in chips)
4a106898: posts small blind $0.02
410e7333: posts big blind $0.05
*** HOLE CARDS ***
Dealt to 4a106898 
Dealt to 410e7333 
Dealt to 4939468 
Dealt to 7968ad27 
Dealt to 82796794 
Dealt to Hero [7d 7c]
4939468: folds
7968ad27: raises $0.07 to $0.12
82796794: folds
Hero: folds
4a106898: folds
410e7333: calls $0.07
*** FLOP *** [Jc 2h 4h]
410e7333: checks
7968ad27: bets $0.09
410e7333: calls $0.09
*** TURN *** [Jc 2h 4h] [9h]
410e7333: checks
7968ad27: bets $0.33
410e7333: folds
Uncalled bet ($0.33) returned to 7968ad27
*** SHOWDOWN ***
7968ad27 collected $0.42 from pot
*** SUMMARY ***
Total pot $0.44 | Rake $0.02 | Jackpot $0 | Bingo $0 | Fortune $0 | Tax $0
Board [Jc 2h 4h 9h]
Seat 1: 4a106898 (small blind) folded before Flop
Seat 2: 410e7333 (big blind) folded on the Turn
Seat 3: 4939468 folded before Flop (didn't bet)
Seat 4: 7968ad27 won ($0.42)
Seat 5: 82796794 folded before Flop (didn't bet)
Seat 6: Hero (button) folded before Flop (didn't bet)


Poker Hand #HD1731656341: Hold'em No Limit ($0.02/$0.05) - 2024/04/15 17:54:11
Table 'NLHBlue46' 6-max Seat #5 is the button
Seat 1: 4a106898 ($5 in chips)
Seat 2: 410e7333 ($1.63 in chips)
Seat 3: 4939468 ($5.07 in chips)
Seat 4: 7968ad27 ($6.13 in chips)
Seat 5: 82796794 ($9.13 in chips)
Seat 6: Hero ($5.89 in chips)
Hero: posts small blind $0.02
4a106898: posts big blind $0.05
*** HOLE CARDS ***
Dealt to 4a106898 
Dealt to 410e7333 
Dealt to 4939468 
Dealt to 7968ad27 
Dealt to 82796794 
Dealt to Hero [Ks 8h]
410e7333: folds
4939468: raises $0.09 to $0.14
7968ad27: folds
82796794: folds
Hero: folds
4a106898: folds
Uncalled bet ($0.09) returned to 4939468
*** SHOWDOWN ***
4939468 collected $0.12 from pot
*** SUMMARY ***
Total pot $0.12 | Rake $0 | Jackpot $0 | Bingo $0 | Fortune $0 | Tax $0
Seat 1: 4a106898 (big blind) folded before Flop
Seat 2: 410e7333 folded before Flop (didn't bet)
Seat 3: 4939468 collected ($0.12)
Seat 4: 7968ad27 folded before Flop (didn't bet)
Seat 5: 82796794 (button) folded before Flop (didn't bet)
Seat 6: Hero (small blind) folded before Flop


Poker Hand #HD1731656234: Hold'em No Limit ($0.02/$0.05) - 2024/04/15 17:53:31
Table 'NLHBlue46' 6-max Seat #4 is the button
Seat 1: 4a106898 ($5.04 in chips)
Seat 2: 410e7333 ($1.63 in chips)
Seat 3: 4939468 ($5.07 in chips)
Seat 4: 7968ad27 ($6.13 in chips)
Seat 5: 82796794 ($9.15 in chips)
Seat 6: Hero ($5.73 in chips)
82796794: posts small blind $0.02
Hero: posts big blind $0.05
*** HOLE CARDS ***
Dealt to 4a106898 
Dealt to 410e7333 
Dealt to 4939468 
Dealt to 7968ad27 
Dealt to 82796794 
Dealt to Hero [4s 4c]
4a106898: raises $0.1 to $0.15
410e7333: folds
4939468: folds
7968ad27: folds
82796794: folds
Hero: calls $0.1
*** FLOP *** [8c 9h Ts]
Hero: checks
4a106898: checks
*** TURN *** [8c 9h Ts] [6h]
Hero: checks
4a106898: checks
*** RIVER *** [8c 9h Ts 6h] [2h]
Hero: checks
4a106898: checks
Hero: shows [4s 4c] (Pair of Fours)
4a106898: shows [3c 3d] (Pair of Treys)
*** SHOWDOWN ***
Hero collected $0.31 from pot
*** SUMMARY ***
Total pot $0.32 | Rake $0.01 | Jackpot $0 | Bingo $0 | Fortune $0 | Tax $0
Board [8c 9h Ts 6h 2h]
Seat 1: 4a106898 showed [3c 3d] and lost with Pair of Treys
Seat 2: 410e7333 folded before Flop (didn't bet)
Seat 3: 4939468 folded before Flop (didn't bet)
Seat 4: 7968ad27 (button) folded before Flop (didn't bet)
Seat 5: 82796794 (small blind) folded before Flop
Seat 6: Hero (big blind) showed [4s 4c] and won ($0.31) with Pair of Fours


Poker Hand #HD1731656154: Hold'em No Limit ($0.02/$0.05) - 2024/04/15 17:53:01
Table 'NLHBlue46' 6-max Seat #3 is the button
Seat 1: 4a106898 ($5.19 in chips)
Seat 2: 410e7333 ($1.63 in chips)
Seat 3: 4939468 ($5.07 in chips)
Seat 4: 7968ad27 ($6.15 in chips)
Seat 5: 82796794 ($8.99 in chips)
Seat 6: Hero ($5.73 in chips)
7968ad27: posts small blind $0.02
82796794: posts big blind $0.05
*** HOLE CARDS ***
Dealt to 4a106898 
Dealt to 410e7333 
Dealt to 4939468 
Dealt to 7968ad27 
Dealt to 82796794 
Dealt to Hero [Ts 4h]
Hero: folds
4a106898: raises $0.1 to $0.15
410e7333: folds
4939468: folds
7968ad27: folds
82796794: calls $0.1
*** FLOP *** [7c Js Td]
82796794: checks
4a106898: checks
*** TURN *** [7c Js Td] [7h]
82796794: bets $0.2
4a106898: folds
Uncalled bet ($0.2) returned to 82796794
*** SHOWDOWN ***
82796794 collected $0.31 from pot
*** SUMMARY ***
Total pot $0.32 | Rake $0.01 | Jackpot $0 | Bingo $0 | Fortune $0 | Tax $0
Board [7c Js Td 7h]
Seat 1: 4a106898 folded on the Turn
Seat 2: 410e7333 folded before Flop (didn't bet)
Seat 3: 4939468 (button) folded before Flop (didn't bet)
Seat 4: 7968ad27 (small blind) folded before Flop
Seat 5: 82796794 (big blind) won ($0.31)
Seat 6: Hero folded before Flop (didn't bet)


Poker Hand #HD1731656065: Hold'em No Limit ($0.02/$0.05) - 2024/04/15 17:52:21
Table 'NLHBlue46' 6-max Seat #2 is the button
Seat 1: 4a106898 ($5.32 in chips)
Seat 2: 410e7333 ($1.63 in chips)
Seat 3: 4939468 ($5.09 in chips)
Seat 4: 7968ad27 ($6.28 in chips)
Seat 5: 82796794 ($8.73 in chips)
Seat 6: Hero ($5.73 in chips)
4939468: posts small blind $0.02
7968ad27: posts big blind $0.05
*** HOLE CARDS ***
Dealt to 4a106898 
Dealt to 410e7333 
Dealt to 4939468 
Dealt to 7968ad27 
Dealt to 82796794 
Dealt to Hero [6d Th]
82796794: raises $0.08 to $0.13
Hero: folds
4a106898: calls $0.13
410e7333: folds
4939468: folds
7968ad27: calls $0.08
*** FLOP *** [6c Kh 7s]
7968ad27: checks
82796794: checks
4a106898: checks
*** TURN *** [6c Kh 7s] [Ad]
7968ad27: checks
82796794: bets $0.21
4a106898: folds
7968ad27: folds
Uncalled bet ($0.21) returned to 82796794
*** SHOWDOWN ***
82796794 collected $0.39 from pot
*** SUMMARY ***
Total pot $0.41 | Rake $0.02 | Jackpot $0 | Bingo $0 | Fortune $0 | Tax $0
Board [6c Kh 7s Ad]
Seat 1: 4a106898 folded on the Turn
Seat 2: 410e7333 (button) folded before Flop (didn't bet)
Seat 3: 4939468 (small blind) folded before Flop
Seat 4: 7968ad27 (big blind) folded on the Turn
Seat 5: 82796794 won ($0.39)
Seat 6: Hero folded before Flop (didn't bet)


Poker Hand #HD1731655982: Hold'em No Limit ($0.02/$0.05) - 2024/04/15 17:51:47
Table 'NLHBlue46' 6-max Seat #1 is the button
Seat 1: 4a106898 ($5.32 in chips)
Seat 2: 410e7333 ($1.76 in chips)
Seat 3: 4939468 ($5.14 in chips)
Seat 4: 7968ad27 ($6.28 in chips)
Seat 5: 82796794 ($8.56 in chips)
Seat 6: Hero ($5.73 in chips)
410e7333: posts small blind $0.02
4939468: posts big blind $0.05
*** HOLE CARDS ***
Dealt to 4a106898 
Dealt to 410e7333 
Dealt to 4939468 
Dealt to 7968ad27 
Dealt to 82796794 
Dealt to Hero [6d Ts]
7968ad27: folds
82796794: raises $0.08 to $0.13
Hero: folds
4a106898: folds
410e7333: calls $0.11
4939468: folds
*** FLOP *** [Qh Kd Tc]
410e7333: checks
82796794: bets $0.15
410e7333: folds
Uncalled bet ($0.15) returned to 82796794
*** SHOWDOWN ***
82796794 collected $0.3 from pot
*** SUMMARY ***
Total pot $0.31 | Rake $0.01 | Jackpot $0 | Bingo $0 | Fortune $0 | Tax $0
Board [Qh Kd Tc]
Seat 1: 4a106898 (button) folded before Flop (didn't bet)
Seat 2: 410e7333 (small blind) folded on the Flop
Seat 3: 4939468 (big blind) folded before Flop
Seat 4: 7968ad27 folded before Flop (didn't bet)
Seat 5: 82796794 won ($0.3)
Seat 6: Hero folded before Flop (didn't bet)


Poker Hand #HD1731655804: Hold'em No Limit ($0.02/$0.05) - 2024/04/15 17:50:44
Table 'NLHBlue46' 6-max Seat #6 is the button
Seat 1: 4a106898 ($5.44 in chips)
Seat 2: 410e7333 ($1.81 in chips)
Seat 3: 4939468 ($5.14 in chips)
Seat 4: 7968ad27 ($6.28 in chips)
Seat 5: 82796794 ($8.56 in chips)
Seat 6: Hero ($5.57 in chips)
4a106898: posts small blind $0.02
410e7333: posts big blind $0.05
*** HOLE CARDS ***
Dealt to 4a106898 
Dealt to 410e7333 
Dealt to 4939468 
Dealt to 7968ad27 
Dealt to 82796794 
Dealt to Hero [As Jc]
4939468: folds
7968ad27: folds
82796794: folds
Hero: raises $0.07 to $0.12
4a106898: calls $0.1
410e7333: folds
*** FLOP *** [6d 6s Qc]
4a106898: checks
Hero: checks
*** TURN *** [6d 6s Qc] [Qd]
4a106898: checks
Hero: bets $0.15
4a106898: folds
Uncalled bet ($0.15) returned to Hero
*** SHOWDOWN ***
Hero collected $0.28 from pot
*** SUMMARY ***
Total pot $0.29 | Rake $0.01 | Jackpot $0 | Bingo $0 | Fortune $0 | Tax $0
Board [6d 6s Qc Qd]
Seat 1: 4a106898 (small blind) folded on the Turn
Seat 2: 410e7333 (big blind) folded before Flop
Seat 3: 4939468 folded before Flop (didn't bet)
Seat 4: 7968ad27 folded before Flop (didn't bet)
Seat 5: 82796794 folded before Flop (didn't bet)
Seat 6: Hero (button) won ($0.28)


Poker Hand #HD1731655686: Hold'em No Limit ($0.02/$0.05) - 2024/04/15 17:49:52
Table 'NLHBlue46' 6-max Seat #5 is the button
Seat 1: 4a106898 ($5.49 in chips)
Seat 2: 410e7333 ($1.81 in chips)
Seat 3: 4939468 ($5.14 in chips)
Seat 4: 7968ad27 ($6.28 in chips)
Seat 5: 82796794 ($9.11 in chips)
Seat 6: Hero ($5.02 in chips)
Hero: posts small blind $0.02
4a106898: posts big blind $0.05
*** HOLE CARDS ***
Dealt to 4a106898 
Dealt to 410e7333 
Dealt to 4939468 
Dealt to 7968ad27 
Dealt to 82796794 
Dealt to Hero [Kh Qd]
410e7333: folds
4939468: folds
7968ad27: folds
82796794: raises $0.08 to $0.13
Hero: raises $0.42 to $0.55
4a106898: folds
82796794: calls $0.42
*** FLOP *** [Ah Ks 9d]
Hero: bets $0.2
82796794: folds
Uncalled bet ($0.2) returned to Hero
*** SHOWDOWN ***
Hero collected $1.1 from pot
*** SUMMARY ***
Total pot $1.15 | Rake $0.05 | Jackpot $0 | Bingo $0 | Fortune $0 | Tax $0
Board [Ah Ks 9d]
Seat 1: 4a106898 (big blind) folded before Flop
Seat 2: 410e7333 folded before Flop (didn't bet)
Seat 3: 4939468 folded before Flop (didn't bet)
Seat 4: 7968ad27 folded before Flop (didn't bet)
Seat 5: 82796794 (button) folded on the Flop
Seat 6: Hero (small blind) won ($1.1)


Poker Hand #HD1731655652: Hold'em No Limit ($0.02/$0.05) - 2024/04/15 17:49:40
Table 'NLHBlue46' 6-max Seat #4 is the button
Seat 1: 4a106898 ($5.49 in chips)
Seat 2: 410e7333 ($1.81 in chips)
Seat 3: 4939468 ($5.14 in chips)
Seat 4: 7968ad27 ($6.28 in chips)
Seat 5: 82796794 ($9.13 in chips)
Seat 6: Hero ($5 in chips)
82796794: posts small blind $0.02
Hero: posts big blind $0.05
*** HOLE CARDS ***
Dealt to 4a106898 
Dealt to 410e7333 
Dealt to 4939468 
Dealt to 7968ad27 
Dealt to 82796794 
Dealt to Hero [7s Qh]
4a106898: folds
410e7333: folds
4939468: folds
7968ad27: folds
82796794: folds
Uncalled bet ($0.03) returned to Hero
*** SHOWDOWN ***
Hero collected $0.04 from pot
*** SUMMARY ***
Total pot $0.04 | Rake $0 | Jackpot $0 | Bingo $0 | Fortune $0 | Tax $0
Seat 1: 4a106898 folded before Flop (didn't bet)
Seat 2: 410e7333 folded before Flop (didn't bet)
Seat 3: 4939468 folded before Flop (didn't bet)
Seat 4: 7968ad27 (button) folded before Flop (didn't bet)
Seat 5: 82796794 (small blind) folded before Flop
Seat 6: Hero (big blind) collected ($0.04)


Poker Hand #HD1731555581: Hold'em No Limit ($0.02/$0.05) - 2024/04/15 17:49:14
Table 'NLHBlue46' 6-max Seat #3 is the button
Seat 1: 4a106898 ($5.49 in chips)
Seat 2: 410e7333 ($1.81 in chips)
Seat 3: 4939468 ($5.14 in chips)
Seat 4: 7968ad27 ($6.14 in chips)
Seat 5: 82796794 ($9.28 in chips)
Seat 6: Hero ($5 in chips)
7968ad27: posts small blind $0.02
82796794: posts big blind $0.05
*** HOLE CARDS ***
Dealt to 4a106898 
Dealt to 410e7333 
Dealt to 4939468 
Dealt to 7968ad27 
Dealt to 82796794 
Dealt to Hero [Qc Td]
Hero: folds
4a106898: folds
410e7333: folds
4939468: folds
7968ad27: raises $0.1 to $0.15
82796794: calls $0.1
*** FLOP *** [As 2h 6h]
7968ad27: bets $0.1
82796794: folds
Uncalled bet ($0.1) returned to 7968ad27
*** SHOWDOWN ***
7968ad27 collected $0.29 from pot
*** SUMMARY ***
Total pot $0.3 | Rake $0.01 | Jackpot $0 | Bingo $0 | Fortune $0 | Tax $0
Board [As 2h 6h]
Seat 1: 4a106898 folded before Flop (didn't bet)
Seat 2: 410e7333 folded before Flop (didn't bet)
Seat 3: 4939468 (button) folded before Flop (didn't bet)
Seat 4: 7968ad27 (small blind) won ($0.29)
Seat 5: 82796794 (big blind) folded on the Flop
Seat 6: Hero folded before Flop (didn't bet)


Poker Hand #HD1731555548: Hold'em No Limit ($0.02/$0.05) - 2024/04/15 17:48:59
Table 'NLHBlue46' 6-max Seat #2 is the button
Seat 1: 4a106898 ($5.49 in chips)
Seat 2: 410e7333 ($1.81 in chips)
Seat 3: 4939468 ($5.16 in chips)
Seat 4: 7968ad27 ($6.12 in chips)
Seat 5: 82796794 ($9.28 in chips)
Seat 6: Hero ($5 in chips)
4939468: posts small blind $0.02
7968ad27: posts big blind $0.05
*** HOLE CARDS ***
Dealt to 4a106898 
Dealt to 410e7333 
Dealt to 4939468 
Dealt to 7968ad27 
Dealt to 82796794 
Dealt to Hero [Ac 8s]
82796794: folds
Hero: folds
4a106898: folds
410e7333: folds
4939468: folds
Uncalled bet ($0.03) returned to 7968ad27
*** SHOWDOWN ***
7968ad27 collected $0.04 from pot
*** SUMMARY ***
Total pot $0.04 | Rake $0 | Jackpot $0 | Bingo $0 | Fortune $0 | Tax $0
Seat 1: 4a106898 folded before Flop (didn't bet)
Seat 2: 410e7333 (button) folded before Flop (didn't bet)
Seat 3: 4939468 (small blind) folded before Flop
Seat 4: 7968ad27 (big blind) collected ($0.04)
Seat 5: 82796794 folded before Flop (didn't bet)
Seat 6: Hero folded before Flop (didn't bet)


Poker Hand #HD1731555515: Hold'em No Limit ($0.02/$0.05) - 2024/04/15 17:48:46
Table 'NLHBlue46' 6-max Seat #1 is the button
Seat 1: 4a106898 ($5.49 in chips)
Seat 2: 410e7333 ($1.76 in chips)
Seat 3: 4939468 ($5.21 in chips)
Seat 4: 7968ad27 ($6.12 in chips)
Seat 5: 82796794 ($9.28 in chips)
Seat 6: Hero ($5 in chips)
410e7333: posts small blind $0.02
4939468: posts big blind $0.05
*** HOLE CARDS ***
Dealt to 4a106898 
Dealt to 410e7333 
Dealt to 4939468 
Dealt to 7968ad27 
Dealt to 82796794 
Dealt to Hero [9h 7s]
7968ad27: folds
82796794: folds
Hero: folds
4a106898: folds
410e7333: raises $0.05 to $0.1
4939468: folds
Uncalled bet ($0.05) returned to 410e7333
*** SHOWDOWN ***
410e7333 collected $0.1 from pot
*** SUMMARY ***
Total pot $0.1 | Rake $0 | Jackpot $0 | Bingo $0 | Fortune $0 | Tax $0
Seat 1: 4a106898 (button) folded before Flop (didn't bet)
Seat 2: 410e7333 (small blind) collected ($0.1)
Seat 3: 4939468 (big blind) folded before Flop
Seat 4: 7968ad27 folded before Flop (didn't bet)
Seat 5: 82796794 folded before Flop (didn't bet)
Seat 6: Hero folded before Flop (didn't bet)


Poker Hand #HD1731555414: Hold'em No Limit ($0.02/$0.05) - 2024/04/15 17:48:06
Table 'NLHBlue46' 6-max Seat #6 is the button
Seat 1: 4a106898 ($5.22 in chips)
Seat 2: 410e7333 ($2.06 in chips)
Seat 3: 4939468 ($5.21 in chips)
Seat 4: 7968ad27 ($6.12 in chips)
Seat 5: 82796794 ($9.28 in chips)
Seat 6: Hero ($5 in chips)
4a106898: posts small blind $0.02
410e7333: posts big blind $0.05
*** HOLE CARDS ***
Dealt to 4a106898 
Dealt to 410e7333 
Dealt to 4939468 
Dealt to 7968ad27 
Dealt to 82796794 
Dealt to Hero [Th 3h]
4939468: folds
7968ad27: folds
82796794: folds
Hero: folds
4a106898: raises $0.1 to $0.15
410e7333: calls $0.1
*** FLOP *** [2c 7d 8c]
4a106898: checks
410e7333: bets $0.15
4a106898: calls $0.15
*** TURN *** [2c 7d 8c] [9s]
4a106898: checks
410e7333: checks
*** RIVER *** [2c 7d 8c 9s] [Ad]
4a106898: bets $0.37
410e7333: folds
Uncalled bet ($0.37) returned to 4a106898
*** SHOWDOWN ***
4a106898 collected $0.57 from pot
*** SUMMARY ***
Total pot $0.6 | Rake $0.03 | Jackpot $0 | Bingo $0 | Fortune $0 | Tax $0
Board [2c 7d 8c 9s Ad]
Seat 1: 4a106898 (small blind) won ($0.57)
Seat 2: 410e7333 (big blind) folded on the River
Seat 3: 4939468 folded before Flop (didn't bet)
Seat 4: 7968ad27 folded before Flop (didn't bet)
Seat 5: 82796794 folded before Flop (didn't bet)
Seat 6: Hero (button) folded before Flop (didn't bet)


Poker Hand #HD1731555373: Hold'em No Limit ($0.02/$0.05) - 2024/04/15 17:47:49
Table 'NLHBlue46' 6-max Seat #5 is the button
Seat 1: 4a106898 ($5.27 in chips)
Seat 2: 410e7333 ($2.06 in chips)
Seat 3: 4939468 ($5.21 in chips)
Seat 4: 7968ad27 ($6.12 in chips)
Seat 5: 82796794 ($9.21 in chips)
Seat 6: Hero ($5 in chips)
Hero: posts small blind $0.02
4a106898: posts big blind $0.05
*** HOLE CARDS ***
Dealt to 4a106898 
Dealt to 410e7333 
Dealt to 4939468 
Dealt to 7968ad27 
Dealt to 82796794 
Dealt to Hero [Ah 2s]
410e7333: folds
4939468: folds
7968ad27: folds
82796794: raises $0.08 to $0.13
Hero: folds
4a106898: folds
Uncalled bet ($0.08) returned to 82796794
*** SHOWDOWN ***
82796794 collected $0.12 from pot
*** SUMMARY ***
Total pot $0.12 | Rake $0 | Jackpot $0 | Bingo $0 | Fortune $0 | Tax $0
Seat 1: 4a106898 (big blind) folded before Flop
Seat 2: 410e7333 folded before Flop (didn't bet)
Seat 3: 4939468 folded before Flop (didn't bet)
Seat 4: 7968ad27 folded before Flop (didn't bet)
Seat 5: 82796794 (button) collected ($0.12)
Seat 6: Hero (small blind) folded before Flop


Poker Hand #HD1731555325: Hold'em No Limit ($0.02/$0.05) - 2024/04/15 17:47:29
Table 'NLHBlue46' 6-max Seat #4 is the button
Seat 1: 4a106898 ($5.27 in chips)
Seat 2: 410e7333 ($2.06 in chips)
Seat 3: 4939468 ($5.14 in chips)
Seat 4: 7968ad27 ($6.12 in chips)
Seat 5: 82796794 ($9.23 in chips)
Seat 6: Hero ($5 in chips)
82796794: posts small blind $0.02
Hero: posts big blind $0.05
*** HOLE CARDS ***
Dealt to 4a106898 
Dealt to 410e7333 
Dealt to 4939468 
Dealt to 7968ad27 
Dealt to 82796794 
Dealt to Hero [7s 3s]
4a106898: folds
410e7333: folds
4939468: raises $0.07 to $0.12
7968ad27: folds
82796794: folds
Hero: folds
Uncalled bet ($0.07) returned to 4939468
*** SHOWDOWN ***
4939468 collected $0.12 from pot
*** SUMMARY ***
Total pot $0.12 | Rake $0 | Jackpot $0 | Bingo $0 | Fortune $0 | Tax $0
Seat 1: 4a106898 folded before Flop (didn't bet)
Seat 2: 410e7333 folded before Flop (didn't bet)
Seat 3: 4939468 collected ($0.12)
Seat 4: 7968ad27 (button) folded before Flop (didn't bet)
Seat 5: 82796794 (small blind) folded before Flop
Seat 6: Hero (big blind) folded before Flop


Poker Hand #HD1731555251: Hold'em No Limit ($0.02/$0.05) - 2024/04/15 17:46:58
Table 'NLHBlue46' 6-max Seat #3 is the button
Seat 1: 4a106898 ($5.27 in chips)
Seat 2: 410e7333 ($2.16 in chips)
Seat 3: 4939468 ($5.14 in chips)
Seat 4: 7968ad27 ($6.62 in chips)
Seat 5: 82796794 ($8.68 in chips)
Seat 6: Hero ($5 in chips)
7968ad27: posts small blind $0.02
82796794: posts big blind $0.05
*** HOLE CARDS ***
Dealt to 4a106898 
Dealt to 410e7333 
Dealt to 4939468 
Dealt to 7968ad27 
Dealt to 82796794 
Dealt to Hero [Kd 9s]
Hero: folds
4a106898: folds
410e7333: raises $0.05 to $0.1
4939468: folds
7968ad27: raises $0.4 to $0.5
82796794: raises $0.88 to $1.38
410e7333: folds
7968ad27: folds
Uncalled bet ($0.88) returned to 82796794
*** SHOWDOWN ***
82796794 collected $1.05 from pot
*** SUMMARY ***
Total pot $1.1 | Rake $0.05 | Jackpot $0 | Bingo $0 | Fortune $0 | Tax $0
Seat 1: 4a106898 folded before Flop (didn't bet)
Seat 2: 410e7333 folded before Flop
Seat 3: 4939468 (button) folded before Flop (didn't bet)
Seat 4: 7968ad27 (small blind) folded before Flop
Seat 5: 82796794 (big blind) collected ($1.05)
Seat 6: Hero folded before Flop (didn't bet)


Poker Hand #HD1731555125: Hold'em No Limit ($0.02/$0.05) - 2024/04/15 17:46:14
Table 'NLHBlue46' 6-max Seat #2 is the button
Seat 1: 4a106898 ($5.4 in chips)
Seat 2: 410e7333 ($1.85 in chips)
Seat 3: 4939468 ($5.16 in chips)
Seat 4: 7968ad27 ($6.67 in chips)
Seat 5: 82796794 ($8.81 in chips)
Seat 6: Hero ($5 in chips)
4939468: posts small blind $0.02
7968ad27: posts big blind $0.05
*** HOLE CARDS ***
Dealt to 4a106898 
Dealt to 410e7333 
Dealt to 4939468 
Dealt to 7968ad27 
Dealt to 82796794 
Dealt to Hero [8s 2s]
82796794: raises $0.08 to $0.13
Hero: folds
4a106898: calls $0.13
410e7333: calls $0.13
4939468: folds
7968ad27: folds
*** FLOP *** [Td 9h 6h]
82796794: checks
4a106898: checks
410e7333: checks
*** TURN *** [Td 9h 6h] [Th]
82796794: checks
4a106898: checks
410e7333: checks
*** RIVER *** [Td 9h 6h Th] [5c]
82796794: checks
4a106898: checks
410e7333: bets $0.23
82796794: folds
4a106898: folds
Uncalled bet ($0.23) returned to 410e7333
*** SHOWDOWN ***
410e7333 collected $0.44 from pot
*** SUMMARY ***
Total pot $0.46 | Rake $0.02 | Jackpot $0 | Bingo $0 | Fortune $0 | Tax $0
Board [Td 9h 6h Th 5c]
Seat 1: 4a106898 folded on the River
Seat 2: 410e7333 (button) won ($0.44)
Seat 3: 4939468 (small blind) folded before Flop
Seat 4: 7968ad27 (big blind) folded before Flop
Seat 5: 82796794 folded on the River
Seat 6: Hero folded before Flop (didn't bet)


Poker Hand #HD1731554943: Hold'em No Limit ($0.02/$0.05) - 2024/04/15 17:45:05
Table 'NLHBlue46' 6-max Seat #1 is the button
Seat 1: 4a106898 ($6.03 in chips)
Seat 2: 410e7333 ($1.87 in chips)
Seat 3: 4939468 ($5.21 in chips)
Seat 4: 7968ad27 ($6.67 in chips)
Seat 5: 82796794 ($8.17 in chips)
Seat 6: Hero ($5 in chips)
410e7333: posts small blind $0.02
4939468: posts big blind $0.05
*** HOLE CARDS ***
Dealt to 4a106898 
Dealt to 410e7333 
Dealt to 4939468 
Dealt to 7968ad27 
Dealt to 82796794 
Dealt to Hero [7s Th]
7968ad27: folds
82796794: raises $0.08 to $0.13
Hero: folds
4a106898: calls $0.13
410e7333: folds
4939468: folds
*** FLOP *** [5h 4s 4c]
82796794: bets $0.11
4a106898: calls $0.11
*** TURN *** [5h 4s 4c] [8s]
82796794: bets $0.39
4a106898: calls $0.39
*** RIVER *** [5h 4s 4c 8s] [3c]
82796794: bets $0.72
4a106898: folds
Uncalled bet ($0.72) returned to 82796794
*** SHOWDOWN ***
82796794 collected $1.27 from pot
*** SUMMARY ***
Total pot $1.33 | Rake $0.06 | Jackpot $0 | Bingo $0 | Fortune $0 | Tax $0
Board [5h 4s 4c 8s 3c]
Seat 1: 4a106898 (button) folded on the River
Seat 2: 410e7333 (small blind) folded before Flop
Seat 3: 4939468 (big blind) folded before Flop
Seat 4: 7968ad27 folded before Flop (didn't bet)
Seat 5: 82796794 won ($1.27)
Seat 6: Hero folded before Flop (didn't bet)


Poker Hand #HD1731554779: Hold'em No Limit ($0.02/$0.05) - 2024/04/15 17:43:57
Table 'NLHBlue46' 6-max Seat #6 is the button
Seat 1: 4a106898 ($6.15 in chips)
Seat 2: 410e7333 ($1.92 in chips)
Seat 3: 4939468 ($5.21 in chips)
Seat 4: 7968ad27 ($6.67 in chips)
Seat 5: 82796794 ($8.17 in chips)
Seat 6: Hero ($5.03 in chips)
4a106898: posts small blind $0.02
410e7333: posts big blind $0.05
*** HOLE CARDS ***
Dealt to 4a106898 
Dealt to 410e7333 
Dealt to 4939468 
Dealt to 7968ad27 
Dealt to 82796794 
Dealt to Hero [Ah Kc]
4939468: folds
7968ad27: folds
82796794: folds
Hero: raises $0.07 to $0.12
4a106898: calls $0.1
410e7333: raises $0.27 to $0.39
Hero: raises $4.64 to $5.03 and is all-in
4a106898: folds
410e7333: calls $1.53 and is all-in
Uncalled bet ($3.11) returned to Hero
Hero: shows [Ah Kc]
410e7333: shows [Qc Qs]
*** FIRST FLOP *** [Ad 6s Ks]
*** FIRST TURN *** [Ad 6s Ks] [3h]
*** FIRST RIVER *** [Ad 6s Ks 3h] [2s]
*** SECOND FLOP *** [Th 9s 8s]
*** SECOND TURN *** [Th 9s 8s] [2d]
*** SECOND RIVER *** [Th 9s 8s 2d] [2c]
*** FIRST SHOWDOWN ***
Hero collected $1.86 from pot
*** SECOND SHOWDOWN ***
410e7333 collected $1.87 from pot
*** SUMMARY ***
Total pot $3.96 | Rake $0.18 | Jackpot $0.05 | Bingo $0 | Fortune $0 | Tax $0
Hand was run two times
FIRST Board [Ad 6s Ks 3h 2s]
SECOND Board [Th 9s 8s 2d 2c]
Seat 1: 4a106898 (small blind) folded before Flop
Seat 2: 410e7333 (big blind) showed [Qc Qs] and lost with Pair of Queens, and won ($1.87) with Pair of Queens and Pair of Twos
Seat 3: 4939468 folded before Flop (didn't bet)
Seat 4: 7968ad27 folded before Flop (didn't bet)
Seat 5: 82796794 folded before Flop (didn't bet)
Seat 6: Hero (button) showed [Ah Kc] and won ($1.86) with Pair of Aces and Pair of Kings, and lost with Pair of Twos


Poker Hand #HD1731554691: Hold'em No Limit ($0.02/$0.05) - 2024/04/15 17:43:26
Table 'NLHBlue46' 6-max Seat #5 is the button
Seat 1: 4a106898 ($6.2 in chips)
Seat 2: 410e7333 ($2.02 in chips)
Seat 3: 4939468 ($5.21 in chips)
Seat 4: 7968ad27 ($6.51 in chips)
Seat 5: 82796794 ($8.17 in chips)
Seat 6: Hero ($5.05 in chips)
Hero: posts small blind $0.02
4a106898: posts big blind $0.05
*** HOLE CARDS ***
Dealt to 4a106898 
Dealt to 410e7333 
Dealt to 4939468 
Dealt to 7968ad27 
Dealt to 82796794 
Dealt to Hero [Kc 6d]
410e7333: raises $0.05 to $0.1
4939468: folds
7968ad27: raises $0.2 to $0.3
82796794: folds
Hero: folds
4a106898: folds
410e7333: folds
Uncalled bet ($0.2) returned to 7968ad27
*** SHOWDOWN ***
7968ad27 collected $0.26 from pot
*** SUMMARY ***
Total pot $0.27 | Rake $0.01 | Jackpot $0 | Bingo $0 | Fortune $0 | Tax $0
Seat 1: 4a106898 (big blind) folded before Flop
Seat 2: 410e7333 folded before Flop
Seat 3: 4939468 folded before Flop (didn't bet)
Seat 4: 7968ad27 collected ($0.26)
Seat 5: 82796794 (button) folded before Flop (didn't bet)
Seat 6: Hero (small blind) folded before Flop


Poker Hand #HD1731554660: Hold'em No Limit ($0.02/$0.05) - 2024/04/15 17:43:13
Table 'NLHBlue46' 6-max Seat #4 is the button
Seat 1: 4a106898 ($6.2 in chips)
Seat 2: 410e7333 ($2.02 in chips)
Seat 3: 4939468 ($5.21 in chips)
Seat 4: 7968ad27 ($6.44 in chips)
Seat 5: 82796794 ($8.19 in chips)
Seat 6: Hero ($5.1 in chips)
82796794: posts small blind $0.02
Hero: posts big blind $0.05
*** HOLE CARDS ***
Dealt to 4a106898 
Dealt to 410e7333 
Dealt to 4939468 
Dealt to 7968ad27 
Dealt to 82796794 
Dealt to Hero [3d 3h]
4a106898: folds
410e7333: folds
4939468: folds
7968ad27: raises $0.07 to $0.12
82796794: folds
Hero: folds
Uncalled bet ($0.07) returned to 7968ad27
*** SHOWDOWN ***
7968ad27 collected $0.12 from pot
*** SUMMARY ***
Total pot $0.12 | Rake $0 | Jackpot $0 | Bingo $0 | Fortune $0 | Tax $0
Seat 1: 4a106898 folded before Flop (didn't bet)
Seat 2: 410e7333 folded before Flop (didn't bet)
Seat 3: 4939468 folded before Flop (didn't bet)
Seat 4: 7968ad27 (button) collected ($0.12)
Seat 5: 82796794 (small blind) folded before Flop
Seat 6: Hero (big blind) folded before Flop


Poker Hand #HD1731554475: Hold'em No Limit ($0.02/$0.05) - 2024/04/15 17:42:01
Table 'NLHBlue46' 6-max Seat #3 is the button
Seat 1: 4a106898 ($6.2 in chips)
Seat 2: 410e7333 ($2.02 in chips)
Seat 3: 4939468 ($5.21 in chips)
Seat 4: 7968ad27 ($5.28 in chips)
Seat 5: 82796794 ($9.53 in chips)
Seat 6: Hero ($5.1 in chips)
7968ad27: posts small blind $0.02
82796794: posts big blind $0.05
*** HOLE CARDS ***
Dealt to 4a106898 
Dealt to 410e7333 
Dealt to 4939468 
Dealt to 7968ad27 
Dealt to 82796794 
Dealt to Hero [4d 3d]
Hero: folds
4a106898: folds
410e7333: folds
4939468: folds
7968ad27: raises $0.1 to $0.15
82796794: calls $0.1
*** FLOP *** [8s 9h 8c]
7968ad27: bets $0.1
82796794: raises $0.32 to $0.42
7968ad27: calls $0.32
*** TURN *** [8s 9h 8c] [4h]
7968ad27: checks
82796794: bets $0.77
7968ad27: calls $0.77
*** RIVER *** [8s 9h 8c 4h] [5s]
7968ad27: checks
82796794: checks
7968ad27: shows [9d Qs] (Pair of Nines and Pair of Eights)
82796794: shows [Qh Tc] (Pair of Eights)
*** SHOWDOWN ***
7968ad27 collected $2.5 from pot
*** SUMMARY ***
Total pot $2.68 | Rake $0.13 | Jackpot $0.05 | Bingo $0 | Fortune $0 | Tax $0
Board [8s 9h 8c 4h 5s]
Seat 1: 4a106898 folded before Flop (didn't bet)
Seat 2: 410e7333 folded before Flop (didn't bet)
Seat 3: 4939468 (button) folded before Flop (didn't bet)
Seat 4: 7968ad27 (small blind) showed [9d Qs] and won ($2.5) with Pair of Nines and Pair of Eights
Seat 5: 82796794 (big blind) showed [Qh Tc] and lost with Pair of Eights
Seat 6: Hero folded before Flop (didn't bet)


Poker Hand #HD1731554418: Hold'em No Limit ($0.02/$0.05) - 2024/04/15 17:41:41
Table 'NLHBlue46' 6-max Seat #2 is the button
Seat 1: 4a106898 ($6.2 in chips)
Seat 2: 410e7333 ($2.02 in chips)
Seat 3: 4939468 ($5.23 in chips)
Seat 4: 7968ad27 ($5.26 in chips)
Seat 5: 82796794 ($9.53 in chips)
Seat 6: Hero ($5.1 in chips)
4939468: posts small blind $0.02
7968ad27: posts big blind $0.05
*** HOLE CARDS ***
Dealt to 4a106898 
Dealt to 410e7333 
Dealt to 4939468 
Dealt to 7968ad27 
Dealt to 82796794 
Dealt to Hero [9d Ah]
82796794: folds
Hero: folds
4a106898: folds
410e7333: folds
4939468: folds
Uncalled bet ($0.03) returned to 7968ad27
*** SHOWDOWN ***
7968ad27 collected $0.04 from pot
*** SUMMARY ***
Total pot $0.04 | Rake $0 | Jackpot $0 | Bingo $0 | Fortune $0 | Tax $0
Seat 1: 4a106898 folded before Flop (didn't bet)
Seat 2: 410e7333 (button) folded before Flop (didn't bet)
Seat 3: 4939468 (small blind) folded before Flop
Seat 4: 7968ad27 (big blind) collected ($0.04)
Seat 5: 82796794 folded before Flop (didn't bet)
Seat 6: Hero folded before Flop (didn't bet)


Poker Hand #HD1731554364: Hold'em No Limit ($0.02/$0.05) - 2024/04/15 17:41:23
Table 'NLHBlue46' 6-max Seat #1 is the button
Seat 1: 4a106898 ($6.2 in chips)
Seat 2: 410e7333 ($2.04 in chips)
Seat 3: 4939468 ($5.28 in chips)
Seat 4: 7968ad27 ($5.26 in chips)
Seat 5: 82796794 ($9.46 in chips)
Seat 6: Hero ($5.1 in chips)
410e7333: posts small blind $0.02
4939468: posts big blind $0.05
*** HOLE CARDS ***
Dealt to 4a106898 
Dealt to 410e7333 
Dealt to 4939468 
Dealt to 7968ad27 
Dealt to 82796794 
Dealt to Hero [9h Ac]
7968ad27: folds
82796794: raises $0.08 to $0.13
Hero: folds
4a106898: folds
410e7333: folds
4939468: folds
Uncalled bet ($0.08) returned to 82796794
*** SHOWDOWN ***
82796794 collected $0.12 from pot
*** SUMMARY ***
Total pot $0.12 | Rake $0 | Jackpot $0 | Bingo $0 | Fortune $0 | Tax $0
Seat 1: 4a106898 (button) folded before Flop (didn't bet)
Seat 2: 410e7333 (small blind) folded before Flop
Seat 3: 4939468 (big blind) folded before Flop
Seat 4: 7968ad27 folded before Flop (didn't bet)
Seat 5: 82796794 collected ($0.12)
Seat 6: Hero folded before Flop (didn't bet)


Poker Hand #HD1731554340: Hold'em No Limit ($0.02/$0.05) - 2024/04/15 17:41:12
Table 'NLHBlue46' 6-max Seat #6 is the button
Seat 1: 4a106898 ($6.22 in chips)
Seat 2: 410e7333 ($2.02 in chips)
Seat 3: 4939468 ($5.28 in chips)
Seat 4: 7968ad27 ($5.26 in chips)
Seat 5: 82796794 ($9.46 in chips)
Seat 6: Hero ($5.1 in chips)
4a106898: posts small blind $0.02
410e7333: posts big blind $0.05
*** HOLE CARDS ***
Dealt to 4a106898 
Dealt to 410e7333 
Dealt to 4939468 
Dealt to 7968ad27 
Dealt to 82796794 
Dealt to Hero [Qh 7d]
4939468: folds
7968ad27: folds
82796794: folds
Hero: folds
4a106898: folds
Uncalled bet ($0.03) returned to 410e7333
*** SHOWDOWN ***
410e7333 collected $0.04 from pot
*** SUMMARY ***
Total pot $0.04 | Rake $0 | Jackpot $0 | Bingo $0 | Fortune $0 | Tax $0
Seat 1: 4a106898 (small blind) folded before Flop
Seat 2: 410e7333 (big blind) collected ($0.04)
Seat 3: 4939468 folded before Flop (didn't bet)
Seat 4: 7968ad27 folded before Flop (didn't bet)
Seat 5: 82796794 folded before Flop (didn't bet)
Seat 6: Hero (button) folded before Flop (didn't bet)


Poker Hand #HD1731554204: Hold'em No Limit ($0.02/$0.05) - 2024/04/15 17:40:13
Table 'NLHBlue46' 6-max Seat #5 is the button
Seat 1: 4a106898 ($6.27 in chips)
Seat 2: 410e7333 ($1.8 in chips)
Seat 3: 4939468 ($5.45 in chips)
Seat 4: 7968ad27 ($5.26 in chips)
Seat 5: 82796794 ($9.46 in chips)
Seat 6: Hero ($5.12 in chips)
Hero: posts small blind $0.02
4a106898: posts big blind $0.05
*** HOLE CARDS ***
Dealt to 4a106898 
Dealt to 410e7333 
Dealt to 4939468 
Dealt to 7968ad27 
Dealt to 82796794 
Dealt to Hero [Td 9h]
410e7333: calls $0.05
4939468: raises $0.12 to $0.17
7968ad27: folds
82796794: folds
Hero: folds
4a106898: folds
410e7333: calls $0.12
*** FLOP *** [6h Ad 5c]
410e7333: checks
4939468: checks
*** TURN *** [6h Ad 5c] [4d]
410e7333: bets $0.14
4939468: folds
Uncalled bet ($0.14) returned to 410e7333
*** SHOWDOWN ***
410e7333 collected $0.39 from pot
*** SUMMARY ***
Total pot $0.41 | Rake $0.02 | Jackpot $0 | Bingo $0 | Fortune $0 | Tax $0
Board [6h Ad 5c 4d]
Seat 1: 4a106898 (big blind) folded before Flop
Seat 2: 410e7333 won ($0.39)
Seat 3: 4939468 folded on the Turn
Seat 4: 7968ad27 folded before Flop (didn't bet)
Seat 5: 82796794 (button) folded before Flop (didn't bet)
Seat 6: Hero (small blind) folded before Flop


Poker Hand #HD1731554129: Hold'em No Limit ($0.02/$0.05) - 2024/04/15 17:39:44
Table 'NLHBlue46' 6-max Seat #4 is the button
Seat 1: 4a106898 ($6.27 in chips)
Seat 2: 410e7333 ($1.61 in chips)
Seat 3: 4939468 ($5.45 in chips)
Seat 4: 7968ad27 ($5.26 in chips)
Seat 5: 82796794 ($9.61 in chips)
Seat 6: Hero ($5.17 in chips)
82796794: posts small blind $0.02
Hero: posts big blind $0.05
*** HOLE CARDS ***
Dealt to 4a106898 
Dealt to 410e7333 
Dealt to 4939468 
Dealt to 7968ad27 
Dealt to 82796794 
Dealt to Hero [Ts 5s]
4a106898: folds
410e7333: raises $0.1 to $0.15
4939468: folds
7968ad27: folds
82796794: calls $0.13
Hero: folds
*** FLOP *** [Td 7s 7d]
82796794: checks
410e7333: bets $0.18
82796794: folds
Uncalled bet ($0.18) returned to 410e7333
*** SHOWDOWN ***
410e7333 collected $0.34 from pot
*** SUMMARY ***
Total pot $0.35 | Rake $0.01 | Jackpot $0 | Bingo $0 | Fortune $0 | Tax $0
Board [Td 7s 7d]
Seat 1: 4a106898 folded before Flop (didn't bet)
Seat 2: 410e7333 won ($0.34)
Seat 3: 4939468 folded before Flop (didn't bet)
Seat 4: 7968ad27 (button) folded before Flop (didn't bet)
Seat 5: 82796794 (small blind) folded on the Flop
Seat 6: Hero (big blind) folded before Flop


Poker Hand #HD1731554100: Hold'em No Limit ($0.02/$0.05) - 2024/04/15 17:39:32
Table 'NLHBlue46' 6-max Seat #3 is the button
Seat 1: 4a106898 ($6.27 in chips)
Seat 2: 410e7333 ($1.61 in chips)
Seat 3: 4939468 ($5.45 in chips)
Seat 4: 7968ad27 ($5.21 in chips)
Seat 5: 82796794 ($9.66 in chips)
Seat 6: Hero ($5.17 in chips)
7968ad27: posts small blind $0.02
82796794: posts big blind $0.05
*** HOLE CARDS ***
Dealt to 4a106898 
Dealt to 410e7333 
Dealt to 4939468 
Dealt to 7968ad27 
Dealt to 82796794 
Dealt to Hero [6s 3h]
Hero: folds
4a106898: folds
410e7333: folds
4939468: folds
7968ad27: raises $0.15 to $0.2
82796794: folds
Uncalled bet ($0.15) returned to 7968ad27
*** SHOWDOWN ***
7968ad27 collected $0.1 from pot
*** SUMMARY ***
Total pot $0.1 | Rake $0 | Jackpot $0 | Bingo $0 | Fortune $0 | Tax $0
Seat 1: 4a106898 folded before Flop (didn't bet)
Seat 2: 410e7333 folded before Flop (didn't bet)
Seat 3: 4939468 (button) folded before Flop (didn't bet)
Seat 4: 7968ad27 (small blind) collected ($0.1)
Seat 5: 82796794 (big blind) folded before Flop
Seat 6: Hero folded before Flop (didn't bet)


Poker Hand #HD1731554003: Hold'em No Limit ($0.02/$0.05) - 2024/04/15 17:38:51
Table 'NLHBlue46' 6-max Seat #2 is the button
Seat 1: 4a106898 ($6.27 in chips)
Seat 2: 410e7333 ($1.82 in chips)
Seat 3: 4939468 ($5.47 in chips)
Seat 4: 7968ad27 ($5 in chips)
Seat 5: 82796794 ($9.66 in chips)
Seat 6: Hero ($5.17 in chips)
4939468: posts small blind $0.02
7968ad27: posts big blind $0.05
*** HOLE CARDS ***
Dealt to 4a106898 
Dealt to 410e7333 
Dealt to 4939468 
Dealt to 7968ad27 
Dealt to 82796794 
Dealt to Hero [6d 8c]
82796794: folds
Hero: folds
4a106898: folds
410e7333: raises $0.05 to $0.1
4939468: folds
7968ad27: calls $0.05
*** FLOP *** [9c Qs 7s]
7968ad27: checks
410e7333: bets $0.11
7968ad27: calls $0.11
*** TURN *** [9c Qs 7s] [Qd]
7968ad27: checks
410e7333: checks
*** RIVER *** [9c Qs 7s Qd] [9d]
7968ad27: checks
410e7333: checks
7968ad27: shows [Ks Th] (Pair of Queens and Pair of Nines)
410e7333: shows [2s 2d] (Pair of Queens and Pair of Nines)
*** SHOWDOWN ***
7968ad27 collected $0.42 from pot
*** SUMMARY ***
Total pot $0.44 | Rake $0.02 | Jackpot $0 | Bingo $0 | Fortune $0 | Tax $0
Board [9c Qs 7s Qd 9d]
Seat 1: 4a106898 folded before Flop (didn't bet)
Seat 2: 410e7333 (button) showed [2s 2d] and lost with Pair of Queens and Pair of Nines
Seat 3: 4939468 (small blind) folded before Flop
Seat 4: 7968ad27 (big blind) showed [Ks Th] and won ($0.42) with Pair of Queens and Pair of Nines
Seat 5: 82796794 folded before Flop (didn't bet)
Seat 6: Hero folded before Flop (didn't bet)


Poker Hand #HD1731553974: Hold'em No Limit ($0.02/$0.05) - 2024/04/15 17:38:37
Table 'NLHBlue46' 6-max Seat #1 is the button
Seat 1: 4a106898 ($6.27 in chips)
Seat 2: 410e7333 ($1.84 in chips)
Seat 3: 4939468 ($5.52 in chips)
Seat 5: 82796794 ($9.66 in chips)
Seat 6: Hero ($5.1 in chips)
410e7333: posts small blind $0.02
4939468: posts big blind $0.05
*** HOLE CARDS ***
Dealt to 4a106898 
Dealt to 410e7333 
Dealt to 4939468 
Dealt to 82796794 
Dealt to Hero [Kh Ah]
82796794: folds
Hero: raises $0.07 to $0.12
4a106898: folds
410e7333: folds
4939468: folds
Uncalled bet ($0.07) returned to Hero
*** SHOWDOWN ***
Hero collected $0.12 from pot
*** SUMMARY ***
Total pot $0.12 | Rake $0 | Jackpot $0 | Bingo $0 | Fortune $0 | Tax $0
Seat 1: 4a106898 (button) folded before Flop (didn't bet)
Seat 2: 410e7333 (small blind) folded before Flop
Seat 3: 4939468 (big blind) folded before Flop
Seat 5: 82796794 folded before Flop (didn't bet)
Seat 6: Hero collected ($0.12)


Poker Hand #HD1731553906: Hold'em No Limit ($0.02/$0.05) - 2024/04/15 17:38:10
Table 'NLHBlue46' 6-max Seat #6 is the button
Seat 1: 4a106898 ($6.29 in chips)
Seat 2: 410e7333 ($1.82 in chips)
Seat 3: 4939468 ($5.52 in chips)
Seat 5: 82796794 ($9.66 in chips)
Seat 6: Hero ($5.1 in chips)
4a106898: posts small blind $0.02
410e7333: posts big blind $0.05
*** HOLE CARDS ***
Dealt to 4a106898 
Dealt to 410e7333 
Dealt to 4939468 
Dealt to 82796794 
Dealt to Hero [Qh 5s]
4939468: folds
82796794: folds
Hero: folds
4a106898: folds
Uncalled bet ($0.03) returned to 410e7333
*** SHOWDOWN ***
410e7333 collected $0.04 from pot
*** SUMMARY ***
Total pot $0.04 | Rake $0 | Jackpot $0 | Bingo $0 | Fortune $0 | Tax $0
Seat 1: 4a106898 (small blind) folded before Flop
Seat 2: 410e7333 (big blind) collected ($0.04)
Seat 3: 4939468 folded before Flop (didn't bet)
Seat 5: 82796794 folded before Flop (didn't bet)
Seat 6: Hero (button) folded before Flop (didn't bet)


Poker Hand #HD1731553881: Hold'em No Limit ($0.02/$0.05) - 2024/04/15 17:37:59
Table 'NLHBlue46' 6-max Seat #5 is the button
Seat 1: 4a106898 ($6.27 in chips)
Seat 2: 410e7333 ($1.82 in chips)
Seat 3: 4939468 ($5.52 in chips)
Seat 5: 82796794 ($9.66 in chips)
Seat 6: Hero ($5.12 in chips)
Hero: posts small blind $0.02
4a106898: posts big blind $0.05
*** HOLE CARDS ***
Dealt to 4a106898 
Dealt to 410e7333 
Dealt to 4939468 
Dealt to 82796794 
Dealt to Hero [7h 6c]
410e7333: folds
4939468: folds
82796794: folds
Hero: folds
Uncalled bet ($0.03) returned to 4a106898
*** SHOWDOWN ***
4a106898 collected $0.04 from pot
*** SUMMARY ***
Total pot $0.04 | Rake $0 | Jackpot $0 | Bingo $0 | Fortune $0 | Tax $0
Seat 1: 4a106898 (big blind) collected ($0.04)
Seat 2: 410e7333 folded before Flop (didn't bet)
Seat 3: 4939468 folded before Flop (didn't bet)
Seat 5: 82796794 (button) folded before Flop (didn't bet)
Seat 6: Hero (small blind) folded before Flop


Poker Hand #HD1731553712: Hold'em No Limit ($0.02/$0.05) - 2024/04/15 17:36:53
Table 'NLHBlue46' 6-max Seat #3 is the button
Seat 1: 4a106898 ($6.27 in chips)
Seat 2: 410e7333 ($1.92 in chips)
Seat 3: 4939468 ($5.62 in chips)
Seat 4: 13f6c9a0 ($3.08 in chips)
Seat 5: 82796794 ($6.74 in chips)
Seat 6: Hero ($5.12 in chips)
13f6c9a0: posts small blind $0.02
82796794: posts big blind $0.05
*** HOLE CARDS ***
Dealt to 4a106898 
Dealt to 410e7333 
Dealt to 4939468 
Dealt to 13f6c9a0 
Dealt to 82796794 
Dealt to Hero [Ts 6c]
Hero: folds
4a106898: folds
410e7333: raises $0.05 to $0.1
4939468: calls $0.1
13f6c9a0: raises $2.98 to $3.08 and is all-in
82796794: raises $3.66 to $6.74 and is all-in
410e7333: folds
4939468: folds
Uncalled bet ($3.66) returned to 82796794
82796794: shows [As Kh]
13f6c9a0: shows [4c 4h]
*** FLOP *** [7d Ks 3s]
*** TURN *** [7d Ks 3s] [Qh]
*** RIVER *** [7d Ks 3s Qh] [5d]
*** SHOWDOWN ***
82796794 collected $6 from pot
*** SUMMARY ***
Total pot $6.36 | Rake $0.31 | Jackpot $0.05 | Bingo $0 | Fortune $0 | Tax $0
Board [7d Ks 3s Qh 5d]
Seat 1: 4a106898 folded before Flop (didn't bet)
Seat 2: 410e7333 folded before Flop
Seat 3: 4939468 (button) folded before Flop
Seat 4: 13f6c9a0 (small blind) showed [4c 4h] and lost with Pair of Fours
Seat 5: 82796794 (big blind) showed [As Kh] and won ($6) with Pair of Kings
Seat 6: Hero folded before Flop (didn't bet)


Poker Hand #HD1731553663: Hold'em No Limit ($0.02/$0.05) - 2024/04/15 17:36:31
Table 'NLHBlue46' 6-max Seat #2 is the button
Seat 1: 4a106898 ($6.27 in chips)
Seat 2: 410e7333 ($1.97 in chips)
Seat 3: 4939468 ($5.64 in chips)
Seat 4: 13f6c9a0 ($3.01 in chips)
Seat 5: 82796794 ($6.74 in chips)
Seat 6: Hero ($5.12 in chips)
4939468: posts small blind $0.02
13f6c9a0: posts big blind $0.05
*** HOLE CARDS ***
Dealt to 4a106898 
Dealt to 410e7333 
Dealt to 4939468 
Dealt to 13f6c9a0 
Dealt to 82796794 
Dealt to Hero [7d 4c]
82796794: folds
Hero: folds
4a106898: folds
410e7333: calls $0.05
4939468: folds
13f6c9a0: raises $2.96 to $3.01 and is all-in
410e7333: folds
Uncalled bet ($2.96) returned to 13f6c9a0
*** SHOWDOWN ***
13f6c9a0 collected $0.12 from pot
*** SUMMARY ***
Total pot $0.12 | Rake $0 | Jackpot $0 | Bingo $0 | Fortune $0 | Tax $0
Seat 1: 4a106898 folded before Flop (didn't bet)
Seat 2: 410e7333 (button) folded before Flop
Seat 3: 4939468 (small blind) folded before Flop
Seat 4: 13f6c9a0 (big blind) collected ($0.12)
Seat 5: 82796794 folded before Flop (didn't bet)
Seat 6: Hero folded before Flop (didn't bet)


Poker Hand #HD1731553611: Hold'em No Limit ($0.02/$0.05) - 2024/04/15 17:36:12
Table 'NLHBlue46' 6-max Seat #1 is the button
Seat 1: 4a106898 ($6.27 in chips)
Seat 2: 410e7333 ($1.99 in chips)
Seat 3: 4939468 ($5.69 in chips)
Seat 4: 13f6c9a0 ($3.01 in chips)
Seat 5: 82796794 ($6.67 in chips)
Seat 6: Hero ($5.12 in chips)
410e7333: posts small blind $0.02
4939468: posts big blind $0.05
*** HOLE CARDS ***
Dealt to 4a106898 
Dealt to 410e7333 
Dealt to 4939468 
Dealt to 13f6c9a0 
Dealt to 82796794 
Dealt to Hero [3d 2c]
13f6c9a0: folds
82796794: raises $0.08 to $0.13
Hero: folds
4a106898: folds
410e7333: folds
4939468: folds
Uncalled bet ($0.08) returned to 82796794
*** SHOWDOWN ***
82796794 collected $0.12 from pot
*** SUMMARY ***
Total pot $0.12 | Rake $0 | Jackpot $0 | Bingo $0 | Fortune $0 | Tax $0
Seat 1: 4a106898 (button) folded before Flop (didn't bet)
Seat 2: 410e7333 (small blind) folded before Flop
Seat 3: 4939468 (big blind) folded before Flop
Seat 4: 13f6c9a0 folded before Flop (didn't bet)
Seat 5: 82796794 collected ($0.12)
Seat 6: Hero folded before Flop (didn't bet)


Poker Hand #HD1731553574: Hold'em No Limit ($0.02/$0.05) - 2024/04/15 17:35:59
Table 'NLHBlue46' 6-max Seat #6 is the button
Seat 1: 4a106898 ($6.29 in chips)
Seat 2: 410e7333 ($2.04 in chips)
Seat 3: 4939468 ($5.69 in chips)
Seat 4: 13f6c9a0 ($3.01 in chips)
Seat 5: 82796794 ($6.67 in chips)
Seat 6: Hero ($5.05 in chips)
4a106898: posts small blind $0.02
410e7333: posts big blind $0.05
*** HOLE CARDS ***
Dealt to 4a106898 
Dealt to 410e7333 
Dealt to 4939468 
Dealt to 13f6c9a0 
Dealt to 82796794 
Dealt to Hero [Ac Th]
4939468: folds
13f6c9a0: folds
82796794: folds
Hero: raises $0.07 to $0.12
4a106898: folds
410e7333: folds
Uncalled bet ($0.07) returned to Hero
*** SHOWDOWN ***
Hero collected $0.12 from pot
*** SUMMARY ***
Total pot $0.12 | Rake $0 | Jackpot $0 | Bingo $0 | Fortune $0 | Tax $0
Seat 1: 4a106898 (small blind) folded before Flop
Seat 2: 410e7333 (big blind) folded before Flop
Seat 3: 4939468 folded before Flop (didn't bet)
Seat 4: 13f6c9a0 folded before Flop (didn't bet)
Seat 5: 82796794 folded before Flop (didn't bet)
Seat 6: Hero (button) collected ($0.12)


Poker Hand #HD1731553524: Hold'em No Limit ($0.02/$0.05) - 2024/04/15 17:35:40
Table 'NLHBlue46' 6-max Seat #5 is the button
Seat 1: 4a106898 ($6.34 in chips)
Seat 2: 410e7333 ($2.04 in chips)
Seat 3: 4939468 ($5.69 in chips)
Seat 4: 13f6c9a0 ($3.01 in chips)
Seat 5: 82796794 ($6.67 in chips)
Seat 6: Hero ($5 in chips)
Hero: posts small blind $0.02
4a106898: posts big blind $0.05
*** HOLE CARDS ***
Dealt to 4a106898 
Dealt to 410e7333 
Dealt to 4939468 
Dealt to 13f6c9a0 
Dealt to 82796794 
Dealt to Hero [Td Qh]
410e7333: folds
4939468: folds
13f6c9a0: folds
82796794: folds
Hero: raises $0.1 to $0.15
4a106898: folds
Uncalled bet ($0.1) returned to Hero
*** SHOWDOWN ***
Hero collected $0.1 from pot
*** SUMMARY ***
Total pot $0.1 | Rake $0 | Jackpot $0 | Bingo $0 | Fortune $0 | Tax $0
Seat 1: 4a106898 (big blind) folded before Flop
Seat 2: 410e7333 folded before Flop (didn't bet)
Seat 3: 4939468 folded before Flop (didn't bet)
Seat 4: 13f6c9a0 folded before Flop (didn't bet)
Seat 5: 82796794 (button) folded before Flop (didn't bet)
Seat 6: Hero (small blind) collected ($0.1)


Poker Hand #HD1731553379: Hold'em No Limit ($0.02/$0.05) - 2024/04/15 17:34:42
Table 'NLHBlue46' 6-max Seat #4 is the button
Seat 1: 4a106898 ($6.34 in chips)
Seat 2: 410e7333 ($2.04 in chips)
Seat 3: 4939468 ($5.22 in chips)
Seat 4: 13f6c9a0 ($3.13 in chips)
Seat 5: 82796794 ($6.69 in chips)
Seat 6: Hero ($5.3 in chips)
82796794: posts small blind $0.02
Hero: posts big blind $0.05
*** HOLE CARDS ***
Dealt to 4a106898 
Dealt to 410e7333 
Dealt to 4939468 
Dealt to 13f6c9a0 
Dealt to 82796794 
Dealt to Hero [Kh Jc]
4a106898: folds
410e7333: folds
4939468: raises $0.07 to $0.12
13f6c9a0: calls $0.12
82796794: folds
Hero: calls $0.07
*** FLOP *** [Tc 8s 9c]
Hero: checks
4939468: bets $0.26
13f6c9a0: folds
Hero: calls $0.26
*** TURN *** [Tc 8s 9c] [2c]
Hero: checks
4939468: checks
*** RIVER *** [Tc 8s 9c 2c] [As]
Hero: checks
4939468: checks
Hero: shows [Kh Jc] (Ace-High)
4939468: shows [Qc Qs] (Pair of Queens)
*** SHOWDOWN ***
4939468 collected $0.85 from pot
*** SUMMARY ***
Total pot $0.9 | Rake $0.05 | Jackpot $0 | Bingo $0 | Fortune $0 | Tax $0
Board [Tc 8s 9c 2c As]
Seat 1: 4a106898 folded before Flop (didn't bet)
Seat 2: 410e7333 folded before Flop (didn't bet)
Seat 3: 4939468 showed [Qc Qs] and won ($0.85) with Pair of Queens
Seat 4: 13f6c9a0 (button) folded on the Flop
Seat 5: 82796794 (small blind) folded before Flop
Seat 6: Hero (big blind) showed [Kh Jc] and lost with Ace-High


Poker Hand #HD1731553331: Hold'em No Limit ($0.02/$0.05) - 2024/04/15 17:34:21
Table 'NLHBlue46' 6-max Seat #3 is the button
Seat 1: 4a106898 ($6.34 in chips)
Seat 2: 410e7333 ($2.04 in chips)
Seat 3: 4939468 ($5.22 in chips)
Seat 4: 13f6c9a0 ($3.08 in chips)
Seat 5: 82796794 ($6.74 in chips)
Seat 6: Hero ($5.3 in chips)
13f6c9a0: posts small blind $0.02
82796794: posts big blind $0.05
*** HOLE CARDS ***
Dealt to 4a106898 
Dealt to 410e7333 
Dealt to 4939468 
Dealt to 13f6c9a0 
Dealt to 82796794 
Dealt to Hero [Qc 8d]
Hero: folds
4a106898: folds
410e7333: folds
4939468: folds
13f6c9a0: raises $0.1 to $0.15
82796794: folds
Uncalled bet ($0.1) returned to 13f6c9a0
*** SHOWDOWN ***
13f6c9a0 collected $0.1 from pot
*** SUMMARY ***
Total pot $0.1 | Rake $0 | Jackpot $0 | Bingo $0 | Fortune $0 | Tax $0
Seat 1: 4a106898 folded before Flop (didn't bet)
Seat 2: 410e7333 folded before Flop (didn't bet)
Seat 3: 4939468 (button) folded before Flop (didn't bet)
Seat 4: 13f6c9a0 (small blind) collected ($0.1)
Seat 5: 82796794 (big blind) folded before Flop
Seat 6: Hero folded before Flop (didn't bet)


Poker Hand #HD1731553247: Hold'em No Limit ($0.02/$0.05) - 2024/04/15 17:33:44
Table 'NLHBlue46' 6-max Seat #2 is the button
Seat 1: 4a106898 ($6.34 in chips)
Seat 2: 410e7333 ($2.04 in chips)
Seat 3: 4939468 ($5.24 in chips)
Seat 4: 13f6c9a0 ($3.18 in chips)
Seat 5: 82796794 ($6.74 in chips)
Seat 6: Hero ($5.19 in chips)
4939468: posts small blind $0.02
13f6c9a0: posts big blind $0.05
*** HOLE CARDS ***
Dealt to 4a106898 
Dealt to 410e7333 
Dealt to 4939468 
Dealt to 13f6c9a0 
Dealt to 82796794 
Dealt to Hero [Kc Jh]
82796794: folds
Hero: raises $0.05 to $0.1
4a106898: folds
410e7333: folds
4939468: folds
13f6c9a0: calls $0.05
*** FLOP *** [5h Qc Ac]
13f6c9a0: checks
Hero: bets $0.15
13f6c9a0: folds
Uncalled bet ($0.15) returned to Hero
*** SHOWDOWN ***
Hero collected $0.21 from pot
*** SUMMARY ***
Total pot $0.22 | Rake $0.01 | Jackpot $0 | Bingo $0 | Fortune $0 | Tax $0
Board [5h Qc Ac]
Seat 1: 4a106898 folded before Flop (didn't bet)
Seat 2: 410e7333 (button) folded before Flop (didn't bet)
Seat 3: 4939468 (small blind) folded before Flop
Seat 4: 13f6c9a0 (big blind) folded on the Flop
Seat 5: 82796794 folded before Flop (didn't bet)
Seat 6: Hero won ($0.21)


Poker Hand #HD1731553176: Hold'em No Limit ($0.02/$0.05) - 2024/04/15 17:33:12
Table 'NLHBlue46' 6-max Seat #1 is the button
Seat 1: 4a106898 ($6.49 in chips)
Seat 2: 410e7333 ($1.85 in chips)
Seat 3: 4939468 ($5.29 in chips)
Seat 4: 13f6c9a0 ($3.18 in chips)
Seat 5: 82796794 ($6.74 in chips)
Seat 6: Hero ($5.19 in chips)
410e7333: posts small blind $0.02
4939468: posts big blind $0.05
*** HOLE CARDS ***
Dealt to 4a106898 
Dealt to 410e7333 
Dealt to 4939468 
Dealt to 13f6c9a0 
Dealt to 82796794 
Dealt to Hero [6c 9c]
13f6c9a0: folds
82796794: folds
Hero: folds
4a106898: raises $0.1 to $0.15
410e7333: raises $0.27 to $0.42
4939468: folds
4a106898: folds
Uncalled bet ($0.27) returned to 410e7333
*** SHOWDOWN ***
410e7333 collected $0.34 from pot
*** SUMMARY ***
Total pot $0.35 | Rake $0.01 | Jackpot $0 | Bingo $0 | Fortune $0 | Tax $0
Seat 1: 4a106898 (button) folded before Flop
Seat 2: 410e7333 (small blind) collected ($0.34)
Seat 3: 4939468 (big blind) folded before Flop
Seat 4: 13f6c9a0 folded before Flop (didn't bet)
Seat 5: 82796794 folded before Flop (didn't bet)
Seat 6: Hero folded before Flop (didn't bet)


Poker Hand #HD1731553089: Hold'em No Limit ($0.02/$0.05) - 2024/04/15 17:32:37
Table 'NLHBlue46' 6-max Seat #6 is the button
Seat 1: 4a106898 ($6.39 in chips)
Seat 2: 410e7333 ($1.9 in chips)
Seat 3: 4939468 ($5.29 in chips)
Seat 4: 13f6c9a0 ($3.23 in chips)
Seat 5: 82796794 ($6.74 in chips)
Seat 6: Hero ($5.19 in chips)
4a106898: posts small blind $0.02
410e7333: posts big blind $0.05
*** HOLE CARDS ***
Dealt to 4a106898 
Dealt to 410e7333 
Dealt to 4939468 
Dealt to 13f6c9a0 
Dealt to 82796794 
Dealt to Hero [Ac 6d]
4939468: folds
13f6c9a0: calls $0.05
82796794: folds
Hero: folds
4a106898: raises $0.12 to $0.17
410e7333: folds
13f6c9a0: folds
Uncalled bet ($0.12) returned to 4a106898
*** SHOWDOWN ***
4a106898 collected $0.15 from pot
*** SUMMARY ***
Total pot $0.15 | Rake $0 | Jackpot $0 | Bingo $0 | Fortune $0 | Tax $0
Seat 1: 4a106898 (small blind) collected ($0.15)
Seat 2: 410e7333 (big blind) folded before Flop
Seat 3: 4939468 folded before Flop (didn't bet)
Seat 4: 13f6c9a0 folded before Flop
Seat 5: 82796794 folded before Flop (didn't bet)
Seat 6: Hero (button) folded before Flop (didn't bet)


Poker Hand #HD1731553018: Hold'em No Limit ($0.02/$0.05) - 2024/04/15 17:32:10
Table 'NLHBlue46' 6-max Seat #5 is the button
Seat 1: 4a106898 ($6.51 in chips)
Seat 3: 4939468 ($5.05 in chips)
Seat 4: 13f6c9a0 ($3.35 in chips)
Seat 5: 82796794 ($6.74 in chips)
Seat 6: Hero ($5.21 in chips)
Hero: posts small blind $0.02
4a106898: posts big blind $0.05
*** HOLE CARDS ***
Dealt to 4a106898 
Dealt to 4939468 
Dealt to 13f6c9a0 
Dealt to 82796794 
Dealt to Hero [3d 8s]
4939468: raises $0.07 to $0.12
13f6c9a0: calls $0.12
82796794: folds
Hero: folds
4a106898: calls $0.07
*** FLOP *** [2d Ac Ad]
4a106898: checks
4939468: bets $0.26
13f6c9a0: folds
4a106898: folds
Uncalled bet ($0.26) returned to 4939468
*** SHOWDOWN ***
4939468 collected $0.36 from pot
*** SUMMARY ***
Total pot $0.38 | Rake $0.02 | Jackpot $0 | Bingo $0 | Fortune $0 | Tax $0
Board [2d Ac Ad]
Seat 1: 4a106898 (big blind) folded on the Flop
Seat 3: 4939468 won ($0.36)
Seat 4: 13f6c9a0 folded on the Flop
Seat 5: 82796794 (button) folded before Flop (didn't bet)
Seat 6: Hero (small blind) folded before Flop


Poker Hand #HD1731552920: Hold'em No Limit ($0.02/$0.05) - 2024/04/15 17:31:28
Table 'NLHBlue46' 6-max Seat #4 is the button
Seat 1: 4a106898 ($6.51 in chips)
Seat 3: 4939468 ($5.05 in chips)
Seat 4: 13f6c9a0 ($3.35 in chips)
Seat 5: 82796794 ($6.89 in chips)
Seat 6: Hero ($5.07 in chips)
82796794: posts small blind $0.02
Hero: posts big blind $0.05
*** HOLE CARDS ***
Dealt to 4a106898 
Dealt to 4939468 
Dealt to 13f6c9a0 
Dealt to 82796794 
Dealt to Hero [9c Ks]
4a106898: folds
4939468: folds
13f6c9a0: folds
82796794: raises $0.1 to $0.15
Hero: calls $0.1
*** FLOP *** [Jh 9s 5h]
82796794: checks
Hero: checks
*** TURN *** [Jh 9s 5h] [Ts]
82796794: checks
Hero: checks
*** RIVER *** [Jh 9s 5h Ts] [Tc]
82796794: checks
Hero: checks
82796794: shows [3d 7d] (Pair of Tens)
Hero: shows [9c Ks] (Pair of Tens and Pair of Nines)
*** SHOWDOWN ***
Hero collected $0.29 from pot
*** SUMMARY ***
Total pot $0.3 | Rake $0.01 | Jackpot $0 | Bingo $0 | Fortune $0 | Tax $0
Board [Jh 9s 5h Ts Tc]
Seat 1: 4a106898 folded before Flop (didn't bet)
Seat 3: 4939468 folded before Flop (didn't bet)
Seat 4: 13f6c9a0 (button) folded before Flop (didn't bet)
Seat 5: 82796794 (small blind) showed [3d 7d] and lost with Pair of Tens
Seat 6: Hero (big blind) showed [9c Ks] and won ($0.29) with Pair of Tens and Pair of Nines


Poker Hand #HD1731552893: Hold'em No Limit ($0.02/$0.05) - 2024/04/15 17:31:19
Table 'NLHBlue46' 6-max Seat #3 is the button
Seat 1: 4a106898 ($6.51 in chips)
Seat 3: 4939468 ($5.05 in chips)
Seat 4: 13f6c9a0 ($3.37 in chips)
Seat 5: 82796794 ($6.87 in chips)
Seat 6: Hero ($5.07 in chips)
13f6c9a0: posts small blind $0.02
82796794: posts big blind $0.05
*** HOLE CARDS ***
Dealt to 4a106898 
Dealt to 4939468 
Dealt to 13f6c9a0 
Dealt to 82796794 
Dealt to Hero [5d Ts]
Hero: folds
4a106898: folds
4939468: folds
13f6c9a0: folds
Uncalled bet ($0.03) returned to 82796794
*** SHOWDOWN ***
82796794 collected $0.04 from pot
*** SUMMARY ***
Total pot $0.04 | Rake $0 | Jackpot $0 | Bingo $0 | Fortune $0 | Tax $0
Seat 1: 4a106898 folded before Flop (didn't bet)
Seat 3: 4939468 (button) folded before Flop (didn't bet)
Seat 4: 13f6c9a0 (small blind) folded before Flop
Seat 5: 82796794 (big blind) collected ($0.04)
Seat 6: Hero folded before Flop (didn't bet)


Poker Hand #HD1731552846: Hold'em No Limit ($0.02/$0.05) - 2024/04/15 17:30:56
Table 'NLHBlue46' 6-max Seat #1 is the button
Seat 1: 4a106898 ($6.51 in chips)
Seat 3: 4939468 ($5.07 in chips)
Seat 4: 13f6c9a0 ($3.42 in chips)
Seat 5: 82796794 ($6.87 in chips)
Seat 6: Hero ($5 in chips)
4939468: posts small blind $0.02
13f6c9a0: posts big blind $0.05
*** HOLE CARDS ***
Dealt to 4a106898 
Dealt to 4939468 
Dealt to 13f6c9a0 
Dealt to 82796794 
Dealt to Hero [Ts Qh]
82796794: folds
Hero: raises $0.07 to $0.12
4a106898: folds
4939468: folds
13f6c9a0: folds
Uncalled bet ($0.07) returned to Hero
*** SHOWDOWN ***
Hero collected $0.12 from pot
*** SUMMARY ***
Total pot $0.12 | Rake $0 | Jackpot $0 | Bingo $0 | Fortune $0 | Tax $0
Seat 1: 4a106898 (button) folded before Flop (didn't bet)
Seat 3: 4939468 (small blind) folded before Flop
Seat 4: 13f6c9a0 (big blind) folded before Flop
Seat 5: 82796794 folded before Flop (didn't bet)
Seat 6: Hero collected ($0.12)


Poker Hand #HD1731552783: Hold'em No Limit ($0.02/$0.05) - 2024/04/15 17:30:32
Table 'NLHBlue46' 6-max Seat #6 is the button
Seat 1: 4a106898 ($6.53 in chips)
Seat 3: 4939468 ($5 in chips)
Seat 4: 13f6c9a0 ($3.47 in chips)
Seat 5: 82796794 ($6.87 in chips)
Seat 6: Hero ($5 in chips)
4a106898: posts small blind $0.02
4939468: posts big blind $0.05
*** HOLE CARDS ***
Dealt to 4a106898 
Dealt to 4939468 
Dealt to 13f6c9a0 
Dealt to 82796794 
Dealt to Hero [9d 6c]
13f6c9a0: calls $0.05
82796794: folds
Hero: folds
4a106898: folds
4939468: raises $0.12 to $0.17
13f6c9a0: folds
Uncalled bet ($0.12) returned to 4939468
*** SHOWDOWN ***
4939468 collected $0.12 from pot
*** SUMMARY ***
Total pot $0.12 | Rake $0 | Jackpot $0 | Bingo $0 | Fortune $0 | Tax $0
Seat 1: 4a106898 (small blind) folded before Flop
Seat 3: 4939468 (big blind) collected ($0.12)
Seat 4: 13f6c9a0 folded before Flop
Seat 5: 82796794 folded before Flop (didn't bet)
Seat 6: Hero (button) folded before Flop (didn't bet)


Poker Hand #HD1731552733: Hold'em No Limit ($0.02/$0.05) - 2024/04/15 17:30:11
Table 'NLHBlue46' 6-max Seat #5 is the button
Seat 1: 4a106898 ($6.58 in chips)
Seat 3: 4939468 ($5 in chips)
Seat 4: 13f6c9a0 ($3.4 in chips)
Seat 5: 82796794 ($6.87 in chips)
Seat 6: Hero ($5 in chips)
Hero: posts small blind $0.02
4a106898: posts big blind $0.05
*** HOLE CARDS ***
Dealt to 4a106898 
Dealt to 4939468 
Dealt to 13f6c9a0 
Dealt to 82796794 
Dealt to Hero [2h Tc]
4939468: folds
13f6c9a0: calls $0.05
82796794: folds
Hero: folds
4a106898: checks
*** FLOP *** [Th 5c 7s]
4a106898: checks
13f6c9a0: checks
*** TURN *** [Th 5c 7s] [Qh]
4a106898: checks
13f6c9a0: bets $0.09
4a106898: folds
Uncalled bet ($0.09) returned to 13f6c9a0
*** SHOWDOWN ***
13f6c9a0 collected $0.12 from pot
*** SUMMARY ***
Total pot $0.12 | Rake $0 | Jackpot $0 | Bingo $0 | Fortune $0 | Tax $0
Board [Th 5c 7s Qh]
Seat 1: 4a106898 (big blind) folded on the Turn
Seat 3: 4939468 folded before Flop (didn't bet)
Seat 4: 13f6c9a0 won ($0.12)
Seat 5: 82796794 (button) folded before Flop (didn't bet)
Seat 6: Hero (small blind) folded before Flop


Poker Hand #HD1731552673: Hold'em No Limit ($0.02/$0.05) - 2024/04/15 17:29:41
Table 'NLHBlue46' 6-max Seat #4 is the button
Seat 1: 4a106898 ($6.58 in chips)
Seat 3: 4939468 ($5 in chips)
Seat 4: 13f6c9a0 ($3.24 in chips)
Seat 5: 82796794 ($6.89 in chips)
Seat 6: Hero ($5.07 in chips)
82796794: posts small blind $0.02
Hero: posts big blind $0.05
*** HOLE CARDS ***
Dealt to 4a106898 
Dealt to 4939468 
Dealt to 13f6c9a0 
Dealt to 82796794 
Dealt to Hero [4h 4c]
4a106898: folds
4939468: folds
13f6c9a0: raises $0.1 to $0.15
82796794: folds
Hero: calls $0.1
*** FLOP *** [Js 9s 8d]
Hero: checks
13f6c9a0: bets $0.32
Hero: folds
Uncalled bet ($0.32) returned to 13f6c9a0
*** SHOWDOWN ***
13f6c9a0 collected $0.31 from pot
*** SUMMARY ***
Total pot $0.32 | Rake $0.01 | Jackpot $0 | Bingo $0 | Fortune $0 | Tax $0
Board [Js 9s 8d]
Seat 1: 4a106898 folded before Flop (didn't bet)
Seat 3: 4939468 folded before Flop (didn't bet)
Seat 4: 13f6c9a0 (button) won ($0.31)
Seat 5: 82796794 (small blind) folded before Flop
Seat 6: Hero (big blind) folded on the Flop


Poker Hand #HD1731552512: Hold'em No Limit ($0.02/$0.05) - 2024/04/15 17:28:38
Table 'NLHBlue46' 6-max Seat #3 is the button
Seat 1: 4a106898 ($6.3 in chips)
Seat 3: 4939468 ($5 in chips)
Seat 4: 13f6c9a0 ($3.39 in chips)
Seat 5: 82796794 ($7.04 in chips)
Seat 6: Hero ($5.07 in chips)
13f6c9a0: posts small blind $0.02
82796794: posts big blind $0.05
*** HOLE CARDS ***
Dealt to 4a106898 
Dealt to 4939468 
Dealt to 13f6c9a0 
Dealt to 82796794 
Dealt to Hero [3h Ad]
Hero: folds
4a106898: raises $0.1 to $0.15
4939468: folds
13f6c9a0: calls $0.13
82796794: calls $0.1
*** FLOP *** [Kc 7h 8s]
13f6c9a0: checks
82796794: checks
4a106898: bets $0.28
13f6c9a0: folds
82796794: folds
Uncalled bet ($0.28) returned to 4a106898
*** SHOWDOWN ***
4a106898 collected $0.43 from pot
*** SUMMARY ***
Total pot $0.45 | Rake $0.02 | Jackpot $0 | Bingo $0 | Fortune $0 | Tax $0
Board [Kc 7h 8s]
Seat 1: 4a106898 won ($0.43)
Seat 3: 4939468 (button) folded before Flop (didn't bet)
Seat 4: 13f6c9a0 (small blind) folded on the Flop
Seat 5: 82796794 (big blind) folded on the Flop
Seat 6: Hero folded before Flop (didn't bet)


Poker Hand #HD1731552432: Hold'em No Limit ($0.02/$0.05) - 2024/04/15 17:28:01
Table 'NLHBlue46' 6-max Seat #1 is the button
Seat 1: 4a106898 ($6.3 in chips)
Seat 3: 4939468 ($5 in chips)
Seat 4: 13f6c9a0 ($3.25 in chips)
Seat 5: 82796794 ($7.17 in chips)
Seat 6: Hero ($5.07 in chips)
4939468: posts small blind $0.02
13f6c9a0: posts big blind $0.05
*** HOLE CARDS ***
Dealt to 4a106898 
Dealt to 4939468 
Dealt to 13f6c9a0 
Dealt to 82796794 
Dealt to Hero [9c Td]
82796794: raises $0.08 to $0.13
Hero: folds
4a106898: folds
4939468: folds
13f6c9a0: calls $0.08
*** FLOP *** [Tc 9s Th]
13f6c9a0: bets $0.14
82796794: folds
Uncalled bet ($0.14) returned to 13f6c9a0
*** SHOWDOWN ***
13f6c9a0 collected $0.27 from pot
*** SUMMARY ***
Total pot $0.28 | Rake $0.01 | Jackpot $0 | Bingo $0 | Fortune $0 | Tax $0
Board [Tc 9s Th]
Seat 1: 4a106898 (button) folded before Flop (didn't bet)
Seat 3: 4939468 (small blind) folded before Flop
Seat 4: 13f6c9a0 (big blind) won ($0.27)
Seat 5: 82796794 folded on the Flop
Seat 6: Hero folded before Flop (didn't bet)


Poker Hand #HD1731552382: Hold'em No Limit ($0.02/$0.05) - 2024/04/15 17:27:37
Table 'NLHBlue46' 6-max Seat #6 is the button
Seat 1: 4a106898 ($6.32 in chips)
Seat 3: 4939468 ($5 in chips)
Seat 5: 82796794 ($7.17 in chips)
Seat 6: Hero ($5 in chips)
4a106898: posts small blind $0.02
4939468: posts big blind $0.05
*** HOLE CARDS ***
Dealt to 4a106898 
Dealt to 4939468 
Dealt to 82796794 
Dealt to Hero [9c Jh]
82796794: folds
Hero: raises $0.07 to $0.12
4a106898: folds
4939468: folds
Uncalled bet ($0.07) returned to Hero
*** SHOWDOWN ***
Hero collected $0.12 from pot
*** SUMMARY ***
Total pot $0.12 | Rake $0 | Jackpot $0 | Bingo $0 | Fortune $0 | Tax $0
Seat 1: 4a106898 (small blind) folded before Flop
Seat 3: 4939468 (big blind) folded before Flop
Seat 5: 82796794 folded before Flop (didn't bet)
Seat 6: Hero (button) collected ($0.12)


Poker Hand #HD1731552365: Hold'em No Limit ($0.02/$0.05) - 2024/04/15 17:27:27
Table 'NLHBlue46' 6-max Seat #5 is the button
Seat 1: 4a106898 ($6.37 in chips)
Seat 3: 4939468 ($5 in chips)
Seat 5: 82796794 ($7.1 in chips)
Seat 6: Hero ($5 in chips)
Hero: posts small blind $0.02
4a106898: posts big blind $0.05
*** HOLE CARDS ***
Dealt to 4a106898 
Dealt to 4939468 
Dealt to 82796794 
Dealt to Hero [4s Qs]
4939468: folds
82796794: raises $0.08 to $0.13
Hero: folds
4a106898: folds
Uncalled bet ($0.08) returned to 82796794
*** SHOWDOWN ***
82796794 collected $0.12 from pot
*** SUMMARY ***
Total pot $0.12 | Rake $0 | Jackpot $0 | Bingo $0 | Fortune $0 | Tax $0
Seat 1: 4a106898 (big blind) folded before Flop
Seat 3: 4939468 folded before Flop (didn't bet)
Seat 5: 82796794 (button) collected ($0.12)
Seat 6: Hero (small blind) folded before Flop


Poker Hand #HD1731552328: Hold'em No Limit ($0.02/$0.05) - 2024/04/15 17:27:13
Table 'NLHBlue46' 6-max Seat #3 is the button
Seat 1: 4a106898 ($6.3 in chips)
Seat 3: 4939468 ($5 in chips)
Seat 5: 82796794 ($7.12 in chips)
Seat 6: Hero ($5 in chips)
82796794: posts small blind $0.02
Hero: posts big blind $0.05
*** HOLE CARDS ***
Dealt to 4a106898 
Dealt to 4939468 
Dealt to 82796794 
Dealt to Hero [7h 8c]
4a106898: raises $0.1 to $0.15
4939468: folds
82796794: folds
Hero: folds
Uncalled bet ($0.1) returned to 4a106898
*** SHOWDOWN ***
4a106898 collected $0.12 from pot
*** SUMMARY ***
Total pot $0.12 | Rake $0 | Jackpot $0 | Bingo $0 | Fortune $0 | Tax $0
Seat 1: 4a106898 collected ($0.12)
Seat 3: 4939468 (button) folded before Flop (didn't bet)
Seat 5: 82796794 (small blind) folded before Flop
Seat 6: Hero (big blind) folded before Flop


