Poker Hand #HD1788722559: Hold'em No Limit ($0.05/$0.1) - 2024/05/26 18:53:34
Table 'NLHRed17' 6-max Seat #1 is the button
Seat 1: f7e8c84f ($10 in chips)
Seat 2: c4b075b5 ($9.44 in chips)
Seat 3: 2e33682b ($11.79 in chips)
Seat 4: 5ff083b4 ($13.91 in chips)
Seat 5: 8c1ff383 ($5.31 in chips)
Seat 6: Hero ($24.52 in chips)
c4b075b5: posts small blind $0.05
2e33682b: posts big blind $0.1
*** HOLE CARDS ***
Dealt to f7e8c84f 
Dealt to c4b075b5 
Dealt to 2e33682b 
Dealt to 5ff083b4 
Dealt to 8c1ff383 
Dealt to Hero [Qc 6d]
5ff083b4: folds
8c1ff383: raises $0.1 to $0.2
Hero: folds
f7e8c84f: folds
c4b075b5: folds
2e33682b: folds
Uncalled bet ($0.1) returned to 8c1ff383
*** SHOWDOWN ***
8c1ff383 collected $0.25 from pot
*** SUMMARY ***
Total pot $0.25 | Rake $0 | Jackpot $0 | Bingo $0 | Fortune $0 | Tax $0
Seat 1: f7e8c84f (button) folded before Flop (didn't bet)
Seat 2: c4b075b5 (small blind) folded before Flop
Seat 3: 2e33682b (big blind) folded before Flop
Seat 4: 5ff083b4 folded before Flop (didn't bet)
Seat 5: 8c1ff383 collected ($0.25)
Seat 6: Hero folded before Flop (didn't bet)


Poker Hand #HD1788722535: Hold'em No Limit ($0.05/$0.1) - 2024/05/26 18:53:24
Table 'NLHRed17' 6-max Seat #6 is the button
Seat 1: f7e8c84f ($10 in chips)
Seat 2: c4b075b5 ($9.54 in chips)
Seat 3: 2e33682b ($11.79 in chips)
Seat 4: 5ff083b4 ($13.91 in chips)
Seat 5: 8c1ff383 ($5.16 in chips)
Seat 6: Hero ($24.52 in chips)
f7e8c84f: posts small blind $0.05
c4b075b5: posts big blind $0.1
*** HOLE CARDS ***
Dealt to f7e8c84f 
Dealt to c4b075b5 
Dealt to 2e33682b 
Dealt to 5ff083b4 
Dealt to 8c1ff383 
Dealt to Hero [8c 2c]
2e33682b: folds
5ff083b4: folds
8c1ff383: raises $0.1 to $0.2
Hero: folds
f7e8c84f: folds
c4b075b5: folds
Uncalled bet ($0.1) returned to 8c1ff383
*** SHOWDOWN ***
8c1ff383 collected $0.25 from pot
*** SUMMARY ***
Total pot $0.25 | Rake $0 | Jackpot $0 | Bingo $0 | Fortune $0 | Tax $0
Seat 1: f7e8c84f (small blind) folded before Flop
Seat 2: c4b075b5 (big blind) folded before Flop
Seat 3: 2e33682b folded before Flop (didn't bet)
Seat 4: 5ff083b4 folded before Flop (didn't bet)
Seat 5: 8c1ff383 collected ($0.25)
Seat 6: Hero (button) folded before Flop (didn't bet)


Poker Hand #HD1788722509: Hold'em No Limit ($0.05/$0.1) - 2024/05/26 18:53:07
Table 'NLHRed17' 6-max Seat #5 is the button
Seat 1: f7e8c84f ($10 in chips)
Seat 2: c4b075b5 ($9.54 in chips)
Seat 3: 2e33682b ($11.79 in chips)
Seat 4: 5ff083b4 ($13.91 in chips)
Seat 5: 8c1ff383 ($5.01 in chips)
Seat 6: Hero ($24.57 in chips)
Hero: posts small blind $0.05
f7e8c84f: posts big blind $0.1
*** HOLE CARDS ***
Dealt to f7e8c84f 
Dealt to c4b075b5 
Dealt to 2e33682b 
Dealt to 5ff083b4 
Dealt to 8c1ff383 
Dealt to Hero [Td Qh]
c4b075b5: folds
2e33682b: folds
5ff083b4: folds
8c1ff383: raises $0.1 to $0.2
Hero: folds
f7e8c84f: folds
Uncalled bet ($0.1) returned to 8c1ff383
*** SHOWDOWN ***
8c1ff383 collected $0.25 from pot
*** SUMMARY ***
Total pot $0.25 | Rake $0 | Jackpot $0 | Bingo $0 | Fortune $0 | Tax $0
Seat 1: f7e8c84f (big blind) folded before Flop
Seat 2: c4b075b5 folded before Flop (didn't bet)
Seat 3: 2e33682b folded before Flop (didn't bet)
Seat 4: 5ff083b4 folded before Flop (didn't bet)
Seat 5: 8c1ff383 (button) collected ($0.25)
Seat 6: Hero (small blind) folded before Flop


Poker Hand #HD1788722451: Hold'em No Limit ($0.05/$0.1) - 2024/05/26 18:52:37
Table 'NLHRed17' 6-max Seat #4 is the button
Seat 2: c4b075b5 ($9.25 in chips)
Seat 3: 2e33682b ($11.79 in chips)
Seat 4: 5ff083b4 ($13.91 in chips)
Seat 5: 8c1ff383 ($5.22 in chips)
Seat 6: Hero ($24.67 in chips)
8c1ff383: posts small blind $0.05
Hero: posts big blind $0.1
*** HOLE CARDS ***
Dealt to c4b075b5 
Dealt to 2e33682b 
Dealt to 5ff083b4 
Dealt to 8c1ff383 
Dealt to Hero [4h Tc]
c4b075b5: raises $0.11 to $0.21
2e33682b: folds
5ff083b4: folds
8c1ff383: calls $0.16
Hero: folds
*** FLOP *** [Qc 9h Qs]
8c1ff383: checks
c4b075b5: checks
*** TURN *** [Qc 9h Qs] [5c]
8c1ff383: checks
c4b075b5: bets $0.39
8c1ff383: folds
Uncalled bet ($0.39) returned to c4b075b5
*** SHOWDOWN ***
c4b075b5 collected $0.5 from pot
*** SUMMARY ***
Total pot $0.52 | Rake $0.02 | Jackpot $0 | Bingo $0 | Fortune $0 | Tax $0
Board [Qc 9h Qs 5c]
Seat 2: c4b075b5 won ($0.5)
Seat 3: 2e33682b folded before Flop (didn't bet)
Seat 4: 5ff083b4 (button) folded before Flop (didn't bet)
Seat 5: 8c1ff383 (small blind) folded on the Turn
Seat 6: Hero (big blind) folded before Flop


Poker Hand #HD1788722413: Hold'em No Limit ($0.05/$0.1) - 2024/05/26 18:52:19
Table 'NLHRed17' 6-max Seat #3 is the button
Seat 2: c4b075b5 ($9.46 in chips)
Seat 3: 2e33682b ($11.79 in chips)
Seat 4: 5ff083b4 ($13.62 in chips)
Seat 5: 8c1ff383 ($5.32 in chips)
Seat 6: Hero ($24.67 in chips)
5ff083b4: posts small blind $0.05
8c1ff383: posts big blind $0.1
*** HOLE CARDS ***
Dealt to c4b075b5 
Dealt to 2e33682b 
Dealt to 5ff083b4 
Dealt to 8c1ff383 
Dealt to Hero [8d 6s]
Hero: folds
c4b075b5: raises $0.11 to $0.21
2e33682b: folds
5ff083b4: raises $0.79 to $1
8c1ff383: folds
c4b075b5: folds
Uncalled bet ($0.79) returned to 5ff083b4
*** SHOWDOWN ***
5ff083b4 collected $0.5 from pot
*** SUMMARY ***
Total pot $0.52 | Rake $0.02 | Jackpot $0 | Bingo $0 | Fortune $0 | Tax $0
Seat 2: c4b075b5 folded before Flop
Seat 3: 2e33682b (button) folded before Flop (didn't bet)
Seat 4: 5ff083b4 (small blind) collected ($0.5)
Seat 5: 8c1ff383 (big blind) folded before Flop
Seat 6: Hero folded before Flop (didn't bet)


Poker Hand #HD1788722277: Hold'em No Limit ($0.05/$0.1) - 2024/05/26 18:51:19
Table 'NLHRed17' 6-max Seat #2 is the button
Seat 2: c4b075b5 ($9.46 in chips)
Seat 3: 2e33682b ($11.22 in chips)
Seat 4: 5ff083b4 ($14.25 in chips)
Seat 5: 8c1ff383 ($5.32 in chips)
Seat 6: Hero ($24.67 in chips)
2e33682b: posts small blind $0.05
5ff083b4: posts big blind $0.1
*** HOLE CARDS ***
Dealt to c4b075b5 
Dealt to 2e33682b 
Dealt to 5ff083b4 
Dealt to 8c1ff383 
Dealt to Hero [Kd 6h]
8c1ff383: folds
Hero: folds
c4b075b5: folds
2e33682b: raises $0.15 to $0.25
5ff083b4: calls $0.15
*** FLOP *** [7c Qs 4c]
2e33682b: checks
5ff083b4: checks
*** TURN *** [7c Qs 4c] [Qh]
2e33682b: checks
5ff083b4: bets $0.38
2e33682b: calls $0.38
*** RIVER *** [7c Qs 4c Qh] [Ad]
2e33682b: checks
5ff083b4: checks
2e33682b: shows [8c 8d] (Pair of Queens and Pair of Eights)
5ff083b4: shows [Kh 7s] (Pair of Queens and Pair of Sevens)
*** SHOWDOWN ***
2e33682b collected $1.2 from pot
*** SUMMARY ***
Total pot $1.26 | Rake $0.06 | Jackpot $0 | Bingo $0 | Fortune $0 | Tax $0
Board [7c Qs 4c Qh Ad]
Seat 2: c4b075b5 (button) folded before Flop (didn't bet)
Seat 3: 2e33682b (small blind) showed [8c 8d] and won ($1.2) with Pair of Queens and Pair of Eights
Seat 4: 5ff083b4 (big blind) showed [Kh 7s] and lost with Pair of Queens and Pair of Sevens
Seat 5: 8c1ff383 folded before Flop (didn't bet)
Seat 6: Hero folded before Flop (didn't bet)


Poker Hand #HD1788722118: Hold'em No Limit ($0.05/$0.1) - 2024/05/26 18:50:04
Table 'NLHRed17' 6-max Seat #1 is the button
Seat 1: 7dc16105 ($13.22 in chips)
Seat 2: c4b075b5 ($9.51 in chips)
Seat 3: 2e33682b ($10.79 in chips)
Seat 4: 5ff083b4 ($14.67 in chips)
Seat 5: 8c1ff383 ($5.32 in chips)
Seat 6: Hero ($24.67 in chips)
c4b075b5: posts small blind $0.05
2e33682b: posts big blind $0.1
*** HOLE CARDS ***
Dealt to 7dc16105 
Dealt to c4b075b5 
Dealt to 2e33682b 
Dealt to 5ff083b4 
Dealt to 8c1ff383 
Dealt to Hero [2h 7d]
5ff083b4: raises $0.12 to $0.22
8c1ff383: folds
Hero: folds
7dc16105: folds
c4b075b5: folds
2e33682b: calls $0.12
*** FLOP *** [Tc 5s 5d]
2e33682b: checks
5ff083b4: bets $0.2
2e33682b: calls $0.2
*** TURN *** [Tc 5s 5d] [Ad]
2e33682b: checks
5ff083b4: checks
*** RIVER *** [Tc 5s 5d Ad] [4s]
2e33682b: checks
5ff083b4: checks
2e33682b: shows [Kc Qc] (Pair of Fives)
5ff083b4: shows [Jd 9d] (Pair of Fives)
*** SHOWDOWN ***
2e33682b collected $0.85 from pot
*** SUMMARY ***
Total pot $0.89 | Rake $0.04 | Jackpot $0 | Bingo $0 | Fortune $0 | Tax $0
Board [Tc 5s 5d Ad 4s]
Seat 1: 7dc16105 (button) folded before Flop (didn't bet)
Seat 2: c4b075b5 (small blind) folded before Flop
Seat 3: 2e33682b (big blind) showed [Kc Qc] and won ($0.85) with Pair of Fives
Seat 4: 5ff083b4 showed [Jd 9d] and lost with Pair of Fives
Seat 5: 8c1ff383 folded before Flop (didn't bet)
Seat 6: Hero folded before Flop (didn't bet)


Poker Hand #HD1788722036: Hold'em No Limit ($0.05/$0.1) - 2024/05/26 18:49:23
Table 'NLHRed17' 6-max Seat #6 is the button
Seat 1: 7dc16105 ($13.27 in chips)
Seat 2: c4b075b5 ($9.61 in chips)
Seat 3: 2e33682b ($10.79 in chips)
Seat 4: 5ff083b4 ($14.67 in chips)
Seat 5: 8c1ff383 ($6.02 in chips)
Seat 6: Hero ($23.89 in chips)
7dc16105: posts small blind $0.05
c4b075b5: posts big blind $0.1
*** HOLE CARDS ***
Dealt to 7dc16105 
Dealt to c4b075b5 
Dealt to 2e33682b 
Dealt to 5ff083b4 
Dealt to 8c1ff383 
Dealt to Hero [Th Ah]
2e33682b: folds
5ff083b4: folds
8c1ff383: raises $0.1 to $0.2
Hero: raises $0.5 to $0.7
7dc16105: folds
c4b075b5: folds
8c1ff383: calls $0.5
*** FLOP *** [Ks Ad 6c]
8c1ff383: checks
Hero: bets $0.5
8c1ff383: folds
Uncalled bet ($0.5) returned to Hero
*** SHOWDOWN ***
Hero collected $1.48 from pot
*** SUMMARY ***
Total pot $1.55 | Rake $0.07 | Jackpot $0 | Bingo $0 | Fortune $0 | Tax $0
Board [Ks Ad 6c]
Seat 1: 7dc16105 (small blind) folded before Flop
Seat 2: c4b075b5 (big blind) folded before Flop
Seat 3: 2e33682b folded before Flop (didn't bet)
Seat 4: 5ff083b4 folded before Flop (didn't bet)
Seat 5: 8c1ff383 folded on the Flop
Seat 6: Hero (button) won ($1.48)


Poker Hand #HD1788721933: Hold'em No Limit ($0.05/$0.1) - 2024/05/26 18:48:37
Table 'NLHRed17' 6-max Seat #5 is the button
Seat 1: 7dc16105 ($13.52 in chips)
Seat 2: c4b075b5 ($9.61 in chips)
Seat 3: 2e33682b ($10.79 in chips)
Seat 4: 5ff083b4 ($15.82 in chips)
Seat 5: 8c1ff383 ($4.7 in chips)
Seat 6: Hero ($23.94 in chips)
Hero: posts small blind $0.05
7dc16105: posts big blind $0.1
*** HOLE CARDS ***
Dealt to 7dc16105 
Dealt to c4b075b5 
Dealt to 2e33682b 
Dealt to 5ff083b4 
Dealt to 8c1ff383 
Dealt to Hero [3c Ks]
c4b075b5: folds
2e33682b: folds
5ff083b4: raises $0.15 to $0.25
8c1ff383: calls $0.25
Hero: folds
7dc16105: calls $0.15
*** FLOP *** [7c 3s 2d]
7dc16105: checks
5ff083b4: checks
8c1ff383: checks
*** TURN *** [7c 3s 2d] [8c]
7dc16105: checks
5ff083b4: checks
8c1ff383: checks
*** RIVER *** [7c 3s 2d 8c] [4c]
7dc16105: checks
5ff083b4: bets $0.9
8c1ff383: calls $0.9
7dc16105: folds
5ff083b4: shows [7h 7d] (Three Sevens)
8c1ff383: shows [Ac 5d] (Fives-High Straight)
*** SHOWDOWN ***
8c1ff383 collected $2.47 from pot
*** SUMMARY ***
Total pot $2.6 | Rake $0.13 | Jackpot $0 | Bingo $0 | Fortune $0 | Tax $0
Board [7c 3s 2d 8c 4c]
Seat 1: 7dc16105 (big blind) folded on the River
Seat 2: c4b075b5 folded before Flop (didn't bet)
Seat 3: 2e33682b folded before Flop (didn't bet)
Seat 4: 5ff083b4 showed [7h 7d] and lost with Three Sevens
Seat 5: 8c1ff383 (button) showed [Ac 5d] and won ($2.47) with Fives-High Straight
Seat 6: Hero (small blind) folded before Flop


Poker Hand #HD1788721900: Hold'em No Limit ($0.05/$0.1) - 2024/05/26 18:48:19
Table 'NLHRed17' 6-max Seat #4 is the button
Seat 1: 7dc16105 ($13.37 in chips)
Seat 2: c4b075b5 ($9.61 in chips)
Seat 3: 2e33682b ($10.79 in chips)
Seat 4: 5ff083b4 ($15.82 in chips)
Seat 5: 8c1ff383 ($4.75 in chips)
Seat 6: Hero ($24.04 in chips)
8c1ff383: posts small blind $0.05
Hero: posts big blind $0.1
*** HOLE CARDS ***
Dealt to 7dc16105 
Dealt to c4b075b5 
Dealt to 2e33682b 
Dealt to 5ff083b4 
Dealt to 8c1ff383 
Dealt to Hero [6h 8h]
7dc16105: raises $0.12 to $0.22
c4b075b5: folds
2e33682b: folds
5ff083b4: folds
8c1ff383: folds
Hero: folds
Uncalled bet ($0.12) returned to 7dc16105
*** SHOWDOWN ***
7dc16105 collected $0.25 from pot
*** SUMMARY ***
Total pot $0.25 | Rake $0 | Jackpot $0 | Bingo $0 | Fortune $0 | Tax $0
Seat 1: 7dc16105 collected ($0.25)
Seat 2: c4b075b5 folded before Flop (didn't bet)
Seat 3: 2e33682b folded before Flop (didn't bet)
Seat 4: 5ff083b4 (button) folded before Flop (didn't bet)
Seat 5: 8c1ff383 (small blind) folded before Flop
Seat 6: Hero (big blind) folded before Flop


Poker Hand #HD1788721839: Hold'em No Limit ($0.05/$0.1) - 2024/05/26 18:47:48
Table 'NLHRed17' 6-max Seat #3 is the button
Seat 1: 7dc16105 ($13.37 in chips)
Seat 2: c4b075b5 ($9.82 in chips)
Seat 3: 2e33682b ($10.79 in chips)
Seat 4: 5ff083b4 ($15.87 in chips)
Seat 5: 8c1ff383 ($4.51 in chips)
Seat 6: Hero ($24.04 in chips)
5ff083b4: posts small blind $0.05
8c1ff383: posts big blind $0.1
*** HOLE CARDS ***
Dealt to 7dc16105 
Dealt to c4b075b5 
Dealt to 2e33682b 
Dealt to 5ff083b4 
Dealt to 8c1ff383 
Dealt to Hero [2s 4s]
Hero: folds
7dc16105: folds
c4b075b5: raises $0.11 to $0.21
2e33682b: folds
5ff083b4: folds
8c1ff383: calls $0.11
*** FLOP *** [Ks 2c Qc]
8c1ff383: bets $0.47
c4b075b5: folds
Uncalled bet ($0.47) returned to 8c1ff383
*** SHOWDOWN ***
8c1ff383 collected $0.45 from pot
*** SUMMARY ***
Total pot $0.47 | Rake $0.02 | Jackpot $0 | Bingo $0 | Fortune $0 | Tax $0
Board [Ks 2c Qc]
Seat 1: 7dc16105 folded before Flop (didn't bet)
Seat 2: c4b075b5 folded on the Flop
Seat 3: 2e33682b (button) folded before Flop (didn't bet)
Seat 4: 5ff083b4 (small blind) folded before Flop
Seat 5: 8c1ff383 (big blind) won ($0.45)
Seat 6: Hero folded before Flop (didn't bet)


Poker Hand #HD1788721812: Hold'em No Limit ($0.05/$0.1) - 2024/05/26 18:47:36
Table 'NLHRed17' 6-max Seat #2 is the button
Seat 1: 7dc16105 ($13.22 in chips)
Seat 2: c4b075b5 ($9.82 in chips)
Seat 3: 2e33682b ($10.84 in chips)
Seat 4: 5ff083b4 ($15.97 in chips)
Seat 5: 8c1ff383 ($4.51 in chips)
Seat 6: Hero ($24.04 in chips)
2e33682b: posts small blind $0.05
5ff083b4: posts big blind $0.1
*** HOLE CARDS ***
Dealt to 7dc16105 
Dealt to c4b075b5 
Dealt to 2e33682b 
Dealt to 5ff083b4 
Dealt to 8c1ff383 
Dealt to Hero [Ts 5d]
8c1ff383: folds
Hero: folds
7dc16105: raises $0.12 to $0.22
c4b075b5: folds
2e33682b: folds
5ff083b4: folds
Uncalled bet ($0.12) returned to 7dc16105
*** SHOWDOWN ***
7dc16105 collected $0.25 from pot
*** SUMMARY ***
Total pot $0.25 | Rake $0 | Jackpot $0 | Bingo $0 | Fortune $0 | Tax $0
Seat 1: 7dc16105 collected ($0.25)
Seat 2: c4b075b5 (button) folded before Flop (didn't bet)
Seat 3: 2e33682b (small blind) folded before Flop
Seat 4: 5ff083b4 (big blind) folded before Flop
Seat 5: 8c1ff383 folded before Flop (didn't bet)
Seat 6: Hero folded before Flop (didn't bet)


Poker Hand #HD1788721759: Hold'em No Limit ($0.05/$0.1) - 2024/05/26 18:47:16
Table 'NLHRed17' 6-max Seat #1 is the button
Seat 1: 7dc16105 ($13.22 in chips)
Seat 2: c4b075b5 ($9.87 in chips)
Seat 3: 2e33682b ($10.94 in chips)
Seat 4: 5ff083b4 ($15.97 in chips)
Seat 5: 8c1ff383 ($4.36 in chips)
Seat 6: Hero ($24.04 in chips)
c4b075b5: posts small blind $0.05
2e33682b: posts big blind $0.1
*** HOLE CARDS ***
Dealt to 7dc16105 
Dealt to c4b075b5 
Dealt to 2e33682b 
Dealt to 5ff083b4 
Dealt to 8c1ff383 
Dealt to Hero [2h Jh]
5ff083b4: folds
8c1ff383: raises $0.3 to $0.4
Hero: folds
7dc16105: folds
c4b075b5: folds
2e33682b: folds
Uncalled bet ($0.3) returned to 8c1ff383
*** SHOWDOWN ***
8c1ff383 collected $0.25 from pot
*** SUMMARY ***
Total pot $0.25 | Rake $0 | Jackpot $0 | Bingo $0 | Fortune $0 | Tax $0
Seat 1: 7dc16105 (button) folded before Flop (didn't bet)
Seat 2: c4b075b5 (small blind) folded before Flop
Seat 3: 2e33682b (big blind) folded before Flop
Seat 4: 5ff083b4 folded before Flop (didn't bet)
Seat 5: 8c1ff383 collected ($0.25)
Seat 6: Hero folded before Flop (didn't bet)


Poker Hand #HD1788721728: Hold'em No Limit ($0.05/$0.1) - 2024/05/26 18:47:02
Table 'NLHRed17' 6-max Seat #6 is the button
Seat 1: 7dc16105 ($13.27 in chips)
Seat 2: c4b075b5 ($9.97 in chips)
Seat 3: 2e33682b ($10.94 in chips)
Seat 4: 5ff083b4 ($15.97 in chips)
Seat 5: 8c1ff383 ($4.21 in chips)
Seat 6: Hero ($24.04 in chips)
7dc16105: posts small blind $0.05
c4b075b5: posts big blind $0.1
*** HOLE CARDS ***
Dealt to 7dc16105 
Dealt to c4b075b5 
Dealt to 2e33682b 
Dealt to 5ff083b4 
Dealt to 8c1ff383 
Dealt to Hero [7c 4d]
2e33682b: folds
5ff083b4: folds
8c1ff383: raises $0.3 to $0.4
Hero: folds
7dc16105: folds
c4b075b5: folds
Uncalled bet ($0.3) returned to 8c1ff383
*** SHOWDOWN ***
8c1ff383 collected $0.25 from pot
*** SUMMARY ***
Total pot $0.25 | Rake $0 | Jackpot $0 | Bingo $0 | Fortune $0 | Tax $0
Seat 1: 7dc16105 (small blind) folded before Flop
Seat 2: c4b075b5 (big blind) folded before Flop
Seat 3: 2e33682b folded before Flop (didn't bet)
Seat 4: 5ff083b4 folded before Flop (didn't bet)
Seat 5: 8c1ff383 collected ($0.25)
Seat 6: Hero (button) folded before Flop (didn't bet)


Poker Hand #HD1788721629: Hold'em No Limit ($0.05/$0.1) - 2024/05/26 18:46:14
Table 'NLHRed17' 6-max Seat #5 is the button
Seat 1: 7dc16105 ($11.27 in chips)
Seat 2: c4b075b5 ($9.97 in chips)
Seat 3: 2e33682b ($10.94 in chips)
Seat 4: 5ff083b4 ($15.97 in chips)
Seat 5: 8c1ff383 ($6.48 in chips)
Seat 6: Hero ($24.09 in chips)
Hero: posts small blind $0.05
7dc16105: posts big blind $0.1
*** HOLE CARDS ***
Dealt to 7dc16105 
Dealt to c4b075b5 
Dealt to 2e33682b 
Dealt to 5ff083b4 
Dealt to 8c1ff383 
Dealt to Hero [5d 8s]
c4b075b5: folds
2e33682b: folds
5ff083b4: folds
8c1ff383: raises $0.1 to $0.2
Hero: folds
7dc16105: calls $0.1
*** FLOP *** [Td 2d 5c]
7dc16105: checks
8c1ff383: bets $0.23
7dc16105: calls $0.23
*** TURN *** [Td 2d 5c] [Jd]
7dc16105: checks
8c1ff383: bets $0.46
7dc16105: raises $1.38 to $1.84
8c1ff383: calls $1.38
*** RIVER *** [Td 2d 5c Jd] [Qs]
7dc16105: bets $4.3
8c1ff383: folds
Uncalled bet ($4.3) returned to 7dc16105
*** SHOWDOWN ***
7dc16105 collected $4.27 from pot
*** SUMMARY ***
Total pot $4.59 | Rake $0.22 | Jackpot $0.1 | Bingo $0 | Fortune $0 | Tax $0
Board [Td 2d 5c Jd Qs]
Seat 1: 7dc16105 (big blind) won ($4.27)
Seat 2: c4b075b5 folded before Flop (didn't bet)
Seat 3: 2e33682b folded before Flop (didn't bet)
Seat 4: 5ff083b4 folded before Flop (didn't bet)
Seat 5: 8c1ff383 (button) folded on the River
Seat 6: Hero (small blind) folded before Flop


Poker Hand #HD1788721508: Hold'em No Limit ($0.05/$0.1) - 2024/05/26 18:45:14
Table 'NLHRed17' 6-max Seat #4 is the button
Seat 1: 7dc16105 ($11.27 in chips)
Seat 2: c4b075b5 ($9.97 in chips)
Seat 3: 2e33682b ($10.94 in chips)
Seat 4: 5ff083b4 ($19.81 in chips)
Seat 5: 8c1ff383 ($3.84 in chips)
Seat 6: Hero ($24.19 in chips)
8c1ff383: posts small blind $0.05
Hero: posts big blind $0.1
*** HOLE CARDS ***
Dealt to 7dc16105 
Dealt to c4b075b5 
Dealt to 2e33682b 
Dealt to 5ff083b4 
Dealt to 8c1ff383 
Dealt to Hero [Kh 6c]
7dc16105: folds
c4b075b5: folds
2e33682b: folds
5ff083b4: raises $0.15 to $0.25
8c1ff383: raises $0.65 to $0.9
Hero: folds
5ff083b4: raises $18.91 to $19.81 and is all-in
8c1ff383: calls $2.94 and is all-in
Uncalled bet ($15.97) returned to 5ff083b4
5ff083b4: shows [Js Ad]
8c1ff383: shows [Qh Qd]
*** FLOP *** [8c 4c 5c]
8c1ff383: Chooses to EV Cashout 
*** TURN *** [8c 4c 5c] [4d]
8c1ff383: Pays Cashout Risk ($0.39)
8c1ff383: Chooses to EV Cashout 
*** RIVER *** [8c 4c 5c 4d] [Th]
8c1ff383: Pays Cashout Risk ($0.43)
*** SHOWDOWN ***
8c1ff383 collected $7.3 from pot
*** SUMMARY ***
Total pot $7.78 | Rake $0.38 | Jackpot $0.1 | Bingo $0 | Fortune $0 | Tax $0
Board [8c 4c 5c 4d Th]
Seat 1: 7dc16105 folded before Flop (didn't bet)
Seat 2: c4b075b5 folded before Flop (didn't bet)
Seat 3: 2e33682b folded before Flop (didn't bet)
Seat 4: 5ff083b4 (button) showed [Js Ad] and lost with Pair of Fours
Seat 5: 8c1ff383 (small blind) showed [Qh Qd] and won ($7.3) with Pair of Queens and Pair of Fours, Cashout Risk ($0.82)
Seat 6: Hero (big blind) folded before Flop


Poker Hand #HD1788721433: Hold'em No Limit ($0.05/$0.1) - 2024/05/26 18:44:39
Table 'NLHRed17' 6-max Seat #3 is the button
Seat 1: 7dc16105 ($11.27 in chips)
Seat 2: c4b075b5 ($9.97 in chips)
Seat 3: 2e33682b ($10.94 in chips)
Seat 4: 5ff083b4 ($20.31 in chips)
Seat 5: 8c1ff383 ($3.39 in chips)
Seat 6: Hero ($24.19 in chips)
5ff083b4: posts small blind $0.05
8c1ff383: posts big blind $0.1
*** HOLE CARDS ***
Dealt to 7dc16105 
Dealt to c4b075b5 
Dealt to 2e33682b 
Dealt to 5ff083b4 
Dealt to 8c1ff383 
Dealt to Hero [Qh 4d]
Hero: folds
7dc16105: folds
c4b075b5: folds
2e33682b: folds
5ff083b4: raises $0.2 to $0.3
8c1ff383: calls $0.2
*** FLOP *** [4c 4s Jd]
5ff083b4: bets $0.2
8c1ff383: raises $0.7 to $0.9
5ff083b4: folds
Uncalled bet ($0.7) returned to 8c1ff383
*** SHOWDOWN ***
8c1ff383 collected $0.95 from pot
*** SUMMARY ***
Total pot $1 | Rake $0.05 | Jackpot $0 | Bingo $0 | Fortune $0 | Tax $0
Board [4c 4s Jd]
Seat 1: 7dc16105 folded before Flop (didn't bet)
Seat 2: c4b075b5 folded before Flop (didn't bet)
Seat 3: 2e33682b (button) folded before Flop (didn't bet)
Seat 4: 5ff083b4 (small blind) folded on the Flop
Seat 5: 8c1ff383 (big blind) won ($0.95)
Seat 6: Hero folded before Flop (didn't bet)


Poker Hand #HD1788721317: Hold'em No Limit ($0.05/$0.1) - 2024/05/26 18:43:43
Table 'NLHRed17' 6-max Seat #2 is the button
Seat 1: 7dc16105 ($11.27 in chips)
Seat 2: c4b075b5 ($9.97 in chips)
Seat 3: 2e33682b ($11.44 in chips)
Seat 4: 5ff083b4 ($19.86 in chips)
Seat 5: 8c1ff383 ($3.39 in chips)
Seat 6: Hero ($24.19 in chips)
2e33682b: posts small blind $0.05
5ff083b4: posts big blind $0.1
*** HOLE CARDS ***
Dealt to 7dc16105 
Dealt to c4b075b5 
Dealt to 2e33682b 
Dealt to 5ff083b4 
Dealt to 8c1ff383 
Dealt to Hero [Ah 7d]
8c1ff383: folds
Hero: folds
7dc16105: folds
c4b075b5: folds
2e33682b: raises $0.15 to $0.25
5ff083b4: calls $0.15
*** FLOP *** [Jd Td 8h]
2e33682b: checks
5ff083b4: checks
*** TURN *** [Jd Td 8h] [3h]
2e33682b: bets $0.25
5ff083b4: raises $0.95 to $1.2
2e33682b: folds
Uncalled bet ($0.95) returned to 5ff083b4
*** SHOWDOWN ***
5ff083b4 collected $0.95 from pot
*** SUMMARY ***
Total pot $1 | Rake $0.05 | Jackpot $0 | Bingo $0 | Fortune $0 | Tax $0
Board [Jd Td 8h 3h]
Seat 1: 7dc16105 folded before Flop (didn't bet)
Seat 2: c4b075b5 (button) folded before Flop (didn't bet)
Seat 3: 2e33682b (small blind) folded on the Turn
Seat 4: 5ff083b4 (big blind) won ($0.95)
Seat 5: 8c1ff383 folded before Flop (didn't bet)
Seat 6: Hero folded before Flop (didn't bet)


Poker Hand #HD1788721269: Hold'em No Limit ($0.05/$0.1) - 2024/05/26 18:43:23
Table 'NLHRed17' 6-max Seat #1 is the button
Seat 1: 7dc16105 ($11.27 in chips)
Seat 2: c4b075b5 ($9.69 in chips)
Seat 3: 2e33682b ($11.54 in chips)
Seat 4: 5ff083b4 ($19.86 in chips)
Seat 5: 8c1ff383 ($3.59 in chips)
Seat 6: Hero ($24.19 in chips)
c4b075b5: posts small blind $0.05
2e33682b: posts big blind $0.1
*** HOLE CARDS ***
Dealt to 7dc16105 
Dealt to c4b075b5 
Dealt to 2e33682b 
Dealt to 5ff083b4 
Dealt to 8c1ff383 
Dealt to Hero [9h Th]
5ff083b4: folds
8c1ff383: raises $0.1 to $0.2
Hero: folds
7dc16105: folds
c4b075b5: raises $0.6 to $0.8
2e33682b: folds
8c1ff383: folds
Uncalled bet ($0.6) returned to c4b075b5
*** SHOWDOWN ***
c4b075b5 collected $0.48 from pot
*** SUMMARY ***
Total pot $0.5 | Rake $0.02 | Jackpot $0 | Bingo $0 | Fortune $0 | Tax $0
Seat 1: 7dc16105 (button) folded before Flop (didn't bet)
Seat 2: c4b075b5 (small blind) collected ($0.48)
Seat 3: 2e33682b (big blind) folded before Flop
Seat 4: 5ff083b4 folded before Flop (didn't bet)
Seat 5: 8c1ff383 folded before Flop
Seat 6: Hero folded before Flop (didn't bet)


Poker Hand #HD1788721240: Hold'em No Limit ($0.05/$0.1) - 2024/05/26 18:43:07
Table 'NLHRed17' 6-max Seat #6 is the button
Seat 1: 7dc16105 ($11.32 in chips)
Seat 2: c4b075b5 ($9.64 in chips)
Seat 3: 2e33682b ($11.54 in chips)
Seat 4: 5ff083b4 ($19.86 in chips)
Seat 5: 8c1ff383 ($3.59 in chips)
Seat 6: Hero ($24.19 in chips)
7dc16105: posts small blind $0.05
c4b075b5: posts big blind $0.1
*** HOLE CARDS ***
Dealt to 7dc16105 
Dealt to c4b075b5 
Dealt to 2e33682b 
Dealt to 5ff083b4 
Dealt to 8c1ff383 
Dealt to Hero [Jc 4h]
2e33682b: folds
5ff083b4: folds
8c1ff383: folds
Hero: folds
7dc16105: folds
Uncalled bet ($0.05) returned to c4b075b5
*** SHOWDOWN ***
c4b075b5 collected $0.1 from pot
*** SUMMARY ***
Total pot $0.1 | Rake $0 | Jackpot $0 | Bingo $0 | Fortune $0 | Tax $0
Seat 1: 7dc16105 (small blind) folded before Flop
Seat 2: c4b075b5 (big blind) collected ($0.1)
Seat 3: 2e33682b folded before Flop (didn't bet)
Seat 4: 5ff083b4 folded before Flop (didn't bet)
Seat 5: 8c1ff383 folded before Flop (didn't bet)
Seat 6: Hero (button) folded before Flop (didn't bet)


Poker Hand #HD1788721137: Hold'em No Limit ($0.05/$0.1) - 2024/05/26 18:42:17
Table 'NLHRed17' 6-max Seat #5 is the button
Seat 1: 7dc16105 ($10.78 in chips)
Seat 2: c4b075b5 ($9.64 in chips)
Seat 3: 2e33682b ($11.54 in chips)
Seat 4: 5ff083b4 ($19.86 in chips)
Seat 5: 8c1ff383 ($3.59 in chips)
Seat 6: Hero ($24.79 in chips)
Hero: posts small blind $0.05
7dc16105: posts big blind $0.1
*** HOLE CARDS ***
Dealt to 7dc16105 
Dealt to c4b075b5 
Dealt to 2e33682b 
Dealt to 5ff083b4 
Dealt to 8c1ff383 
Dealt to Hero [9s Kh]
c4b075b5: folds
2e33682b: folds
5ff083b4: folds
8c1ff383: folds
Hero: raises $0.2 to $0.3
7dc16105: calls $0.2
*** FLOP *** [7h Js Ac]
Hero: checks
7dc16105: checks
*** TURN *** [7h Js Ac] [Jc]
Hero: bets $0.3
7dc16105: calls $0.3
*** RIVER *** [7h Js Ac Jc] [Jh]
Hero: checks
7dc16105: bets $0.9
Hero: folds
Uncalled bet ($0.9) returned to 7dc16105
*** SHOWDOWN ***
7dc16105 collected $1.14 from pot
*** SUMMARY ***
Total pot $1.2 | Rake $0.06 | Jackpot $0 | Bingo $0 | Fortune $0 | Tax $0
Board [7h Js Ac Jc Jh]
Seat 1: 7dc16105 (big blind) won ($1.14)
Seat 2: c4b075b5 folded before Flop (didn't bet)
Seat 3: 2e33682b folded before Flop (didn't bet)
Seat 4: 5ff083b4 folded before Flop (didn't bet)
Seat 5: 8c1ff383 (button) folded before Flop (didn't bet)
Seat 6: Hero (small blind) folded on the River


Poker Hand #HD1788721102: Hold'em No Limit ($0.05/$0.1) - 2024/05/26 18:41:59
Table 'NLHRed17' 6-max Seat #4 is the button
Seat 1: 7dc16105 ($10.78 in chips)
Seat 2: c4b075b5 ($9.64 in chips)
Seat 3: 2e33682b ($11.54 in chips)
Seat 4: 5ff083b4 ($19.86 in chips)
Seat 5: 8c1ff383 ($3.49 in chips)
Seat 6: Hero ($24.89 in chips)
8c1ff383: posts small blind $0.05
Hero: posts big blind $0.1
*** HOLE CARDS ***
Dealt to 7dc16105 
Dealt to c4b075b5 
Dealt to 2e33682b 
Dealt to 5ff083b4 
Dealt to 8c1ff383 
Dealt to Hero [Jh 6s]
7dc16105: folds
c4b075b5: folds
2e33682b: folds
5ff083b4: folds
8c1ff383: raises $0.1 to $0.2
Hero: folds
Uncalled bet ($0.1) returned to 8c1ff383
*** SHOWDOWN ***
8c1ff383 collected $0.2 from pot
*** SUMMARY ***
Total pot $0.2 | Rake $0 | Jackpot $0 | Bingo $0 | Fortune $0 | Tax $0
Seat 1: 7dc16105 folded before Flop (didn't bet)
Seat 2: c4b075b5 folded before Flop (didn't bet)
Seat 3: 2e33682b folded before Flop (didn't bet)
Seat 4: 5ff083b4 (button) folded before Flop (didn't bet)
Seat 5: 8c1ff383 (small blind) collected ($0.2)
Seat 6: Hero (big blind) folded before Flop


Poker Hand #HD1788721055: Hold'em No Limit ($0.05/$0.1) - 2024/05/26 18:41:36
Table 'NLHRed17' 6-max Seat #3 is the button
Seat 1: 7dc16105 ($10.78 in chips)
Seat 2: c4b075b5 ($9.49 in chips)
Seat 3: 2e33682b ($11.54 in chips)
Seat 4: 5ff083b4 ($19.91 in chips)
Seat 5: 8c1ff383 ($3.59 in chips)
Seat 6: Hero ($24.89 in chips)
5ff083b4: posts small blind $0.05
8c1ff383: posts big blind $0.1
*** HOLE CARDS ***
Dealt to 7dc16105 
Dealt to c4b075b5 
Dealt to 2e33682b 
Dealt to 5ff083b4 
Dealt to 8c1ff383 
Dealt to Hero [4s 5s]
Hero: folds
7dc16105: folds
c4b075b5: raises $0.11 to $0.21
2e33682b: folds
5ff083b4: folds
8c1ff383: folds
Uncalled bet ($0.11) returned to c4b075b5
*** SHOWDOWN ***
c4b075b5 collected $0.25 from pot
*** SUMMARY ***
Total pot $0.25 | Rake $0 | Jackpot $0 | Bingo $0 | Fortune $0 | Tax $0
Seat 1: 7dc16105 folded before Flop (didn't bet)
Seat 2: c4b075b5 collected ($0.25)
Seat 3: 2e33682b (button) folded before Flop (didn't bet)
Seat 4: 5ff083b4 (small blind) folded before Flop
Seat 5: 8c1ff383 (big blind) folded before Flop
Seat 6: Hero folded before Flop (didn't bet)


Poker Hand #HD1788721010: Hold'em No Limit ($0.05/$0.1) - 2024/05/26 18:41:14
Table 'NLHRed17' 6-max Seat #2 is the button
Seat 1: 7dc16105 ($10.78 in chips)
Seat 2: c4b075b5 ($9.49 in chips)
Seat 3: 2e33682b ($11.59 in chips)
Seat 4: 5ff083b4 ($20.01 in chips)
Seat 5: 8c1ff383 ($3.59 in chips)
Seat 6: Hero ($24.74 in chips)
2e33682b: posts small blind $0.05
5ff083b4: posts big blind $0.1
*** HOLE CARDS ***
Dealt to 7dc16105 
Dealt to c4b075b5 
Dealt to 2e33682b 
Dealt to 5ff083b4 
Dealt to 8c1ff383 
Dealt to Hero [Ad Jd]
8c1ff383: folds
Hero: raises $0.1 to $0.2
7dc16105: folds
c4b075b5: folds
2e33682b: folds
5ff083b4: folds
Uncalled bet ($0.1) returned to Hero
*** SHOWDOWN ***
Hero collected $0.25 from pot
*** SUMMARY ***
Total pot $0.25 | Rake $0 | Jackpot $0 | Bingo $0 | Fortune $0 | Tax $0
Seat 1: 7dc16105 folded before Flop (didn't bet)
Seat 2: c4b075b5 (button) folded before Flop (didn't bet)
Seat 3: 2e33682b (small blind) folded before Flop
Seat 4: 5ff083b4 (big blind) folded before Flop
Seat 5: 8c1ff383 folded before Flop (didn't bet)
Seat 6: Hero collected ($0.25)


Poker Hand #HD1788720984: Hold'em No Limit ($0.05/$0.1) - 2024/05/26 18:40:59
Table 'NLHRed17' 6-max Seat #1 is the button
Seat 1: 7dc16105 ($10.63 in chips)
Seat 2: c4b075b5 ($9.54 in chips)
Seat 3: 2e33682b ($11.69 in chips)
Seat 4: 5ff083b4 ($20.01 in chips)
Seat 5: 8c1ff383 ($3.59 in chips)
Seat 6: Hero ($24.74 in chips)
c4b075b5: posts small blind $0.05
2e33682b: posts big blind $0.1
*** HOLE CARDS ***
Dealt to 7dc16105 
Dealt to c4b075b5 
Dealt to 2e33682b 
Dealt to 5ff083b4 
Dealt to 8c1ff383 
Dealt to Hero [6s 8s]
5ff083b4: folds
8c1ff383: folds
Hero: folds
7dc16105: raises $0.2 to $0.3
c4b075b5: folds
2e33682b: folds
Uncalled bet ($0.2) returned to 7dc16105
*** SHOWDOWN ***
7dc16105 collected $0.25 from pot
*** SUMMARY ***
Total pot $0.25 | Rake $0 | Jackpot $0 | Bingo $0 | Fortune $0 | Tax $0
Seat 1: 7dc16105 (button) collected ($0.25)
Seat 2: c4b075b5 (small blind) folded before Flop
Seat 3: 2e33682b (big blind) folded before Flop
Seat 4: 5ff083b4 folded before Flop (didn't bet)
Seat 5: 8c1ff383 folded before Flop (didn't bet)
Seat 6: Hero folded before Flop (didn't bet)


Poker Hand #HD1788720941: Hold'em No Limit ($0.05/$0.1) - 2024/05/26 18:40:34
Table 'NLHRed17' 6-max Seat #6 is the button
Seat 1: 7dc16105 ($10.35 in chips)
Seat 2: c4b075b5 ($9.64 in chips)
Seat 3: 2e33682b ($11.69 in chips)
Seat 4: 5ff083b4 ($20.01 in chips)
Seat 5: 8c1ff383 ($3.79 in chips)
Seat 6: Hero ($24.74 in chips)
7dc16105: posts small blind $0.05
c4b075b5: posts big blind $0.1
*** HOLE CARDS ***
Dealt to 7dc16105 
Dealt to c4b075b5 
Dealt to 2e33682b 
Dealt to 5ff083b4 
Dealt to 8c1ff383 
Dealt to Hero [3c 6c]
2e33682b: folds
5ff083b4: folds
8c1ff383: raises $0.1 to $0.2
Hero: folds
7dc16105: raises $0.7 to $0.9
c4b075b5: folds
8c1ff383: folds
Uncalled bet ($0.7) returned to 7dc16105
7dc16105: shows [2h 7h]
*** SHOWDOWN ***
7dc16105 collected $0.48 from pot
*** SUMMARY ***
Total pot $0.5 | Rake $0.02 | Jackpot $0 | Bingo $0 | Fortune $0 | Tax $0
Seat 1: 7dc16105 (small blind) showed [2h 7h] and collected ($0.48)
Seat 2: c4b075b5 (big blind) folded before Flop
Seat 3: 2e33682b folded before Flop (didn't bet)
Seat 4: 5ff083b4 folded before Flop (didn't bet)
Seat 5: 8c1ff383 folded before Flop
Seat 6: Hero (button) folded before Flop (didn't bet)


Poker Hand #HD1788720873: Hold'em No Limit ($0.05/$0.1) - 2024/05/26 18:40:05
Table 'NLHRed17' 6-max Seat #5 is the button
Seat 1: 7dc16105 ($10.45 in chips)
Seat 2: c4b075b5 ($9.64 in chips)
Seat 3: 2e33682b ($11.69 in chips)
Seat 4: 5ff083b4 ($20.01 in chips)
Seat 5: 8c1ff383 ($3.99 in chips)
Seat 6: Hero ($24.46 in chips)
Hero: posts small blind $0.05
7dc16105: posts big blind $0.1
*** HOLE CARDS ***
Dealt to 7dc16105 
Dealt to c4b075b5 
Dealt to 2e33682b 
Dealt to 5ff083b4 
Dealt to 8c1ff383 
Dealt to Hero [Ts Ks]
c4b075b5: folds
2e33682b: folds
5ff083b4: folds
8c1ff383: raises $0.1 to $0.2
Hero: raises $0.9 to $1.1
7dc16105: folds
8c1ff383: folds
Uncalled bet ($0.9) returned to Hero
*** SHOWDOWN ***
Hero collected $0.48 from pot
*** SUMMARY ***
Total pot $0.5 | Rake $0.02 | Jackpot $0 | Bingo $0 | Fortune $0 | Tax $0
Seat 1: 7dc16105 (big blind) folded before Flop
Seat 2: c4b075b5 folded before Flop (didn't bet)
Seat 3: 2e33682b folded before Flop (didn't bet)
Seat 4: 5ff083b4 folded before Flop (didn't bet)
Seat 5: 8c1ff383 (button) folded before Flop
Seat 6: Hero (small blind) collected ($0.48)


Poker Hand #HD1788720839: Hold'em No Limit ($0.05/$0.1) - 2024/05/26 18:39:48
Table 'NLHRed17' 6-max Seat #4 is the button
Seat 1: 7dc16105 ($10.3 in chips)
Seat 2: c4b075b5 ($9.64 in chips)
Seat 3: 2e33682b ($11.69 in chips)
Seat 4: 5ff083b4 ($20.01 in chips)
Seat 5: 8c1ff383 ($4.04 in chips)
Seat 6: Hero ($24.56 in chips)
8c1ff383: posts small blind $0.05
Hero: posts big blind $0.1
*** HOLE CARDS ***
Dealt to 7dc16105 
Dealt to c4b075b5 
Dealt to 2e33682b 
Dealt to 5ff083b4 
Dealt to 8c1ff383 
Dealt to Hero [2d Th]
7dc16105: raises $0.12 to $0.22
c4b075b5: folds
2e33682b: folds
5ff083b4: folds
8c1ff383: folds
Hero: folds
Uncalled bet ($0.12) returned to 7dc16105
*** SHOWDOWN ***
7dc16105 collected $0.25 from pot
*** SUMMARY ***
Total pot $0.25 | Rake $0 | Jackpot $0 | Bingo $0 | Fortune $0 | Tax $0
Seat 1: 7dc16105 collected ($0.25)
Seat 2: c4b075b5 folded before Flop (didn't bet)
Seat 3: 2e33682b folded before Flop (didn't bet)
Seat 4: 5ff083b4 (button) folded before Flop (didn't bet)
Seat 5: 8c1ff383 (small blind) folded before Flop
Seat 6: Hero (big blind) folded before Flop


Poker Hand #HD1788720765: Hold'em No Limit ($0.05/$0.1) - 2024/05/26 18:39:14
Table 'NLHRed17' 6-max Seat #3 is the button
Seat 1: 7dc16105 ($10.3 in chips)
Seat 2: c4b075b5 ($9.85 in chips)
Seat 3: 2e33682b ($11.69 in chips)
Seat 4: 5ff083b4 ($20.06 in chips)
Seat 5: 8c1ff383 ($3.8 in chips)
Seat 6: Hero ($24.56 in chips)
5ff083b4: posts small blind $0.05
8c1ff383: posts big blind $0.1
*** HOLE CARDS ***
Dealt to 7dc16105 
Dealt to c4b075b5 
Dealt to 2e33682b 
Dealt to 5ff083b4 
Dealt to 8c1ff383 
Dealt to Hero [5h Jh]
Hero: folds
7dc16105: folds
c4b075b5: raises $0.11 to $0.21
2e33682b: folds
5ff083b4: folds
8c1ff383: calls $0.11
*** FLOP *** [Jd 6d 9c]
8c1ff383: checks
c4b075b5: checks
*** TURN *** [Jd 6d 9c] [7d]
8c1ff383: bets $0.47
c4b075b5: folds
Uncalled bet ($0.47) returned to 8c1ff383
*** SHOWDOWN ***
8c1ff383 collected $0.45 from pot
*** SUMMARY ***
Total pot $0.47 | Rake $0.02 | Jackpot $0 | Bingo $0 | Fortune $0 | Tax $0
Board [Jd 6d 9c 7d]
Seat 1: 7dc16105 folded before Flop (didn't bet)
Seat 2: c4b075b5 folded on the Turn
Seat 3: 2e33682b (button) folded before Flop (didn't bet)
Seat 4: 5ff083b4 (small blind) folded before Flop
Seat 5: 8c1ff383 (big blind) won ($0.45)
Seat 6: Hero folded before Flop (didn't bet)


Poker Hand #HD1788720722: Hold'em No Limit ($0.05/$0.1) - 2024/05/26 18:38:56
Table 'NLHRed17' 6-max Seat #2 is the button
Seat 1: 7dc16105 ($10.15 in chips)
Seat 2: c4b075b5 ($9.85 in chips)
Seat 3: 2e33682b ($11.74 in chips)
Seat 4: 5ff083b4 ($20.16 in chips)
Seat 6: Hero ($24.56 in chips)
2e33682b: posts small blind $0.05
5ff083b4: posts big blind $0.1
*** HOLE CARDS ***
Dealt to 7dc16105 
Dealt to c4b075b5 
Dealt to 2e33682b 
Dealt to 5ff083b4 
Dealt to Hero [4h 6c]
Hero: folds
7dc16105: raises $0.12 to $0.22
c4b075b5: folds
2e33682b: folds
5ff083b4: folds
Uncalled bet ($0.12) returned to 7dc16105
*** SHOWDOWN ***
7dc16105 collected $0.25 from pot
*** SUMMARY ***
Total pot $0.25 | Rake $0 | Jackpot $0 | Bingo $0 | Fortune $0 | Tax $0
Seat 1: 7dc16105 collected ($0.25)
Seat 2: c4b075b5 (button) folded before Flop (didn't bet)
Seat 3: 2e33682b (small blind) folded before Flop
Seat 4: 5ff083b4 (big blind) folded before Flop
Seat 6: Hero folded before Flop (didn't bet)


Poker Hand #HD1788720701: Hold'em No Limit ($0.05/$0.1) - 2024/05/26 18:38:44
Table 'NLHRed17' 6-max Seat #1 is the button
Seat 1: 7dc16105 ($10.15 in chips)
Seat 2: c4b075b5 ($9.9 in chips)
Seat 3: 2e33682b ($11.69 in chips)
Seat 4: 5ff083b4 ($20.16 in chips)
Seat 6: Hero ($24.56 in chips)
c4b075b5: posts small blind $0.05
2e33682b: posts big blind $0.1
*** HOLE CARDS ***
Dealt to 7dc16105 
Dealt to c4b075b5 
Dealt to 2e33682b 
Dealt to 5ff083b4 
Dealt to Hero [5s 7c]
5ff083b4: folds
Hero: folds
7dc16105: folds
c4b075b5: folds
Uncalled bet ($0.05) returned to 2e33682b
*** SHOWDOWN ***
2e33682b collected $0.1 from pot
*** SUMMARY ***
Total pot $0.1 | Rake $0 | Jackpot $0 | Bingo $0 | Fortune $0 | Tax $0
Seat 1: 7dc16105 (button) folded before Flop (didn't bet)
Seat 2: c4b075b5 (small blind) folded before Flop
Seat 3: 2e33682b (big blind) collected ($0.1)
Seat 4: 5ff083b4 folded before Flop (didn't bet)
Seat 6: Hero folded before Flop (didn't bet)


Poker Hand #HD1788720670: Hold'em No Limit ($0.05/$0.1) - 2024/05/26 18:38:32
Table 'NLHRed17' 6-max Seat #6 is the button
Seat 1: 7dc16105 ($10.05 in chips)
Seat 2: c4b075b5 ($10 in chips)
Seat 3: 2e33682b ($11.69 in chips)
Seat 4: 5ff083b4 ($20.16 in chips)
Seat 6: Hero ($24.56 in chips)
7dc16105: posts small blind $0.05
c4b075b5: posts big blind $0.1
*** HOLE CARDS ***
Dealt to 7dc16105 
Dealt to c4b075b5 
Dealt to 2e33682b 
Dealt to 5ff083b4 
Dealt to Hero [Jd 8c]
2e33682b: folds
5ff083b4: folds
Hero: folds
7dc16105: raises $0.2 to $0.3
c4b075b5: folds
Uncalled bet ($0.2) returned to 7dc16105
*** SHOWDOWN ***
7dc16105 collected $0.2 from pot
*** SUMMARY ***
Total pot $0.2 | Rake $0 | Jackpot $0 | Bingo $0 | Fortune $0 | Tax $0
Seat 1: 7dc16105 (small blind) collected ($0.2)
Seat 2: c4b075b5 (big blind) folded before Flop
Seat 3: 2e33682b folded before Flop (didn't bet)
Seat 4: 5ff083b4 folded before Flop (didn't bet)
Seat 6: Hero (button) folded before Flop (didn't bet)


Poker Hand #HD1788720654: Hold'em No Limit ($0.05/$0.1) - 2024/05/26 18:38:20
Table 'NLHRed17' 6-max Seat #4 is the button
Seat 1: 7dc16105 ($10 in chips)
Seat 3: 2e33682b ($11.69 in chips)
Seat 4: 5ff083b4 ($20.16 in chips)
Seat 6: Hero ($24.61 in chips)
Hero: posts small blind $0.05
7dc16105: posts big blind $0.1
*** HOLE CARDS ***
Dealt to 7dc16105 
Dealt to 2e33682b 
Dealt to 5ff083b4 
Dealt to Hero [6d 5d]
2e33682b: folds
5ff083b4: folds
Hero: folds
Uncalled bet ($0.05) returned to 7dc16105
*** SHOWDOWN ***
7dc16105 collected $0.1 from pot
*** SUMMARY ***
Total pot $0.1 | Rake $0 | Jackpot $0 | Bingo $0 | Fortune $0 | Tax $0
Seat 1: 7dc16105 (big blind) collected ($0.1)
Seat 3: 2e33682b folded before Flop (didn't bet)
Seat 4: 5ff083b4 (button) folded before Flop (didn't bet)
Seat 6: Hero (small blind) folded before Flop


Poker Hand #HD1788720562: Hold'em No Limit ($0.05/$0.1) - 2024/05/26 18:37:35
Table 'NLHRed17' 6-max Seat #3 is the button
Seat 3: 2e33682b ($11.69 in chips)
Seat 4: 5ff083b4 ($17.64 in chips)
Seat 5: 8c1ff383 ($2.9 in chips)
Seat 6: Hero ($24.61 in chips)
5ff083b4: posts small blind $0.05
8c1ff383: posts big blind $0.1
*** HOLE CARDS ***
Dealt to 2e33682b 
Dealt to 5ff083b4 
Dealt to 8c1ff383 
Dealt to Hero [Js 5d]
Hero: folds
2e33682b: folds
5ff083b4: raises $0.2 to $0.3
8c1ff383: calls $0.2
*** FLOP *** [9s Ad 3h]
5ff083b4: checks
8c1ff383: bets $0.3
5ff083b4: calls $0.3
*** TURN *** [9s Ad 3h] [9c]
5ff083b4: checks
8c1ff383: bets $0.6
5ff083b4: raises $1.8 to $2.4
8c1ff383: calls $1.7 and is all-in
Uncalled bet ($0.1) returned to 5ff083b4
5ff083b4: shows [Ah 4d] (Pair of Aces and Pair of Nines)
8c1ff383: shows [3d Qd] (Pair of Nines and Pair of Treys)
*** RIVER *** [9s Ad 3h 9c] [Jh]
*** SHOWDOWN ***
5ff083b4 collected $5.42 from pot
*** SUMMARY ***
Total pot $5.8 | Rake $0.28 | Jackpot $0.1 | Bingo $0 | Fortune $0 | Tax $0
Board [9s Ad 3h 9c Jh]
Seat 3: 2e33682b (button) folded before Flop (didn't bet)
Seat 4: 5ff083b4 (small blind) showed [Ah 4d] and won ($5.42) with Pair of Aces and Pair of Nines
Seat 5: 8c1ff383 (big blind) showed [3d Qd] and lost with Pair of Nines and Pair of Treys
Seat 6: Hero folded before Flop (didn't bet)


Poker Hand #HD1788720505: Hold'em No Limit ($0.05/$0.1) - 2024/05/26 18:37:11
Table 'NLHRed17' 6-max Seat #6 is the button
Seat 3: 2e33682b ($11.41 in chips)
Seat 4: 5ff083b4 ($17.74 in chips)
Seat 5: 8c1ff383 ($3.1 in chips)
Seat 6: Hero ($24.61 in chips)
2e33682b: posts small blind $0.05
5ff083b4: posts big blind $0.1
*** HOLE CARDS ***
Dealt to 2e33682b 
Dealt to 5ff083b4 
Dealt to 8c1ff383 
Dealt to Hero [Kd 7d]
8c1ff383: raises $0.1 to $0.2
Hero: folds
2e33682b: raises $0.9 to $1.1
5ff083b4: folds
8c1ff383: folds
Uncalled bet ($0.9) returned to 2e33682b
*** SHOWDOWN ***
2e33682b collected $0.48 from pot
*** SUMMARY ***
Total pot $0.5 | Rake $0.02 | Jackpot $0 | Bingo $0 | Fortune $0 | Tax $0
Seat 3: 2e33682b (small blind) collected ($0.48)
Seat 4: 5ff083b4 (big blind) folded before Flop
Seat 5: 8c1ff383 folded before Flop
Seat 6: Hero (button) folded before Flop (didn't bet)


Poker Hand #HD1788720474: Hold'em No Limit ($0.05/$0.1) - 2024/05/26 18:36:57
Table 'NLHRed17' 6-max Seat #5 is the button
Seat 3: 2e33682b ($11.51 in chips)
Seat 4: 5ff083b4 ($17.59 in chips)
Seat 5: 8c1ff383 ($3.1 in chips)
Seat 6: Hero ($24.66 in chips)
Hero: posts small blind $0.05
2e33682b: posts big blind $0.1
*** HOLE CARDS ***
Dealt to 2e33682b 
Dealt to 5ff083b4 
Dealt to 8c1ff383 
Dealt to Hero [Ad Ts]
5ff083b4: raises $0.12 to $0.22
8c1ff383: folds
Hero: folds
2e33682b: folds
Uncalled bet ($0.12) returned to 5ff083b4
*** SHOWDOWN ***
5ff083b4 collected $0.25 from pot
*** SUMMARY ***
Total pot $0.25 | Rake $0 | Jackpot $0 | Bingo $0 | Fortune $0 | Tax $0
Seat 3: 2e33682b (big blind) folded before Flop
Seat 4: 5ff083b4 collected ($0.25)
Seat 5: 8c1ff383 (button) folded before Flop (didn't bet)
Seat 6: Hero (small blind) folded before Flop


Poker Hand #HD1788720448: Hold'em No Limit ($0.05/$0.1) - 2024/05/26 18:36:43
Table 'NLHRed17' 6-max Seat #4 is the button
Seat 3: 2e33682b ($11.36 in chips)
Seat 4: 5ff083b4 ($17.59 in chips)
Seat 5: 8c1ff383 ($3.15 in chips)
Seat 6: Hero ($24.76 in chips)
8c1ff383: posts small blind $0.05
Hero: posts big blind $0.1
*** HOLE CARDS ***
Dealt to 2e33682b 
Dealt to 5ff083b4 
Dealt to 8c1ff383 
Dealt to Hero [2d 9h]
2e33682b: raises $0.1 to $0.2
5ff083b4: folds
8c1ff383: folds
Hero: folds
Uncalled bet ($0.1) returned to 2e33682b
*** SHOWDOWN ***
2e33682b collected $0.25 from pot
*** SUMMARY ***
Total pot $0.25 | Rake $0 | Jackpot $0 | Bingo $0 | Fortune $0 | Tax $0
Seat 3: 2e33682b collected ($0.25)
Seat 4: 5ff083b4 (button) folded before Flop (didn't bet)
Seat 5: 8c1ff383 (small blind) folded before Flop
Seat 6: Hero (big blind) folded before Flop


Poker Hand #HD1788720425: Hold'em No Limit ($0.05/$0.1) - 2024/05/26 18:36:29
Table 'NLHRed17' 6-max Seat #3 is the button
Seat 3: 2e33682b ($11.36 in chips)
Seat 4: 5ff083b4 ($17.49 in chips)
Seat 5: 8c1ff383 ($3.25 in chips)
Seat 6: Hero ($24.76 in chips)
5ff083b4: posts small blind $0.05
8c1ff383: posts big blind $0.1
*** HOLE CARDS ***
Dealt to 2e33682b 
Dealt to 5ff083b4 
Dealt to 8c1ff383 
Dealt to Hero [Ts 2h]
Hero: folds
2e33682b: folds
5ff083b4: raises $0.2 to $0.3
8c1ff383: folds
Uncalled bet ($0.2) returned to 5ff083b4
*** SHOWDOWN ***
5ff083b4 collected $0.2 from pot
*** SUMMARY ***
Total pot $0.2 | Rake $0 | Jackpot $0 | Bingo $0 | Fortune $0 | Tax $0
Seat 3: 2e33682b (button) folded before Flop (didn't bet)
Seat 4: 5ff083b4 (small blind) collected ($0.2)
Seat 5: 8c1ff383 (big blind) folded before Flop
Seat 6: Hero folded before Flop (didn't bet)


Poker Hand #HD1788720364: Hold'em No Limit ($0.05/$0.1) - 2024/05/26 18:36:02
Table 'NLHRed17' 6-max Seat #6 is the button
Seat 3: 2e33682b ($11.08 in chips)
Seat 4: 5ff083b4 ($17.59 in chips)
Seat 5: 8c1ff383 ($3.45 in chips)
Seat 6: Hero ($24.76 in chips)
2e33682b: posts small blind $0.05
5ff083b4: posts big blind $0.1
*** HOLE CARDS ***
Dealt to 2e33682b 
Dealt to 5ff083b4 
Dealt to 8c1ff383 
Dealt to Hero [Ts Ac]
8c1ff383: raises $0.1 to $0.2
Hero: folds
2e33682b: raises $0.9 to $1.1
5ff083b4: folds
8c1ff383: folds
Uncalled bet ($0.9) returned to 2e33682b
*** SHOWDOWN ***
2e33682b collected $0.48 from pot
*** SUMMARY ***
Total pot $0.5 | Rake $0.02 | Jackpot $0 | Bingo $0 | Fortune $0 | Tax $0
Seat 3: 2e33682b (small blind) collected ($0.48)
Seat 4: 5ff083b4 (big blind) folded before Flop
Seat 5: 8c1ff383 folded before Flop
Seat 6: Hero (button) folded before Flop (didn't bet)


Poker Hand #HD1788720312: Hold'em No Limit ($0.05/$0.1) - 2024/05/26 18:35:37
Table 'NLHRed17' 6-max Seat #5 is the button
Seat 3: 2e33682b ($11.18 in chips)
Seat 4: 5ff083b4 ($17.25 in chips)
Seat 5: 8c1ff383 ($3.67 in chips)
Seat 6: Hero ($24.81 in chips)
Hero: posts small blind $0.05
2e33682b: posts big blind $0.1
*** HOLE CARDS ***
Dealt to 2e33682b 
Dealt to 5ff083b4 
Dealt to 8c1ff383 
Dealt to Hero [6d Qs]
5ff083b4: raises $0.12 to $0.22
8c1ff383: calls $0.22
Hero: folds
2e33682b: folds
*** FLOP *** [5h Js Qc]
5ff083b4: bets $0.45
8c1ff383: folds
Uncalled bet ($0.45) returned to 5ff083b4
*** SHOWDOWN ***
5ff083b4 collected $0.56 from pot
*** SUMMARY ***
Total pot $0.59 | Rake $0.03 | Jackpot $0 | Bingo $0 | Fortune $0 | Tax $0
Board [5h Js Qc]
Seat 3: 2e33682b (big blind) folded before Flop
Seat 4: 5ff083b4 won ($0.56)
Seat 5: 8c1ff383 (button) folded on the Flop
Seat 6: Hero (small blind) folded before Flop


Poker Hand #HD1788720290: Hold'em No Limit ($0.05/$0.1) - 2024/05/26 18:35:27
Table 'NLHRed17' 6-max Seat #4 is the button
Seat 3: 2e33682b ($11.18 in chips)
Seat 4: 5ff083b4 ($17.25 in chips)
Seat 5: 8c1ff383 ($3.57 in chips)
Seat 6: Hero ($24.91 in chips)
8c1ff383: posts small blind $0.05
Hero: posts big blind $0.1
*** HOLE CARDS ***
Dealt to 2e33682b 
Dealt to 5ff083b4 
Dealt to 8c1ff383 
Dealt to Hero [3d 4h]
2e33682b: folds
5ff083b4: folds
8c1ff383: raises $0.1 to $0.2
Hero: folds
Uncalled bet ($0.1) returned to 8c1ff383
*** SHOWDOWN ***
8c1ff383 collected $0.2 from pot
*** SUMMARY ***
Total pot $0.2 | Rake $0 | Jackpot $0 | Bingo $0 | Fortune $0 | Tax $0
Seat 3: 2e33682b folded before Flop (didn't bet)
Seat 4: 5ff083b4 (button) folded before Flop (didn't bet)
Seat 5: 8c1ff383 (small blind) collected ($0.2)
Seat 6: Hero (big blind) folded before Flop


Poker Hand #HD1788720226: Hold'em No Limit ($0.05/$0.1) - 2024/05/26 18:34:54
Table 'NLHRed17' 6-max Seat #3 is the button
Seat 3: 2e33682b ($10.27 in chips)
Seat 4: 5ff083b4 ($18.15 in chips)
Seat 5: 8c1ff383 ($3.67 in chips)
Seat 6: Hero ($24.91 in chips)
5ff083b4: posts small blind $0.05
8c1ff383: posts big blind $0.1
*** HOLE CARDS ***
Dealt to 2e33682b 
Dealt to 5ff083b4 
Dealt to 8c1ff383 
Dealt to Hero [9c Td]
Hero: folds
2e33682b: raises $0.1 to $0.2
5ff083b4: raises $0.7 to $0.9
8c1ff383: folds
2e33682b: raises $1.5 to $2.4
5ff083b4: folds
Uncalled bet ($1.5) returned to 2e33682b
*** SHOWDOWN ***
2e33682b collected $1.81 from pot
*** SUMMARY ***
Total pot $1.9 | Rake $0.09 | Jackpot $0 | Bingo $0 | Fortune $0 | Tax $0
Seat 3: 2e33682b (button) collected ($1.81)
Seat 4: 5ff083b4 (small blind) folded before Flop
Seat 5: 8c1ff383 (big blind) folded before Flop
Seat 6: Hero folded before Flop (didn't bet)


Poker Hand #HD1788720177: Hold'em No Limit ($0.05/$0.1) - 2024/05/26 18:34:25
Table 'NLHRed17' 6-max Seat #6 is the button
Seat 3: 2e33682b ($10.32 in chips)
Seat 4: 5ff083b4 ($18.25 in chips)
Seat 5: 8c1ff383 ($3.67 in chips)
Seat 6: Hero ($24.76 in chips)
2e33682b: posts small blind $0.05
5ff083b4: posts big blind $0.1
*** HOLE CARDS ***
Dealt to 2e33682b 
Dealt to 5ff083b4 
Dealt to 8c1ff383 
Dealt to Hero [Jh 8h]
8c1ff383: folds
Hero: raises $0.14 to $0.24
2e33682b: folds
5ff083b4: folds
Uncalled bet ($0.14) returned to Hero
*** SHOWDOWN ***
Hero collected $0.25 from pot
*** SUMMARY ***
Total pot $0.25 | Rake $0 | Jackpot $0 | Bingo $0 | Fortune $0 | Tax $0
Seat 3: 2e33682b (small blind) folded before Flop
Seat 4: 5ff083b4 (big blind) folded before Flop
Seat 5: 8c1ff383 folded before Flop (didn't bet)
Seat 6: Hero (button) collected ($0.25)


Poker Hand #HD1788720122: Hold'em No Limit ($0.05/$0.1) - 2024/05/26 18:34:02
Table 'NLHRed17' 6-max Seat #5 is the button
Seat 3: 2e33682b ($10 in chips)
Seat 4: 5ff083b4 ($18.25 in chips)
Seat 5: 8c1ff383 ($3.97 in chips)
Seat 6: Hero ($24.81 in chips)
Hero: posts small blind $0.05
2e33682b: posts big blind $0.1
*** HOLE CARDS ***
Dealt to 2e33682b 
Dealt to 5ff083b4 
Dealt to 8c1ff383 
Dealt to Hero [6d Ks]
5ff083b4: folds
8c1ff383: raises $0.2 to $0.3
Hero: folds
2e33682b: raises $0.9 to $1.2
8c1ff383: folds
Uncalled bet ($0.9) returned to 2e33682b
*** SHOWDOWN ***
2e33682b collected $0.62 from pot
*** SUMMARY ***
Total pot $0.65 | Rake $0.03 | Jackpot $0 | Bingo $0 | Fortune $0 | Tax $0
Seat 3: 2e33682b (big blind) collected ($0.62)
Seat 4: 5ff083b4 folded before Flop (didn't bet)
Seat 5: 8c1ff383 (button) folded before Flop
Seat 6: Hero (small blind) folded before Flop


Poker Hand #HD1788720085: Hold'em No Limit ($0.05/$0.1) - 2024/05/26 18:33:45
Table 'NLHRed17' 6-max Seat #4 is the button
Seat 3: 2e33682b ($10 in chips)
Seat 4: 5ff083b4 ($18.25 in chips)
Seat 5: 8c1ff383 ($4.02 in chips)
Seat 6: Hero ($24.76 in chips)
8c1ff383: posts small blind $0.05
Hero: posts big blind $0.1
*** HOLE CARDS ***
Dealt to 2e33682b 
Dealt to 5ff083b4 
Dealt to 8c1ff383 
Dealt to Hero [3h 6c]
2e33682b: folds
5ff083b4: folds
8c1ff383: folds
Uncalled bet ($0.05) returned to Hero
*** SHOWDOWN ***
Hero collected $0.1 from pot
*** SUMMARY ***
Total pot $0.1 | Rake $0 | Jackpot $0 | Bingo $0 | Fortune $0 | Tax $0
Seat 3: 2e33682b folded before Flop (didn't bet)
Seat 4: 5ff083b4 (button) folded before Flop (didn't bet)
Seat 5: 8c1ff383 (small blind) folded before Flop
Seat 6: Hero (big blind) collected ($0.1)


Poker Hand #HD1788720041: Hold'em No Limit ($0.05/$0.1) - 2024/05/26 18:33:21
Table 'NLHRed17' 6-max Seat #3 is the button
Seat 3: 2e33682b ($10 in chips)
Seat 4: 5ff083b4 ($18.75 in chips)
Seat 5: 8c1ff383 ($3.57 in chips)
Seat 6: Hero ($24.76 in chips)
5ff083b4: posts small blind $0.05
8c1ff383: posts big blind $0.1
*** HOLE CARDS ***
Dealt to 2e33682b 
Dealt to 5ff083b4 
Dealt to 8c1ff383 
Dealt to Hero [Ks 7c]
Hero: folds
2e33682b: folds
5ff083b4: raises $0.2 to $0.3
8c1ff383: calls $0.2
*** FLOP *** [Qs 8s Kc]
5ff083b4: bets $0.2
8c1ff383: raises $0.5 to $0.7
5ff083b4: folds
Uncalled bet ($0.5) returned to 8c1ff383
*** SHOWDOWN ***
8c1ff383 collected $0.95 from pot
*** SUMMARY ***
Total pot $1 | Rake $0.05 | Jackpot $0 | Bingo $0 | Fortune $0 | Tax $0
Board [Qs 8s Kc]
Seat 3: 2e33682b (button) folded before Flop (didn't bet)
Seat 4: 5ff083b4 (small blind) folded on the Flop
Seat 5: 8c1ff383 (big blind) won ($0.95)
Seat 6: Hero folded before Flop (didn't bet)


Poker Hand #HD1788720010: Hold'em No Limit ($0.05/$0.1) - 2024/05/26 18:33:09
Table 'NLHRed17' 6-max Seat #6 is the button
Seat 3: 2e33682b ($10 in chips)
Seat 4: 5ff083b4 ($18.7 in chips)
Seat 5: 8c1ff383 ($3.57 in chips)
Seat 6: Hero ($24.76 in chips)
2e33682b: posts small blind $0.05
5ff083b4: posts big blind $0.1
*** HOLE CARDS ***
Dealt to 2e33682b 
Dealt to 5ff083b4 
Dealt to 8c1ff383 
Dealt to Hero [7d 2h]
8c1ff383: folds
Hero: folds
2e33682b: folds
Uncalled bet ($0.05) returned to 5ff083b4
*** SHOWDOWN ***
5ff083b4 collected $0.1 from pot
*** SUMMARY ***
Total pot $0.1 | Rake $0 | Jackpot $0 | Bingo $0 | Fortune $0 | Tax $0
Seat 3: 2e33682b (small blind) folded before Flop
Seat 4: 5ff083b4 (big blind) collected ($0.1)
Seat 5: 8c1ff383 folded before Flop (didn't bet)
Seat 6: Hero (button) folded before Flop (didn't bet)


Poker Hand #HD1788719970: Hold'em No Limit ($0.05/$0.1) - 2024/05/26 18:32:48
Table 'NLHRed17' 6-max Seat #5 is the button
Seat 3: 2e33682b ($10 in chips)
Seat 4: 5ff083b4 ($18.7 in chips)
Seat 5: 8c1ff383 ($3.42 in chips)
Seat 6: Hero ($24.81 in chips)
Hero: posts small blind $0.05
2e33682b: posts big blind $0.1
*** HOLE CARDS ***
Dealt to 2e33682b 
Dealt to 5ff083b4 
Dealt to 8c1ff383 
Dealt to Hero [5d 5s]
5ff083b4: folds
8c1ff383: raises $0.1 to $0.2
Hero: folds
2e33682b: folds
Uncalled bet ($0.1) returned to 8c1ff383
*** SHOWDOWN ***
8c1ff383 collected $0.25 from pot
*** SUMMARY ***
Total pot $0.25 | Rake $0 | Jackpot $0 | Bingo $0 | Fortune $0 | Tax $0
Seat 3: 2e33682b (big blind) folded before Flop
Seat 4: 5ff083b4 folded before Flop (didn't bet)
Seat 5: 8c1ff383 (button) collected ($0.25)
Seat 6: Hero (small blind) folded before Flop


Poker Hand #HD1788719927: Hold'em No Limit ($0.05/$0.1) - 2024/05/26 18:32:31
Table 'NLHRed17' 6-max Seat #4 is the button
Seat 3: 2e33682b ($10 in chips)
Seat 4: 5ff083b4 ($18.7 in chips)
Seat 5: 8c1ff383 ($3.32 in chips)
Seat 6: Hero ($24.91 in chips)
8c1ff383: posts small blind $0.05
Hero: posts big blind $0.1
*** HOLE CARDS ***
Dealt to 2e33682b 
Dealt to 5ff083b4 
Dealt to 8c1ff383 
Dealt to Hero [Qc 6h]
2e33682b: folds
5ff083b4: folds
8c1ff383: raises $0.3 to $0.4
Hero: folds
Uncalled bet ($0.3) returned to 8c1ff383
*** SHOWDOWN ***
8c1ff383 collected $0.2 from pot
*** SUMMARY ***
Total pot $0.2 | Rake $0 | Jackpot $0 | Bingo $0 | Fortune $0 | Tax $0
Seat 3: 2e33682b folded before Flop (didn't bet)
Seat 4: 5ff083b4 (button) folded before Flop (didn't bet)
Seat 5: 8c1ff383 (small blind) collected ($0.2)
Seat 6: Hero (big blind) folded before Flop


Poker Hand #HD1788719875: Hold'em No Limit ($0.05/$0.1) - 2024/05/26 18:32:08
Table 'NLHRed17' 6-max Seat #3 is the button
Seat 3: 2e33682b ($10 in chips)
Seat 4: 5ff083b4 ($18.6 in chips)
Seat 5: 8c1ff383 ($3.42 in chips)
Seat 6: Hero ($24.91 in chips)
5ff083b4: posts small blind $0.05
8c1ff383: posts big blind $0.1
*** HOLE CARDS ***
Dealt to 2e33682b 
Dealt to 5ff083b4 
Dealt to 8c1ff383 
Dealt to Hero [5s Ad]
Hero: folds
2e33682b: folds
5ff083b4: raises $0.2 to $0.3
8c1ff383: folds
Uncalled bet ($0.2) returned to 5ff083b4
*** SHOWDOWN ***
5ff083b4 collected $0.2 from pot
*** SUMMARY ***
Total pot $0.2 | Rake $0 | Jackpot $0 | Bingo $0 | Fortune $0 | Tax $0
Seat 3: 2e33682b (button) folded before Flop (didn't bet)
Seat 4: 5ff083b4 (small blind) collected ($0.2)
Seat 5: 8c1ff383 (big blind) folded before Flop
Seat 6: Hero folded before Flop (didn't bet)


Poker Hand #HD1788719770: Hold'em No Limit ($0.05/$0.1) - 2024/05/26 18:31:18
Table 'NLHRed17' 6-max Seat #6 is the button
Seat 3: 2e33682b ($10.05 in chips)
Seat 4: 5ff083b4 ($19.34 in chips)
Seat 5: 8c1ff383 ($2.7 in chips)
Seat 6: Hero ($24.91 in chips)
2e33682b: posts small blind $0.05
5ff083b4: posts big blind $0.1
*** HOLE CARDS ***
Dealt to 2e33682b 
Dealt to 5ff083b4 
Dealt to 8c1ff383 
Dealt to Hero [Jc 3h]
8c1ff383: raises $0.1 to $0.2
Hero: folds
2e33682b: folds
5ff083b4: calls $0.1
*** FLOP *** [Qc 3s 4s]
5ff083b4: checks
8c1ff383: bets $0.23
5ff083b4: calls $0.23
*** TURN *** [Qc 3s 4s] [2s]
5ff083b4: bets $0.31
8c1ff383: calls $0.31
*** RIVER *** [Qc 3s 4s 2s] [5h]
5ff083b4: checks
8c1ff383: bets $1.96 and is all-in
5ff083b4: folds
Uncalled bet ($1.96) returned to 8c1ff383
*** SHOWDOWN ***
8c1ff383 collected $1.46 from pot
*** SUMMARY ***
Total pot $1.53 | Rake $0.07 | Jackpot $0 | Bingo $0 | Fortune $0 | Tax $0
Board [Qc 3s 4s 2s 5h]
Seat 3: 2e33682b (small blind) folded before Flop
Seat 4: 5ff083b4 (big blind) folded on the River
Seat 5: 8c1ff383 won ($1.46)
Seat 6: Hero (button) folded before Flop (didn't bet)


Poker Hand #HD1788719754: Hold'em No Limit ($0.05/$0.1) - 2024/05/26 18:31:11
Table 'NLHRed17' 6-max Seat #5 is the button
Seat 3: 2e33682b ($10 in chips)
Seat 4: 5ff083b4 ($19.34 in chips)
Seat 5: 8c1ff383 ($2.7 in chips)
Seat 6: Hero ($24.96 in chips)
Hero: posts small blind $0.05
2e33682b: posts big blind $0.1
*** HOLE CARDS ***
Dealt to 2e33682b 
Dealt to 5ff083b4 
Dealt to 8c1ff383 
Dealt to Hero [Qs 4d]
5ff083b4: folds
8c1ff383: folds
Hero: folds
Uncalled bet ($0.05) returned to 2e33682b
*** SHOWDOWN ***
2e33682b collected $0.1 from pot
*** SUMMARY ***
Total pot $0.1 | Rake $0 | Jackpot $0 | Bingo $0 | Fortune $0 | Tax $0
Seat 3: 2e33682b (big blind) collected ($0.1)
Seat 4: 5ff083b4 folded before Flop (didn't bet)
Seat 5: 8c1ff383 (button) folded before Flop (didn't bet)
Seat 6: Hero (small blind) folded before Flop


Poker Hand #HD1788719731: Hold'em No Limit ($0.05/$0.1) - 2024/05/26 18:30:56
Table 'NLHRed17' 6-max Seat #4 is the button
Seat 1: d2046be3 ($15.28 in chips)
Seat 2: aaa36d80 ($11.13 in chips)
Seat 4: 5ff083b4 ($19.34 in chips)
Seat 5: 8c1ff383 ($2.75 in chips)
Seat 6: Hero ($25.06 in chips)
8c1ff383: posts small blind $0.05
Hero: posts big blind $0.1
*** HOLE CARDS ***
Dealt to d2046be3 
Dealt to aaa36d80 
Dealt to 5ff083b4 
Dealt to 8c1ff383 
Dealt to Hero [Ad 7h]
d2046be3: folds
aaa36d80: raises $0.14 to $0.24
5ff083b4: folds
8c1ff383: folds
Hero: folds
Uncalled bet ($0.14) returned to aaa36d80
*** SHOWDOWN ***
aaa36d80 collected $0.25 from pot
*** SUMMARY ***
Total pot $0.25 | Rake $0 | Jackpot $0 | Bingo $0 | Fortune $0 | Tax $0
Seat 1: d2046be3 folded before Flop (didn't bet)
Seat 2: aaa36d80 collected ($0.25)
Seat 4: 5ff083b4 (button) folded before Flop (didn't bet)
Seat 5: 8c1ff383 (small blind) folded before Flop
Seat 6: Hero (big blind) folded before Flop


Poker Hand #HD1788719664: Hold'em No Limit ($0.05/$0.1) - 2024/05/26 18:30:28
Table 'NLHRed17' 6-max Seat #2 is the button
Seat 1: d2046be3 ($15.28 in chips)
Seat 2: aaa36d80 ($10.59 in chips)
Seat 4: 5ff083b4 ($19.39 in chips)
Seat 5: 8c1ff383 ($3.29 in chips)
Seat 6: Hero ($25.06 in chips)
5ff083b4: posts small blind $0.05
8c1ff383: posts big blind $0.1
*** HOLE CARDS ***
Dealt to d2046be3 
Dealt to aaa36d80 
Dealt to 5ff083b4 
Dealt to 8c1ff383 
Dealt to Hero [8s 2c]
Hero: folds
d2046be3: folds
aaa36d80: raises $0.14 to $0.24
5ff083b4: folds
8c1ff383: calls $0.14
*** FLOP *** [5h 8d 9s]
8c1ff383: checks
aaa36d80: bets $0.3
8c1ff383: calls $0.3
*** TURN *** [5h 8d 9s] [2h]
8c1ff383: checks
aaa36d80: bets $0.85
8c1ff383: folds
Uncalled bet ($0.85) returned to aaa36d80
*** SHOWDOWN ***
aaa36d80 collected $1.08 from pot
*** SUMMARY ***
Total pot $1.13 | Rake $0.05 | Jackpot $0 | Bingo $0 | Fortune $0 | Tax $0
Board [5h 8d 9s 2h]
Seat 1: d2046be3 folded before Flop (didn't bet)
Seat 2: aaa36d80 (button) won ($1.08)
Seat 4: 5ff083b4 (small blind) folded before Flop
Seat 5: 8c1ff383 (big blind) folded on the Turn
Seat 6: Hero folded before Flop (didn't bet)


Poker Hand #HD1788719565: Hold'em No Limit ($0.05/$0.1) - 2024/05/26 18:29:39
Table 'NLHRed17' 6-max Seat #1 is the button
Seat 1: d2046be3 ($14.83 in chips)
Seat 2: aaa36d80 ($10.64 in chips)
Seat 4: 5ff083b4 ($19.83 in chips)
Seat 5: 8c1ff383 ($3.29 in chips)
Seat 6: Hero ($25.06 in chips)
aaa36d80: posts small blind $0.05
5ff083b4: posts big blind $0.1
*** HOLE CARDS ***
Dealt to d2046be3 
Dealt to aaa36d80 
Dealt to 5ff083b4 
Dealt to 8c1ff383 
Dealt to Hero [9h 8c]
8c1ff383: folds
Hero: folds
d2046be3: raises $0.15 to $0.25
aaa36d80: folds
5ff083b4: calls $0.15
*** FLOP *** [7c Jd 6c]
5ff083b4: checks
d2046be3: bets $0.19
5ff083b4: calls $0.19
*** TURN *** [7c Jd 6c] [Kh]
5ff083b4: checks
d2046be3: bets $0.7
5ff083b4: folds
Uncalled bet ($0.7) returned to d2046be3
*** SHOWDOWN ***
d2046be3 collected $0.89 from pot
*** SUMMARY ***
Total pot $0.93 | Rake $0.04 | Jackpot $0 | Bingo $0 | Fortune $0 | Tax $0
Board [7c Jd 6c Kh]
Seat 1: d2046be3 (button) won ($0.89)
Seat 2: aaa36d80 (small blind) folded before Flop
Seat 4: 5ff083b4 (big blind) folded on the Turn
Seat 5: 8c1ff383 folded before Flop (didn't bet)
Seat 6: Hero folded before Flop (didn't bet)


Poker Hand #HD1788719394: Hold'em No Limit ($0.05/$0.1) - 2024/05/26 18:28:18
Table 'NLHRed17' 6-max Seat #6 is the button
Seat 1: d2046be3 ($14.88 in chips)
Seat 2: aaa36d80 ($10.74 in chips)
Seat 3: 77fce0a2 ($9.88 in chips)
Seat 4: 5ff083b4 ($10 in chips)
Seat 5: 8c1ff383 ($4.19 in chips)
Seat 6: Hero ($25.06 in chips)
d2046be3: posts small blind $0.05
aaa36d80: posts big blind $0.1
*** HOLE CARDS ***
Dealt to d2046be3 
Dealt to aaa36d80 
Dealt to 77fce0a2 
Dealt to 5ff083b4 
Dealt to 8c1ff383 
Dealt to Hero [2c 8d]
77fce0a2: raises $0.2 to $0.3
5ff083b4: raises $0.6 to $0.9
8c1ff383: calls $0.9
Hero: folds
d2046be3: folds
aaa36d80: folds
77fce0a2: calls $0.6
*** FLOP *** [6s 4c Qc]
77fce0a2: checks
5ff083b4: checks
8c1ff383: checks
*** TURN *** [6s 4c Qc] [4s]
77fce0a2: bets $1.65
5ff083b4: calls $1.65
8c1ff383: folds
*** RIVER *** [6s 4c Qc 4s] [5s]
77fce0a2: bets $7.33 and is all-in
5ff083b4: calls $7.33
77fce0a2: shows [Ac Qh] (Pair of Queens and Pair of Fours)
5ff083b4: shows [6c 6d] (Sixes Full over Fours)
*** SHOWDOWN ***
5ff083b4 collected $19.71 from pot
*** SUMMARY ***
Total pot $20.81 | Rake $1 | Jackpot $0.1 | Bingo $0 | Fortune $0 | Tax $0
Board [6s 4c Qc 4s 5s]
Seat 1: d2046be3 (small blind) folded before Flop
Seat 2: aaa36d80 (big blind) folded before Flop
Seat 3: 77fce0a2 showed [Ac Qh] and lost with Pair of Queens and Pair of Fours
Seat 4: 5ff083b4 showed [6c 6d] and won ($19.71) with Sixes Full over Fours
Seat 5: 8c1ff383 folded on the Turn
Seat 6: Hero (button) folded before Flop (didn't bet)


Poker Hand #HD1788719290: Hold'em No Limit ($0.05/$0.1) - 2024/05/26 18:27:25
Table 'NLHRed17' 6-max Seat #5 is the button
Seat 1: d2046be3 ($14.98 in chips)
Seat 2: aaa36d80 ($10.98 in chips)
Seat 3: 77fce0a2 ($9.88 in chips)
Seat 4: 5ff083b4 ($11.6 in chips)
Seat 5: 8c1ff383 ($2.06 in chips)
Seat 6: Hero ($25.11 in chips)
Hero: posts small blind $0.05
d2046be3: posts big blind $0.1
*** HOLE CARDS ***
Dealt to d2046be3 
Dealt to aaa36d80 
Dealt to 77fce0a2 
Dealt to 5ff083b4 
Dealt to 8c1ff383 
Dealt to Hero [9h Tc]
aaa36d80: raises $0.14 to $0.24
77fce0a2: folds
5ff083b4: raises $0.56 to $0.8
8c1ff383: raises $1.26 to $2.06 and is all-in
Hero: folds
d2046be3: folds
aaa36d80: folds
5ff083b4: calls $1.26
8c1ff383: shows [Ah Ac]
5ff083b4: shows [8h 8d]
*** FLOP *** [Ad 6h Js]
*** TURN *** [Ad 6h Js] [2h]
*** RIVER *** [Ad 6h Js 2h] [Jd]
*** SHOWDOWN ***
8c1ff383 collected $4.19 from pot
*** SUMMARY ***
Total pot $4.51 | Rake $0.22 | Jackpot $0.1 | Bingo $0 | Fortune $0 | Tax $0
Board [Ad 6h Js 2h Jd]
Seat 1: d2046be3 (big blind) folded before Flop
Seat 2: aaa36d80 folded before Flop
Seat 3: 77fce0a2 folded before Flop (didn't bet)
Seat 4: 5ff083b4 showed [8h 8d] and lost with Pair of Jacks and Pair of Eights
Seat 5: 8c1ff383 (button) showed [Ah Ac] and won ($4.19) with Aces Full over Jacks
Seat 6: Hero (small blind) folded before Flop


Poker Hand #HD1788719223: Hold'em No Limit ($0.05/$0.1) - 2024/05/26 18:26:49
Table 'NLHRed17' 6-max Seat #4 is the button
Seat 1: d2046be3 ($14.98 in chips)
Seat 2: aaa36d80 ($10.44 in chips)
Seat 3: 77fce0a2 ($9.88 in chips)
Seat 4: 5ff083b4 ($11.6 in chips)
Seat 5: 8c1ff383 ($2.55 in chips)
Seat 6: Hero ($25.21 in chips)
8c1ff383: posts small blind $0.05
Hero: posts big blind $0.1
*** HOLE CARDS ***
Dealt to d2046be3 
Dealt to aaa36d80 
Dealt to 77fce0a2 
Dealt to 5ff083b4 
Dealt to 8c1ff383 
Dealt to Hero [7h 4d]
d2046be3: folds
aaa36d80: raises $0.14 to $0.24
77fce0a2: folds
5ff083b4: folds
8c1ff383: calls $0.19
Hero: folds
*** FLOP *** [8d 5c 4h]
8c1ff383: checks
aaa36d80: bets $0.25
8c1ff383: calls $0.25
*** TURN *** [8d 5c 4h] [As]
8c1ff383: checks
aaa36d80: bets $0.6
8c1ff383: folds
Uncalled bet ($0.6) returned to aaa36d80
*** SHOWDOWN ***
aaa36d80 collected $1.03 from pot
*** SUMMARY ***
Total pot $1.08 | Rake $0.05 | Jackpot $0 | Bingo $0 | Fortune $0 | Tax $0
Board [8d 5c 4h As]
Seat 1: d2046be3 folded before Flop (didn't bet)
Seat 2: aaa36d80 won ($1.03)
Seat 3: 77fce0a2 folded before Flop (didn't bet)
Seat 4: 5ff083b4 (button) folded before Flop (didn't bet)
Seat 5: 8c1ff383 (small blind) folded on the Turn
Seat 6: Hero (big blind) folded before Flop


Poker Hand #HD1788719146: Hold'em No Limit ($0.05/$0.1) - 2024/05/26 18:26:05
Table 'NLHRed17' 6-max Seat #3 is the button
Seat 1: d2046be3 ($14.98 in chips)
Seat 2: aaa36d80 ($10.44 in chips)
Seat 3: 77fce0a2 ($9.88 in chips)
Seat 4: 5ff083b4 ($10.47 in chips)
Seat 5: 8c1ff383 ($3.8 in chips)
Seat 6: Hero ($25.21 in chips)
5ff083b4: posts small blind $0.05
8c1ff383: posts big blind $0.1
*** HOLE CARDS ***
Dealt to d2046be3 
Dealt to aaa36d80 
Dealt to 77fce0a2 
Dealt to 5ff083b4 
Dealt to 8c1ff383 
Dealt to Hero [5h 2s]
Hero: folds
d2046be3: folds
aaa36d80: folds
77fce0a2: folds
5ff083b4: raises $0.2 to $0.3
8c1ff383: calls $0.2
*** FLOP *** [Ts 8h 4c]
5ff083b4: checks
8c1ff383: checks
*** TURN *** [Ts 8h 4c] [5c]
5ff083b4: bets $0.45
8c1ff383: calls $0.45
*** RIVER *** [Ts 8h 4c 5c] [9h]
5ff083b4: bets $0.5
8c1ff383: calls $0.5
5ff083b4: shows [Th 6h] (Pair of Tens)
8c1ff383: shows [3s 5s] (Pair of Fives)
*** SHOWDOWN ***
5ff083b4 collected $2.38 from pot
*** SUMMARY ***
Total pot $2.5 | Rake $0.12 | Jackpot $0 | Bingo $0 | Fortune $0 | Tax $0
Board [Ts 8h 4c 5c 9h]
Seat 1: d2046be3 folded before Flop (didn't bet)
Seat 2: aaa36d80 folded before Flop (didn't bet)
Seat 3: 77fce0a2 (button) folded before Flop (didn't bet)
Seat 4: 5ff083b4 (small blind) showed [Th 6h] and won ($2.38) with Pair of Tens
Seat 5: 8c1ff383 (big blind) showed [3s 5s] and lost with Pair of Fives
Seat 6: Hero folded before Flop (didn't bet)


Poker Hand #HD1788719116: Hold'em No Limit ($0.05/$0.1) - 2024/05/26 18:25:50
Table 'NLHRed17' 6-max Seat #2 is the button
Seat 1: d2046be3 ($14.98 in chips)
Seat 2: aaa36d80 ($10.44 in chips)
Seat 3: 77fce0a2 ($9.93 in chips)
Seat 4: 5ff083b4 ($10.42 in chips)
Seat 6: Hero ($25.21 in chips)
77fce0a2: posts small blind $0.05
5ff083b4: posts big blind $0.1
*** HOLE CARDS ***
Dealt to d2046be3 
Dealt to aaa36d80 
Dealt to 77fce0a2 
Dealt to 5ff083b4 
Dealt to Hero [2s 9s]
Hero: folds
d2046be3: folds
aaa36d80: folds
77fce0a2: folds
Uncalled bet ($0.05) returned to 5ff083b4
*** SHOWDOWN ***
5ff083b4 collected $0.1 from pot
*** SUMMARY ***
Total pot $0.1 | Rake $0 | Jackpot $0 | Bingo $0 | Fortune $0 | Tax $0
Seat 1: d2046be3 folded before Flop (didn't bet)
Seat 2: aaa36d80 (button) folded before Flop (didn't bet)
Seat 3: 77fce0a2 (small blind) folded before Flop
Seat 4: 5ff083b4 (big blind) collected ($0.1)
Seat 6: Hero folded before Flop (didn't bet)


Poker Hand #HD1788719075: Hold'em No Limit ($0.05/$0.1) - 2024/05/26 18:25:22
Table 'NLHRed17' 6-max Seat #1 is the button
Seat 1: d2046be3 ($14.98 in chips)
Seat 2: aaa36d80 ($10.49 in chips)
Seat 3: 77fce0a2 ($10.03 in chips)
Seat 4: 5ff083b4 ($10.42 in chips)
Seat 6: Hero ($25.06 in chips)
aaa36d80: posts small blind $0.05
77fce0a2: posts big blind $0.1
*** HOLE CARDS ***
Dealt to d2046be3 
Dealt to aaa36d80 
Dealt to 77fce0a2 
Dealt to 5ff083b4 
Dealt to Hero [7s Ah]
5ff083b4: folds
Hero: raises $0.14 to $0.24
d2046be3: folds
aaa36d80: folds
77fce0a2: folds
Uncalled bet ($0.14) returned to Hero
*** SHOWDOWN ***
Hero collected $0.25 from pot
*** SUMMARY ***
Total pot $0.25 | Rake $0 | Jackpot $0 | Bingo $0 | Fortune $0 | Tax $0
Seat 1: d2046be3 (button) folded before Flop (didn't bet)
Seat 2: aaa36d80 (small blind) folded before Flop
Seat 3: 77fce0a2 (big blind) folded before Flop
Seat 4: 5ff083b4 folded before Flop (didn't bet)
Seat 6: Hero collected ($0.25)


Poker Hand #HD1788719038: Hold'em No Limit ($0.05/$0.1) - 2024/05/26 18:24:59
Table 'NLHRed17' 6-max Seat #6 is the button
Seat 1: d2046be3 ($15.03 in chips)
Seat 2: aaa36d80 ($10.44 in chips)
Seat 3: 77fce0a2 ($10.03 in chips)
Seat 4: 5ff083b4 ($10.42 in chips)
Seat 5: a3b0c510 ($10.25 in chips)
Seat 6: Hero ($25.06 in chips)
d2046be3: posts small blind $0.05
aaa36d80: posts big blind $0.1
*** HOLE CARDS ***
Dealt to d2046be3 
Dealt to aaa36d80 
Dealt to 77fce0a2 
Dealt to 5ff083b4 
Dealt to a3b0c510 
Dealt to Hero [4h 3s]
77fce0a2: folds
5ff083b4: folds
a3b0c510: folds
Hero: folds
d2046be3: folds
Uncalled bet ($0.05) returned to aaa36d80
*** SHOWDOWN ***
aaa36d80 collected $0.1 from pot
*** SUMMARY ***
Total pot $0.1 | Rake $0 | Jackpot $0 | Bingo $0 | Fortune $0 | Tax $0
Seat 1: d2046be3 (small blind) folded before Flop
Seat 2: aaa36d80 (big blind) collected ($0.1)
Seat 3: 77fce0a2 folded before Flop (didn't bet)
Seat 4: 5ff083b4 folded before Flop (didn't bet)
Seat 5: a3b0c510 folded before Flop (didn't bet)
Seat 6: Hero (button) folded before Flop (didn't bet)


Poker Hand #HD1788718945: Hold'em No Limit ($0.05/$0.1) - 2024/05/26 18:24:11
Table 'NLHRed17' 6-max Seat #5 is the button
Seat 1: d2046be3 ($15.13 in chips)
Seat 2: aaa36d80 ($10.44 in chips)
Seat 3: 77fce0a2 ($10.33 in chips)
Seat 4: 5ff083b4 ($10 in chips)
Seat 5: a3b0c510 ($10.25 in chips)
Seat 6: Hero ($25.11 in chips)
Hero: posts small blind $0.05
d2046be3: posts big blind $0.1
*** HOLE CARDS ***
Dealt to d2046be3 
Dealt to aaa36d80 
Dealt to 77fce0a2 
Dealt to 5ff083b4 
Dealt to a3b0c510 
Dealt to Hero [9s 9d]
aaa36d80: folds
77fce0a2: raises $0.2 to $0.3
5ff083b4: raises $0.7 to $1
a3b0c510: folds
Hero: folds
d2046be3: folds
77fce0a2: folds
Uncalled bet ($0.7) returned to 5ff083b4
*** SHOWDOWN ***
5ff083b4 collected $0.72 from pot
*** SUMMARY ***
Total pot $0.75 | Rake $0.03 | Jackpot $0 | Bingo $0 | Fortune $0 | Tax $0
Seat 1: d2046be3 (big blind) folded before Flop
Seat 2: aaa36d80 folded before Flop (didn't bet)
Seat 3: 77fce0a2 folded before Flop
Seat 4: 5ff083b4 collected ($0.72)
Seat 5: a3b0c510 (button) folded before Flop (didn't bet)
Seat 6: Hero (small blind) folded before Flop


Poker Hand #HD1788718899: Hold'em No Limit ($0.05/$0.1) - 2024/05/26 18:23:50
Table 'NLHRed17' 6-max Seat #4 is the button
Seat 1: d2046be3 ($15.13 in chips)
Seat 2: aaa36d80 ($10.29 in chips)
Seat 3: 77fce0a2 ($10.33 in chips)
Seat 4: 5ff083b4 ($10 in chips)
Seat 5: a3b0c510 ($10.3 in chips)
Seat 6: Hero ($25.21 in chips)
a3b0c510: posts small blind $0.05
Hero: posts big blind $0.1
*** HOLE CARDS ***
Dealt to d2046be3 
Dealt to aaa36d80 
Dealt to 77fce0a2 
Dealt to 5ff083b4 
Dealt to a3b0c510 
Dealt to Hero [9d Kc]
d2046be3: folds
aaa36d80: raises $0.14 to $0.24
77fce0a2: folds
5ff083b4: folds
a3b0c510: folds
Hero: folds
Uncalled bet ($0.14) returned to aaa36d80
*** SHOWDOWN ***
aaa36d80 collected $0.25 from pot
*** SUMMARY ***
Total pot $0.25 | Rake $0 | Jackpot $0 | Bingo $0 | Fortune $0 | Tax $0
Seat 1: d2046be3 folded before Flop (didn't bet)
Seat 2: aaa36d80 collected ($0.25)
Seat 3: 77fce0a2 folded before Flop (didn't bet)
Seat 4: 5ff083b4 (button) folded before Flop (didn't bet)
Seat 5: a3b0c510 (small blind) folded before Flop
Seat 6: Hero (big blind) folded before Flop


Poker Hand #HD1788718861: Hold'em No Limit ($0.05/$0.1) - 2024/05/26 18:23:29
Table 'NLHRed17' 6-max Seat #3 is the button
Seat 1: d2046be3 ($15.13 in chips)
Seat 2: aaa36d80 ($10.29 in chips)
Seat 3: 77fce0a2 ($10.33 in chips)
Seat 4: 5ff083b4 ($10 in chips)
Seat 5: a3b0c510 ($10.25 in chips)
Seat 6: Hero ($25.21 in chips)
5ff083b4: posts small blind $0.05
a3b0c510: posts big blind $0.1
*** HOLE CARDS ***
Dealt to d2046be3 
Dealt to aaa36d80 
Dealt to 77fce0a2 
Dealt to 5ff083b4 
Dealt to a3b0c510 
Dealt to Hero [7c Jd]
Hero: folds
d2046be3: folds
aaa36d80: folds
77fce0a2: folds
5ff083b4: folds
Uncalled bet ($0.05) returned to a3b0c510
*** SHOWDOWN ***
a3b0c510 collected $0.1 from pot
*** SUMMARY ***
Total pot $0.1 | Rake $0 | Jackpot $0 | Bingo $0 | Fortune $0 | Tax $0
Seat 1: d2046be3 folded before Flop (didn't bet)
Seat 2: aaa36d80 folded before Flop (didn't bet)
Seat 3: 77fce0a2 (button) folded before Flop (didn't bet)
Seat 4: 5ff083b4 (small blind) folded before Flop
Seat 5: a3b0c510 (big blind) collected ($0.1)
Seat 6: Hero folded before Flop (didn't bet)


Poker Hand #HD1788718818: Hold'em No Limit ($0.05/$0.1) - 2024/05/26 18:23:11
Table 'NLHRed17' 6-max Seat #2 is the button
Seat 1: d2046be3 ($14.98 in chips)
Seat 2: aaa36d80 ($10.29 in chips)
Seat 3: 77fce0a2 ($10.38 in chips)
Seat 4: 5ff083b4 ($10 in chips)
Seat 5: a3b0c510 ($10.25 in chips)
Seat 6: Hero ($25.21 in chips)
77fce0a2: posts small blind $0.05
5ff083b4: posts big blind $0.1
*** HOLE CARDS ***
Dealt to d2046be3 
Dealt to aaa36d80 
Dealt to 77fce0a2 
Dealt to 5ff083b4 
Dealt to a3b0c510 
Dealt to Hero [2d 6d]
a3b0c510: folds
Hero: folds
d2046be3: raises $0.15 to $0.25
aaa36d80: folds
77fce0a2: folds
5ff083b4: folds
Uncalled bet ($0.15) returned to d2046be3
*** SHOWDOWN ***
d2046be3 collected $0.25 from pot
*** SUMMARY ***
Total pot $0.25 | Rake $0 | Jackpot $0 | Bingo $0 | Fortune $0 | Tax $0
Seat 1: d2046be3 collected ($0.25)
Seat 2: aaa36d80 (button) folded before Flop (didn't bet)
Seat 3: 77fce0a2 (small blind) folded before Flop
Seat 4: 5ff083b4 (big blind) folded before Flop
Seat 5: a3b0c510 folded before Flop (didn't bet)
Seat 6: Hero folded before Flop (didn't bet)


Poker Hand #HD1788718692: Hold'em No Limit ($0.05/$0.1) - 2024/05/26 18:22:05
Table 'NLHRed17' 6-max Seat #1 is the button
Seat 1: d2046be3 ($14.98 in chips)
Seat 2: aaa36d80 ($10.34 in chips)
Seat 3: 77fce0a2 ($10.6 in chips)
Seat 4: 5ff083b4 ($10 in chips)
Seat 5: a3b0c510 ($10 in chips)
Seat 6: Hero ($25.21 in chips)
aaa36d80: posts small blind $0.05
77fce0a2: posts big blind $0.1
*** HOLE CARDS ***
Dealt to d2046be3 
Dealt to aaa36d80 
Dealt to 77fce0a2 
Dealt to 5ff083b4 
Dealt to a3b0c510 
Dealt to Hero [3h 6s]
5ff083b4: folds
a3b0c510: raises $0.12 to $0.22
Hero: folds
d2046be3: folds
aaa36d80: folds
77fce0a2: calls $0.12
*** FLOP *** [Th Js Qc]
77fce0a2: checks
a3b0c510: checks
*** TURN *** [Th Js Qc] [4h]
77fce0a2: checks
a3b0c510: bets $0.32
77fce0a2: folds
Uncalled bet ($0.32) returned to a3b0c510
*** SHOWDOWN ***
a3b0c510 collected $0.47 from pot
*** SUMMARY ***
Total pot $0.49 | Rake $0.02 | Jackpot $0 | Bingo $0 | Fortune $0 | Tax $0
Board [Th Js Qc 4h]
Seat 1: d2046be3 (button) folded before Flop (didn't bet)
Seat 2: aaa36d80 (small blind) folded before Flop
Seat 3: 77fce0a2 (big blind) folded on the Turn
Seat 4: 5ff083b4 folded before Flop (didn't bet)
Seat 5: a3b0c510 won ($0.47)
Seat 6: Hero folded before Flop (didn't bet)


Poker Hand #HD1788718659: Hold'em No Limit ($0.05/$0.1) - 2024/05/26 18:21:49
Table 'NLHRed17' 6-max Seat #6 is the button
Seat 1: d2046be3 ($15.03 in chips)
Seat 2: aaa36d80 ($10.44 in chips)
Seat 3: 77fce0a2 ($10.6 in chips)
Seat 4: 5ff083b4 ($10 in chips)
Seat 5: a3b0c510 ($10 in chips)
Seat 6: Hero ($25.06 in chips)
d2046be3: posts small blind $0.05
aaa36d80: posts big blind $0.1
*** HOLE CARDS ***
Dealt to d2046be3 
Dealt to aaa36d80 
Dealt to 77fce0a2 
Dealt to 5ff083b4 
Dealt to a3b0c510 
Dealt to Hero [8d 8h]
77fce0a2: folds
5ff083b4: folds
a3b0c510: folds
Hero: raises $0.14 to $0.24
d2046be3: folds
aaa36d80: folds
Uncalled bet ($0.14) returned to Hero
*** SHOWDOWN ***
Hero collected $0.25 from pot
*** SUMMARY ***
Total pot $0.25 | Rake $0 | Jackpot $0 | Bingo $0 | Fortune $0 | Tax $0
Seat 1: d2046be3 (small blind) folded before Flop
Seat 2: aaa36d80 (big blind) folded before Flop
Seat 3: 77fce0a2 folded before Flop (didn't bet)
Seat 4: 5ff083b4 folded before Flop (didn't bet)
Seat 5: a3b0c510 folded before Flop (didn't bet)
Seat 6: Hero (button) collected ($0.25)


Poker Hand #HD1788718546: Hold'em No Limit ($0.05/$0.1) - 2024/05/26 18:20:50
Table 'NLHRed17' 6-max Seat #5 is the button
Seat 1: d2046be3 ($15.7 in chips)
Seat 2: aaa36d80 ($10.44 in chips)
Seat 3: 77fce0a2 ($9.95 in chips)
Seat 4: 5ff083b4 ($10 in chips)
Seat 5: a3b0c510 ($10 in chips)
Seat 6: Hero ($25.11 in chips)
Hero: posts small blind $0.05
d2046be3: posts big blind $0.1
*** HOLE CARDS ***
Dealt to d2046be3 
Dealt to aaa36d80 
Dealt to 77fce0a2 
Dealt to 5ff083b4 
Dealt to a3b0c510 
Dealt to Hero [Kc 8s]
aaa36d80: folds
77fce0a2: raises $0.15 to $0.25
5ff083b4: folds
a3b0c510: folds
Hero: folds
d2046be3: calls $0.15
*** FLOP *** [5s 3h Th]
d2046be3: checks
77fce0a2: checks
*** TURN *** [5s 3h Th] [7h]
d2046be3: bets $0.42
77fce0a2: calls $0.42
*** RIVER *** [5s 3h Th 7h] [6c]
d2046be3: checks
77fce0a2: checks
d2046be3: shows [9s 7s] (Pair of Sevens)
77fce0a2: shows [9c 9h] (Pair of Nines)
*** SHOWDOWN ***
77fce0a2 collected $1.32 from pot
*** SUMMARY ***
Total pot $1.39 | Rake $0.07 | Jackpot $0 | Bingo $0 | Fortune $0 | Tax $0
Board [5s 3h Th 7h 6c]
Seat 1: d2046be3 (big blind) showed [9s 7s] and lost with Pair of Sevens
Seat 2: aaa36d80 folded before Flop (didn't bet)
Seat 3: 77fce0a2 showed [9c 9h] and won ($1.32) with Pair of Nines
Seat 4: 5ff083b4 folded before Flop (didn't bet)
Seat 5: a3b0c510 (button) folded before Flop (didn't bet)
Seat 6: Hero (small blind) folded before Flop


Poker Hand #HD1788718454: Hold'em No Limit ($0.05/$0.1) - 2024/05/26 18:20:04
Table 'NLHRed17' 6-max Seat #4 is the button
Seat 1: d2046be3 ($15.7 in chips)
Seat 2: aaa36d80 ($10.44 in chips)
Seat 3: 77fce0a2 ($8.9 in chips)
Seat 4: 5ff083b4 ($10.7 in chips)
Seat 5: a3b0c510 ($10.05 in chips)
Seat 6: Hero ($25.21 in chips)
a3b0c510: posts small blind $0.05
Hero: posts big blind $0.1
*** HOLE CARDS ***
Dealt to d2046be3 
Dealt to aaa36d80 
Dealt to 77fce0a2 
Dealt to 5ff083b4 
Dealt to a3b0c510 
Dealt to Hero [5d Qs]
d2046be3: folds
aaa36d80: folds
77fce0a2: raises $0.2 to $0.3
5ff083b4: raises $0.7 to $1
a3b0c510: folds
Hero: folds
77fce0a2: raises $2.15 to $3.15
5ff083b4: folds
Uncalled bet ($2.15) returned to 77fce0a2
*** SHOWDOWN ***
77fce0a2 collected $2.05 from pot
*** SUMMARY ***
Total pot $2.15 | Rake $0.1 | Jackpot $0 | Bingo $0 | Fortune $0 | Tax $0
Seat 1: d2046be3 folded before Flop (didn't bet)
Seat 2: aaa36d80 folded before Flop (didn't bet)
Seat 3: 77fce0a2 collected ($2.05)
Seat 4: 5ff083b4 (button) folded before Flop
Seat 5: a3b0c510 (small blind) folded before Flop
Seat 6: Hero (big blind) folded before Flop


Poker Hand #HD1788718425: Hold'em No Limit ($0.05/$0.1) - 2024/05/26 18:19:50
Table 'NLHRed17' 6-max Seat #3 is the button
Seat 1: d2046be3 ($15.7 in chips)
Seat 2: aaa36d80 ($10.44 in chips)
Seat 3: 77fce0a2 ($8.9 in chips)
Seat 4: 5ff083b4 ($10.75 in chips)
Seat 5: a3b0c510 ($10.15 in chips)
Seat 6: Hero ($25.06 in chips)
5ff083b4: posts small blind $0.05
a3b0c510: posts big blind $0.1
*** HOLE CARDS ***
Dealt to d2046be3 
Dealt to aaa36d80 
Dealt to 77fce0a2 
Dealt to 5ff083b4 
Dealt to a3b0c510 
Dealt to Hero [Kh Ad]
Hero: raises $0.1 to $0.2
d2046be3: folds
aaa36d80: folds
77fce0a2: folds
5ff083b4: folds
a3b0c510: folds
Uncalled bet ($0.1) returned to Hero
*** SHOWDOWN ***
Hero collected $0.25 from pot
*** SUMMARY ***
Total pot $0.25 | Rake $0 | Jackpot $0 | Bingo $0 | Fortune $0 | Tax $0
Seat 1: d2046be3 folded before Flop (didn't bet)
Seat 2: aaa36d80 folded before Flop (didn't bet)
Seat 3: 77fce0a2 (button) folded before Flop (didn't bet)
Seat 4: 5ff083b4 (small blind) folded before Flop
Seat 5: a3b0c510 (big blind) folded before Flop
Seat 6: Hero collected ($0.25)


Poker Hand #HD1788718391: Hold'em No Limit ($0.05/$0.1) - 2024/05/26 18:19:30
Table 'NLHRed17' 6-max Seat #2 is the button
Seat 1: d2046be3 ($15.7 in chips)
Seat 2: aaa36d80 ($10.44 in chips)
Seat 3: 77fce0a2 ($8.95 in chips)
Seat 4: 5ff083b4 ($10.85 in chips)
Seat 5: a3b0c510 ($10.15 in chips)
Seat 6: Hero ($24.91 in chips)
77fce0a2: posts small blind $0.05
5ff083b4: posts big blind $0.1
*** HOLE CARDS ***
Dealt to d2046be3 
Dealt to aaa36d80 
Dealt to 77fce0a2 
Dealt to 5ff083b4 
Dealt to a3b0c510 
Dealt to Hero [Jc Ks]
a3b0c510: folds
Hero: raises $0.1 to $0.2
d2046be3: folds
aaa36d80: folds
77fce0a2: folds
5ff083b4: folds
Uncalled bet ($0.1) returned to Hero
*** SHOWDOWN ***
Hero collected $0.25 from pot
*** SUMMARY ***
Total pot $0.25 | Rake $0 | Jackpot $0 | Bingo $0 | Fortune $0 | Tax $0
Seat 1: d2046be3 folded before Flop (didn't bet)
Seat 2: aaa36d80 (button) folded before Flop (didn't bet)
Seat 3: 77fce0a2 (small blind) folded before Flop
Seat 4: 5ff083b4 (big blind) folded before Flop
Seat 5: a3b0c510 folded before Flop (didn't bet)
Seat 6: Hero collected ($0.25)


Poker Hand #HD1788718351: Hold'em No Limit ($0.05/$0.1) - 2024/05/26 18:19:11
Table 'NLHRed17' 6-max Seat #1 is the button
Seat 1: d2046be3 ($15.7 in chips)
Seat 2: aaa36d80 ($10.49 in chips)
Seat 3: 77fce0a2 ($8.9 in chips)
Seat 4: 5ff083b4 ($10.85 in chips)
Seat 5: a3b0c510 ($10.15 in chips)
Seat 6: Hero ($24.91 in chips)
aaa36d80: posts small blind $0.05
77fce0a2: posts big blind $0.1
*** HOLE CARDS ***
Dealt to d2046be3 
Dealt to aaa36d80 
Dealt to 77fce0a2 
Dealt to 5ff083b4 
Dealt to a3b0c510 
Dealt to Hero [As 4d]
5ff083b4: folds
a3b0c510: folds
Hero: folds
d2046be3: folds
aaa36d80: folds
Uncalled bet ($0.05) returned to 77fce0a2
*** SHOWDOWN ***
77fce0a2 collected $0.1 from pot
*** SUMMARY ***
Total pot $0.1 | Rake $0 | Jackpot $0 | Bingo $0 | Fortune $0 | Tax $0
Seat 1: d2046be3 (button) folded before Flop (didn't bet)
Seat 2: aaa36d80 (small blind) folded before Flop
Seat 3: 77fce0a2 (big blind) collected ($0.1)
Seat 4: 5ff083b4 folded before Flop (didn't bet)
Seat 5: a3b0c510 folded before Flop (didn't bet)
Seat 6: Hero folded before Flop (didn't bet)


Poker Hand #HD1788718286: Hold'em No Limit ($0.05/$0.1) - 2024/05/26 18:18:40
Table 'NLHRed17' 6-max Seat #6 is the button
Seat 1: d2046be3 ($16 in chips)
Seat 2: aaa36d80 ($10.22 in chips)
Seat 3: 77fce0a2 ($8.9 in chips)
Seat 4: 5ff083b4 ($10.85 in chips)
Seat 5: a3b0c510 ($10.15 in chips)
Seat 6: Hero ($24.91 in chips)
d2046be3: posts small blind $0.05
aaa36d80: posts big blind $0.1
*** HOLE CARDS ***
Dealt to d2046be3 
Dealt to aaa36d80 
Dealt to 77fce0a2 
Dealt to 5ff083b4 
Dealt to a3b0c510 
Dealt to Hero [Jd 5h]
77fce0a2: folds
5ff083b4: folds
a3b0c510: folds
Hero: folds
d2046be3: raises $0.2 to $0.3
aaa36d80: raises $0.6 to $0.9
d2046be3: folds
Uncalled bet ($0.6) returned to aaa36d80
*** SHOWDOWN ***
aaa36d80 collected $0.57 from pot
*** SUMMARY ***
Total pot $0.6 | Rake $0.03 | Jackpot $0 | Bingo $0 | Fortune $0 | Tax $0
Seat 1: d2046be3 (small blind) folded before Flop
Seat 2: aaa36d80 (big blind) collected ($0.57)
Seat 3: 77fce0a2 folded before Flop (didn't bet)
Seat 4: 5ff083b4 folded before Flop (didn't bet)
Seat 5: a3b0c510 folded before Flop (didn't bet)
Seat 6: Hero (button) folded before Flop (didn't bet)


Poker Hand #HD1788718255: Hold'em No Limit ($0.05/$0.1) - 2024/05/26 18:18:26
Table 'NLHRed17' 6-max Seat #5 is the button
Seat 1: d2046be3 ($16.1 in chips)
Seat 2: aaa36d80 ($10.22 in chips)
Seat 3: 77fce0a2 ($8.9 in chips)
Seat 4: 5ff083b4 ($10.85 in chips)
Seat 5: a3b0c510 ($10 in chips)
Seat 6: Hero ($24.96 in chips)
Hero: posts small blind $0.05
d2046be3: posts big blind $0.1
*** HOLE CARDS ***
Dealt to d2046be3 
Dealt to aaa36d80 
Dealt to 77fce0a2 
Dealt to 5ff083b4 
Dealt to a3b0c510 
Dealt to Hero [3c Qd]
aaa36d80: folds
77fce0a2: folds
5ff083b4: folds
a3b0c510: raises $0.15 to $0.25
Hero: folds
d2046be3: folds
Uncalled bet ($0.15) returned to a3b0c510
*** SHOWDOWN ***
a3b0c510 collected $0.25 from pot
*** SUMMARY ***
Total pot $0.25 | Rake $0 | Jackpot $0 | Bingo $0 | Fortune $0 | Tax $0
Seat 1: d2046be3 (big blind) folded before Flop
Seat 2: aaa36d80 folded before Flop (didn't bet)
Seat 3: 77fce0a2 folded before Flop (didn't bet)
Seat 4: 5ff083b4 folded before Flop (didn't bet)
Seat 5: a3b0c510 (button) collected ($0.25)
Seat 6: Hero (small blind) folded before Flop


Poker Hand #HD1788718200: Hold'em No Limit ($0.05/$0.1) - 2024/05/26 18:17:55
Table 'NLHRed17' 6-max Seat #4 is the button
Seat 1: d2046be3 ($16.1 in chips)
Seat 2: aaa36d80 ($10.22 in chips)
Seat 3: 77fce0a2 ($8.9 in chips)
Seat 4: 5ff083b4 ($10.7 in chips)
Seat 5: a3b0c510 ($10.05 in chips)
Seat 6: Hero ($25.06 in chips)
a3b0c510: posts small blind $0.05
Hero: posts big blind $0.1
*** HOLE CARDS ***
Dealt to d2046be3 
Dealt to aaa36d80 
Dealt to 77fce0a2 
Dealt to 5ff083b4 
Dealt to a3b0c510 
Dealt to Hero [Qd 4d]
d2046be3: folds
aaa36d80: folds
77fce0a2: folds
5ff083b4: raises $0.15 to $0.25
a3b0c510: folds
Hero: folds
Uncalled bet ($0.15) returned to 5ff083b4
*** SHOWDOWN ***
5ff083b4 collected $0.25 from pot
*** SUMMARY ***
Total pot $0.25 | Rake $0 | Jackpot $0 | Bingo $0 | Fortune $0 | Tax $0
Seat 1: d2046be3 folded before Flop (didn't bet)
Seat 2: aaa36d80 folded before Flop (didn't bet)
Seat 3: 77fce0a2 folded before Flop (didn't bet)
Seat 4: 5ff083b4 (button) collected ($0.25)
Seat 5: a3b0c510 (small blind) folded before Flop
Seat 6: Hero (big blind) folded before Flop


Poker Hand #HD1788718160: Hold'em No Limit ($0.05/$0.1) - 2024/05/26 18:17:36
Table 'NLHRed17' 6-max Seat #3 is the button
Seat 1: d2046be3 ($15.95 in chips)
Seat 2: aaa36d80 ($10.22 in chips)
Seat 3: 77fce0a2 ($8.9 in chips)
Seat 4: 5ff083b4 ($10.75 in chips)
Seat 5: a3b0c510 ($10.15 in chips)
Seat 6: Hero ($25.06 in chips)
5ff083b4: posts small blind $0.05
a3b0c510: posts big blind $0.1
*** HOLE CARDS ***
Dealt to d2046be3 
Dealt to aaa36d80 
Dealt to 77fce0a2 
Dealt to 5ff083b4 
Dealt to a3b0c510 
Dealt to Hero [5d 4h]
Hero: folds
d2046be3: raises $0.15 to $0.25
aaa36d80: folds
77fce0a2: folds
5ff083b4: folds
a3b0c510: folds
Uncalled bet ($0.15) returned to d2046be3
*** SHOWDOWN ***
d2046be3 collected $0.25 from pot
*** SUMMARY ***
Total pot $0.25 | Rake $0 | Jackpot $0 | Bingo $0 | Fortune $0 | Tax $0
Seat 1: d2046be3 collected ($0.25)
Seat 2: aaa36d80 folded before Flop (didn't bet)
Seat 3: 77fce0a2 (button) folded before Flop (didn't bet)
Seat 4: 5ff083b4 (small blind) folded before Flop
Seat 5: a3b0c510 (big blind) folded before Flop
Seat 6: Hero folded before Flop (didn't bet)


Poker Hand #HD1788718034: Hold'em No Limit ($0.05/$0.1) - 2024/05/26 18:16:31
Table 'NLHRed17' 6-max Seat #2 is the button
Seat 1: d2046be3 ($15.95 in chips)
Seat 2: aaa36d80 ($10.22 in chips)
Seat 3: 77fce0a2 ($8.95 in chips)
Seat 4: 5ff083b4 ($10.85 in chips)
Seat 5: a3b0c510 ($10.15 in chips)
Seat 6: Hero ($24.91 in chips)
77fce0a2: posts small blind $0.05
5ff083b4: posts big blind $0.1
*** HOLE CARDS ***
Dealt to d2046be3 
Dealt to aaa36d80 
Dealt to 77fce0a2 
Dealt to 5ff083b4 
Dealt to a3b0c510 
Dealt to Hero [Ad Ks]
a3b0c510: folds
Hero: raises $0.1 to $0.2
d2046be3: folds
aaa36d80: folds
77fce0a2: folds
5ff083b4: folds
Uncalled bet ($0.1) returned to Hero
*** SHOWDOWN ***
Hero collected $0.25 from pot
*** SUMMARY ***
Total pot $0.25 | Rake $0 | Jackpot $0 | Bingo $0 | Fortune $0 | Tax $0
Seat 1: d2046be3 folded before Flop (didn't bet)
Seat 2: aaa36d80 (button) folded before Flop (didn't bet)
Seat 3: 77fce0a2 (small blind) folded before Flop
Seat 4: 5ff083b4 (big blind) folded before Flop
Seat 5: a3b0c510 folded before Flop (didn't bet)
Seat 6: Hero collected ($0.25)


Poker Hand #HD1788717989: Hold'em No Limit ($0.05/$0.1) - 2024/05/26 18:16:05
Table 'NLHRed17' 6-max Seat #1 is the button
Seat 1: d2046be3 ($15.8 in chips)
Seat 2: aaa36d80 ($10.27 in chips)
Seat 3: 77fce0a2 ($9.05 in chips)
Seat 4: 5ff083b4 ($10.85 in chips)
Seat 5: a3b0c510 ($10.15 in chips)
Seat 6: Hero ($24.91 in chips)
aaa36d80: posts small blind $0.05
77fce0a2: posts big blind $0.1
*** HOLE CARDS ***
Dealt to d2046be3 
Dealt to aaa36d80 
Dealt to 77fce0a2 
Dealt to 5ff083b4 
Dealt to a3b0c510 
Dealt to Hero [3d 9h]
5ff083b4: folds
a3b0c510: folds
Hero: folds
d2046be3: raises $0.15 to $0.25
aaa36d80: folds
77fce0a2: folds
Uncalled bet ($0.15) returned to d2046be3
*** SHOWDOWN ***
d2046be3 collected $0.25 from pot
*** SUMMARY ***
Total pot $0.25 | Rake $0 | Jackpot $0 | Bingo $0 | Fortune $0 | Tax $0
Seat 1: d2046be3 (button) collected ($0.25)
Seat 2: aaa36d80 (small blind) folded before Flop
Seat 3: 77fce0a2 (big blind) folded before Flop
Seat 4: 5ff083b4 folded before Flop (didn't bet)
Seat 5: a3b0c510 folded before Flop (didn't bet)
Seat 6: Hero folded before Flop (didn't bet)


Poker Hand #HD1788717906: Hold'em No Limit ($0.05/$0.1) - 2024/05/26 18:15:14
Table 'NLHRed17' 6-max Seat #6 is the button
Seat 1: d2046be3 ($15.85 in chips)
Seat 2: aaa36d80 ($10 in chips)
Seat 3: 77fce0a2 ($9.05 in chips)
Seat 4: 5ff083b4 ($10.85 in chips)
Seat 5: a3b0c510 ($10.15 in chips)
Seat 6: Hero ($25.15 in chips)
d2046be3: posts small blind $0.05
aaa36d80: posts big blind $0.1
*** HOLE CARDS ***
Dealt to d2046be3 
Dealt to aaa36d80 
Dealt to 77fce0a2 
Dealt to 5ff083b4 
Dealt to a3b0c510 
Dealt to Hero [6s 6c]
77fce0a2: folds
5ff083b4: folds
a3b0c510: folds
Hero: raises $0.14 to $0.24
d2046be3: folds
aaa36d80: raises $0.61 to $0.85
Hero: folds
Uncalled bet ($0.61) returned to aaa36d80
*** SHOWDOWN ***
aaa36d80 collected $0.51 from pot
*** SUMMARY ***
Total pot $0.53 | Rake $0.02 | Jackpot $0 | Bingo $0 | Fortune $0 | Tax $0
Seat 1: d2046be3 (small blind) folded before Flop
Seat 2: aaa36d80 (big blind) collected ($0.51)
Seat 3: 77fce0a2 folded before Flop (didn't bet)
Seat 4: 5ff083b4 folded before Flop (didn't bet)
Seat 5: a3b0c510 folded before Flop (didn't bet)
Seat 6: Hero (button) folded before Flop


Poker Hand #HD1788717878: Hold'em No Limit ($0.05/$0.1) - 2024/05/26 18:15:01
Table 'NLHRed17' 6-max Seat #5 is the button
Seat 1: d2046be3 ($15.8 in chips)
Seat 2: aaa36d80 ($10 in chips)
Seat 3: 77fce0a2 ($9.05 in chips)
Seat 4: 5ff083b4 ($10.85 in chips)
Seat 5: a3b0c510 ($10.15 in chips)
Seat 6: Hero ($25.2 in chips)
Hero: posts small blind $0.05
d2046be3: posts big blind $0.1
*** HOLE CARDS ***
Dealt to d2046be3 
Dealt to aaa36d80 
Dealt to 77fce0a2 
Dealt to 5ff083b4 
Dealt to a3b0c510 
Dealt to Hero [6s 7c]
aaa36d80: folds
77fce0a2: folds
5ff083b4: folds
a3b0c510: folds
Hero: folds
Uncalled bet ($0.05) returned to d2046be3
*** SHOWDOWN ***
d2046be3 collected $0.1 from pot
*** SUMMARY ***
Total pot $0.1 | Rake $0 | Jackpot $0 | Bingo $0 | Fortune $0 | Tax $0
Seat 1: d2046be3 (big blind) collected ($0.1)
Seat 2: aaa36d80 folded before Flop (didn't bet)
Seat 3: 77fce0a2 folded before Flop (didn't bet)
Seat 4: 5ff083b4 folded before Flop (didn't bet)
Seat 5: a3b0c510 (button) folded before Flop (didn't bet)
Seat 6: Hero (small blind) folded before Flop


Poker Hand #HD1788717838: Hold'em No Limit ($0.05/$0.1) - 2024/05/26 18:14:43
Table 'NLHRed17' 6-max Seat #4 is the button
Seat 1: d2046be3 ($15.8 in chips)
Seat 2: aaa36d80 ($10 in chips)
Seat 3: 77fce0a2 ($9.05 in chips)
Seat 4: 5ff083b4 ($10.85 in chips)
Seat 5: a3b0c510 ($10.05 in chips)
Seat 6: Hero ($25.3 in chips)
a3b0c510: posts small blind $0.05
Hero: posts big blind $0.1
*** HOLE CARDS ***
Dealt to d2046be3 
Dealt to aaa36d80 
Dealt to 77fce0a2 
Dealt to 5ff083b4 
Dealt to a3b0c510 
Dealt to Hero [Jh 3c]
d2046be3: folds
aaa36d80: folds
77fce0a2: folds
5ff083b4: folds
a3b0c510: raises $0.2 to $0.3
Hero: folds
Uncalled bet ($0.2) returned to a3b0c510
*** SHOWDOWN ***
a3b0c510 collected $0.2 from pot
*** SUMMARY ***
Total pot $0.2 | Rake $0 | Jackpot $0 | Bingo $0 | Fortune $0 | Tax $0
Seat 1: d2046be3 folded before Flop (didn't bet)
Seat 2: aaa36d80 folded before Flop (didn't bet)
Seat 3: 77fce0a2 folded before Flop (didn't bet)
Seat 4: 5ff083b4 (button) folded before Flop (didn't bet)
Seat 5: a3b0c510 (small blind) collected ($0.2)
Seat 6: Hero (big blind) folded before Flop


Poker Hand #HD1788717792: Hold'em No Limit ($0.05/$0.1) - 2024/05/26 18:14:20
Table 'NLHRed17' 6-max Seat #3 is the button
Seat 1: d2046be3 ($15.8 in chips)
Seat 2: aaa36d80 ($10 in chips)
Seat 3: 77fce0a2 ($9.05 in chips)
Seat 4: 5ff083b4 ($10.9 in chips)
Seat 5: a3b0c510 ($10.15 in chips)
Seat 6: Hero ($25.15 in chips)
5ff083b4: posts small blind $0.05
a3b0c510: posts big blind $0.1
*** HOLE CARDS ***
Dealt to d2046be3 
Dealt to aaa36d80 
Dealt to 77fce0a2 
Dealt to 5ff083b4 
Dealt to a3b0c510 
Dealt to Hero [Js Kd]
Hero: raises $0.1 to $0.2
d2046be3: folds
aaa36d80: folds
77fce0a2: folds
5ff083b4: folds
a3b0c510: folds
Uncalled bet ($0.1) returned to Hero
*** SHOWDOWN ***
Hero collected $0.25 from pot
*** SUMMARY ***
Total pot $0.25 | Rake $0 | Jackpot $0 | Bingo $0 | Fortune $0 | Tax $0
Seat 1: d2046be3 folded before Flop (didn't bet)
Seat 2: aaa36d80 folded before Flop (didn't bet)
Seat 3: 77fce0a2 (button) folded before Flop (didn't bet)
Seat 4: 5ff083b4 (small blind) folded before Flop
Seat 5: a3b0c510 (big blind) folded before Flop
Seat 6: Hero collected ($0.25)


Poker Hand #HD1788717596: Hold'em No Limit ($0.05/$0.1) - 2024/05/26 18:12:32
Table 'NLHRed17' 6-max Seat #2 is the button
Seat 1: d2046be3 ($15.8 in chips)
Seat 2: aaa36d80 ($10 in chips)
Seat 3: 77fce0a2 ($10.05 in chips)
Seat 4: 5ff083b4 ($10 in chips)
Seat 5: a3b0c510 ($10.15 in chips)
Seat 6: Hero ($25.15 in chips)
77fce0a2: posts small blind $0.05
5ff083b4: posts big blind $0.1
*** HOLE CARDS ***
Dealt to d2046be3 
Dealt to aaa36d80 
Dealt to 77fce0a2 
Dealt to 5ff083b4 
Dealt to a3b0c510 
Dealt to Hero [7d Qc]
a3b0c510: folds
Hero: folds
d2046be3: folds
aaa36d80: folds
77fce0a2: raises $0.15 to $0.25
5ff083b4: calls $0.15
*** FLOP *** [9d 5h Ah]
77fce0a2: bets $0.25
5ff083b4: calls $0.25
*** TURN *** [9d 5h Ah] [6s]
77fce0a2: bets $0.5
5ff083b4: calls $0.5
*** RIVER *** [9d 5h Ah 6s] [Js]
77fce0a2: checks
5ff083b4: checks
77fce0a2: shows [8d Kh] (Ace-High)
5ff083b4: shows [3c Ac] (Pair of Aces)
*** SHOWDOWN ***
5ff083b4 collected $1.9 from pot
*** SUMMARY ***
Total pot $2 | Rake $0.1 | Jackpot $0 | Bingo $0 | Fortune $0 | Tax $0
Board [9d 5h Ah 6s Js]
Seat 1: d2046be3 folded before Flop (didn't bet)
Seat 2: aaa36d80 (button) folded before Flop (didn't bet)
Seat 3: 77fce0a2 (small blind) showed [8d Kh] and lost with Ace-High
Seat 4: 5ff083b4 (big blind) showed [3c Ac] and won ($1.9) with Pair of Aces
Seat 5: a3b0c510 folded before Flop (didn't bet)
Seat 6: Hero folded before Flop (didn't bet)


Poker Hand #HD1788717564: Hold'em No Limit ($0.05/$0.1) - 2024/05/26 18:12:15
Table 'NLHRed17' 6-max Seat #1 is the button
Seat 1: d2046be3 ($15.65 in chips)
Seat 2: aaa36d80 ($10.05 in chips)
Seat 3: 77fce0a2 ($10.15 in chips)
Seat 4: 5ff083b4 ($10 in chips)
Seat 5: a3b0c510 ($10.15 in chips)
Seat 6: Hero ($25.15 in chips)
aaa36d80: posts small blind $0.05
77fce0a2: posts big blind $0.1
*** HOLE CARDS ***
Dealt to d2046be3 
Dealt to aaa36d80 
Dealt to 77fce0a2 
Dealt to 5ff083b4 
Dealt to a3b0c510 
Dealt to Hero [5d Qd]
5ff083b4: folds
a3b0c510: folds
Hero: folds
d2046be3: raises $0.15 to $0.25
aaa36d80: folds
77fce0a2: folds
Uncalled bet ($0.15) returned to d2046be3
*** SHOWDOWN ***
d2046be3 collected $0.25 from pot
*** SUMMARY ***
Total pot $0.25 | Rake $0 | Jackpot $0 | Bingo $0 | Fortune $0 | Tax $0
Seat 1: d2046be3 (button) collected ($0.25)
Seat 2: aaa36d80 (small blind) folded before Flop
Seat 3: 77fce0a2 (big blind) folded before Flop
Seat 4: 5ff083b4 folded before Flop (didn't bet)
Seat 5: a3b0c510 folded before Flop (didn't bet)
Seat 6: Hero folded before Flop (didn't bet)


Poker Hand #HD1788717540: Hold'em No Limit ($0.05/$0.1) - 2024/05/26 18:11:57
Table 'NLHRed17' 6-max Seat #6 is the button
Seat 1: d2046be3 ($15.7 in chips)
Seat 2: aaa36d80 ($10 in chips)
Seat 3: 77fce0a2 ($10.15 in chips)
Seat 4: 5ff083b4 ($10 in chips)
Seat 5: a3b0c510 ($10.15 in chips)
Seat 6: Hero ($25.15 in chips)
d2046be3: posts small blind $0.05
aaa36d80: posts big blind $0.1
*** HOLE CARDS ***
Dealt to d2046be3 
Dealt to aaa36d80 
Dealt to 77fce0a2 
Dealt to 5ff083b4 
Dealt to a3b0c510 
Dealt to Hero [4h 3d]
77fce0a2: folds
5ff083b4: folds
a3b0c510: folds
Hero: folds
d2046be3: folds
Uncalled bet ($0.05) returned to aaa36d80
*** SHOWDOWN ***
aaa36d80 collected $0.1 from pot
*** SUMMARY ***
Total pot $0.1 | Rake $0 | Jackpot $0 | Bingo $0 | Fortune $0 | Tax $0
Seat 1: d2046be3 (small blind) folded before Flop
Seat 2: aaa36d80 (big blind) collected ($0.1)
Seat 3: 77fce0a2 folded before Flop (didn't bet)
Seat 4: 5ff083b4 folded before Flop (didn't bet)
Seat 5: a3b0c510 folded before Flop (didn't bet)
Seat 6: Hero (button) folded before Flop (didn't bet)


Poker Hand #HD1788717502: Hold'em No Limit ($0.05/$0.1) - 2024/05/26 18:11:38
Table 'NLHRed17' 6-max Seat #5 is the button
Seat 1: d2046be3 ($15.8 in chips)
Seat 2: aaa36d80 ($10 in chips)
Seat 3: 77fce0a2 ($10.15 in chips)
Seat 4: 5ff083b4 ($10 in chips)
Seat 5: a3b0c510 ($10 in chips)
Seat 6: Hero ($25.2 in chips)
Hero: posts small blind $0.05
d2046be3: posts big blind $0.1
*** HOLE CARDS ***
Dealt to d2046be3 
Dealt to aaa36d80 
Dealt to 77fce0a2 
Dealt to 5ff083b4 
Dealt to a3b0c510 
Dealt to Hero [4s Tc]
aaa36d80: folds
77fce0a2: folds
5ff083b4: folds
a3b0c510: raises $0.15 to $0.25
Hero: folds
d2046be3: folds
Uncalled bet ($0.15) returned to a3b0c510
*** SHOWDOWN ***
a3b0c510 collected $0.25 from pot
*** SUMMARY ***
Total pot $0.25 | Rake $0 | Jackpot $0 | Bingo $0 | Fortune $0 | Tax $0
Seat 1: d2046be3 (big blind) folded before Flop
Seat 2: aaa36d80 folded before Flop (didn't bet)
Seat 3: 77fce0a2 folded before Flop (didn't bet)
Seat 4: 5ff083b4 folded before Flop (didn't bet)
Seat 5: a3b0c510 (button) collected ($0.25)
Seat 6: Hero (small blind) folded before Flop


Poker Hand #HD1788717475: Hold'em No Limit ($0.05/$0.1) - 2024/05/26 18:11:24
Table 'NLHRed17' 6-max Seat #4 is the button
Seat 1: d2046be3 ($15.65 in chips)
Seat 2: aaa36d80 ($10 in chips)
Seat 3: 77fce0a2 ($10.15 in chips)
Seat 4: 5ff083b4 ($10 in chips)
Seat 5: a3b0c510 ($10 in chips)
Seat 6: Hero ($25.3 in chips)
a3b0c510: posts small blind $0.05
Hero: posts big blind $0.1
*** HOLE CARDS ***
Dealt to d2046be3 
Dealt to aaa36d80 
Dealt to 77fce0a2 
Dealt to 5ff083b4 
Dealt to a3b0c510 
Dealt to Hero [5d 9h]
d2046be3: raises $0.15 to $0.25
aaa36d80: folds
77fce0a2: folds
5ff083b4: folds
a3b0c510: folds
Hero: folds
Uncalled bet ($0.15) returned to d2046be3
*** SHOWDOWN ***
d2046be3 collected $0.25 from pot
*** SUMMARY ***
Total pot $0.25 | Rake $0 | Jackpot $0 | Bingo $0 | Fortune $0 | Tax $0
Seat 1: d2046be3 collected ($0.25)
Seat 2: aaa36d80 folded before Flop (didn't bet)
Seat 3: 77fce0a2 folded before Flop (didn't bet)
Seat 4: 5ff083b4 (button) folded before Flop (didn't bet)
Seat 5: a3b0c510 (small blind) folded before Flop
Seat 6: Hero (big blind) folded before Flop


Poker Hand #HD1788717433: Hold'em No Limit ($0.05/$0.1) - 2024/05/26 18:11:03
Table 'NLHRed17' 6-max Seat #3 is the button
Seat 1: d2046be3 ($15.65 in chips)
Seat 2: aaa36d80 ($10 in chips)
Seat 3: 77fce0a2 ($10 in chips)
Seat 4: 5ff083b4 ($10.05 in chips)
Seat 5: a3b0c510 ($10 in chips)
Seat 6: Hero ($25.3 in chips)
5ff083b4: posts small blind $0.05
a3b0c510: posts big blind $0.1
*** HOLE CARDS ***
Dealt to d2046be3 
Dealt to aaa36d80 
Dealt to 77fce0a2 
Dealt to 5ff083b4 
Dealt to a3b0c510 
Dealt to Hero [5d 7s]
Hero: folds
d2046be3: folds
aaa36d80: folds
77fce0a2: raises $0.2 to $0.3
5ff083b4: folds
a3b0c510: folds
Uncalled bet ($0.2) returned to 77fce0a2
*** SHOWDOWN ***
77fce0a2 collected $0.25 from pot
*** SUMMARY ***
Total pot $0.25 | Rake $0 | Jackpot $0 | Bingo $0 | Fortune $0 | Tax $0
Seat 1: d2046be3 folded before Flop (didn't bet)
Seat 2: aaa36d80 folded before Flop (didn't bet)
Seat 3: 77fce0a2 (button) collected ($0.25)
Seat 4: 5ff083b4 (small blind) folded before Flop
Seat 5: a3b0c510 (big blind) folded before Flop
Seat 6: Hero folded before Flop (didn't bet)


Poker Hand #HD1788717400: Hold'em No Limit ($0.05/$0.1) - 2024/05/26 18:10:42
Table 'NLHRed17' 6-max Seat #2 is the button
Seat 1: d2046be3 ($15.65 in chips)
Seat 2: aaa36d80 ($10 in chips)
Seat 3: 77fce0a2 ($10.05 in chips)
Seat 4: 5ff083b4 ($10 in chips)
Seat 6: Hero ($25.3 in chips)
77fce0a2: posts small blind $0.05
5ff083b4: posts big blind $0.1
*** HOLE CARDS ***
Dealt to d2046be3 
Dealt to aaa36d80 
Dealt to 77fce0a2 
Dealt to 5ff083b4 
Dealt to Hero [8s Ah]
Hero: folds
d2046be3: folds
aaa36d80: folds
77fce0a2: folds
Uncalled bet ($0.05) returned to 5ff083b4
*** SHOWDOWN ***
5ff083b4 collected $0.1 from pot
*** SUMMARY ***
Total pot $0.1 | Rake $0 | Jackpot $0 | Bingo $0 | Fortune $0 | Tax $0
Seat 1: d2046be3 folded before Flop (didn't bet)
Seat 2: aaa36d80 (button) folded before Flop (didn't bet)
Seat 3: 77fce0a2 (small blind) folded before Flop
Seat 4: 5ff083b4 (big blind) collected ($0.1)
Seat 6: Hero folded before Flop (didn't bet)


Poker Hand #HD1788717356: Hold'em No Limit ($0.05/$0.1) - 2024/05/26 18:10:14
Table 'NLHRed17' 6-max Seat #1 is the button
Seat 1: d2046be3 ($15.5 in chips)
Seat 2: aaa36d80 ($10 in chips)
Seat 3: 77fce0a2 ($10.15 in chips)
Seat 4: 5ff083b4 ($10 in chips)
Seat 6: Hero ($25.3 in chips)
aaa36d80: posts small blind $0.05
77fce0a2: posts big blind $0.1
*** HOLE CARDS ***
Dealt to d2046be3 
Dealt to aaa36d80 
Dealt to 77fce0a2 
Dealt to 5ff083b4 
Dealt to Hero [4c 2d]
5ff083b4: folds
Hero: folds
d2046be3: raises $0.15 to $0.25
aaa36d80: folds
77fce0a2: folds
Uncalled bet ($0.15) returned to d2046be3
*** SHOWDOWN ***
d2046be3 collected $0.25 from pot
*** SUMMARY ***
Total pot $0.25 | Rake $0 | Jackpot $0 | Bingo $0 | Fortune $0 | Tax $0
Seat 1: d2046be3 (button) collected ($0.25)
Seat 2: aaa36d80 (small blind) folded before Flop
Seat 3: 77fce0a2 (big blind) folded before Flop
Seat 4: 5ff083b4 folded before Flop (didn't bet)
Seat 6: Hero folded before Flop (didn't bet)


Poker Hand #HD1788717265: Hold'em No Limit ($0.05/$0.1) - 2024/05/26 18:09:27
Table 'NLHRed17' 6-max Seat #6 is the button
Seat 1: d2046be3 ($14.4 in chips)
Seat 2: aaa36d80 ($10 in chips)
Seat 3: 77fce0a2 ($10.15 in chips)
Seat 4: 5ff083b4 ($10 in chips)
Seat 6: Hero ($26.41 in chips)
d2046be3: posts small blind $0.05
aaa36d80: posts big blind $0.1
*** HOLE CARDS ***
Dealt to d2046be3 
Dealt to aaa36d80 
Dealt to 77fce0a2 
Dealt to 5ff083b4 
Dealt to Hero [Jd Jc]
77fce0a2: folds
5ff083b4: folds
Hero: raises $0.14 to $0.24
d2046be3: raises $0.87 to $1.11
aaa36d80: folds
Hero: calls $0.87
*** FLOP *** [7c Ah Kd]
d2046be3: bets $0.77
Hero: folds
Uncalled bet ($0.77) returned to d2046be3
*** SHOWDOWN ***
d2046be3 collected $2.21 from pot
*** SUMMARY ***
Total pot $2.32 | Rake $0.11 | Jackpot $0 | Bingo $0 | Fortune $0 | Tax $0
Board [7c Ah Kd]
Seat 1: d2046be3 (small blind) won ($2.21)
Seat 2: aaa36d80 (big blind) folded before Flop
Seat 3: 77fce0a2 folded before Flop (didn't bet)
Seat 4: 5ff083b4 folded before Flop (didn't bet)
Seat 6: Hero (button) folded on the Flop


Poker Hand #HD1788717233: Hold'em No Limit ($0.05/$0.1) - 2024/05/26 18:09:11
Table 'NLHRed17' 6-max Seat #4 is the button
Seat 1: d2046be3 ($14.5 in chips)
Seat 2: aaa36d80 ($10 in chips)
Seat 3: 77fce0a2 ($10 in chips)
Seat 4: 5ff083b4 ($10 in chips)
Seat 6: Hero ($26.46 in chips)
Hero: posts small blind $0.05
d2046be3: posts big blind $0.1
*** HOLE CARDS ***
Dealt to d2046be3 
Dealt to aaa36d80 
Dealt to 77fce0a2 
Dealt to 5ff083b4 
Dealt to Hero [Jh 7s]
aaa36d80: folds
77fce0a2: raises $0.1 to $0.2
5ff083b4: folds
Hero: folds
d2046be3: folds
Uncalled bet ($0.1) returned to 77fce0a2
*** SHOWDOWN ***
77fce0a2 collected $0.25 from pot
*** SUMMARY ***
Total pot $0.25 | Rake $0 | Jackpot $0 | Bingo $0 | Fortune $0 | Tax $0
Seat 1: d2046be3 (big blind) folded before Flop
Seat 2: aaa36d80 folded before Flop (didn't bet)
Seat 3: 77fce0a2 collected ($0.25)
Seat 4: 5ff083b4 (button) folded before Flop (didn't bet)
Seat 6: Hero (small blind) folded before Flop


Poker Hand #HD1788717199: Hold'em No Limit ($0.05/$0.1) - 2024/05/26 18:08:53
Table 'NLHRed17' 6-max Seat #3 is the button
Seat 1: d2046be3 ($14.35 in chips)
Seat 2: aaa36d80 ($10 in chips)
Seat 3: 77fce0a2 ($10 in chips)
Seat 4: 5ff083b4 ($10 in chips)
Seat 6: Hero ($26.56 in chips)
5ff083b4: posts small blind $0.05
Hero: posts big blind $0.1
*** HOLE CARDS ***
Dealt to d2046be3 
Dealt to aaa36d80 
Dealt to 77fce0a2 
Dealt to 5ff083b4 
Dealt to Hero [5c 9s]
d2046be3: raises $0.15 to $0.25
aaa36d80: folds
77fce0a2: folds
5ff083b4: folds
Hero: folds
Uncalled bet ($0.15) returned to d2046be3
*** SHOWDOWN ***
d2046be3 collected $0.25 from pot
*** SUMMARY ***
Total pot $0.25 | Rake $0 | Jackpot $0 | Bingo $0 | Fortune $0 | Tax $0
Seat 1: d2046be3 collected ($0.25)
Seat 2: aaa36d80 folded before Flop (didn't bet)
Seat 3: 77fce0a2 (button) folded before Flop (didn't bet)
Seat 4: 5ff083b4 (small blind) folded before Flop
Seat 6: Hero (big blind) folded before Flop


Poker Hand #HD1788717150: Hold'em No Limit ($0.05/$0.1) - 2024/05/26 18:08:19
Table 'NLHRed17' 6-max Seat #2 is the button
Seat 1: d2046be3 ($14.35 in chips)
Seat 2: aaa36d80 ($10 in chips)
Seat 3: 77fce0a2 ($10.2 in chips)
Seat 4: 5ff083b4 ($10 in chips)
Seat 6: Hero ($26.28 in chips)
77fce0a2: posts small blind $0.05
5ff083b4: posts big blind $0.1
*** HOLE CARDS ***
Dealt to d2046be3 
Dealt to aaa36d80 
Dealt to 77fce0a2 
Dealt to 5ff083b4 
Dealt to Hero [Kc Kd]
Hero: raises $0.1 to $0.2
d2046be3: folds
aaa36d80: folds
77fce0a2: calls $0.15
5ff083b4: folds
*** FLOP *** [Qs Ts 6s]
77fce0a2: checks
Hero: bets $0.3
77fce0a2: folds
Uncalled bet ($0.3) returned to Hero
*** SHOWDOWN ***
Hero collected $0.48 from pot
*** SUMMARY ***
Total pot $0.5 | Rake $0.02 | Jackpot $0 | Bingo $0 | Fortune $0 | Tax $0
Board [Qs Ts 6s]
Seat 1: d2046be3 folded before Flop (didn't bet)
Seat 2: aaa36d80 (button) folded before Flop (didn't bet)
Seat 3: 77fce0a2 (small blind) folded on the Flop
Seat 4: 5ff083b4 (big blind) folded before Flop
Seat 6: Hero won ($0.48)


Poker Hand #HD1788717105: Hold'em No Limit ($0.05/$0.1) - 2024/05/26 18:07:53
Table 'NLHRed17' 6-max Seat #1 is the button
Seat 1: d2046be3 ($14.35 in chips)
Seat 2: aaa36d80 ($10 in chips)
Seat 3: 77fce0a2 ($10.15 in chips)
Seat 6: Hero ($26.28 in chips)
aaa36d80: posts small blind $0.05
77fce0a2: posts big blind $0.1
*** HOLE CARDS ***
Dealt to d2046be3 
Dealt to aaa36d80 
Dealt to 77fce0a2 
Dealt to Hero [Ts 2d]
Hero: folds
d2046be3: folds
aaa36d80: folds
Uncalled bet ($0.05) returned to 77fce0a2
*** SHOWDOWN ***
77fce0a2 collected $0.1 from pot
*** SUMMARY ***
Total pot $0.1 | Rake $0 | Jackpot $0 | Bingo $0 | Fortune $0 | Tax $0
Seat 1: d2046be3 (button) folded before Flop (didn't bet)
Seat 2: aaa36d80 (small blind) folded before Flop
Seat 3: 77fce0a2 (big blind) collected ($0.1)
Seat 6: Hero folded before Flop (didn't bet)


Poker Hand #HD1788717081: Hold'em No Limit ($0.05/$0.1) - 2024/05/26 18:07:42
Table 'NLHRed17' 6-max Seat #6 is the button
Seat 1: d2046be3 ($14.25 in chips)
Seat 2: aaa36d80 ($10 in chips)
Seat 3: 77fce0a2 ($10.15 in chips)
Seat 6: Hero ($26.28 in chips)
d2046be3: posts small blind $0.05
aaa36d80: posts big blind $0.1
*** HOLE CARDS ***
Dealt to d2046be3 
Dealt to aaa36d80 
Dealt to 77fce0a2 
Dealt to Hero [9h 6h]
77fce0a2: folds
Hero: folds
d2046be3: raises $0.2 to $0.3
aaa36d80: folds
Uncalled bet ($0.2) returned to d2046be3
*** SHOWDOWN ***
d2046be3 collected $0.2 from pot
*** SUMMARY ***
Total pot $0.2 | Rake $0 | Jackpot $0 | Bingo $0 | Fortune $0 | Tax $0
Seat 1: d2046be3 (small blind) collected ($0.2)
Seat 2: aaa36d80 (big blind) folded before Flop
Seat 3: 77fce0a2 folded before Flop (didn't bet)
Seat 6: Hero (button) folded before Flop (didn't bet)


Poker Hand #HD1788717041: Hold'em No Limit ($0.05/$0.1) - 2024/05/26 18:07:21
Table 'NLHRed17' 6-max Seat #3 is the button
Seat 1: d2046be3 ($14.35 in chips)
Seat 2: aaa36d80 ($10 in chips)
Seat 3: 77fce0a2 ($10 in chips)
Seat 6: Hero ($26.33 in chips)
Hero: posts small blind $0.05
d2046be3: posts big blind $0.1
*** HOLE CARDS ***
Dealt to d2046be3 
Dealt to aaa36d80 
Dealt to 77fce0a2 
Dealt to Hero [6s Qs]
aaa36d80: folds
77fce0a2: raises $0.15 to $0.25
Hero: folds
d2046be3: folds
Uncalled bet ($0.15) returned to 77fce0a2
*** SHOWDOWN ***
77fce0a2 collected $0.25 from pot
*** SUMMARY ***
Total pot $0.25 | Rake $0 | Jackpot $0 | Bingo $0 | Fortune $0 | Tax $0
Seat 1: d2046be3 (big blind) folded before Flop
Seat 2: aaa36d80 folded before Flop (didn't bet)
Seat 3: 77fce0a2 (button) collected ($0.25)
Seat 6: Hero (small blind) folded before Flop


Poker Hand #HD1788717020: Hold'em No Limit ($0.05/$0.1) - 2024/05/26 18:07:10
Table 'NLHRed17' 6-max Seat #2 is the button
Seat 1: d2046be3 ($14.35 in chips)
Seat 2: aaa36d80 ($10 in chips)
Seat 3: 77fce0a2 ($9.9 in chips)
Seat 4: b0a36c0c ($17.88 in chips)
Seat 6: Hero ($26.33 in chips)
77fce0a2: posts small blind $0.05
b0a36c0c: posts big blind $0.1
*** HOLE CARDS ***
Dealt to d2046be3 
Dealt to aaa36d80 
Dealt to 77fce0a2 
Dealt to b0a36c0c 
Dealt to Hero [2d 4c]
Hero: folds
d2046be3: folds
aaa36d80: folds
77fce0a2: raises $0.1 to $0.2
b0a36c0c: folds
Uncalled bet ($0.1) returned to 77fce0a2
*** SHOWDOWN ***
77fce0a2 collected $0.2 from pot
*** SUMMARY ***
Total pot $0.2 | Rake $0 | Jackpot $0 | Bingo $0 | Fortune $0 | Tax $0
Seat 1: d2046be3 folded before Flop (didn't bet)
Seat 2: aaa36d80 (button) folded before Flop (didn't bet)
Seat 3: 77fce0a2 (small blind) collected ($0.2)
Seat 4: b0a36c0c (big blind) folded before Flop
Seat 6: Hero folded before Flop (didn't bet)


Poker Hand #HD1788716879: Hold'em No Limit ($0.05/$0.1) - 2024/05/26 18:05:51
Table 'NLHRed17' 6-max Seat #1 is the button
Seat 1: d2046be3 ($14.35 in chips)
Seat 2: aaa36d80 ($10 in chips)
Seat 3: 77fce0a2 ($10 in chips)
Seat 4: b0a36c0c ($17.74 in chips)
Seat 6: Hero ($26.33 in chips)
aaa36d80: posts small blind $0.05
77fce0a2: posts big blind $0.1
*** HOLE CARDS ***
Dealt to d2046be3 
Dealt to aaa36d80 
Dealt to 77fce0a2 
Dealt to b0a36c0c 
Dealt to Hero [8s Js]
b0a36c0c: calls $0.1
Hero: folds
d2046be3: folds
aaa36d80: folds
77fce0a2: checks
*** FLOP *** [4c 7h 5h]
77fce0a2: checks
b0a36c0c: bets $0.25
77fce0a2: folds
Uncalled bet ($0.25) returned to b0a36c0c
*** SHOWDOWN ***
b0a36c0c collected $0.24 from pot
*** SUMMARY ***
Total pot $0.25 | Rake $0.01 | Jackpot $0 | Bingo $0 | Fortune $0 | Tax $0
Board [4c 7h 5h]
Seat 1: d2046be3 (button) folded before Flop (didn't bet)
Seat 2: aaa36d80 (small blind) folded before Flop
Seat 3: 77fce0a2 (big blind) folded on the Flop
Seat 4: b0a36c0c won ($0.24)
Seat 6: Hero folded before Flop (didn't bet)


Poker Hand #HD1788716848: Hold'em No Limit ($0.05/$0.1) - 2024/05/26 18:05:38
Table 'NLHRed17' 6-max Seat #6 is the button
Seat 1: d2046be3 ($14.25 in chips)
Seat 2: aaa36d80 ($10 in chips)
Seat 4: b0a36c0c ($17.74 in chips)
Seat 6: Hero ($26.33 in chips)
d2046be3: posts small blind $0.05
aaa36d80: posts big blind $0.1
*** HOLE CARDS ***
Dealt to d2046be3 
Dealt to aaa36d80 
Dealt to b0a36c0c 
Dealt to Hero [5c 9s]
b0a36c0c: folds
Hero: folds
d2046be3: raises $0.2 to $0.3
aaa36d80: folds
Uncalled bet ($0.2) returned to d2046be3
*** SHOWDOWN ***
d2046be3 collected $0.2 from pot
*** SUMMARY ***
Total pot $0.2 | Rake $0 | Jackpot $0 | Bingo $0 | Fortune $0 | Tax $0
Seat 1: d2046be3 (small blind) collected ($0.2)
Seat 2: aaa36d80 (big blind) folded before Flop
Seat 4: b0a36c0c folded before Flop (didn't bet)
Seat 6: Hero (button) folded before Flop (didn't bet)


Poker Hand #HD1788716688: Hold'em No Limit ($0.05/$0.1) - 2024/05/26 18:04:11
Table 'NLHRed17' 6-max Seat #4 is the button
Seat 1: d2046be3 ($14.35 in chips)
Seat 2: d38b56c9 ($12.38 in chips)
Seat 4: b0a36c0c ($21.34 in chips)
Seat 6: Hero ($23.09 in chips)
Hero: posts small blind $0.05
d2046be3: posts big blind $0.1
*** HOLE CARDS ***
Dealt to d2046be3 
Dealt to d38b56c9 
Dealt to b0a36c0c 
Dealt to Hero [8c 8s]
d38b56c9: folds
b0a36c0c: raises $0.15 to $0.25
Hero: raises $0.85 to $1.1
d2046be3: folds
b0a36c0c: calls $0.85
*** FLOP *** [2s As 3c]
Hero: bets $0.7
b0a36c0c: calls $0.7
*** TURN *** [2s As 3c] [Js]
Hero: checks
b0a36c0c: checks
*** RIVER *** [2s As 3c Js] [3s]
Hero: checks
b0a36c0c: bets $1.8
Hero: calls $1.8
b0a36c0c: shows [5c 5d] (Pair of Fives and Pair of Treys)
Hero: shows [8c 8s] (Ace High Flush)
*** SHOWDOWN ***
Hero collected $6.84 from pot
*** SUMMARY ***
Total pot $7.3 | Rake $0.36 | Jackpot $0.1 | Bingo $0 | Fortune $0 | Tax $0
Board [2s As 3c Js 3s]
Seat 1: d2046be3 (big blind) folded before Flop
Seat 2: d38b56c9 folded before Flop (didn't bet)
Seat 4: b0a36c0c (button) showed [5c 5d] and lost with Pair of Fives and Pair of Treys
Seat 6: Hero (small blind) showed [8c 8s] and won ($6.84) with Ace High Flush


Poker Hand #HD1788716592: Hold'em No Limit ($0.05/$0.1) - 2024/05/26 18:03:19
Table 'NLHRed17' 6-max Seat #3 is the button
Seat 1: d2046be3 ($14.35 in chips)
Seat 2: d38b56c9 ($12.38 in chips)
Seat 3: 4594eefd ($6.64 in chips)
Seat 4: b0a36c0c ($21.24 in chips)
Seat 5: 124e7fda ($5.41 in chips)
Seat 6: Hero ($23.09 in chips)
b0a36c0c: posts small blind $0.05
124e7fda: posts big blind $0.1
*** HOLE CARDS ***
Dealt to d2046be3 
Dealt to d38b56c9 
Dealt to 4594eefd 
Dealt to b0a36c0c 
Dealt to 124e7fda 
Dealt to Hero [7c 9s]
Hero: folds
d2046be3: folds
d38b56c9: folds
4594eefd: folds
b0a36c0c: raises $0.2 to $0.3
124e7fda: folds
Uncalled bet ($0.2) returned to b0a36c0c
*** SHOWDOWN ***
b0a36c0c collected $0.2 from pot
*** SUMMARY ***
Total pot $0.2 | Rake $0 | Jackpot $0 | Bingo $0 | Fortune $0 | Tax $0
Seat 1: d2046be3 folded before Flop (didn't bet)
Seat 2: d38b56c9 folded before Flop (didn't bet)
Seat 3: 4594eefd (button) folded before Flop (didn't bet)
Seat 4: b0a36c0c (small blind) collected ($0.2)
Seat 5: 124e7fda (big blind) folded before Flop
Seat 6: Hero folded before Flop (didn't bet)


Poker Hand #HD1788716427: Hold'em No Limit ($0.05/$0.1) - 2024/05/26 18:01:56
Table 'NLHRed17' 6-max Seat #2 is the button
Seat 1: d2046be3 ($13.65 in chips)
Seat 2: d38b56c9 ($12.63 in chips)
Seat 3: 4594eefd ($6.89 in chips)
Seat 4: b0a36c0c ($21.49 in chips)
Seat 5: 124e7fda ($5.41 in chips)
Seat 6: Hero ($23.09 in chips)
4594eefd: posts small blind $0.05
b0a36c0c: posts big blind $0.1
*** HOLE CARDS ***
Dealt to d2046be3 
Dealt to d38b56c9 
Dealt to 4594eefd 
Dealt to b0a36c0c 
Dealt to 124e7fda 
Dealt to Hero [7s 4d]
124e7fda: folds
Hero: folds
d2046be3: raises $0.15 to $0.25
d38b56c9: calls $0.25
4594eefd: calls $0.2
b0a36c0c: calls $0.15
*** FLOP *** [9s 8h Kc]
4594eefd: checks
b0a36c0c: checks
d2046be3: checks
d38b56c9: checks
*** TURN *** [9s 8h Kc] [Ac]
4594eefd: checks
b0a36c0c: checks
d2046be3: checks
d38b56c9: checks
*** RIVER *** [9s 8h Kc Ac] [9h]
4594eefd: checks
b0a36c0c: checks
d2046be3: checks
d38b56c9: checks
4594eefd: shows [5d 2d] (Pair of Nines)
b0a36c0c: shows [4h 5h] (Pair of Nines)
d2046be3: shows [Ad Jc] (Pair of Aces and Pair of Nines)
d38b56c9: shows [8d Qs] (Pair of Nines and Pair of Eights)
*** SHOWDOWN ***
d2046be3 collected $0.95 from pot
*** SUMMARY ***
Total pot $1 | Rake $0.05 | Jackpot $0 | Bingo $0 | Fortune $0 | Tax $0
Board [9s 8h Kc Ac 9h]
Seat 1: d2046be3 showed [Ad Jc] and won ($0.95) with Pair of Aces and Pair of Nines
Seat 2: d38b56c9 (button) showed [8d Qs] and lost with Pair of Nines and Pair of Eights
Seat 3: 4594eefd (small blind) showed [5d 2d] and lost with Pair of Nines
Seat 4: b0a36c0c (big blind) showed [4h 5h] and lost with Pair of Nines
Seat 5: 124e7fda folded before Flop (didn't bet)
Seat 6: Hero folded before Flop (didn't bet)


Poker Hand #HD1788716339: Hold'em No Limit ($0.05/$0.1) - 2024/05/26 18:01:16
Table 'NLHRed17' 6-max Seat #1 is the button
Seat 1: d2046be3 ($13.65 in chips)
Seat 2: d38b56c9 ($12.68 in chips)
Seat 3: 4594eefd ($6.99 in chips)
Seat 4: b0a36c0c ($21.49 in chips)
Seat 5: 124e7fda ($4.71 in chips)
Seat 6: Hero ($23.71 in chips)
d38b56c9: posts small blind $0.05
4594eefd: posts big blind $0.1
*** HOLE CARDS ***
Dealt to d2046be3 
Dealt to d38b56c9 
Dealt to 4594eefd 
Dealt to b0a36c0c 
Dealt to 124e7fda 
Dealt to Hero [Qs Ad]
b0a36c0c: folds
124e7fda: calls $0.1
Hero: raises $0.24 to $0.34
d2046be3: folds
d38b56c9: folds
4594eefd: folds
124e7fda: calls $0.24
*** FLOP *** [7s 4d 8d]
124e7fda: checks
Hero: bets $0.28
124e7fda: calls $0.28
*** TURN *** [7s 4d 8d] [9c]
124e7fda: checks
Hero: checks
*** RIVER *** [7s 4d 8d 9c] [7h]
124e7fda: bets $1.05
Hero: folds
Uncalled bet ($1.05) returned to 124e7fda
*** SHOWDOWN ***
124e7fda collected $1.32 from pot
*** SUMMARY ***
Total pot $1.39 | Rake $0.07 | Jackpot $0 | Bingo $0 | Fortune $0 | Tax $0
Board [7s 4d 8d 9c 7h]
Seat 1: d2046be3 (button) folded before Flop (didn't bet)
Seat 2: d38b56c9 (small blind) folded before Flop
Seat 3: 4594eefd (big blind) folded before Flop
Seat 4: b0a36c0c folded before Flop (didn't bet)
Seat 5: 124e7fda won ($1.32)
Seat 6: Hero folded on the River


Poker Hand #HD1788716313: Hold'em No Limit ($0.05/$0.1) - 2024/05/26 18:01:00
Table 'NLHRed17' 6-max Seat #6 is the button
Seat 1: d2046be3 ($13.7 in chips)
Seat 2: d38b56c9 ($12.78 in chips)
Seat 3: 4594eefd ($6.99 in chips)
Seat 4: b0a36c0c ($21.49 in chips)
Seat 5: 124e7fda ($4.71 in chips)
Seat 6: Hero ($23.56 in chips)
d2046be3: posts small blind $0.05
d38b56c9: posts big blind $0.1
*** HOLE CARDS ***
Dealt to d2046be3 
Dealt to d38b56c9 
Dealt to 4594eefd 
Dealt to b0a36c0c 
Dealt to 124e7fda 
Dealt to Hero [9d Th]
4594eefd: folds
b0a36c0c: folds
124e7fda: folds
Hero: raises $0.14 to $0.24
d2046be3: folds
d38b56c9: folds
Uncalled bet ($0.14) returned to Hero
*** SHOWDOWN ***
Hero collected $0.25 from pot
*** SUMMARY ***
Total pot $0.25 | Rake $0 | Jackpot $0 | Bingo $0 | Fortune $0 | Tax $0
Seat 1: d2046be3 (small blind) folded before Flop
Seat 2: d38b56c9 (big blind) folded before Flop
Seat 3: 4594eefd folded before Flop (didn't bet)
Seat 4: b0a36c0c folded before Flop (didn't bet)
Seat 5: 124e7fda folded before Flop (didn't bet)
Seat 6: Hero (button) collected ($0.25)


Poker Hand #HD1788716222: Hold'em No Limit ($0.05/$0.1) - 2024/05/26 18:00:09
Table 'NLHRed17' 6-max Seat #5 is the button
Seat 1: d2046be3 ($12.96 in chips)
Seat 2: d38b56c9 ($12.78 in chips)
Seat 3: 4594eefd ($6.99 in chips)
Seat 4: b0a36c0c ($21.49 in chips)
Seat 5: 124e7fda ($5.48 in chips)
Seat 6: Hero ($23.61 in chips)
Hero: posts small blind $0.05
d2046be3: posts big blind $0.1
*** HOLE CARDS ***
Dealt to d2046be3 
Dealt to d38b56c9 
Dealt to 4594eefd 
Dealt to b0a36c0c 
Dealt to 124e7fda 
Dealt to Hero [Js 4h]
d38b56c9: folds
4594eefd: folds
b0a36c0c: folds
124e7fda: calls $0.1
Hero: folds
d2046be3: checks
*** FLOP *** [4s 5d 9h]
d2046be3: checks
124e7fda: checks
*** TURN *** [4s 5d 9h] [6h]
d2046be3: bets $0.19
124e7fda: calls $0.19
*** RIVER *** [4s 5d 9h 6h] [Qd]
d2046be3: checks
124e7fda: bets $0.48
d2046be3: calls $0.48
124e7fda: shows [Ks 7h] (King-High)
d2046be3: shows [6d 3s] (Pair of Sixes)
*** SHOWDOWN ***
d2046be3 collected $1.51 from pot
*** SUMMARY ***
Total pot $1.59 | Rake $0.08 | Jackpot $0 | Bingo $0 | Fortune $0 | Tax $0
Board [4s 5d 9h 6h Qd]
Seat 1: d2046be3 (big blind) showed [6d 3s] and won ($1.51) with Pair of Sixes
Seat 2: d38b56c9 folded before Flop (didn't bet)
Seat 3: 4594eefd folded before Flop (didn't bet)
Seat 4: b0a36c0c folded before Flop (didn't bet)
Seat 5: 124e7fda (button) showed [Ks 7h] and lost with King-High
Seat 6: Hero (small blind) folded before Flop


Poker Hand #HD1788716186: Hold'em No Limit ($0.05/$0.1) - 2024/05/26 17:59:52
Table 'NLHRed17' 6-max Seat #4 is the button
Seat 1: d2046be3 ($12.96 in chips)
Seat 2: d38b56c9 ($12.78 in chips)
Seat 3: 4594eefd ($6.99 in chips)
Seat 4: b0a36c0c ($21.49 in chips)
Seat 5: 124e7fda ($5.39 in chips)
Seat 6: Hero ($23.71 in chips)
124e7fda: posts small blind $0.05
Hero: posts big blind $0.1
*** HOLE CARDS ***
Dealt to d2046be3 
Dealt to d38b56c9 
Dealt to 4594eefd 
Dealt to b0a36c0c 
Dealt to 124e7fda 
Dealt to Hero [2d 7s]
d2046be3: folds
d38b56c9: folds
4594eefd: folds
b0a36c0c: folds
124e7fda: calls $0.05
Hero: checks
*** FLOP *** [As 8c Jd]
124e7fda: bets $0.1
Hero: folds
Uncalled bet ($0.1) returned to 124e7fda
*** SHOWDOWN ***
124e7fda collected $0.19 from pot
*** SUMMARY ***
Total pot $0.2 | Rake $0.01 | Jackpot $0 | Bingo $0 | Fortune $0 | Tax $0
Board [As 8c Jd]
Seat 1: d2046be3 folded before Flop (didn't bet)
Seat 2: d38b56c9 folded before Flop (didn't bet)
Seat 3: 4594eefd folded before Flop (didn't bet)
Seat 4: b0a36c0c (button) folded before Flop (didn't bet)
Seat 5: 124e7fda (small blind) won ($0.19)
Seat 6: Hero (big blind) folded on the Flop


Poker Hand #HD1788716159: Hold'em No Limit ($0.05/$0.1) - 2024/05/26 17:59:40
Table 'NLHRed17' 6-max Seat #3 is the button
Seat 1: d2046be3 ($12.96 in chips)
Seat 2: d38b56c9 ($12.78 in chips)
Seat 3: 4594eefd ($6.99 in chips)
Seat 4: b0a36c0c ($21.54 in chips)
Seat 5: 124e7fda ($5.34 in chips)
Seat 6: Hero ($23.71 in chips)
b0a36c0c: posts small blind $0.05
124e7fda: posts big blind $0.1
*** HOLE CARDS ***
Dealt to d2046be3 
Dealt to d38b56c9 
Dealt to 4594eefd 
Dealt to b0a36c0c 
Dealt to 124e7fda 
Dealt to Hero [2d 4h]
Hero: folds
d2046be3: folds
d38b56c9: folds
4594eefd: folds
b0a36c0c: folds
Uncalled bet ($0.05) returned to 124e7fda
*** SHOWDOWN ***
124e7fda collected $0.1 from pot
*** SUMMARY ***
Total pot $0.1 | Rake $0 | Jackpot $0 | Bingo $0 | Fortune $0 | Tax $0
Seat 1: d2046be3 folded before Flop (didn't bet)
Seat 2: d38b56c9 folded before Flop (didn't bet)
Seat 3: 4594eefd (button) folded before Flop (didn't bet)
Seat 4: b0a36c0c (small blind) folded before Flop
Seat 5: 124e7fda (big blind) collected ($0.1)
Seat 6: Hero folded before Flop (didn't bet)


Poker Hand #HD1788716064: Hold'em No Limit ($0.05/$0.1) - 2024/05/26 17:58:45
Table 'NLHRed17' 6-max Seat #2 is the button
Seat 1: d2046be3 ($12.96 in chips)
Seat 2: d38b56c9 ($12.78 in chips)
Seat 3: 4594eefd ($6.9 in chips)
Seat 4: b0a36c0c ($21.64 in chips)
Seat 5: 124e7fda ($5.34 in chips)
Seat 6: Hero ($23.71 in chips)
4594eefd: posts small blind $0.05
b0a36c0c: posts big blind $0.1
*** HOLE CARDS ***
Dealt to d2046be3 
Dealt to d38b56c9 
Dealt to 4594eefd 
Dealt to b0a36c0c 
Dealt to 124e7fda 
Dealt to Hero [9s 2d]
124e7fda: folds
Hero: folds
d2046be3: folds
d38b56c9: folds
4594eefd: calls $0.05
b0a36c0c: checks
*** FLOP *** [8h 5s Kc]
4594eefd: checks
b0a36c0c: checks
*** TURN *** [8h 5s Kc] [Qd]
4594eefd: bets $0.15
b0a36c0c: folds
Uncalled bet ($0.15) returned to 4594eefd
*** SHOWDOWN ***
4594eefd collected $0.19 from pot
*** SUMMARY ***
Total pot $0.2 | Rake $0.01 | Jackpot $0 | Bingo $0 | Fortune $0 | Tax $0
Board [8h 5s Kc Qd]
Seat 1: d2046be3 folded before Flop (didn't bet)
Seat 2: d38b56c9 (button) folded before Flop (didn't bet)
Seat 3: 4594eefd (small blind) won ($0.19)
Seat 4: b0a36c0c (big blind) folded on the Turn
Seat 5: 124e7fda folded before Flop (didn't bet)
Seat 6: Hero folded before Flop (didn't bet)


Poker Hand #HD1788716010: Hold'em No Limit ($0.05/$0.1) - 2024/05/26 17:58:17
Table 'NLHRed17' 6-max Seat #1 is the button
Seat 1: d2046be3 ($13.33 in chips)
Seat 2: d38b56c9 ($12.25 in chips)
Seat 3: 4594eefd ($7 in chips)
Seat 4: b0a36c0c ($21.64 in chips)
Seat 5: 124e7fda ($5.44 in chips)
Seat 6: Hero ($23.71 in chips)
d38b56c9: posts small blind $0.05
4594eefd: posts big blind $0.1
*** HOLE CARDS ***
Dealt to d2046be3 
Dealt to d38b56c9 
Dealt to 4594eefd 
Dealt to b0a36c0c 
Dealt to 124e7fda 
Dealt to Hero [7c 6h]
b0a36c0c: folds
124e7fda: calls $0.1
Hero: folds
d2046be3: raises $0.27 to $0.37
d38b56c9: raises $0.71 to $1.08
4594eefd: folds
124e7fda: folds
d2046be3: folds
Uncalled bet ($0.71) returned to d38b56c9
*** SHOWDOWN ***
d38b56c9 collected $0.9 from pot
*** SUMMARY ***
Total pot $0.94 | Rake $0.04 | Jackpot $0 | Bingo $0 | Fortune $0 | Tax $0
Seat 1: d2046be3 (button) folded before Flop
Seat 2: d38b56c9 (small blind) collected ($0.9)
Seat 3: 4594eefd (big blind) folded before Flop
Seat 4: b0a36c0c folded before Flop (didn't bet)
Seat 5: 124e7fda folded before Flop
Seat 6: Hero folded before Flop (didn't bet)


Poker Hand #HD1788715876: Hold'em No Limit ($0.05/$0.1) - 2024/05/26 17:57:09
Table 'NLHRed17' 6-max Seat #6 is the button
Seat 1: d2046be3 ($10 in chips)
Seat 2: d38b56c9 ($12.35 in chips)
Seat 3: 4594eefd ($10.7 in chips)
Seat 4: b0a36c0c ($21.64 in chips)
Seat 5: 124e7fda ($5.44 in chips)
Seat 6: Hero ($23.71 in chips)
d2046be3: posts small blind $0.05
d38b56c9: posts big blind $0.1
*** HOLE CARDS ***
Dealt to d2046be3 
Dealt to d38b56c9 
Dealt to 4594eefd 
Dealt to b0a36c0c 
Dealt to 124e7fda 
Dealt to Hero [6s Qh]
4594eefd: calls $0.1
b0a36c0c: folds
124e7fda: folds
Hero: folds
d2046be3: raises $0.45 to $0.55
d38b56c9: folds
4594eefd: calls $0.45
*** FLOP *** [8h 5s 4d]
d2046be3: checks
4594eefd: bets $0.9
d2046be3: calls $0.9
*** TURN *** [8h 5s 4d] [4s]
d2046be3: checks
4594eefd: bets $2.25
d2046be3: calls $2.25
*** RIVER *** [8h 5s 4d 4s] [9c]
d2046be3: checks
4594eefd: checks
d2046be3: shows [As Ad] (Pair of Aces and Pair of Fours)
4594eefd: shows [Kc Qc] (Pair of Fours)
*** SHOWDOWN ***
d2046be3 collected $7.03 from pot
*** SUMMARY ***
Total pot $7.5 | Rake $0.37 | Jackpot $0.1 | Bingo $0 | Fortune $0 | Tax $0
Board [8h 5s 4d 4s 9c]
Seat 1: d2046be3 (small blind) showed [As Ad] and won ($7.03) with Pair of Aces and Pair of Fours
Seat 2: d38b56c9 (big blind) folded before Flop
Seat 3: 4594eefd showed [Kc Qc] and lost with Pair of Fours
Seat 4: b0a36c0c folded before Flop (didn't bet)
Seat 5: 124e7fda folded before Flop (didn't bet)
Seat 6: Hero (button) folded before Flop (didn't bet)


Poker Hand #HD1788715801: Hold'em No Limit ($0.05/$0.1) - 2024/05/26 17:56:31
Table 'NLHRed17' 6-max Seat #5 is the button
Seat 1: d2046be3 ($10 in chips)
Seat 2: d38b56c9 ($12.35 in chips)
Seat 3: 4594eefd ($10.56 in chips)
Seat 4: b0a36c0c ($21.64 in chips)
Seat 5: 124e7fda ($5.44 in chips)
Seat 6: Hero ($23.76 in chips)
Hero: posts small blind $0.05
d2046be3: posts big blind $0.1
*** HOLE CARDS ***
Dealt to d2046be3 
Dealt to d38b56c9 
Dealt to 4594eefd 
Dealt to b0a36c0c 
Dealt to 124e7fda 
Dealt to Hero [9c 8h]
d38b56c9: folds
4594eefd: calls $0.1
b0a36c0c: folds
124e7fda: folds
Hero: folds
d2046be3: checks
*** FLOP *** [5d 3s Kh]
d2046be3: checks
4594eefd: bets $0.19
d2046be3: folds
Uncalled bet ($0.19) returned to 4594eefd
*** SHOWDOWN ***
4594eefd collected $0.24 from pot
*** SUMMARY ***
Total pot $0.25 | Rake $0.01 | Jackpot $0 | Bingo $0 | Fortune $0 | Tax $0
Board [5d 3s Kh]
Seat 1: d2046be3 (big blind) folded on the Flop
Seat 2: d38b56c9 folded before Flop (didn't bet)
Seat 3: 4594eefd won ($0.24)
Seat 4: b0a36c0c folded before Flop (didn't bet)
Seat 5: 124e7fda (button) folded before Flop (didn't bet)
Seat 6: Hero (small blind) folded before Flop


Poker Hand #HD1788715767: Hold'em No Limit ($0.05/$0.1) - 2024/05/26 17:56:14
Table 'NLHRed17' 6-max Seat #4 is the button
Seat 1: d2046be3 ($10 in chips)
Seat 2: d38b56c9 ($12.35 in chips)
Seat 3: 4594eefd ($10.61 in chips)
Seat 4: b0a36c0c ($21.64 in chips)
Seat 5: 124e7fda ($5.29 in chips)
Seat 6: Hero ($23.86 in chips)
124e7fda: posts small blind $0.05
Hero: posts big blind $0.1
4594eefd: posts missed blind $0.05
*** HOLE CARDS ***
Dealt to d2046be3 
Dealt to d38b56c9 
Dealt to 4594eefd 
Dealt to b0a36c0c 
Dealt to 124e7fda 
Dealt to Hero [3s 8c]
d2046be3: folds
d38b56c9: folds
4594eefd: folds
b0a36c0c: folds
124e7fda: raises $0.2 to $0.3
Hero: folds
Uncalled bet ($0.2) returned to 124e7fda
*** SHOWDOWN ***
124e7fda collected $0.25 from pot
*** SUMMARY ***
Total pot $0.25 | Rake $0 | Jackpot $0 | Bingo $0 | Fortune $0 | Tax $0
Seat 1: d2046be3 folded before Flop (didn't bet)
Seat 2: d38b56c9 folded before Flop (didn't bet)
Seat 3: 4594eefd folded before Flop
Seat 4: b0a36c0c (button) folded before Flop (didn't bet)
Seat 5: 124e7fda (small blind) collected ($0.25)
Seat 6: Hero (big blind) folded before Flop


Poker Hand #HD1788655636: Hold'em No Limit ($0.05/$0.1) - 2024/05/26 17:55:08
Table 'NLHRed17' 6-max Seat #2 is the button
Seat 1: d2046be3 ($10.35 in chips)
Seat 2: d38b56c9 ($12.35 in chips)
Seat 4: b0a36c0c ($21.69 in chips)
Seat 5: 124e7fda ($3.58 in chips)
Seat 6: Hero ($24.06 in chips)
b0a36c0c: posts small blind $0.05
124e7fda: posts big blind $0.1
*** HOLE CARDS ***
Dealt to d2046be3 
Dealt to d38b56c9 
Dealt to b0a36c0c 
Dealt to 124e7fda 
Dealt to Hero [9d 8d]
Hero: raises $0.1 to $0.2
d2046be3: raises $0.42 to $0.62
d38b56c9: folds
b0a36c0c: folds
124e7fda: calls $0.52
Hero: folds
*** FLOP *** [Qh Th 9h]
124e7fda: checks
d2046be3: checks
*** TURN *** [Qh Th 9h] [As]
124e7fda: bets $1.12
d2046be3: calls $1.12
*** RIVER *** [Qh Th 9h As] [4h]
124e7fda: bets $1.84 and is all-in
d2046be3: folds
Uncalled bet ($1.84) returned to 124e7fda
*** SHOWDOWN ***
124e7fda collected $3.45 from pot
*** SUMMARY ***
Total pot $3.73 | Rake $0.18 | Jackpot $0.1 | Bingo $0 | Fortune $0 | Tax $0
Board [Qh Th 9h As 4h]
Seat 1: d2046be3 folded on the River
Seat 2: d38b56c9 (button) folded before Flop (didn't bet)
Seat 4: b0a36c0c (small blind) folded before Flop
Seat 5: 124e7fda (big blind) won ($3.45)
Seat 6: Hero folded before Flop


Poker Hand #HD1788655577: Hold'em No Limit ($0.05/$0.1) - 2024/05/26 17:54:36
Table 'NLHRed17' 6-max Seat #1 is the button
Seat 1: d2046be3 ($10.35 in chips)
Seat 2: d38b56c9 ($12.4 in chips)
Seat 3: 4594eefd ($10.71 in chips)
Seat 4: b0a36c0c ($21.54 in chips)
Seat 5: 124e7fda ($3.58 in chips)
Seat 6: Hero ($24.06 in chips)
d38b56c9: posts small blind $0.05
4594eefd: posts big blind $0.1
*** HOLE CARDS ***
Dealt to d2046be3 
Dealt to d38b56c9 
Dealt to 4594eefd 
Dealt to b0a36c0c 
Dealt to 124e7fda 
Dealt to Hero [Qs 4d]
b0a36c0c: raises $0.25 to $0.35
124e7fda: folds
Hero: folds
d2046be3: folds
d38b56c9: folds
4594eefd: folds
Uncalled bet ($0.25) returned to b0a36c0c
*** SHOWDOWN ***
b0a36c0c collected $0.25 from pot
*** SUMMARY ***
Total pot $0.25 | Rake $0 | Jackpot $0 | Bingo $0 | Fortune $0 | Tax $0
Seat 1: d2046be3 (button) folded before Flop (didn't bet)
Seat 2: d38b56c9 (small blind) folded before Flop
Seat 3: 4594eefd (big blind) folded before Flop
Seat 4: b0a36c0c collected ($0.25)
Seat 5: 124e7fda folded before Flop (didn't bet)
Seat 6: Hero folded before Flop (didn't bet)


Poker Hand #HD1788655453: Hold'em No Limit ($0.05/$0.1) - 2024/05/26 17:53:33
Table 'NLHRed17' 6-max Seat #6 is the button
Seat 1: d2046be3 ($10.4 in chips)
Seat 2: d38b56c9 ($10 in chips)
Seat 3: 4594eefd ($13.32 in chips)
Seat 4: b0a36c0c ($21.54 in chips)
Seat 5: 124e7fda ($3.68 in chips)
Seat 6: Hero ($24.06 in chips)
d2046be3: posts small blind $0.05
d38b56c9: posts big blind $0.1
*** HOLE CARDS ***
Dealt to d2046be3 
Dealt to d38b56c9 
Dealt to 4594eefd 
Dealt to b0a36c0c 
Dealt to 124e7fda 
Dealt to Hero [Th Jd]
4594eefd: calls $0.1
b0a36c0c: folds
124e7fda: calls $0.1
Hero: folds
d2046be3: folds
d38b56c9: checks
*** FLOP *** [2c Ts 8h]
d38b56c9: bets $0.18
4594eefd: calls $0.18
124e7fda: folds
*** TURN *** [2c Ts 8h] [Jc]
d38b56c9: bets $0.54
4594eefd: calls $0.54
*** RIVER *** [2c Ts 8h Jc] [Tc]
d38b56c9: bets $1.79
4594eefd: calls $1.79
d38b56c9: shows [9s 7d] (Jacks-High Straight)
4594eefd: shows [2d 8d] (Pair of Tens and Pair of Eights)
*** SHOWDOWN ***
d38b56c9 collected $5.01 from pot
*** SUMMARY ***
Total pot $5.37 | Rake $0.26 | Jackpot $0.1 | Bingo $0 | Fortune $0 | Tax $0
Board [2c Ts 8h Jc Tc]
Seat 1: d2046be3 (small blind) folded before Flop
Seat 2: d38b56c9 (big blind) showed [9s 7d] and won ($5.01) with Jacks-High Straight
Seat 3: 4594eefd showed [2d 8d] and lost with Pair of Tens and Pair of Eights
Seat 4: b0a36c0c folded before Flop (didn't bet)
Seat 5: 124e7fda folded on the Flop
Seat 6: Hero (button) folded before Flop (didn't bet)


Poker Hand #HD1788655345: Hold'em No Limit ($0.05/$0.1) - 2024/05/26 17:52:41
Table 'NLHRed17' 6-max Seat #5 is the button
Seat 1: d2046be3 ($10.5 in chips)
Seat 2: d38b56c9 ($10 in chips)
Seat 4: b0a36c0c ($21.54 in chips)
Seat 5: 124e7fda ($3.35 in chips)
Seat 6: Hero ($24.11 in chips)
Hero: posts small blind $0.05
d2046be3: posts big blind $0.1
*** HOLE CARDS ***
Dealt to d2046be3 
Dealt to d38b56c9 
Dealt to b0a36c0c 
Dealt to 124e7fda 
Dealt to Hero [2s 9h]
d38b56c9: raises $0.1 to $0.2
b0a36c0c: folds
124e7fda: calls $0.2
Hero: folds
d2046be3: folds
*** FLOP *** [5h Th Tc]
d38b56c9: checks
124e7fda: checks
*** TURN *** [5h Th Tc] [3c]
d38b56c9: checks
124e7fda: checks
*** RIVER *** [5h Th Tc 3c] [2c]
d38b56c9: checks
124e7fda: checks
d38b56c9: shows [9s Ks] (Pair of Tens)
124e7fda: shows [Kd 2d] (Pair of Tens and Pair of Twos)
*** SHOWDOWN ***
124e7fda collected $0.53 from pot
*** SUMMARY ***
Total pot $0.55 | Rake $0.02 | Jackpot $0 | Bingo $0 | Fortune $0 | Tax $0
Board [5h Th Tc 3c 2c]
Seat 1: d2046be3 (big blind) folded before Flop
Seat 2: d38b56c9 showed [9s Ks] and lost with Pair of Tens
Seat 4: b0a36c0c folded before Flop (didn't bet)
Seat 5: 124e7fda (button) showed [Kd 2d] and won ($0.53) with Pair of Tens and Pair of Twos
Seat 6: Hero (small blind) folded before Flop


Poker Hand #HD1788655309: Hold'em No Limit ($0.05/$0.1) - 2024/05/26 17:52:18
Table 'NLHRed17' 6-max Seat #4 is the button
Seat 1: d2046be3 ($10.5 in chips)
Seat 2: d38b56c9 ($10 in chips)
Seat 3: 4594eefd ($13.32 in chips)
Seat 4: b0a36c0c ($21.39 in chips)
Seat 5: 124e7fda ($3.4 in chips)
Seat 6: Hero ($24.21 in chips)
124e7fda: posts small blind $0.05
Hero: posts big blind $0.1
*** HOLE CARDS ***
Dealt to d2046be3 
Dealt to d38b56c9 
Dealt to 4594eefd 
Dealt to b0a36c0c 
Dealt to 124e7fda 
Dealt to Hero [7d 2s]
d2046be3: folds
d38b56c9: folds
4594eefd: folds
b0a36c0c: raises $0.15 to $0.25
124e7fda: folds
Hero: folds
Uncalled bet ($0.15) returned to b0a36c0c
*** SHOWDOWN ***
b0a36c0c collected $0.25 from pot
*** SUMMARY ***
Total pot $0.25 | Rake $0 | Jackpot $0 | Bingo $0 | Fortune $0 | Tax $0
Seat 1: d2046be3 folded before Flop (didn't bet)
Seat 2: d38b56c9 folded before Flop (didn't bet)
Seat 3: 4594eefd folded before Flop (didn't bet)
Seat 4: b0a36c0c (button) collected ($0.25)
Seat 5: 124e7fda (small blind) folded before Flop
Seat 6: Hero (big blind) folded before Flop


Poker Hand #HD1788655204: Hold'em No Limit ($0.05/$0.1) - 2024/05/26 17:51:23
Table 'NLHRed17' 6-max Seat #3 is the button
Seat 1: d2046be3 ($10.75 in chips)
Seat 2: d38b56c9 ($10 in chips)
Seat 3: 4594eefd ($13.32 in chips)
Seat 4: b0a36c0c ($21.44 in chips)
Seat 5: 124e7fda ($2.89 in chips)
Seat 6: Hero ($24.21 in chips)
b0a36c0c: posts small blind $0.05
124e7fda: posts big blind $0.1
*** HOLE CARDS ***
Dealt to d2046be3 
Dealt to d38b56c9 
Dealt to 4594eefd 
Dealt to b0a36c0c 
Dealt to 124e7fda 
Dealt to Hero [Ts 9d]
Hero: folds
d2046be3: raises $0.15 to $0.25
d38b56c9: calls $0.25
4594eefd: folds
b0a36c0c: folds
124e7fda: calls $0.15
*** FLOP *** [6d 4c Qs]
124e7fda: checks
d2046be3: checks
d38b56c9: checks
*** TURN *** [6d 4c Qs] [9h]
124e7fda: checks
d2046be3: checks
d38b56c9: checks
*** RIVER *** [6d 4c Qs 9h] [7s]
124e7fda: checks
d2046be3: checks
d38b56c9: checks
124e7fda: shows [3c 7c] (Pair of Sevens)
d2046be3: shows [Jc Kc] (King-High)
d38b56c9: shows [2h 2d] (Pair of Twos)
*** SHOWDOWN ***
124e7fda collected $0.76 from pot
*** SUMMARY ***
Total pot $0.8 | Rake $0.04 | Jackpot $0 | Bingo $0 | Fortune $0 | Tax $0
Board [6d 4c Qs 9h 7s]
Seat 1: d2046be3 showed [Jc Kc] and lost with King-High
Seat 2: d38b56c9 showed [2h 2d] and lost with Pair of Twos
Seat 3: 4594eefd (button) folded before Flop (didn't bet)
Seat 4: b0a36c0c (small blind) folded before Flop
Seat 5: 124e7fda (big blind) showed [3c 7c] and won ($0.76) with Pair of Sevens
Seat 6: Hero folded before Flop (didn't bet)


Poker Hand #HD1788655144: Hold'em No Limit ($0.05/$0.1) - 2024/05/26 17:50:52
Table 'NLHRed17' 6-max Seat #2 is the button
Seat 1: d2046be3 ($10.75 in chips)
Seat 2: d38b56c9 ($10 in chips)
Seat 3: 4594eefd ($13.04 in chips)
Seat 4: b0a36c0c ($21.54 in chips)
Seat 5: 124e7fda ($2.89 in chips)
Seat 6: Hero ($24.21 in chips)
4594eefd: posts small blind $0.05
b0a36c0c: posts big blind $0.1
*** HOLE CARDS ***
Dealt to d2046be3 
Dealt to d38b56c9 
Dealt to 4594eefd 
Dealt to b0a36c0c 
Dealt to 124e7fda 
Dealt to Hero [5s 7c]
124e7fda: folds
Hero: folds
d2046be3: folds
d38b56c9: raises $0.1 to $0.2
4594eefd: calls $0.15
b0a36c0c: folds
*** FLOP *** [3d Ts Th]
4594eefd: bets $0.38
d38b56c9: folds
Uncalled bet ($0.38) returned to 4594eefd
*** SHOWDOWN ***
4594eefd collected $0.48 from pot
*** SUMMARY ***
Total pot $0.5 | Rake $0.02 | Jackpot $0 | Bingo $0 | Fortune $0 | Tax $0
Board [3d Ts Th]
Seat 1: d2046be3 folded before Flop (didn't bet)
Seat 2: d38b56c9 (button) folded on the Flop
Seat 3: 4594eefd (small blind) won ($0.48)
Seat 4: b0a36c0c (big blind) folded before Flop
Seat 5: 124e7fda folded before Flop (didn't bet)
Seat 6: Hero folded before Flop (didn't bet)


Poker Hand #HD1788655094: Hold'em No Limit ($0.05/$0.1) - 2024/05/26 17:50:23
Table 'NLHRed17' 6-max Seat #1 is the button
Seat 1: d2046be3 ($10.75 in chips)
Seat 2: d38b56c9 ($10 in chips)
Seat 3: 4594eefd ($12.5 in chips)
Seat 4: b0a36c0c ($21.54 in chips)
Seat 5: 124e7fda ($3.43 in chips)
Seat 6: Hero ($24.21 in chips)
d38b56c9: posts small blind $0.05
4594eefd: posts big blind $0.1
*** HOLE CARDS ***
Dealt to d2046be3 
Dealt to d38b56c9 
Dealt to 4594eefd 
Dealt to b0a36c0c 
Dealt to 124e7fda 
Dealt to Hero [2c 5d]
b0a36c0c: folds
124e7fda: raises $0.1 to $0.2
Hero: folds
d2046be3: folds
d38b56c9: folds
4594eefd: raises $0.34 to $0.54
124e7fda: calls $0.34
*** FLOP *** [2d 6s Ah]
4594eefd: bets $0.85
124e7fda: folds
Uncalled bet ($0.85) returned to 4594eefd
*** SHOWDOWN ***
4594eefd collected $1.08 from pot
*** SUMMARY ***
Total pot $1.13 | Rake $0.05 | Jackpot $0 | Bingo $0 | Fortune $0 | Tax $0
Board [2d 6s Ah]
Seat 1: d2046be3 (button) folded before Flop (didn't bet)
Seat 2: d38b56c9 (small blind) folded before Flop
Seat 3: 4594eefd (big blind) won ($1.08)
Seat 4: b0a36c0c folded before Flop (didn't bet)
Seat 5: 124e7fda folded on the Flop
Seat 6: Hero folded before Flop (didn't bet)


Poker Hand #HD1788655003: Hold'em No Limit ($0.05/$0.1) - 2024/05/26 17:49:36
Table 'NLHRed17' 6-max Seat #6 is the button
Seat 1: d2046be3 ($10.8 in chips)
Seat 2: d38b56c9 ($10 in chips)
Seat 3: 4594eefd ($12.5 in chips)
Seat 4: b0a36c0c ($21.54 in chips)
Seat 5: 124e7fda ($3.29 in chips)
Seat 6: Hero ($24.21 in chips)
d2046be3: posts small blind $0.05
d38b56c9: posts big blind $0.1
*** HOLE CARDS ***
Dealt to d2046be3 
Dealt to d38b56c9 
Dealt to 4594eefd 
Dealt to b0a36c0c 
Dealt to 124e7fda 
Dealt to Hero [7d 5d]
4594eefd: folds
b0a36c0c: folds
124e7fda: calls $0.1
Hero: folds
d2046be3: folds
d38b56c9: checks
*** FLOP *** [3c Kc Td]
d38b56c9: checks
124e7fda: checks
*** TURN *** [3c Kc Td] [8c]
d38b56c9: checks
124e7fda: bets $0.13
d38b56c9: folds
Uncalled bet ($0.13) returned to 124e7fda
*** SHOWDOWN ***
124e7fda collected $0.24 from pot
*** SUMMARY ***
Total pot $0.25 | Rake $0.01 | Jackpot $0 | Bingo $0 | Fortune $0 | Tax $0
Board [3c Kc Td 8c]
Seat 1: d2046be3 (small blind) folded before Flop
Seat 2: d38b56c9 (big blind) folded on the Turn
Seat 3: 4594eefd folded before Flop (didn't bet)
Seat 4: b0a36c0c folded before Flop (didn't bet)
Seat 5: 124e7fda won ($0.24)
Seat 6: Hero (button) folded before Flop (didn't bet)


Poker Hand #HD1788654901: Hold'em No Limit ($0.05/$0.1) - 2024/05/26 17:48:46
Table 'NLHRed17' 6-max Seat #5 is the button
Seat 1: d2046be3 ($10 in chips)
Seat 2: d38b56c9 ($10 in chips)
Seat 3: 4594eefd ($12.5 in chips)
Seat 4: b0a36c0c ($21.54 in chips)
Seat 5: 124e7fda ($3.29 in chips)
Seat 6: Hero ($24.26 in chips)
Hero: posts small blind $0.05
d2046be3: posts big blind $0.1
*** HOLE CARDS ***
Dealt to d2046be3 
Dealt to d38b56c9 
Dealt to 4594eefd 
Dealt to b0a36c0c 
Dealt to 124e7fda 
Dealt to Hero [3d 9s]
d38b56c9: raises $0.1 to $0.2
4594eefd: folds
b0a36c0c: folds
124e7fda: folds
Hero: folds
d2046be3: calls $0.1
*** FLOP *** [2s Jd Kh]
d2046be3: checks
d38b56c9: bets $0.2
d2046be3: calls $0.2
*** TURN *** [2s Jd Kh] [Ac]
d2046be3: checks
d38b56c9: bets $0.43
d2046be3: calls $0.43
*** RIVER *** [2s Jd Kh Ac] [Jh]
d2046be3: checks
d38b56c9: checks
d2046be3: shows [Ah Tc] (Pair of Aces and Pair of Jacks)
d38b56c9: shows [Kd Qd] (Pair of Kings and Pair of Jacks)
*** SHOWDOWN ***
d2046be3 collected $1.63 from pot
*** SUMMARY ***
Total pot $1.71 | Rake $0.08 | Jackpot $0 | Bingo $0 | Fortune $0 | Tax $0
Board [2s Jd Kh Ac Jh]
Seat 1: d2046be3 (big blind) showed [Ah Tc] and won ($1.63) with Pair of Aces and Pair of Jacks
Seat 2: d38b56c9 showed [Kd Qd] and lost with Pair of Kings and Pair of Jacks
Seat 3: 4594eefd folded before Flop (didn't bet)
Seat 4: b0a36c0c folded before Flop (didn't bet)
Seat 5: 124e7fda (button) folded before Flop (didn't bet)
Seat 6: Hero (small blind) folded before Flop


Poker Hand #HD1788654783: Hold'em No Limit ($0.05/$0.1) - 2024/05/26 17:47:46
Table 'NLHRed17' 6-max Seat #4 is the button
Seat 1: d2046be3 ($10.1 in chips)
Seat 2: d38b56c9 ($10 in chips)
Seat 3: 4594eefd ($11.49 in chips)
Seat 4: b0a36c0c ($21.54 in chips)
Seat 5: 124e7fda ($3.34 in chips)
Seat 6: Hero ($24.36 in chips)
124e7fda: posts small blind $0.05
Hero: posts big blind $0.1
*** HOLE CARDS ***
Dealt to d2046be3 
Dealt to d38b56c9 
Dealt to 4594eefd 
Dealt to b0a36c0c 
Dealt to 124e7fda 
Dealt to Hero [7h 4c]
d2046be3: raises $0.15 to $0.25
d38b56c9: calls $0.25
4594eefd: calls $0.25
b0a36c0c: folds
124e7fda: folds
Hero: folds
*** FLOP *** [8h 7c 5s]
d2046be3: checks
d38b56c9: checks
4594eefd: checks
*** TURN *** [8h 7c 5s] [8d]
d2046be3: checks
d38b56c9: checks
4594eefd: checks
*** RIVER *** [8h 7c 5s 8d] [As]
d2046be3: checks
d38b56c9: bets $0.45
4594eefd: calls $0.45
d2046be3: folds
d38b56c9: shows [Td Ac] (Pair of Aces and Pair of Eights)
4594eefd: shows [Ad Jd] (Pair of Aces and Pair of Eights)
*** SHOWDOWN ***
4594eefd collected $1.71 from pot
*** SUMMARY ***
Total pot $1.8 | Rake $0.09 | Jackpot $0 | Bingo $0 | Fortune $0 | Tax $0
Board [8h 7c 5s 8d As]
Seat 1: d2046be3 folded on the River
Seat 2: d38b56c9 showed [Td Ac] and lost with Pair of Aces and Pair of Eights
Seat 3: 4594eefd showed [Ad Jd] and won ($1.71) with Pair of Aces and Pair of Eights
Seat 4: b0a36c0c (button) folded before Flop (didn't bet)
Seat 5: 124e7fda (small blind) folded before Flop
Seat 6: Hero (big blind) folded before Flop


Poker Hand #HD1788654701: Hold'em No Limit ($0.05/$0.1) - 2024/05/26 17:47:06
Table 'NLHRed17' 6-max Seat #3 is the button
Seat 1: d2046be3 ($10.1 in chips)
Seat 2: d38b56c9 ($10 in chips)
Seat 3: 4594eefd ($11.18 in chips)
Seat 4: b0a36c0c ($21.59 in chips)
Seat 5: 124e7fda ($3.63 in chips)
Seat 6: Hero ($24.36 in chips)
b0a36c0c: posts small blind $0.05
124e7fda: posts big blind $0.1
*** HOLE CARDS ***
Dealt to d2046be3 
Dealt to d38b56c9 
Dealt to 4594eefd 
Dealt to b0a36c0c 
Dealt to 124e7fda 
Dealt to Hero [2d Js]
Hero: folds
d2046be3: folds
d38b56c9: folds
4594eefd: calls $0.1
b0a36c0c: folds
124e7fda: checks
*** FLOP *** [4c Kh 6h]
124e7fda: checks
4594eefd: bets $0.19
124e7fda: calls $0.19
*** TURN *** [4c Kh 6h] [5h]
124e7fda: checks
4594eefd: bets $0.48
124e7fda: folds
Uncalled bet ($0.48) returned to 4594eefd
*** SHOWDOWN ***
4594eefd collected $0.6 from pot
*** SUMMARY ***
Total pot $0.63 | Rake $0.03 | Jackpot $0 | Bingo $0 | Fortune $0 | Tax $0
Board [4c Kh 6h 5h]
Seat 1: d2046be3 folded before Flop (didn't bet)
Seat 2: d38b56c9 folded before Flop (didn't bet)
Seat 3: 4594eefd (button) won ($0.6)
Seat 4: b0a36c0c (small blind) folded before Flop
Seat 5: 124e7fda (big blind) folded on the Turn
Seat 6: Hero folded before Flop (didn't bet)


Poker Hand #HD1788654651: Hold'em No Limit ($0.05/$0.1) - 2024/05/26 17:46:41
Table 'NLHRed17' 6-max Seat #2 is the button
Seat 1: d2046be3 ($10.1 in chips)
Seat 2: d38b56c9 ($10 in chips)
Seat 3: 4594eefd ($10.71 in chips)
Seat 4: b0a36c0c ($21.69 in chips)
Seat 5: 124e7fda ($3.63 in chips)
Seat 6: Hero ($24.56 in chips)
4594eefd: posts small blind $0.05
b0a36c0c: posts big blind $0.1
*** HOLE CARDS ***
Dealt to d2046be3 
Dealt to d38b56c9 
Dealt to 4594eefd 
Dealt to b0a36c0c 
Dealt to 124e7fda 
Dealt to Hero [5s 5h]
124e7fda: folds
Hero: raises $0.1 to $0.2
d2046be3: folds
d38b56c9: calls $0.2
4594eefd: calls $0.15
b0a36c0c: folds
*** FLOP *** [9c Ac 3c]
4594eefd: checks
Hero: checks
d38b56c9: checks
*** TURN *** [9c Ac 3c] [8c]
4594eefd: bets $0.53
Hero: folds
d38b56c9: folds
Uncalled bet ($0.53) returned to 4594eefd
*** SHOWDOWN ***
4594eefd collected $0.67 from pot
*** SUMMARY ***
Total pot $0.7 | Rake $0.03 | Jackpot $0 | Bingo $0 | Fortune $0 | Tax $0
Board [9c Ac 3c 8c]
Seat 1: d2046be3 folded before Flop (didn't bet)
Seat 2: d38b56c9 (button) folded on the Turn
Seat 3: 4594eefd (small blind) won ($0.67)
Seat 4: b0a36c0c (big blind) folded before Flop
Seat 5: 124e7fda folded before Flop (didn't bet)
Seat 6: Hero folded on the Turn


Poker Hand #HD1788654621: Hold'em No Limit ($0.05/$0.1) - 2024/05/26 17:46:27
Table 'NLHRed17' 6-max Seat #1 is the button
Seat 1: d2046be3 ($10.1 in chips)
Seat 2: d38b56c9 ($10.05 in chips)
Seat 3: 4594eefd ($10.81 in chips)
Seat 4: b0a36c0c ($21.69 in chips)
Seat 5: 124e7fda ($3.63 in chips)
Seat 6: Hero ($24.41 in chips)
d38b56c9: posts small blind $0.05
4594eefd: posts big blind $0.1
*** HOLE CARDS ***
Dealt to d2046be3 
Dealt to d38b56c9 
Dealt to 4594eefd 
Dealt to b0a36c0c 
Dealt to 124e7fda 
Dealt to Hero [7s As]
b0a36c0c: folds
124e7fda: folds
Hero: raises $0.14 to $0.24
d2046be3: folds
d38b56c9: folds
4594eefd: folds
Uncalled bet ($0.14) returned to Hero
*** SHOWDOWN ***
Hero collected $0.25 from pot
*** SUMMARY ***
Total pot $0.25 | Rake $0 | Jackpot $0 | Bingo $0 | Fortune $0 | Tax $0
Seat 1: d2046be3 (button) folded before Flop (didn't bet)
Seat 2: d38b56c9 (small blind) folded before Flop
Seat 3: 4594eefd (big blind) folded before Flop
Seat 4: b0a36c0c folded before Flop (didn't bet)
Seat 5: 124e7fda folded before Flop (didn't bet)
Seat 6: Hero collected ($0.25)


Poker Hand #HD1788654575: Hold'em No Limit ($0.05/$0.1) - 2024/05/26 17:46:05
Table 'NLHRed17' 6-max Seat #6 is the button
Seat 1: d2046be3 ($10.15 in chips)
Seat 2: d38b56c9 ($10.15 in chips)
Seat 3: 4594eefd ($10.91 in chips)
Seat 4: b0a36c0c ($21.45 in chips)
Seat 5: 124e7fda ($3.63 in chips)
Seat 6: Hero ($24.41 in chips)
d2046be3: posts small blind $0.05
d38b56c9: posts big blind $0.1
*** HOLE CARDS ***
Dealt to d2046be3 
Dealt to d38b56c9 
Dealt to 4594eefd 
Dealt to b0a36c0c 
Dealt to 124e7fda 
Dealt to Hero [4d 9c]
4594eefd: calls $0.1
b0a36c0c: raises $0.35 to $0.45
124e7fda: folds
Hero: folds
d2046be3: folds
d38b56c9: folds
4594eefd: folds
Uncalled bet ($0.35) returned to b0a36c0c
*** SHOWDOWN ***
b0a36c0c collected $0.34 from pot
*** SUMMARY ***
Total pot $0.35 | Rake $0.01 | Jackpot $0 | Bingo $0 | Fortune $0 | Tax $0
Seat 1: d2046be3 (small blind) folded before Flop
Seat 2: d38b56c9 (big blind) folded before Flop
Seat 3: 4594eefd folded before Flop
Seat 4: b0a36c0c collected ($0.34)
Seat 5: 124e7fda folded before Flop (didn't bet)
Seat 6: Hero (button) folded before Flop (didn't bet)


Poker Hand #HD1788654535: Hold'em No Limit ($0.05/$0.1) - 2024/05/26 17:45:46
Table 'NLHRed17' 6-max Seat #5 is the button
Seat 1: d2046be3 ($10 in chips)
Seat 2: d38b56c9 ($10.15 in chips)
Seat 3: 4594eefd ($11.01 in chips)
Seat 4: b0a36c0c ($21.45 in chips)
Seat 5: 124e7fda ($3.63 in chips)
Seat 6: Hero ($24.46 in chips)
Hero: posts small blind $0.05
d2046be3: posts big blind $0.1
*** HOLE CARDS ***
Dealt to d2046be3 
Dealt to d38b56c9 
Dealt to 4594eefd 
Dealt to b0a36c0c 
Dealt to 124e7fda 
Dealt to Hero [Kc 5s]
d38b56c9: folds
4594eefd: calls $0.1
b0a36c0c: folds
124e7fda: folds
Hero: folds
d2046be3: raises $0.38 to $0.48
4594eefd: folds
Uncalled bet ($0.38) returned to d2046be3
*** SHOWDOWN ***
d2046be3 collected $0.25 from pot
*** SUMMARY ***
Total pot $0.25 | Rake $0 | Jackpot $0 | Bingo $0 | Fortune $0 | Tax $0
Seat 1: d2046be3 (big blind) collected ($0.25)
Seat 2: d38b56c9 folded before Flop (didn't bet)
Seat 3: 4594eefd folded before Flop
Seat 4: b0a36c0c folded before Flop (didn't bet)
Seat 5: 124e7fda (button) folded before Flop (didn't bet)
Seat 6: Hero (small blind) folded before Flop


Poker Hand #HD1788654518: Hold'em No Limit ($0.05/$0.1) - 2024/05/26 17:45:34
Table 'NLHRed17' 6-max Seat #4 is the button
Seat 1: d2046be3 ($10 in chips)
Seat 2: d38b56c9 ($10.15 in chips)
Seat 3: 4594eefd ($11.01 in chips)
Seat 4: b0a36c0c ($21.45 in chips)
Seat 5: 124e7fda ($3.68 in chips)
Seat 6: Hero ($24.41 in chips)
124e7fda: posts small blind $0.05
Hero: posts big blind $0.1
*** HOLE CARDS ***
Dealt to d2046be3 
Dealt to d38b56c9 
Dealt to 4594eefd 
Dealt to b0a36c0c 
Dealt to 124e7fda 
Dealt to Hero [As Th]
d2046be3: folds
d38b56c9: folds
4594eefd: folds
b0a36c0c: folds
124e7fda: folds
Uncalled bet ($0.05) returned to Hero
*** SHOWDOWN ***
Hero collected $0.1 from pot
*** SUMMARY ***
Total pot $0.1 | Rake $0 | Jackpot $0 | Bingo $0 | Fortune $0 | Tax $0
Seat 1: d2046be3 folded before Flop (didn't bet)
Seat 2: d38b56c9 folded before Flop (didn't bet)
Seat 3: 4594eefd folded before Flop (didn't bet)
Seat 4: b0a36c0c (button) folded before Flop (didn't bet)
Seat 5: 124e7fda (small blind) folded before Flop
Seat 6: Hero (big blind) collected ($0.1)


Poker Hand #HD1788654449: Hold'em No Limit ($0.05/$0.1) - 2024/05/26 17:44:55
Table 'NLHRed17' 6-max Seat #3 is the button
Seat 1: d2046be3 ($10 in chips)
Seat 2: d38b56c9 ($10.15 in chips)
Seat 3: 4594eefd ($11.11 in chips)
Seat 4: b0a36c0c ($21.5 in chips)
Seat 5: 124e7fda ($3.54 in chips)
Seat 6: Hero ($24.41 in chips)
b0a36c0c: posts small blind $0.05
124e7fda: posts big blind $0.1
*** HOLE CARDS ***
Dealt to d2046be3 
Dealt to d38b56c9 
Dealt to 4594eefd 
Dealt to b0a36c0c 
Dealt to 124e7fda 
Dealt to Hero [Jd 3s]
Hero: folds
d2046be3: folds
d38b56c9: folds
4594eefd: calls $0.1
b0a36c0c: folds
124e7fda: checks
*** FLOP *** [3c 6h 9c]
124e7fda: checks
4594eefd: checks
*** TURN *** [3c 6h 9c] [6s]
124e7fda: bets $0.13
4594eefd: folds
Uncalled bet ($0.13) returned to 124e7fda
*** SHOWDOWN ***
124e7fda collected $0.24 from pot
*** SUMMARY ***
Total pot $0.25 | Rake $0.01 | Jackpot $0 | Bingo $0 | Fortune $0 | Tax $0
Board [3c 6h 9c 6s]
Seat 1: d2046be3 folded before Flop (didn't bet)
Seat 2: d38b56c9 folded before Flop (didn't bet)
Seat 3: 4594eefd (button) folded on the Turn
Seat 4: b0a36c0c (small blind) folded before Flop
Seat 5: 124e7fda (big blind) won ($0.24)
Seat 6: Hero folded before Flop (didn't bet)


Poker Hand #HD1788654409: Hold'em No Limit ($0.05/$0.1) - 2024/05/26 17:44:35
Table 'NLHRed17' 6-max Seat #2 is the button
Seat 1: d2046be3 ($10 in chips)
Seat 2: d38b56c9 ($10 in chips)
Seat 3: 4594eefd ($11.16 in chips)
Seat 4: b0a36c0c ($21.6 in chips)
Seat 5: 124e7fda ($3.54 in chips)
Seat 6: Hero ($24.41 in chips)
4594eefd: posts small blind $0.05
b0a36c0c: posts big blind $0.1
*** HOLE CARDS ***
Dealt to d2046be3 
Dealt to d38b56c9 
Dealt to 4594eefd 
Dealt to b0a36c0c 
Dealt to 124e7fda 
Dealt to Hero [Js 9c]
124e7fda: folds
Hero: folds
d2046be3: folds
d38b56c9: raises $0.1 to $0.2
4594eefd: folds
b0a36c0c: folds
Uncalled bet ($0.1) returned to d38b56c9
*** SHOWDOWN ***
d38b56c9 collected $0.25 from pot
*** SUMMARY ***
Total pot $0.25 | Rake $0 | Jackpot $0 | Bingo $0 | Fortune $0 | Tax $0
Seat 1: d2046be3 folded before Flop (didn't bet)
Seat 2: d38b56c9 (button) collected ($0.25)
Seat 3: 4594eefd (small blind) folded before Flop
Seat 4: b0a36c0c (big blind) folded before Flop
Seat 5: 124e7fda folded before Flop (didn't bet)
Seat 6: Hero folded before Flop (didn't bet)


Poker Hand #HD1788654307: Hold'em No Limit ($0.05/$0.1) - 2024/05/26 17:43:41
Table 'NLHRed17' 6-max Seat #1 is the button
Seat 1: d2046be3 ($10 in chips)
Seat 2: d38b56c9 ($10.07 in chips)
Seat 3: 4594eefd ($11.51 in chips)
Seat 4: b0a36c0c ($21.95 in chips)
Seat 5: 124e7fda ($1.56 in chips)
Seat 6: Hero ($24.41 in chips)
d38b56c9: posts small blind $0.05
4594eefd: posts big blind $0.1
*** HOLE CARDS ***
Dealt to d2046be3 
Dealt to d38b56c9 
Dealt to 4594eefd 
Dealt to b0a36c0c 
Dealt to 124e7fda 
Dealt to Hero [2h 7s]
b0a36c0c: raises $0.25 to $0.35
124e7fda: calls $0.35
Hero: folds
d2046be3: folds
d38b56c9: calls $0.3
4594eefd: calls $0.25
*** FLOP *** [6c Kc 6s]
d38b56c9: checks
4594eefd: checks
b0a36c0c: checks
124e7fda: bets $1.21 and is all-in
d38b56c9: calls $1.21
4594eefd: folds
b0a36c0c: folds
124e7fda: shows [Qd Kd] (Pair of Kings and Pair of Sixes)
d38b56c9: shows [9h 9s] (Pair of Nines and Pair of Sixes)
*** TURN *** [6c Kc 6s] [6h]
*** RIVER *** [6c Kc 6s 6h] [3c]
*** SHOWDOWN ***
124e7fda collected $3.54 from pot
*** SUMMARY ***
Total pot $3.82 | Rake $0.18 | Jackpot $0.1 | Bingo $0 | Fortune $0 | Tax $0
Board [6c Kc 6s 6h 3c]
Seat 1: d2046be3 (button) folded before Flop (didn't bet)
Seat 2: d38b56c9 (small blind) showed [9h 9s] and lost with Sixes Full over Nines
Seat 3: 4594eefd (big blind) folded on the Flop
Seat 4: b0a36c0c folded on the Flop
Seat 5: 124e7fda showed [Qd Kd] and won ($3.54) with Sixes Full over Kings
Seat 6: Hero folded before Flop (didn't bet)


Poker Hand #HD1788654252: Hold'em No Limit ($0.05/$0.1) - 2024/05/26 17:43:20
Table 'NLHRed17' 6-max Seat #6 is the button
Seat 1: d2046be3 ($10 in chips)
Seat 2: d38b56c9 ($10.17 in chips)
Seat 3: 4594eefd ($11.51 in chips)
Seat 4: b0a36c0c ($21.95 in chips)
Seat 5: 124e7fda ($1.42 in chips)
Seat 6: Hero ($24.41 in chips)
d2046be3: posts small blind $0.05
d38b56c9: posts big blind $0.1
*** HOLE CARDS ***
Dealt to d2046be3 
Dealt to d38b56c9 
Dealt to 4594eefd 
Dealt to b0a36c0c 
Dealt to 124e7fda 
Dealt to Hero [Qh 2h]
4594eefd: folds
b0a36c0c: folds
124e7fda: calls $0.1
Hero: folds
d2046be3: folds
d38b56c9: checks
*** FLOP *** [7d 7h Kc]
d38b56c9: checks
124e7fda: bets $0.13
d38b56c9: folds
Uncalled bet ($0.13) returned to 124e7fda
*** SHOWDOWN ***
124e7fda collected $0.24 from pot
*** SUMMARY ***
Total pot $0.25 | Rake $0.01 | Jackpot $0 | Bingo $0 | Fortune $0 | Tax $0
Board [7d 7h Kc]
Seat 1: d2046be3 (small blind) folded before Flop
Seat 2: d38b56c9 (big blind) folded on the Flop
Seat 3: 4594eefd folded before Flop (didn't bet)
Seat 4: b0a36c0c folded before Flop (didn't bet)
Seat 5: 124e7fda won ($0.24)
Seat 6: Hero (button) folded before Flop (didn't bet)


Poker Hand #HD1788654191: Hold'em No Limit ($0.05/$0.1) - 2024/05/26 17:42:48
Table 'NLHRed17' 6-max Seat #5 is the button
Seat 1: d2046be3 ($10 in chips)
Seat 2: d38b56c9 ($10.17 in chips)
Seat 3: 4594eefd ($11.51 in chips)
Seat 4: b0a36c0c ($21.95 in chips)
Seat 5: 124e7fda ($1.28 in chips)
Seat 6: Hero ($24.46 in chips)
Hero: posts small blind $0.05
d2046be3: posts big blind $0.1
*** HOLE CARDS ***
Dealt to d2046be3 
Dealt to d38b56c9 
Dealt to 4594eefd 
Dealt to b0a36c0c 
Dealt to 124e7fda 
Dealt to Hero [5s 7c]
d38b56c9: folds
4594eefd: folds
b0a36c0c: folds
124e7fda: calls $0.1
Hero: folds
d2046be3: checks
*** FLOP *** [4h Qc Js]
d2046be3: checks
124e7fda: checks
*** TURN *** [4h Qc Js] [Qh]
d2046be3: checks
124e7fda: bets $0.19
d2046be3: folds
Uncalled bet ($0.19) returned to 124e7fda
*** SHOWDOWN ***
124e7fda collected $0.24 from pot
*** SUMMARY ***
Total pot $0.25 | Rake $0.01 | Jackpot $0 | Bingo $0 | Fortune $0 | Tax $0
Board [4h Qc Js Qh]
Seat 1: d2046be3 (big blind) folded on the Turn
Seat 2: d38b56c9 folded before Flop (didn't bet)
Seat 3: 4594eefd folded before Flop (didn't bet)
Seat 4: b0a36c0c folded before Flop (didn't bet)
Seat 5: 124e7fda (button) won ($0.24)
Seat 6: Hero (small blind) folded before Flop


Poker Hand #HD1788654133: Hold'em No Limit ($0.05/$0.1) - 2024/05/26 17:42:19
Table 'NLHRed17' 6-max Seat #4 is the button
Seat 1: d2046be3 ($10 in chips)
Seat 2: d38b56c9 ($10.37 in chips)
Seat 3: 4594eefd ($11.18 in chips)
Seat 4: b0a36c0c ($21.95 in chips)
Seat 5: 124e7fda ($1.33 in chips)
Seat 6: Hero ($24.56 in chips)
124e7fda: posts small blind $0.05
Hero: posts big blind $0.1
*** HOLE CARDS ***
Dealt to d2046be3 
Dealt to d38b56c9 
Dealt to 4594eefd 
Dealt to b0a36c0c 
Dealt to 124e7fda 
Dealt to Hero [2c 9s]
d2046be3: folds
d38b56c9: raises $0.1 to $0.2
4594eefd: calls $0.2
b0a36c0c: folds
124e7fda: folds
Hero: folds
*** FLOP *** [4s Kh 5s]
d38b56c9: checks
4594eefd: bets $0.28
d38b56c9: folds
Uncalled bet ($0.28) returned to 4594eefd
*** SHOWDOWN ***
4594eefd collected $0.53 from pot
*** SUMMARY ***
Total pot $0.55 | Rake $0.02 | Jackpot $0 | Bingo $0 | Fortune $0 | Tax $0
Board [4s Kh 5s]
Seat 1: d2046be3 folded before Flop (didn't bet)
Seat 2: d38b56c9 folded on the Flop
Seat 3: 4594eefd won ($0.53)
Seat 4: b0a36c0c (button) folded before Flop (didn't bet)
Seat 5: 124e7fda (small blind) folded before Flop
Seat 6: Hero (big blind) folded before Flop


Poker Hand #HD1788654066: Hold'em No Limit ($0.05/$0.1) - 2024/05/26 17:41:46
Table 'NLHRed17' 6-max Seat #3 is the button
Seat 1: d2046be3 ($10 in chips)
Seat 2: d38b56c9 ($10.37 in chips)
Seat 3: 4594eefd ($10.48 in chips)
Seat 4: b0a36c0c ($22.2 in chips)
Seat 5: 124e7fda ($1.58 in chips)
Seat 6: Hero ($24.56 in chips)
b0a36c0c: posts small blind $0.05
124e7fda: posts big blind $0.1
*** HOLE CARDS ***
Dealt to d2046be3 
Dealt to d38b56c9 
Dealt to 4594eefd 
Dealt to b0a36c0c 
Dealt to 124e7fda 
Dealt to Hero [9s Qh]
Hero: folds
d2046be3: raises $0.15 to $0.25
d38b56c9: folds
4594eefd: calls $0.25
b0a36c0c: calls $0.2
124e7fda: calls $0.15
*** FLOP *** [5d Ts Kd]
b0a36c0c: checks
124e7fda: checks
d2046be3: checks
4594eefd: bets $0.75
b0a36c0c: folds
124e7fda: folds
d2046be3: folds
Uncalled bet ($0.75) returned to 4594eefd
*** SHOWDOWN ***
4594eefd collected $0.95 from pot
*** SUMMARY ***
Total pot $1 | Rake $0.05 | Jackpot $0 | Bingo $0 | Fortune $0 | Tax $0
Board [5d Ts Kd]
Seat 1: d2046be3 folded on the Flop
Seat 2: d38b56c9 folded before Flop (didn't bet)
Seat 3: 4594eefd (button) won ($0.95)
Seat 4: b0a36c0c (small blind) folded on the Flop
Seat 5: 124e7fda (big blind) folded on the Flop
Seat 6: Hero folded before Flop (didn't bet)


Poker Hand #HD1788654022: Hold'em No Limit ($0.05/$0.1) - 2024/05/26 17:41:23
Table 'NLHRed17' 6-max Seat #2 is the button
Seat 1: d2046be3 ($10 in chips)
Seat 2: d38b56c9 ($10 in chips)
Seat 3: 4594eefd ($10.53 in chips)
Seat 4: b0a36c0c ($22.3 in chips)
Seat 5: 124e7fda ($1.58 in chips)
Seat 6: Hero ($24.56 in chips)
4594eefd: posts small blind $0.05
b0a36c0c: posts big blind $0.1
*** HOLE CARDS ***
Dealt to d2046be3 
Dealt to d38b56c9 
Dealt to 4594eefd 
Dealt to b0a36c0c 
Dealt to 124e7fda 
Dealt to Hero [2s Kh]
124e7fda: folds
Hero: folds
d2046be3: raises $0.15 to $0.25
d38b56c9: raises $0.45 to $0.7
4594eefd: folds
b0a36c0c: folds
d2046be3: folds
Uncalled bet ($0.45) returned to d38b56c9
*** SHOWDOWN ***
d38b56c9 collected $0.62 from pot
*** SUMMARY ***
Total pot $0.65 | Rake $0.03 | Jackpot $0 | Bingo $0 | Fortune $0 | Tax $0
Seat 1: d2046be3 folded before Flop
Seat 2: d38b56c9 (button) collected ($0.62)
Seat 3: 4594eefd (small blind) folded before Flop
Seat 4: b0a36c0c (big blind) folded before Flop
Seat 5: 124e7fda folded before Flop (didn't bet)
Seat 6: Hero folded before Flop (didn't bet)


Poker Hand #HD1788653931: Hold'em No Limit ($0.05/$0.1) - 2024/05/26 17:40:39
Table 'NLHRed17' 6-max Seat #1 is the button
Seat 1: d2046be3 ($10 in chips)
Seat 2: d38b56c9 ($10 in chips)
Seat 3: 4594eefd ($10.21 in chips)
Seat 4: b0a36c0c ($22.6 in chips)
Seat 5: 124e7fda ($1.58 in chips)
Seat 6: Hero ($24.56 in chips)
d38b56c9: posts small blind $0.05
4594eefd: posts big blind $0.1
*** HOLE CARDS ***
Dealt to d2046be3 
Dealt to d38b56c9 
Dealt to 4594eefd 
Dealt to b0a36c0c 
Dealt to 124e7fda 
Dealt to Hero [As Jd]
b0a36c0c: raises $0.2 to $0.3
124e7fda: folds
Hero: folds
d2046be3: folds
d38b56c9: folds
4594eefd: calls $0.2
*** FLOP *** [4d Ts Qc]
4594eefd: checks
b0a36c0c: checks
*** TURN *** [4d Ts Qc] [Qd]
4594eefd: checks
b0a36c0c: checks
*** RIVER *** [4d Ts Qc Qd] [Jc]
4594eefd: bets $0.49
b0a36c0c: folds
Uncalled bet ($0.49) returned to 4594eefd
*** SHOWDOWN ***
4594eefd collected $0.62 from pot
*** SUMMARY ***
Total pot $0.65 | Rake $0.03 | Jackpot $0 | Bingo $0 | Fortune $0 | Tax $0
Board [4d Ts Qc Qd Jc]
Seat 1: d2046be3 (button) folded before Flop (didn't bet)
Seat 2: d38b56c9 (small blind) folded before Flop
Seat 3: 4594eefd (big blind) won ($0.62)
Seat 4: b0a36c0c folded on the River
Seat 5: 124e7fda folded before Flop (didn't bet)
Seat 6: Hero folded before Flop (didn't bet)


Poker Hand #HD1788653823: Hold'em No Limit ($0.05/$0.1) - 2024/05/26 17:39:48
Table 'NLHRed17' 6-max Seat #6 is the button
Seat 1: d2046be3 ($10 in chips)
Seat 2: d38b56c9 ($10.36 in chips)
Seat 3: 4594eefd ($10.21 in chips)
Seat 4: b0a36c0c ($22.15 in chips)
Seat 5: 124e7fda ($1.58 in chips)
Seat 6: Hero ($24.56 in chips)
d2046be3: posts small blind $0.05
d38b56c9: posts big blind $0.1
*** HOLE CARDS ***
Dealt to d2046be3 
Dealt to d38b56c9 
Dealt to 4594eefd 
Dealt to b0a36c0c 
Dealt to 124e7fda 
Dealt to Hero [Qc 7s]
4594eefd: folds
b0a36c0c: raises $0.15 to $0.25
124e7fda: folds
Hero: folds
d2046be3: folds
d38b56c9: calls $0.15
*** FLOP *** [2s Js 4h]
d38b56c9: checks
b0a36c0c: bets $0.19
d38b56c9: calls $0.19
*** TURN *** [2s Js 4h] [8h]
d38b56c9: checks
b0a36c0c: bets $0.5
d38b56c9: folds
Uncalled bet ($0.5) returned to b0a36c0c
*** SHOWDOWN ***
b0a36c0c collected $0.89 from pot
*** SUMMARY ***
Total pot $0.93 | Rake $0.04 | Jackpot $0 | Bingo $0 | Fortune $0 | Tax $0
Board [2s Js 4h 8h]
Seat 1: d2046be3 (small blind) folded before Flop
Seat 2: d38b56c9 (big blind) folded on the Turn
Seat 3: 4594eefd folded before Flop (didn't bet)
Seat 4: b0a36c0c won ($0.89)
Seat 5: 124e7fda folded before Flop (didn't bet)
Seat 6: Hero (button) folded before Flop (didn't bet)


Poker Hand #HD1788653752: Hold'em No Limit ($0.05/$0.1) - 2024/05/26 17:39:10
Table 'NLHRed17' 6-max Seat #5 is the button
Seat 1: d2046be3 ($10 in chips)
Seat 2: d38b56c9 ($10.36 in chips)
Seat 3: 4594eefd ($10.21 in chips)
Seat 4: b0a36c0c ($21.48 in chips)
Seat 5: 124e7fda ($2.16 in chips)
Seat 6: Hero ($24.61 in chips)
Hero: posts small blind $0.05
d2046be3: posts big blind $0.1
*** HOLE CARDS ***
Dealt to d2046be3 
Dealt to d38b56c9 
Dealt to 4594eefd 
Dealt to b0a36c0c 
Dealt to 124e7fda 
Dealt to Hero [Qs 9d]
d38b56c9: folds
4594eefd: folds
b0a36c0c: raises $0.15 to $0.25
124e7fda: calls $0.25
Hero: folds
d2046be3: folds
*** FLOP *** [5s Kd 8s]
b0a36c0c: checks
124e7fda: bets $0.33
b0a36c0c: raises $2.37 to $2.7
124e7fda: folds
Uncalled bet ($2.37) returned to b0a36c0c
*** SHOWDOWN ***
b0a36c0c collected $1.25 from pot
*** SUMMARY ***
Total pot $1.31 | Rake $0.06 | Jackpot $0 | Bingo $0 | Fortune $0 | Tax $0
Board [5s Kd 8s]
Seat 1: d2046be3 (big blind) folded before Flop
Seat 2: d38b56c9 folded before Flop (didn't bet)
Seat 3: 4594eefd folded before Flop (didn't bet)
Seat 4: b0a36c0c won ($1.25)
Seat 5: 124e7fda (button) folded on the Flop
Seat 6: Hero (small blind) folded before Flop


Poker Hand #HD1788653687: Hold'em No Limit ($0.05/$0.1) - 2024/05/26 17:38:38
Table 'NLHRed17' 6-max Seat #4 is the button
Seat 2: d38b56c9 ($10.36 in chips)
Seat 3: 4594eefd ($10.07 in chips)
Seat 4: b0a36c0c ($21.48 in chips)
Seat 5: 124e7fda ($2.21 in chips)
Seat 6: Hero ($24.71 in chips)
124e7fda: posts small blind $0.05
Hero: posts big blind $0.1
*** HOLE CARDS ***
Dealt to d38b56c9 
Dealt to 4594eefd 
Dealt to b0a36c0c 
Dealt to 124e7fda 
Dealt to Hero [5d 9c]
d38b56c9: folds
4594eefd: calls $0.1
b0a36c0c: folds
124e7fda: folds
Hero: checks
*** FLOP *** [Qs 7d 5h]
Hero: checks
4594eefd: bets $0.19
Hero: folds
Uncalled bet ($0.19) returned to 4594eefd
*** SHOWDOWN ***
4594eefd collected $0.24 from pot
*** SUMMARY ***
Total pot $0.25 | Rake $0.01 | Jackpot $0 | Bingo $0 | Fortune $0 | Tax $0
Board [Qs 7d 5h]
Seat 2: d38b56c9 folded before Flop (didn't bet)
Seat 3: 4594eefd won ($0.24)
Seat 4: b0a36c0c (button) folded before Flop (didn't bet)
Seat 5: 124e7fda (small blind) folded before Flop
Seat 6: Hero (big blind) folded on the Flop


Poker Hand #HD1788653635: Hold'em No Limit ($0.05/$0.1) - 2024/05/26 17:38:10
Table 'NLHRed17' 6-max Seat #3 is the button
Seat 2: d38b56c9 ($10.36 in chips)
Seat 3: 4594eefd ($10.17 in chips)
Seat 4: b0a36c0c ($21.53 in chips)
Seat 5: 124e7fda ($2.07 in chips)
Seat 6: Hero ($24.71 in chips)
b0a36c0c: posts small blind $0.05
124e7fda: posts big blind $0.1
*** HOLE CARDS ***
Dealt to d38b56c9 
Dealt to 4594eefd 
Dealt to b0a36c0c 
Dealt to 124e7fda 
Dealt to Hero [5d Th]
Hero: folds
d38b56c9: folds
4594eefd: calls $0.1
b0a36c0c: folds
124e7fda: checks
*** FLOP *** [9d 2s 8s]
124e7fda: checks
4594eefd: checks
*** TURN *** [9d 2s 8s] [9h]
124e7fda: bets $0.19
4594eefd: folds
Uncalled bet ($0.19) returned to 124e7fda
*** SHOWDOWN ***
124e7fda collected $0.24 from pot
*** SUMMARY ***
Total pot $0.25 | Rake $0.01 | Jackpot $0 | Bingo $0 | Fortune $0 | Tax $0
Board [9d 2s 8s 9h]
Seat 2: d38b56c9 folded before Flop (didn't bet)
Seat 3: 4594eefd (button) folded on the Turn
Seat 4: b0a36c0c (small blind) folded before Flop
Seat 5: 124e7fda (big blind) won ($0.24)
Seat 6: Hero folded before Flop (didn't bet)


Poker Hand #HD1788653562: Hold'em No Limit ($0.05/$0.1) - 2024/05/26 17:37:29
Table 'NLHRed17' 6-max Seat #2 is the button
Seat 2: d38b56c9 ($10.36 in chips)
Seat 3: 4594eefd ($9.85 in chips)
Seat 4: b0a36c0c ($21.63 in chips)
Seat 5: 124e7fda ($2.07 in chips)
Seat 6: Hero ($24.95 in chips)
4594eefd: posts small blind $0.05
b0a36c0c: posts big blind $0.1
*** HOLE CARDS ***
Dealt to d38b56c9 
Dealt to 4594eefd 
Dealt to b0a36c0c 
Dealt to 124e7fda 
Dealt to Hero [Td Qc]
124e7fda: folds
Hero: raises $0.14 to $0.24
d38b56c9: folds
4594eefd: calls $0.19
b0a36c0c: folds
*** FLOP *** [6s 4c 7c]
4594eefd: checks
Hero: checks
*** TURN *** [6s 4c 7c] [4s]
4594eefd: bets $0.44
Hero: folds
Uncalled bet ($0.44) returned to 4594eefd
*** SHOWDOWN ***
4594eefd collected $0.56 from pot
*** SUMMARY ***
Total pot $0.58 | Rake $0.02 | Jackpot $0 | Bingo $0 | Fortune $0 | Tax $0
Board [6s 4c 7c 4s]
Seat 2: d38b56c9 (button) folded before Flop (didn't bet)
Seat 3: 4594eefd (small blind) won ($0.56)
Seat 4: b0a36c0c (big blind) folded before Flop
Seat 5: 124e7fda folded before Flop (didn't bet)
Seat 6: Hero folded on the Turn


Poker Hand #HD1788653441: Hold'em No Limit ($0.05/$0.1) - 2024/05/26 17:36:30
Table 'NLHRed17' 6-max Seat #6 is the button
Seat 1: 664815b5 ($11.74 in chips)
Seat 2: d38b56c9 ($13.03 in chips)
Seat 4: b0a36c0c ($19.27 in chips)
Seat 5: 124e7fda ($2.07 in chips)
Seat 6: Hero ($24.95 in chips)
664815b5: posts small blind $0.05
d38b56c9: posts big blind $0.1
*** HOLE CARDS ***
Dealt to 664815b5 
Dealt to d38b56c9 
Dealt to b0a36c0c 
Dealt to 124e7fda 
Dealt to Hero [Ac 3c]
b0a36c0c: raises $0.15 to $0.25
124e7fda: folds
Hero: folds
664815b5: folds
d38b56c9: calls $0.15
*** FLOP *** [8c 3d Kh]
d38b56c9: bets $0.28
b0a36c0c: raises $0.52 to $0.8
d38b56c9: calls $0.52
*** TURN *** [8c 3d Kh] [4c]
d38b56c9: bets $1.62
b0a36c0c: raises $16.6 to $18.22 and is all-in
d38b56c9: folds
Uncalled bet ($16.6) returned to b0a36c0c
*** SHOWDOWN ***
b0a36c0c collected $5.03 from pot
*** SUMMARY ***
Total pot $5.39 | Rake $0.26 | Jackpot $0.1 | Bingo $0 | Fortune $0 | Tax $0
Board [8c 3d Kh 4c]
Seat 1: 664815b5 (small blind) folded before Flop
Seat 2: d38b56c9 (big blind) folded on the Turn
Seat 4: b0a36c0c won ($5.03)
Seat 5: 124e7fda folded before Flop (didn't bet)
Seat 6: Hero (button) folded before Flop (didn't bet)


Poker Hand #HD1788653413: Hold'em No Limit ($0.05/$0.1) - 2024/05/26 17:36:11
Table 'NLHRed17' 6-max Seat #5 is the button
Seat 1: 664815b5 ($11.69 in chips)
Seat 2: d38b56c9 ($13.03 in chips)
Seat 4: b0a36c0c ($19.27 in chips)
Seat 5: 124e7fda ($2.07 in chips)
Seat 6: Hero ($25 in chips)
Hero: posts small blind $0.05
664815b5: posts big blind $0.1
*** HOLE CARDS ***
Dealt to 664815b5 
Dealt to d38b56c9 
Dealt to b0a36c0c 
Dealt to 124e7fda 
Dealt to Hero [Jd 8c]
d38b56c9: folds
b0a36c0c: folds
124e7fda: folds
Hero: folds
Uncalled bet ($0.05) returned to 664815b5
*** SHOWDOWN ***
664815b5 collected $0.1 from pot
*** SUMMARY ***
Total pot $0.1 | Rake $0 | Jackpot $0 | Bingo $0 | Fortune $0 | Tax $0
Seat 1: 664815b5 (big blind) collected ($0.1)
Seat 2: d38b56c9 folded before Flop (didn't bet)
Seat 4: b0a36c0c folded before Flop (didn't bet)
Seat 5: 124e7fda (button) folded before Flop (didn't bet)
Seat 6: Hero (small blind) folded before Flop


Poker Hand #HD1788653300: Hold'em No Limit ($0.05/$0.1) - 2024/05/26 17:35:16
Table 'NLHRed17' 6-max Seat #4 is the button
Seat 1: 664815b5 ($12.04 in chips)
Seat 2: d38b56c9 ($13.03 in chips)
Seat 3: 4594eefd ($9.9 in chips)
Seat 4: b0a36c0c ($19.27 in chips)
Seat 5: 124e7fda ($2.12 in chips)
Seat 6: Hero ($24.59 in chips)
124e7fda: posts small blind $0.05
Hero: posts big blind $0.1
4594eefd: posts missed blind $0.05
*** HOLE CARDS ***
Dealt to 664815b5 
Dealt to d38b56c9 
Dealt to 4594eefd 
Dealt to b0a36c0c 
Dealt to 124e7fda 
Dealt to Hero [Kc Kh]
664815b5: raises $0.25 to $0.35
d38b56c9: folds
4594eefd: folds
b0a36c0c: folds
124e7fda: folds
Hero: raises $0.95 to $1.3
664815b5: folds
Uncalled bet ($0.95) returned to Hero
*** SHOWDOWN ***
Hero collected $0.76 from pot
*** SUMMARY ***
Total pot $0.8 | Rake $0.04 | Jackpot $0 | Bingo $0 | Fortune $0 | Tax $0
Seat 1: 664815b5 folded before Flop
Seat 2: d38b56c9 folded before Flop (didn't bet)
Seat 3: 4594eefd folded before Flop
Seat 4: b0a36c0c (button) folded before Flop (didn't bet)
Seat 5: 124e7fda (small blind) folded before Flop
Seat 6: Hero (big blind) collected ($0.76)


Poker Hand #HD1788653256: Hold'em No Limit ($0.05/$0.1) - 2024/05/26 17:34:58
Table 'NLHRed17' 6-max Seat #2 is the button
Seat 1: 664815b5 ($12.04 in chips)
Seat 2: d38b56c9 ($12.88 in chips)
Seat 4: b0a36c0c ($19.32 in chips)
Seat 5: 124e7fda ($2.22 in chips)
Seat 6: Hero ($24.59 in chips)
b0a36c0c: posts small blind $0.05
124e7fda: posts big blind $0.1
*** HOLE CARDS ***
Dealt to 664815b5 
Dealt to d38b56c9 
Dealt to b0a36c0c 
Dealt to 124e7fda 
Dealt to Hero [6d Js]
Hero: folds
664815b5: folds
d38b56c9: raises $0.1 to $0.2
b0a36c0c: folds
124e7fda: folds
Uncalled bet ($0.1) returned to d38b56c9
*** SHOWDOWN ***
d38b56c9 collected $0.25 from pot
*** SUMMARY ***
Total pot $0.25 | Rake $0 | Jackpot $0 | Bingo $0 | Fortune $0 | Tax $0
Seat 1: 664815b5 folded before Flop (didn't bet)
Seat 2: d38b56c9 (button) collected ($0.25)
Seat 4: b0a36c0c (small blind) folded before Flop
Seat 5: 124e7fda (big blind) folded before Flop
Seat 6: Hero folded before Flop (didn't bet)


Poker Hand #HD1788653195: Hold'em No Limit ($0.05/$0.1) - 2024/05/26 17:34:24
Table 'NLHRed17' 6-max Seat #1 is the button
Seat 1: 664815b5 ($12.04 in chips)
Seat 2: d38b56c9 ($12.78 in chips)
Seat 3: 4594eefd ($1.03 in chips)
Seat 4: b0a36c0c ($19.32 in chips)
Seat 5: 124e7fda ($2.22 in chips)
Seat 6: Hero ($24.59 in chips)
d38b56c9: posts small blind $0.05
4594eefd: posts big blind $0.1
*** HOLE CARDS ***
Dealt to 664815b5 
Dealt to d38b56c9 
Dealt to 4594eefd 
Dealt to b0a36c0c 
Dealt to 124e7fda 
Dealt to Hero [3c 7s]
b0a36c0c: folds
124e7fda: folds
Hero: folds
664815b5: folds
d38b56c9: raises $0.1 to $0.2
4594eefd: folds
Uncalled bet ($0.1) returned to d38b56c9
*** SHOWDOWN ***
d38b56c9 collected $0.2 from pot
*** SUMMARY ***
Total pot $0.2 | Rake $0 | Jackpot $0 | Bingo $0 | Fortune $0 | Tax $0
Seat 1: 664815b5 (button) folded before Flop (didn't bet)
Seat 2: d38b56c9 (small blind) collected ($0.2)
Seat 3: 4594eefd (big blind) folded before Flop
Seat 4: b0a36c0c folded before Flop (didn't bet)
Seat 5: 124e7fda folded before Flop (didn't bet)
Seat 6: Hero folded before Flop (didn't bet)


Poker Hand #HD1788653058: Hold'em No Limit ($0.05/$0.1) - 2024/05/26 17:33:16
Table 'NLHRed17' 6-max Seat #6 is the button
Seat 1: 664815b5 ($12.09 in chips)
Seat 2: d38b56c9 ($13.15 in chips)
Seat 3: 4594eefd ($11.03 in chips)
Seat 4: b0a36c0c ($10 in chips)
Seat 5: 124e7fda ($2.22 in chips)
Seat 6: Hero ($24.59 in chips)
664815b5: posts small blind $0.05
d38b56c9: posts big blind $0.1
*** HOLE CARDS ***
Dealt to 664815b5 
Dealt to d38b56c9 
Dealt to 4594eefd 
Dealt to b0a36c0c 
Dealt to 124e7fda 
Dealt to Hero [3c Kh]
4594eefd: calls $0.1
b0a36c0c: raises $0.27 to $0.37
124e7fda: folds
Hero: folds
664815b5: folds
d38b56c9: calls $0.27
4594eefd: calls $0.27
*** FLOP *** [3d 5d Ah]
d38b56c9: checks
4594eefd: bets $0.1
b0a36c0c: raises $0.9 to $1
d38b56c9: folds
4594eefd: raises $9.66 to $10.66 and is all-in
b0a36c0c: calls $8.63 and is all-in
Uncalled bet ($1.03) returned to 4594eefd
4594eefd: shows [As Ts] (Pair of Aces)
b0a36c0c: shows [Ad Kd] (Pair of Aces)
*** TURN *** [3d 5d Ah] [9c]
*** RIVER *** [3d 5d Ah 9c] [8d]
*** SHOWDOWN ***
b0a36c0c collected $19.32 from pot
*** SUMMARY ***
Total pot $20.42 | Rake $1 | Jackpot $0.1 | Bingo $0 | Fortune $0 | Tax $0
Board [3d 5d Ah 9c 8d]
Seat 1: 664815b5 (small blind) folded before Flop
Seat 2: d38b56c9 (big blind) folded on the Flop
Seat 3: 4594eefd showed [As Ts] and lost with Pair of Aces
Seat 4: b0a36c0c showed [Ad Kd] and won ($19.32) with Ace High Flush
Seat 5: 124e7fda folded before Flop (didn't bet)
Seat 6: Hero (button) folded before Flop (didn't bet)


Poker Hand #HD1788653023: Hold'em No Limit ($0.05/$0.1) - 2024/05/26 17:33:02
Table 'NLHRed17' 6-max Seat #5 is the button
Seat 1: 664815b5 ($12.04 in chips)
Seat 2: d38b56c9 ($13.15 in chips)
Seat 3: 4594eefd ($11.03 in chips)
Seat 4: b0a36c0c ($10 in chips)
Seat 5: 124e7fda ($2.22 in chips)
Seat 6: Hero ($24.64 in chips)
Hero: posts small blind $0.05
664815b5: posts big blind $0.1
*** HOLE CARDS ***
Dealt to 664815b5 
Dealt to d38b56c9 
Dealt to 4594eefd 
Dealt to b0a36c0c 
Dealt to 124e7fda 
Dealt to Hero [Th 6c]
d38b56c9: folds
4594eefd: folds
b0a36c0c: folds
124e7fda: folds
Hero: folds
Uncalled bet ($0.05) returned to 664815b5
*** SHOWDOWN ***
664815b5 collected $0.1 from pot
*** SUMMARY ***
Total pot $0.1 | Rake $0 | Jackpot $0 | Bingo $0 | Fortune $0 | Tax $0
Seat 1: 664815b5 (big blind) collected ($0.1)
Seat 2: d38b56c9 folded before Flop (didn't bet)
Seat 3: 4594eefd folded before Flop (didn't bet)
Seat 4: b0a36c0c folded before Flop (didn't bet)
Seat 5: 124e7fda (button) folded before Flop (didn't bet)
Seat 6: Hero (small blind) folded before Flop


Poker Hand #HD1788652914: Hold'em No Limit ($0.05/$0.1) - 2024/05/26 17:31:59
Table 'NLHRed17' 6-max Seat #4 is the button
Seat 1: 664815b5 ($12.04 in chips)
Seat 2: d38b56c9 ($13.45 in chips)
Seat 3: 4594eefd ($10.33 in chips)
Seat 4: b0a36c0c ($10 in chips)
Seat 5: 124e7fda ($2.27 in chips)
Seat 6: Hero ($24.74 in chips)
124e7fda: posts small blind $0.05
Hero: posts big blind $0.1
*** HOLE CARDS ***
Dealt to 664815b5 
Dealt to d38b56c9 
Dealt to 4594eefd 
Dealt to b0a36c0c 
Dealt to 124e7fda 
Dealt to Hero [5s Td]
664815b5: folds
d38b56c9: calls $0.1
4594eefd: calls $0.1
b0a36c0c: raises $0.2 to $0.3
124e7fda: folds
Hero: folds
d38b56c9: calls $0.2
4594eefd: calls $0.2
*** FLOP *** [Ks 6s 3c]
d38b56c9: checks
4594eefd: checks
b0a36c0c: checks
*** TURN *** [Ks 6s 3c] [As]
d38b56c9: checks
4594eefd: bets $0.53
b0a36c0c: folds
d38b56c9: folds
Uncalled bet ($0.53) returned to 4594eefd
*** SHOWDOWN ***
4594eefd collected $1 from pot
*** SUMMARY ***
Total pot $1.05 | Rake $0.05 | Jackpot $0 | Bingo $0 | Fortune $0 | Tax $0
Board [Ks 6s 3c As]
Seat 1: 664815b5 folded before Flop (didn't bet)
Seat 2: d38b56c9 folded on the Turn
Seat 3: 4594eefd won ($1)
Seat 4: b0a36c0c (button) folded on the Turn
Seat 5: 124e7fda (small blind) folded before Flop
Seat 6: Hero (big blind) folded before Flop


Poker Hand #HD1788652869: Hold'em No Limit ($0.05/$0.1) - 2024/05/26 17:31:37
Table 'NLHRed17' 6-max Seat #3 is the button
Seat 1: 664815b5 ($12.04 in chips)
Seat 2: d38b56c9 ($13.45 in chips)
Seat 3: 4594eefd ($10.33 in chips)
Seat 4: b0a36c0c ($10 in chips)
Seat 5: 124e7fda ($2 in chips)
Seat 6: Hero ($24.74 in chips)
b0a36c0c: posts small blind $0.05
124e7fda: posts big blind $0.1
*** HOLE CARDS ***
Dealt to 664815b5 
Dealt to d38b56c9 
Dealt to 4594eefd 
Dealt to b0a36c0c 
Dealt to 124e7fda 
Dealt to Hero [4h Ah]
Hero: folds
664815b5: folds
d38b56c9: folds
4594eefd: folds
b0a36c0c: raises $0.2 to $0.3
124e7fda: calls $0.2
*** FLOP *** [2h Kc 4s]
b0a36c0c: checks
124e7fda: bets $0.3
b0a36c0c: folds
Uncalled bet ($0.3) returned to 124e7fda
*** SHOWDOWN ***
124e7fda collected $0.57 from pot
*** SUMMARY ***
Total pot $0.6 | Rake $0.03 | Jackpot $0 | Bingo $0 | Fortune $0 | Tax $0
Board [2h Kc 4s]
Seat 1: 664815b5 folded before Flop (didn't bet)
Seat 2: d38b56c9 folded before Flop (didn't bet)
Seat 3: 4594eefd (button) folded before Flop (didn't bet)
Seat 4: b0a36c0c (small blind) folded on the Flop
Seat 5: 124e7fda (big blind) won ($0.57)
Seat 6: Hero folded before Flop (didn't bet)


Poker Hand #HD1788652774: Hold'em No Limit ($0.05/$0.1) - 2024/05/26 17:30:52
Table 'NLHRed17' 6-max Seat #2 is the button
Seat 1: 664815b5 ($12.04 in chips)
Seat 2: d38b56c9 ($13.65 in chips)
Seat 3: 4594eefd ($10.05 in chips)
Seat 4: b0a36c0c ($10 in chips)
Seat 6: Hero ($24.74 in chips)
4594eefd: posts small blind $0.05
b0a36c0c: posts big blind $0.1
*** HOLE CARDS ***
Dealt to 664815b5 
Dealt to d38b56c9 
Dealt to 4594eefd 
Dealt to b0a36c0c 
Dealt to Hero [7d Jh]
Hero: folds
664815b5: folds
d38b56c9: raises $0.1 to $0.2
4594eefd: calls $0.15
b0a36c0c: folds
*** FLOP *** [Js 5c Ad]
4594eefd: checks
d38b56c9: checks
*** TURN *** [Js 5c Ad] [9d]
4594eefd: bets $0.25
d38b56c9: folds
Uncalled bet ($0.25) returned to 4594eefd
*** SHOWDOWN ***
4594eefd collected $0.48 from pot
*** SUMMARY ***
Total pot $0.5 | Rake $0.02 | Jackpot $0 | Bingo $0 | Fortune $0 | Tax $0
Board [Js 5c Ad 9d]
Seat 1: 664815b5 folded before Flop (didn't bet)
Seat 2: d38b56c9 (button) folded on the Turn
Seat 3: 4594eefd (small blind) won ($0.48)
Seat 4: b0a36c0c (big blind) folded before Flop
Seat 6: Hero folded before Flop (didn't bet)


Poker Hand #HD1788652722: Hold'em No Limit ($0.05/$0.1) - 2024/05/26 17:30:27
Table 'NLHRed17' 6-max Seat #1 is the button
Seat 1: 664815b5 ($12.04 in chips)
Seat 2: d38b56c9 ($13.7 in chips)
Seat 3: 4594eefd ($10.15 in chips)
Seat 4: b0a36c0c ($10 in chips)
Seat 6: Hero ($24.37 in chips)
d38b56c9: posts small blind $0.05
4594eefd: posts big blind $0.1
*** HOLE CARDS ***
Dealt to 664815b5 
Dealt to d38b56c9 
Dealt to 4594eefd 
Dealt to b0a36c0c 
Dealt to Hero [Jd Js]
b0a36c0c: raises $0.15 to $0.25
Hero: raises $0.55 to $0.8
664815b5: folds
d38b56c9: folds
4594eefd: folds
b0a36c0c: folds
Uncalled bet ($0.55) returned to Hero
*** SHOWDOWN ***
Hero collected $0.62 from pot
*** SUMMARY ***
Total pot $0.65 | Rake $0.03 | Jackpot $0 | Bingo $0 | Fortune $0 | Tax $0
Seat 1: 664815b5 (button) folded before Flop (didn't bet)
Seat 2: d38b56c9 (small blind) folded before Flop
Seat 3: 4594eefd (big blind) folded before Flop
Seat 4: b0a36c0c folded before Flop
Seat 6: Hero collected ($0.62)


Poker Hand #HD1788652697: Hold'em No Limit ($0.05/$0.1) - 2024/05/26 17:30:12
Table 'NLHRed17' 6-max Seat #6 is the button
Seat 1: 664815b5 ($12.09 in chips)
Seat 2: d38b56c9 ($13.8 in chips)
Seat 3: 4594eefd ($10 in chips)
Seat 4: b0a36c0c ($10 in chips)
Seat 6: Hero ($24.37 in chips)
664815b5: posts small blind $0.05
d38b56c9: posts big blind $0.1
4594eefd: posts big blind $0.1
*** HOLE CARDS ***
Dealt to 664815b5 
Dealt to d38b56c9 
Dealt to 4594eefd 
Dealt to b0a36c0c 
Dealt to Hero [4h 9s]
4594eefd: raises $0.19 to $0.29
b0a36c0c: folds
Hero: folds
664815b5: folds
d38b56c9: folds
Uncalled bet ($0.19) returned to 4594eefd
*** SHOWDOWN ***
4594eefd collected $0.25 from pot
*** SUMMARY ***
Total pot $0.25 | Rake $0 | Jackpot $0 | Bingo $0 | Fortune $0 | Tax $0
Seat 1: 664815b5 (small blind) folded before Flop
Seat 2: d38b56c9 (big blind) folded before Flop
Seat 3: 4594eefd collected ($0.25)
Seat 4: b0a36c0c folded before Flop (didn't bet)
Seat 6: Hero (button) folded before Flop (didn't bet)


Poker Hand #HD1788652578: Hold'em No Limit ($0.05/$0.1) - 2024/05/26 17:29:10
Table 'NLHRed17' 6-max Seat #4 is the button
Seat 1: 664815b5 ($12.09 in chips)
Seat 2: d38b56c9 ($13.8 in chips)
Seat 4: b0a36c0c ($10.15 in chips)
Seat 5: 7e14c054 ($5.27 in chips)
Seat 6: Hero ($19.47 in chips)
7e14c054: posts small blind $0.05
Hero: posts big blind $0.1
*** HOLE CARDS ***
Dealt to 664815b5 
Dealt to d38b56c9 
Dealt to b0a36c0c 
Dealt to 7e14c054 
Dealt to Hero [Ah Kh]
664815b5: folds
d38b56c9: folds
b0a36c0c: raises $0.15 to $0.25
7e14c054: calls $0.2
Hero: raises $0.95 to $1.2
b0a36c0c: folds
7e14c054: calls $0.95
*** FLOP *** [7d Ac Kc]
7e14c054: bets $0.88
Hero: calls $0.88
*** TURN *** [7d Ac Kc] [5d]
7e14c054: bets $2.21
Hero: raises $5.83 to $8.04
7e14c054: calls $0.98 and is all-in
Uncalled bet ($4.85) returned to Hero
Hero: shows [Ah Kh] (Pair of Aces and Pair of Kings)
7e14c054: shows [5h As] (Pair of Aces and Pair of Fives)
*** FIRST RIVER *** [7d Ac Kc 5d] [7h]
*** SECOND RIVER *** [7d Ac Kc 5d] [Jd]
*** FIRST SHOWDOWN ***
Hero collected $5.09 from pot
*** SECOND SHOWDOWN ***
Hero collected $5.08 from pot
*** SUMMARY ***
Total pot $10.79 | Rake $0.52 | Jackpot $0.1 | Bingo $0 | Fortune $0 | Tax $0
Hand was run two times
FIRST Board [7d Ac Kc 5d 7h]
SECOND Board [Jd]
Seat 1: 664815b5 folded before Flop (didn't bet)
Seat 2: d38b56c9 folded before Flop (didn't bet)
Seat 4: b0a36c0c (button) folded before Flop
Seat 5: 7e14c054 (small blind) showed [5h As] and lost with Pair of Aces and Pair of Sevens, and lost
Seat 6: Hero (big blind) showed [Ah Kh] and won ($5.09) with Pair of Aces and Pair of Kings, and won ($5.08)


Poker Hand #HD1788652554: Hold'em No Limit ($0.05/$0.1) - 2024/05/26 17:28:56
Table 'NLHRed17' 6-max Seat #2 is the button
Seat 1: 664815b5 ($12.09 in chips)
Seat 2: d38b56c9 ($13.8 in chips)
Seat 4: b0a36c0c ($10.2 in chips)
Seat 5: 7e14c054 ($5.22 in chips)
Seat 6: Hero ($19.47 in chips)
b0a36c0c: posts small blind $0.05
7e14c054: posts big blind $0.1
*** HOLE CARDS ***
Dealt to 664815b5 
Dealt to d38b56c9 
Dealt to b0a36c0c 
Dealt to 7e14c054 
Dealt to Hero [4c 2s]
Hero: folds
664815b5: folds
d38b56c9: folds
b0a36c0c: folds
Uncalled bet ($0.05) returned to 7e14c054
*** SHOWDOWN ***
7e14c054 collected $0.1 from pot
*** SUMMARY ***
Total pot $0.1 | Rake $0 | Jackpot $0 | Bingo $0 | Fortune $0 | Tax $0
Seat 1: 664815b5 folded before Flop (didn't bet)
Seat 2: d38b56c9 (button) folded before Flop (didn't bet)
Seat 4: b0a36c0c (small blind) folded before Flop
Seat 5: 7e14c054 (big blind) collected ($0.1)
Seat 6: Hero folded before Flop (didn't bet)


Poker Hand #HD1788652541: Hold'em No Limit ($0.05/$0.1) - 2024/05/26 17:28:46
Table 'NLHRed17' 6-max Seat #1 is the button
Seat 1: 664815b5 ($12.09 in chips)
Seat 2: d38b56c9 ($13.85 in chips)
Seat 4: b0a36c0c ($10.15 in chips)
Seat 6: Hero ($19.47 in chips)
d38b56c9: posts small blind $0.05
b0a36c0c: posts big blind $0.1
*** HOLE CARDS ***
Dealt to 664815b5 
Dealt to d38b56c9 
Dealt to b0a36c0c 
Dealt to Hero [5c Ks]
Hero: folds
664815b5: folds
d38b56c9: folds
Uncalled bet ($0.05) returned to b0a36c0c
*** SHOWDOWN ***
b0a36c0c collected $0.1 from pot
*** SUMMARY ***
Total pot $0.1 | Rake $0 | Jackpot $0 | Bingo $0 | Fortune $0 | Tax $0
Seat 1: 664815b5 (button) folded before Flop (didn't bet)
Seat 2: d38b56c9 (small blind) folded before Flop
Seat 4: b0a36c0c (big blind) collected ($0.1)
Seat 6: Hero folded before Flop (didn't bet)


Poker Hand #HD1788652478: Hold'em No Limit ($0.05/$0.1) - 2024/05/26 17:28:15
Table 'NLHRed17' 6-max Seat #6 is the button
Seat 1: 664815b5 ($12.14 in chips)
Seat 2: d38b56c9 ($14.09 in chips)
Seat 3: 1ca2a5b6 ($14.12 in chips)
Seat 4: b0a36c0c ($10.15 in chips)
Seat 6: Hero ($19.2 in chips)
664815b5: posts small blind $0.05
d38b56c9: posts big blind $0.1
*** HOLE CARDS ***
Dealt to 664815b5 
Dealt to d38b56c9 
Dealt to 1ca2a5b6 
Dealt to b0a36c0c 
Dealt to Hero [Kd Kh]
1ca2a5b6: folds
b0a36c0c: folds
Hero: raises $0.14 to $0.24
664815b5: folds
d38b56c9: calls $0.14
*** FLOP *** [Kc 7d 3c]
d38b56c9: checks
Hero: bets $0.2
d38b56c9: folds
Uncalled bet ($0.2) returned to Hero
*** SHOWDOWN ***
Hero collected $0.51 from pot
*** SUMMARY ***
Total pot $0.53 | Rake $0.02 | Jackpot $0 | Bingo $0 | Fortune $0 | Tax $0
Board [Kc 7d 3c]
Seat 1: 664815b5 (small blind) folded before Flop
Seat 2: d38b56c9 (big blind) folded on the Flop
Seat 3: 1ca2a5b6 folded before Flop (didn't bet)
Seat 4: b0a36c0c folded before Flop (didn't bet)
Seat 6: Hero (button) won ($0.51)


Poker Hand #HD1788652309: Hold'em No Limit ($0.05/$0.1) - 2024/05/26 17:26:48
Table 'NLHRed17' 6-max Seat #5 is the button
Seat 1: 664815b5 ($12.24 in chips)
Seat 2: d38b56c9 ($14.09 in chips)
Seat 3: 1ca2a5b6 ($14.32 in chips)
Seat 4: b0a36c0c ($10.15 in chips)
Seat 5: d1476d8c ($13.06 in chips)
Seat 6: Hero ($10 in chips)
Hero: posts small blind $0.05
664815b5: posts big blind $0.1
*** HOLE CARDS ***
Dealt to 664815b5 
Dealt to d38b56c9 
Dealt to 1ca2a5b6 
Dealt to b0a36c0c 
Dealt to d1476d8c 
Dealt to Hero [Ad Kc]
d38b56c9: folds
1ca2a5b6: raises $0.1 to $0.2
b0a36c0c: folds
d1476d8c: calls $0.2
Hero: raises $1 to $1.2
664815b5: folds
1ca2a5b6: folds
d1476d8c: calls $1
*** FLOP *** [9c Ac 6d]
Hero: bets $1.1
d1476d8c: raises $2.45 to $3.55
Hero: calls $2.45
*** TURN *** [9c Ac 6d] [9s]
Hero: checks
d1476d8c: bets $8.31 and is all-in
Hero: calls $5.25 and is all-in
Uncalled bet ($3.06) returned to d1476d8c
d1476d8c: shows [Ks Jc] (Pair of Nines)
Hero: shows [Ad Kc] (Pair of Aces and Pair of Nines)
*** RIVER *** [9c Ac 6d 9s] [Qs]
*** SHOWDOWN ***
Hero collected $19.2 from pot
*** SUMMARY ***
Total pot $20.3 | Rake $1 | Jackpot $0.1 | Bingo $0 | Fortune $0 | Tax $0
Board [9c Ac 6d 9s Qs]
Seat 1: 664815b5 (big blind) folded before Flop
Seat 2: d38b56c9 folded before Flop (didn't bet)
Seat 3: 1ca2a5b6 folded before Flop
Seat 4: b0a36c0c folded before Flop (didn't bet)
Seat 5: d1476d8c (button) showed [Ks Jc] and lost with Pair of Nines
Seat 6: Hero (small blind) showed [Ad Kc] and won ($19.2) with Pair of Aces and Pair of Nines


Poker Hand #HD1788652276: Hold'em No Limit ($0.05/$0.1) - 2024/05/26 17:26:32
Table 'NLHRed17' 6-max Seat #4 is the button
Seat 1: 664815b5 ($12.24 in chips)
Seat 2: d38b56c9 ($14.09 in chips)
Seat 3: 1ca2a5b6 ($14.32 in chips)
Seat 4: b0a36c0c ($10 in chips)
Seat 5: d1476d8c ($13.11 in chips)
Seat 6: Hero ($10 in chips)
d1476d8c: posts small blind $0.05
Hero: posts big blind $0.1
*** HOLE CARDS ***
Dealt to 664815b5 
Dealt to d38b56c9 
Dealt to 1ca2a5b6 
Dealt to b0a36c0c 
Dealt to d1476d8c 
Dealt to Hero [4d 3s]
664815b5: folds
d38b56c9: folds
1ca2a5b6: folds
b0a36c0c: raises $0.2 to $0.3
d1476d8c: folds
Hero: folds
Uncalled bet ($0.2) returned to b0a36c0c
*** SHOWDOWN ***
b0a36c0c collected $0.25 from pot
*** SUMMARY ***
Total pot $0.25 | Rake $0 | Jackpot $0 | Bingo $0 | Fortune $0 | Tax $0
Seat 1: 664815b5 folded before Flop (didn't bet)
Seat 2: d38b56c9 folded before Flop (didn't bet)
Seat 3: 1ca2a5b6 folded before Flop (didn't bet)
Seat 4: b0a36c0c (button) collected ($0.25)
Seat 5: d1476d8c (small blind) folded before Flop
Seat 6: Hero (big blind) folded before Flop


