Poker Hand #HD1860555845: Hold'em No Limit ($0.05/$0.1) - 2024/07/17 10:55:16
Table 'NLHRed6' 6-max Seat #6 is the button
Seat 1: Hero ($13.01 in chips)
Seat 6: d11b6654 ($4.14 in chips)
d11b6654: posts small blind $0.05
Hero: posts big blind $0.1
*** HOLE CARDS ***
Dealt to Hero [2h Td]
Dealt to d11b6654 
d11b6654: calls $0.05
Hero: checks
*** FLOP *** [Qc Ah 5s]
Hero: checks
d11b6654: checks
*** TURN *** [Qc Ah 5s] [4d]
Hero: checks
d11b6654: checks
*** RIVER *** [Qc Ah 5s 4d] [8h]
Hero: checks
d11b6654: checks
d11b6654: shows [7c 9c] (Ace-High)
Hero: shows [2h Td] (Ace-High)
*** SHOWDOWN ***
Hero collected $0.19 from pot
*** SUMMARY ***
Total pot $0.2 | Rake $0.01 | Jackpot $0 | Bingo $0 | Fortune $0 | Tax $0
Board [Qc Ah 5s 4d 8h]
Seat 1: Hero (big blind) showed [2h Td] and won ($0.19) with Ace-High
Seat 6: d11b6654 (small blind) showed [7c 9c] and lost with Ace-High


Poker Hand #HD1860555820: Hold'em No Limit ($0.05/$0.1) - 2024/07/17 10:55:02
Table 'NLHRed6' 6-max Seat #5 is the button
Seat 1: Hero ($13.11 in chips)
Seat 5: 7ffbbea8 ($11.6 in chips)
Seat 6: d11b6654 ($4.05 in chips)
d11b6654: posts small blind $0.05
Hero: posts big blind $0.1
*** HOLE CARDS ***
Dealt to Hero [Js 5d]
Dealt to 7ffbbea8 
Dealt to d11b6654 
7ffbbea8: folds
d11b6654: calls $0.05
Hero: checks
*** FLOP *** [Tc 7h Qd]
d11b6654: bets $0.1
Hero: folds
Uncalled bet ($0.1) returned to d11b6654
*** SHOWDOWN ***
d11b6654 collected $0.19 from pot
*** SUMMARY ***
Total pot $0.2 | Rake $0.01 | Jackpot $0 | Bingo $0 | Fortune $0 | Tax $0
Board [Tc 7h Qd]
Seat 1: Hero (big blind) folded on the Flop
Seat 5: 7ffbbea8 (button) folded before Flop (didn't bet)
Seat 6: d11b6654 (small blind) won ($0.19)


Poker Hand #HD1860555799: Hold'em No Limit ($0.05/$0.1) - 2024/07/17 10:54:51
Table 'NLHRed6' 6-max Seat #4 is the button
Seat 1: Hero ($13.11 in chips)
Seat 4: 2c4553d9 ($13.02 in chips)
Seat 5: 7ffbbea8 ($11.65 in chips)
Seat 6: d11b6654 ($4 in chips)
7ffbbea8: posts small blind $0.05
d11b6654: posts big blind $0.1
*** HOLE CARDS ***
Dealt to Hero [8d Qs]
Dealt to 2c4553d9 
Dealt to 7ffbbea8 
Dealt to d11b6654 
Hero: folds
2c4553d9: folds
7ffbbea8: folds
Uncalled bet ($0.05) returned to d11b6654
*** SHOWDOWN ***
d11b6654 collected $0.1 from pot
*** SUMMARY ***
Total pot $0.1 | Rake $0 | Jackpot $0 | Bingo $0 | Fortune $0 | Tax $0
Seat 1: Hero folded before Flop (didn't bet)
Seat 4: 2c4553d9 (button) folded before Flop (didn't bet)
Seat 5: 7ffbbea8 (small blind) folded before Flop
Seat 6: d11b6654 (big blind) collected ($0.1)


Poker Hand #HD1860555787: Hold'em No Limit ($0.05/$0.1) - 2024/07/17 10:54:42
Table 'NLHRed6' 6-max Seat #1 is the button
Seat 1: Hero ($13.11 in chips)
Seat 4: 2c4553d9 ($13.07 in chips)
Seat 5: 7ffbbea8 ($11.6 in chips)
Seat 6: d11b6654 ($4 in chips)
2c4553d9: posts small blind $0.05
7ffbbea8: posts big blind $0.1
*** HOLE CARDS ***
Dealt to Hero [Td 5h]
Dealt to 2c4553d9 
Dealt to 7ffbbea8 
Dealt to d11b6654 
d11b6654: folds
Hero: folds
2c4553d9: folds
Uncalled bet ($0.05) returned to 7ffbbea8
*** SHOWDOWN ***
7ffbbea8 collected $0.1 from pot
*** SUMMARY ***
Total pot $0.1 | Rake $0 | Jackpot $0 | Bingo $0 | Fortune $0 | Tax $0
Seat 1: Hero (button) folded before Flop (didn't bet)
Seat 4: 2c4553d9 (small blind) folded before Flop
Seat 5: 7ffbbea8 (big blind) collected ($0.1)
Seat 6: d11b6654 folded before Flop (didn't bet)


Poker Hand #HD1860555774: Hold'em No Limit ($0.05/$0.1) - 2024/07/17 10:54:34
Table 'NLHRed6' 6-max Seat #6 is the button
Seat 1: Hero ($13.16 in chips)
Seat 4: 2c4553d9 ($13.02 in chips)
Seat 5: 7ffbbea8 ($11.6 in chips)
Seat 6: d11b6654 ($4 in chips)
Hero: posts small blind $0.05
2c4553d9: posts big blind $0.1
*** HOLE CARDS ***
Dealt to Hero [Kh 3c]
Dealt to 2c4553d9 
Dealt to 7ffbbea8 
Dealt to d11b6654 
7ffbbea8: folds
d11b6654: folds
Hero: folds
Uncalled bet ($0.05) returned to 2c4553d9
*** SHOWDOWN ***
2c4553d9 collected $0.1 from pot
*** SUMMARY ***
Total pot $0.1 | Rake $0 | Jackpot $0 | Bingo $0 | Fortune $0 | Tax $0
Seat 1: Hero (small blind) folded before Flop
Seat 4: 2c4553d9 (big blind) collected ($0.1)
Seat 5: 7ffbbea8 folded before Flop (didn't bet)
Seat 6: d11b6654 (button) folded before Flop (didn't bet)


Poker Hand #HD1860555689: Hold'em No Limit ($0.05/$0.1) - 2024/07/17 10:53:47
Table 'NLHRed6' 6-max Seat #5 is the button
Seat 1: Hero ($13.26 in chips)
Seat 4: 2c4553d9 ($14.02 in chips)
Seat 5: 7ffbbea8 ($10.55 in chips)
Seat 6: d11b6654 ($4.05 in chips)
d11b6654: posts small blind $0.05
Hero: posts big blind $0.1
*** HOLE CARDS ***
Dealt to Hero [7h 8h]
Dealt to 2c4553d9 
Dealt to 7ffbbea8 
Dealt to d11b6654 
2c4553d9: raises $0.1 to $0.2
7ffbbea8: raises $0.8 to $1
d11b6654: folds
Hero: folds
2c4553d9: calls $0.8
*** FLOP *** [5h 5c Jh]
2c4553d9: checks
7ffbbea8: checks
*** TURN *** [5h 5c Jh] [8c]
2c4553d9: checks
7ffbbea8: checks
*** RIVER *** [5h 5c Jh 8c] [Qc]
2c4553d9: checks
7ffbbea8: bets $1.62
2c4553d9: folds
Uncalled bet ($1.62) returned to 7ffbbea8
*** SHOWDOWN ***
7ffbbea8 collected $2.05 from pot
*** SUMMARY ***
Total pot $2.15 | Rake $0.1 | Jackpot $0 | Bingo $0 | Fortune $0 | Tax $0
Board [5h 5c Jh 8c Qc]
Seat 1: Hero (big blind) folded before Flop
Seat 4: 2c4553d9 folded on the River
Seat 5: 7ffbbea8 (button) won ($2.05)
Seat 6: d11b6654 (small blind) folded before Flop


Poker Hand #HD1860555683: Hold'em No Limit ($0.05/$0.1) - 2024/07/17 10:53:42
Table 'NLHRed6' 6-max Seat #4 is the button
Seat 1: Hero ($13.26 in chips)
Seat 4: 2c4553d9 ($14.02 in chips)
Seat 5: 7ffbbea8 ($10.6 in chips)
Seat 6: d11b6654 ($4 in chips)
7ffbbea8: posts small blind $0.05
d11b6654: posts big blind $0.1
*** HOLE CARDS ***
Dealt to Hero [2s 3s]
Dealt to 2c4553d9 
Dealt to 7ffbbea8 
Dealt to d11b6654 
Hero: folds
2c4553d9: folds
7ffbbea8: folds
Uncalled bet ($0.05) returned to d11b6654
*** SHOWDOWN ***
d11b6654 collected $0.1 from pot
*** SUMMARY ***
Total pot $0.1 | Rake $0 | Jackpot $0 | Bingo $0 | Fortune $0 | Tax $0
Seat 1: Hero folded before Flop (didn't bet)
Seat 4: 2c4553d9 (button) folded before Flop (didn't bet)
Seat 5: 7ffbbea8 (small blind) folded before Flop
Seat 6: d11b6654 (big blind) collected ($0.1)


Poker Hand #HD1860455594: Hold'em No Limit ($0.05/$0.1) - 2024/07/17 10:52:53
Table 'NLHRed6' 6-max Seat #1 is the button
Seat 1: Hero ($13.5 in chips)
Seat 4: 2c4553d9 ($14.26 in chips)
Seat 5: 7ffbbea8 ($10.15 in chips)
Seat 6: d11b6654 ($4 in chips)
2c4553d9: posts small blind $0.05
7ffbbea8: posts big blind $0.1
*** HOLE CARDS ***
Dealt to Hero [Ah Js]
Dealt to 2c4553d9 
Dealt to 7ffbbea8 
Dealt to d11b6654 
d11b6654: folds
Hero: raises $0.14 to $0.24
2c4553d9: calls $0.19
7ffbbea8: calls $0.14
*** FLOP *** [Jh Kc 6c]
2c4553d9: checks
7ffbbea8: checks
Hero: checks
*** TURN *** [Jh Kc 6c] [2c]
2c4553d9: checks
7ffbbea8: checks
Hero: checks
*** RIVER *** [Jh Kc 6c 2c] [3s]
2c4553d9: checks
7ffbbea8: bets $0.72
Hero: folds
2c4553d9: folds
Uncalled bet ($0.72) returned to 7ffbbea8
*** SHOWDOWN ***
7ffbbea8 collected $0.69 from pot
*** SUMMARY ***
Total pot $0.72 | Rake $0.03 | Jackpot $0 | Bingo $0 | Fortune $0 | Tax $0
Board [Jh Kc 6c 2c 3s]
Seat 1: Hero (button) folded on the River
Seat 4: 2c4553d9 (small blind) folded on the River
Seat 5: 7ffbbea8 (big blind) won ($0.69)
Seat 6: d11b6654 folded before Flop (didn't bet)


Poker Hand #HD1860455575: Hold'em No Limit ($0.05/$0.1) - 2024/07/17 10:52:38
Table 'NLHRed6' 6-max Seat #6 is the button
Seat 1: Hero ($13.4 in chips)
Seat 4: 2c4553d9 ($14.36 in chips)
Seat 5: 7ffbbea8 ($10.15 in chips)
Seat 6: d11b6654 ($4 in chips)
Hero: posts small blind $0.05
2c4553d9: posts big blind $0.1
*** HOLE CARDS ***
Dealt to Hero [Th Qs]
Dealt to 2c4553d9 
Dealt to 7ffbbea8 
Dealt to d11b6654 
7ffbbea8: folds
d11b6654: folds
Hero: raises $0.2 to $0.3
2c4553d9: folds
Uncalled bet ($0.2) returned to Hero
*** SHOWDOWN ***
Hero collected $0.2 from pot
*** SUMMARY ***
Total pot $0.2 | Rake $0 | Jackpot $0 | Bingo $0 | Fortune $0 | Tax $0
Seat 1: Hero (small blind) collected ($0.2)
Seat 4: 2c4553d9 (big blind) folded before Flop
Seat 5: 7ffbbea8 folded before Flop (didn't bet)
Seat 6: d11b6654 (button) folded before Flop (didn't bet)


Poker Hand #HD1860455480: Hold'em No Limit ($0.05/$0.1) - 2024/07/17 10:51:27
Table 'NLHRed6' 6-max Seat #5 is the button
Seat 1: Hero ($13.5 in chips)
Seat 3: 49d05dd9 ($10.47 in chips)
Seat 4: 2c4553d9 ($14.36 in chips)
Seat 5: 7ffbbea8 ($12.1 in chips)
Seat 6: d11b6654 ($4.05 in chips)
d11b6654: posts small blind $0.05
Hero: posts big blind $0.1
*** HOLE CARDS ***
Dealt to Hero [6d 3s]
Dealt to 49d05dd9 
Dealt to 2c4553d9 
Dealt to 7ffbbea8 
Dealt to d11b6654 
49d05dd9: raises $0.15 to $0.25
2c4553d9: folds
7ffbbea8: calls $0.25
d11b6654: folds
Hero: folds
*** FLOP *** [3c Qs Qc]
49d05dd9: bets $0.1
7ffbbea8: calls $0.1
*** TURN *** [3c Qs Qc] [3d]
49d05dd9: bets $0.1
7ffbbea8: calls $0.1
*** RIVER *** [3c Qs Qc 3d] [8d]
49d05dd9: bets $1.5
7ffbbea8: calls $1.5
49d05dd9: shows [Kd Qh] (Queens Full over Treys)
7ffbbea8: shows [9d 9s] (Pair of Queens and Pair of Nines)
*** SHOWDOWN ***
49d05dd9 collected $3.76 from pot
*** SUMMARY ***
Total pot $4.05 | Rake $0.19 | Jackpot $0.1 | Bingo $0 | Fortune $0 | Tax $0
Board [3c Qs Qc 3d 8d]
Seat 1: Hero (big blind) folded before Flop
Seat 3: 49d05dd9 showed [Kd Qh] and won ($3.76) with Queens Full over Treys
Seat 4: 2c4553d9 folded before Flop (didn't bet)
Seat 5: 7ffbbea8 (button) showed [9d 9s] and lost with Pair of Queens and Pair of Nines
Seat 6: d11b6654 (small blind) folded before Flop


Poker Hand #HD1860455466: Hold'em No Limit ($0.05/$0.1) - 2024/07/17 10:51:17
Table 'NLHRed6' 6-max Seat #4 is the button
Seat 1: Hero ($13.5 in chips)
Seat 3: 49d05dd9 ($10.47 in chips)
Seat 4: 2c4553d9 ($14.36 in chips)
Seat 5: 7ffbbea8 ($12.15 in chips)
Seat 6: d11b6654 ($4 in chips)
7ffbbea8: posts small blind $0.05
d11b6654: posts big blind $0.1
*** HOLE CARDS ***
Dealt to Hero [Kd 8d]
Dealt to 49d05dd9 
Dealt to 2c4553d9 
Dealt to 7ffbbea8 
Dealt to d11b6654 
Hero: folds
49d05dd9: folds
2c4553d9: folds
7ffbbea8: folds
Uncalled bet ($0.05) returned to d11b6654
*** SHOWDOWN ***
d11b6654 collected $0.1 from pot
*** SUMMARY ***
Total pot $0.1 | Rake $0 | Jackpot $0 | Bingo $0 | Fortune $0 | Tax $0
Seat 1: Hero folded before Flop (didn't bet)
Seat 3: 49d05dd9 folded before Flop (didn't bet)
Seat 4: 2c4553d9 (button) folded before Flop (didn't bet)
Seat 5: 7ffbbea8 (small blind) folded before Flop
Seat 6: d11b6654 (big blind) collected ($0.1)


Poker Hand #HD1860455427: Hold'em No Limit ($0.05/$0.1) - 2024/07/17 10:50:52
Table 'NLHRed6' 6-max Seat #3 is the button
Seat 1: Hero ($13.5 in chips)
Seat 3: 49d05dd9 ($10.15 in chips)
Seat 4: 2c4553d9 ($14.61 in chips)
Seat 5: 7ffbbea8 ($12.25 in chips)
2c4553d9: posts small blind $0.05
7ffbbea8: posts big blind $0.1
*** HOLE CARDS ***
Dealt to Hero [Kd 9h]
Dealt to 49d05dd9 
Dealt to 2c4553d9 
Dealt to 7ffbbea8 
Hero: folds
49d05dd9: raises $0.15 to $0.25
2c4553d9: calls $0.2
7ffbbea8: folds
*** FLOP *** [6c 5d 6d]
2c4553d9: checks
49d05dd9: bets $0.4
2c4553d9: folds
Uncalled bet ($0.4) returned to 49d05dd9
*** SHOWDOWN ***
49d05dd9 collected $0.57 from pot
*** SUMMARY ***
Total pot $0.6 | Rake $0.03 | Jackpot $0 | Bingo $0 | Fortune $0 | Tax $0
Board [6c 5d 6d]
Seat 1: Hero folded before Flop (didn't bet)
Seat 3: 49d05dd9 (button) won ($0.57)
Seat 4: 2c4553d9 (small blind) folded on the Flop
Seat 5: 7ffbbea8 (big blind) folded before Flop


Poker Hand #HD1860455405: Hold'em No Limit ($0.05/$0.1) - 2024/07/17 10:50:43
Table 'NLHRed6' 6-max Seat #1 is the button
Seat 1: Hero ($13.5 in chips)
Seat 3: 49d05dd9 ($10.05 in chips)
Seat 4: 2c4553d9 ($14.71 in chips)
Seat 5: 7ffbbea8 ($12.25 in chips)
49d05dd9: posts small blind $0.05
2c4553d9: posts big blind $0.1
*** HOLE CARDS ***
Dealt to Hero [Kh 4d]
Dealt to 49d05dd9 
Dealt to 2c4553d9 
Dealt to 7ffbbea8 
7ffbbea8: folds
Hero: folds
49d05dd9: raises $0.2 to $0.3
2c4553d9: folds
Uncalled bet ($0.2) returned to 49d05dd9
*** SHOWDOWN ***
49d05dd9 collected $0.2 from pot
*** SUMMARY ***
Total pot $0.2 | Rake $0 | Jackpot $0 | Bingo $0 | Fortune $0 | Tax $0
Seat 1: Hero (button) folded before Flop (didn't bet)
Seat 3: 49d05dd9 (small blind) collected ($0.2)
Seat 4: 2c4553d9 (big blind) folded before Flop
Seat 5: 7ffbbea8 folded before Flop (didn't bet)


Poker Hand #HD1860455391: Hold'em No Limit ($0.05/$0.1) - 2024/07/17 10:50:35
Table 'NLHRed6' 6-max Seat #5 is the button
Seat 1: Hero ($13.55 in chips)
Seat 3: 49d05dd9 ($10 in chips)
Seat 4: 2c4553d9 ($14.71 in chips)
Seat 5: 7ffbbea8 ($12.25 in chips)
Hero: posts small blind $0.05
49d05dd9: posts big blind $0.1
*** HOLE CARDS ***
Dealt to Hero [7d 5c]
Dealt to 49d05dd9 
Dealt to 2c4553d9 
Dealt to 7ffbbea8 
2c4553d9: folds
7ffbbea8: folds
Hero: folds
Uncalled bet ($0.05) returned to 49d05dd9
*** SHOWDOWN ***
49d05dd9 collected $0.1 from pot
*** SUMMARY ***
Total pot $0.1 | Rake $0 | Jackpot $0 | Bingo $0 | Fortune $0 | Tax $0
Seat 1: Hero (small blind) folded before Flop
Seat 3: 49d05dd9 (big blind) collected ($0.1)
Seat 4: 2c4553d9 folded before Flop (didn't bet)
Seat 5: 7ffbbea8 (button) folded before Flop (didn't bet)


Poker Hand #HD1860455283: Hold'em No Limit ($0.05/$0.1) - 2024/07/17 10:49:25
Table 'NLHRed6' 6-max Seat #4 is the button
Seat 1: Hero ($11.38 in chips)
Seat 3: 49d05dd9 ($10 in chips)
Seat 4: 2c4553d9 ($14.71 in chips)
Seat 5: 7ffbbea8 ($12.3 in chips)
7ffbbea8: posts small blind $0.05
Hero: posts big blind $0.1
*** HOLE CARDS ***
Dealt to Hero [7h 8h]
Dealt to 49d05dd9 
Dealt to 2c4553d9 
Dealt to 7ffbbea8 
49d05dd9: raises $0.15 to $0.25
2c4553d9: folds
7ffbbea8: folds
Hero: calls $0.15
*** FLOP *** [Qs 6h Tc]
Hero: checks
49d05dd9: bets $0.37
Hero: calls $0.37
*** TURN *** [Qs 6h Tc] [4s]
Hero: checks
49d05dd9: checks
*** RIVER *** [Qs 6h Tc 4s] [5c]
Hero: checks
49d05dd9: bets $1.84
Hero: raises $8.92 to $10.76 and is all-in
49d05dd9: folds
Uncalled bet ($8.92) returned to Hero
*** SHOWDOWN ***
Hero collected $4.63 from pot
*** SUMMARY ***
Total pot $4.97 | Rake $0.24 | Jackpot $0.1 | Bingo $0 | Fortune $0 | Tax $0
Board [Qs 6h Tc 4s 5c]
Seat 1: Hero (big blind) won ($4.63)
Seat 3: 49d05dd9 folded on the River
Seat 4: 2c4553d9 (button) folded before Flop (didn't bet)
Seat 5: 7ffbbea8 (small blind) folded before Flop


Poker Hand #HD1860455211: Hold'em No Limit ($0.05/$0.1) - 2024/07/17 10:48:34
Table 'NLHRed6' 6-max Seat #3 is the button
Seat 1: Hero ($10.5 in chips)
Seat 3: 49d05dd9 ($10 in chips)
Seat 4: 2c4553d9 ($14.76 in chips)
Seat 5: 7ffbbea8 ($13.22 in chips)
2c4553d9: posts small blind $0.05
7ffbbea8: posts big blind $0.1
*** HOLE CARDS ***
Dealt to Hero [Kd As]
Dealt to 49d05dd9 
Dealt to 2c4553d9 
Dealt to 7ffbbea8 
Hero: raises $0.14 to $0.24
49d05dd9: folds
2c4553d9: folds
7ffbbea8: calls $0.14
*** FLOP *** [4d 5s 2c]
7ffbbea8: checks
Hero: bets $0.3
7ffbbea8: calls $0.3
*** TURN *** [4d 5s 2c] [Qd]
7ffbbea8: checks
Hero: checks
*** RIVER *** [4d 5s 2c Qd] [Kc]
7ffbbea8: checks
Hero: bets $0.38
7ffbbea8: calls $0.38
Hero: shows [Kd As] (Pair of Kings)
7ffbbea8: shows [8h 8s] (Pair of Eights)
*** SHOWDOWN ***
Hero collected $1.8 from pot
*** SUMMARY ***
Total pot $1.89 | Rake $0.09 | Jackpot $0 | Bingo $0 | Fortune $0 | Tax $0
Board [4d 5s 2c Qd Kc]
Seat 1: Hero showed [Kd As] and won ($1.8) with Pair of Kings
Seat 3: 49d05dd9 (button) folded before Flop (didn't bet)
Seat 4: 2c4553d9 (small blind) folded before Flop
Seat 5: 7ffbbea8 (big blind) showed [8h 8s] and lost with Pair of Eights


Poker Hand #HD1860455168: Hold'em No Limit ($0.05/$0.1) - 2024/07/17 10:48:12
Table 'NLHRed6' 6-max Seat #2 is the button
Seat 1: Hero ($10.5 in chips)
Seat 2: 711a3682 ($12.68 in chips)
Seat 3: 49d05dd9 ($10 in chips)
Seat 4: 2c4553d9 ($14.71 in chips)
Seat 5: 7ffbbea8 ($13.22 in chips)
49d05dd9: posts small blind $0.05
2c4553d9: posts big blind $0.1
*** HOLE CARDS ***
Dealt to Hero [Ks 5h]
Dealt to 711a3682 
Dealt to 49d05dd9 
Dealt to 2c4553d9 
Dealt to 7ffbbea8 
7ffbbea8: folds
Hero: folds
711a3682: folds
49d05dd9: folds
Uncalled bet ($0.05) returned to 2c4553d9
*** SHOWDOWN ***
2c4553d9 collected $0.1 from pot
*** SUMMARY ***
Total pot $0.1 | Rake $0 | Jackpot $0 | Bingo $0 | Fortune $0 | Tax $0
Seat 1: Hero folded before Flop (didn't bet)
Seat 2: 711a3682 (button) folded before Flop (didn't bet)
Seat 3: 49d05dd9 (small blind) folded before Flop
Seat 4: 2c4553d9 (big blind) collected ($0.1)
Seat 5: 7ffbbea8 folded before Flop (didn't bet)


Poker Hand #HD1860455056: Hold'em No Limit ($0.05/$0.1) - 2024/07/17 10:47:01
Table 'NLHRed6' 6-max Seat #1 is the button
Seat 1: Hero ($10 in chips)
Seat 2: 711a3682 ($13.12 in chips)
Seat 3: 49d05dd9 ($10 in chips)
Seat 4: 2c4553d9 ($14.71 in chips)
Seat 5: 7ffbbea8 ($13.22 in chips)
711a3682: posts small blind $0.05
49d05dd9: posts big blind $0.1
*** HOLE CARDS ***
Dealt to Hero [Ks As]
Dealt to 711a3682 
Dealt to 49d05dd9 
Dealt to 2c4553d9 
Dealt to 7ffbbea8 
2c4553d9: folds
7ffbbea8: folds
Hero: raises $0.14 to $0.24
711a3682: calls $0.19
49d05dd9: folds
*** FLOP *** [5c 9h 9s]
711a3682: checks
Hero: bets $0.2
711a3682: calls $0.2
*** TURN *** [5c 9h 9s] [Kd]
711a3682: checks
Hero: checks
*** RIVER *** [5c 9h 9s Kd] [8s]
711a3682: checks
Hero: checks
711a3682: shows [8h Ah] (Pair of Nines and Pair of Eights)
Hero: shows [Ks As] (Pair of Kings and Pair of Nines)
*** SHOWDOWN ***
Hero collected $0.94 from pot
*** SUMMARY ***
Total pot $0.98 | Rake $0.04 | Jackpot $0 | Bingo $0 | Fortune $0 | Tax $0
Board [5c 9h 9s Kd 8s]
Seat 1: Hero (button) showed [Ks As] and won ($0.94) with Pair of Kings and Pair of Nines
Seat 2: 711a3682 (small blind) showed [8h Ah] and lost with Pair of Nines and Pair of Eights
Seat 3: 49d05dd9 (big blind) folded before Flop
Seat 4: 2c4553d9 folded before Flop (didn't bet)
Seat 5: 7ffbbea8 folded before Flop (didn't bet)


Poker Hand #HD1860455027: Hold'em No Limit ($0.05/$0.1) - 2024/07/17 10:46:37
Table 'NLHRed6' 6-max Seat #5 is the button
Seat 1: Hero ($10 in chips)
Seat 2: 711a3682 ($13.22 in chips)
Seat 4: 2c4553d9 ($14.71 in chips)
Seat 5: 7ffbbea8 ($13.07 in chips)
Hero: posts small blind $0.05
711a3682: posts big blind $0.1
*** HOLE CARDS ***
Dealt to Hero [Qc 5s]
Dealt to 711a3682 
Dealt to 2c4553d9 
Dealt to 7ffbbea8 
2c4553d9: folds
7ffbbea8: raises $0.15 to $0.25
Hero: folds
711a3682: folds
Uncalled bet ($0.15) returned to 7ffbbea8
*** SHOWDOWN ***
7ffbbea8 collected $0.25 from pot
*** SUMMARY ***
Total pot $0.25 | Rake $0 | Jackpot $0 | Bingo $0 | Fortune $0 | Tax $0
Seat 1: Hero (small blind) folded before Flop
Seat 2: 711a3682 (big blind) folded before Flop
Seat 4: 2c4553d9 folded before Flop (didn't bet)
Seat 5: 7ffbbea8 (button) collected ($0.25)


Poker Hand #HD1860455011: Hold'em No Limit ($0.05/$0.1) - 2024/07/17 10:46:28
Table 'NLHRed6' 6-max Seat #4 is the button
Seat 1: Hero ($10 in chips)
Seat 2: 711a3682 ($13.22 in chips)
Seat 4: 2c4553d9 ($14.71 in chips)
Seat 5: 7ffbbea8 ($12.97 in chips)
7ffbbea8: posts small blind $0.05
Hero: posts big blind $0.1
*** HOLE CARDS ***
Dealt to Hero [5d 3c]
Dealt to 711a3682 
Dealt to 2c4553d9 
Dealt to 7ffbbea8 
711a3682: folds
2c4553d9: folds
7ffbbea8: raises $0.2 to $0.3
Hero: folds
Uncalled bet ($0.2) returned to 7ffbbea8
*** SHOWDOWN ***
7ffbbea8 collected $0.2 from pot
*** SUMMARY ***
Total pot $0.2 | Rake $0 | Jackpot $0 | Bingo $0 | Fortune $0 | Tax $0
Seat 1: Hero (big blind) folded before Flop
Seat 2: 711a3682 folded before Flop (didn't bet)
Seat 4: 2c4553d9 (button) folded before Flop (didn't bet)
Seat 5: 7ffbbea8 (small blind) collected ($0.2)


Poker Hand #HD1860455002: Hold'em No Limit ($0.05/$0.1) - 2024/07/17 10:46:20
Table 'NLHRed6' 6-max Seat #2 is the button
Seat 1: Hero ($10 in chips)
Seat 2: 711a3682 ($13.22 in chips)
Seat 4: 2c4553d9 ($14.76 in chips)
Seat 5: 7ffbbea8 ($12.92 in chips)
2c4553d9: posts small blind $0.05
7ffbbea8: posts big blind $0.1
*** HOLE CARDS ***
Dealt to Hero [6s Qd]
Dealt to 711a3682 
Dealt to 2c4553d9 
Dealt to 7ffbbea8 
Hero: folds
711a3682: folds
2c4553d9: folds
Uncalled bet ($0.05) returned to 7ffbbea8
*** SHOWDOWN ***
7ffbbea8 collected $0.1 from pot
*** SUMMARY ***
Total pot $0.1 | Rake $0 | Jackpot $0 | Bingo $0 | Fortune $0 | Tax $0
Seat 1: Hero folded before Flop (didn't bet)
Seat 2: 711a3682 (button) folded before Flop (didn't bet)
Seat 4: 2c4553d9 (small blind) folded before Flop
Seat 5: 7ffbbea8 (big blind) collected ($0.1)


Poker Hand #HD1860454992: Hold'em No Limit ($0.05/$0.1) - 2024/07/17 10:46:13
Table 'NLHRed6' 6-max Seat #1 is the button
Seat 1: Hero ($10 in chips)
Seat 2: 711a3682 ($13.12 in chips)
Seat 4: 2c4553d9 ($14.86 in chips)
Seat 5: 7ffbbea8 ($12.92 in chips)
711a3682: posts small blind $0.05
2c4553d9: posts big blind $0.1
*** HOLE CARDS ***
Dealt to Hero [9c 7s]
Dealt to 711a3682 
Dealt to 2c4553d9 
Dealt to 7ffbbea8 
7ffbbea8: folds
Hero: folds
711a3682: raises $0.15 to $0.25
2c4553d9: folds
Uncalled bet ($0.15) returned to 711a3682
*** SHOWDOWN ***
711a3682 collected $0.2 from pot
*** SUMMARY ***
Total pot $0.2 | Rake $0 | Jackpot $0 | Bingo $0 | Fortune $0 | Tax $0
Seat 1: Hero (button) folded before Flop (didn't bet)
Seat 2: 711a3682 (small blind) collected ($0.2)
Seat 4: 2c4553d9 (big blind) folded before Flop
Seat 5: 7ffbbea8 folded before Flop (didn't bet)


Poker Hand #HD1860454977: Hold'em No Limit ($0.05/$0.1) - 2024/07/17 10:46:03
Table 'NLHRed6' 6-max Seat #5 is the button
Seat 1: Hero ($10 in chips)
Seat 2: 711a3682 ($13.07 in chips)
Seat 3: 53c36c1 ($7.04 in chips)
Seat 4: 2c4553d9 ($14.86 in chips)
Seat 5: 7ffbbea8 ($12.92 in chips)
Hero: posts small blind $0.05
711a3682: posts big blind $0.1
*** HOLE CARDS ***
Dealt to Hero [3c 5c]
Dealt to 711a3682 
Dealt to 53c36c1 
Dealt to 2c4553d9 
Dealt to 7ffbbea8 
53c36c1: folds
2c4553d9: folds
7ffbbea8: folds
Hero: folds
Uncalled bet ($0.05) returned to 711a3682
*** SHOWDOWN ***
711a3682 collected $0.1 from pot
*** SUMMARY ***
Total pot $0.1 | Rake $0 | Jackpot $0 | Bingo $0 | Fortune $0 | Tax $0
Seat 1: Hero (small blind) folded before Flop
Seat 2: 711a3682 (big blind) collected ($0.1)
Seat 3: 53c36c1 folded before Flop (didn't bet)
Seat 4: 2c4553d9 folded before Flop (didn't bet)
Seat 5: 7ffbbea8 (button) folded before Flop (didn't bet)


Poker Hand #HD1860454964: Hold'em No Limit ($0.05/$0.1) - 2024/07/17 10:45:54
Table 'NLHRed6' 6-max Seat #4 is the button
Seat 1: Hero ($10 in chips)
Seat 2: 711a3682 ($12.92 in chips)
Seat 3: 53c36c1 ($7.04 in chips)
Seat 4: 2c4553d9 ($14.86 in chips)
Seat 5: 7ffbbea8 ($12.97 in chips)
7ffbbea8: posts small blind $0.05
Hero: posts big blind $0.1
*** HOLE CARDS ***
Dealt to Hero [9d 6h]
Dealt to 711a3682 
Dealt to 53c36c1 
Dealt to 2c4553d9 
Dealt to 7ffbbea8 
711a3682: raises $0.15 to $0.25
53c36c1: folds
2c4553d9: folds
7ffbbea8: folds
Hero: folds
Uncalled bet ($0.15) returned to 711a3682
*** SHOWDOWN ***
711a3682 collected $0.25 from pot
*** SUMMARY ***
Total pot $0.25 | Rake $0 | Jackpot $0 | Bingo $0 | Fortune $0 | Tax $0
Seat 1: Hero (big blind) folded before Flop
Seat 2: 711a3682 collected ($0.25)
Seat 3: 53c36c1 folded before Flop (didn't bet)
Seat 4: 2c4553d9 (button) folded before Flop (didn't bet)
Seat 5: 7ffbbea8 (small blind) folded before Flop


Poker Hand #HD1860454890: Hold'em No Limit ($0.05/$0.1) - 2024/07/17 10:45:08
Table 'NLHRed6' 6-max Seat #3 is the button
Seat 1: Hero ($10 in chips)
Seat 2: 711a3682 ($12.92 in chips)
Seat 3: 53c36c1 ($7.04 in chips)
Seat 4: 2c4553d9 ($16.19 in chips)
Seat 5: 7ffbbea8 ($11.77 in chips)
2c4553d9: posts small blind $0.05
7ffbbea8: posts big blind $0.1
*** HOLE CARDS ***
Dealt to Hero [7h 5h]
Dealt to 711a3682 
Dealt to 53c36c1 
Dealt to 2c4553d9 
Dealt to 7ffbbea8 
Hero: folds
711a3682: folds
53c36c1: folds
2c4553d9: raises $0.1 to $0.2
7ffbbea8: calls $0.1
*** FLOP *** [Ks Ad 4c]
2c4553d9: checks
7ffbbea8: checks
*** TURN *** [Ks Ad 4c] [4d]
2c4553d9: bets $0.2
7ffbbea8: raises $0.4 to $0.6
2c4553d9: calls $0.4
*** RIVER *** [Ks Ad 4c 4d] [Kd]
2c4553d9: checks
7ffbbea8: bets $0.53
2c4553d9: calls $0.53
7ffbbea8: shows [Qh 4h] (Fours Full over Kings)
2c4553d9: shows [5d 9d] (Ace High Flush)
*** SHOWDOWN ***
7ffbbea8 collected $2.53 from pot
*** SUMMARY ***
Total pot $2.66 | Rake $0.13 | Jackpot $0 | Bingo $0 | Fortune $0 | Tax $0
Board [Ks Ad 4c 4d Kd]
Seat 1: Hero folded before Flop (didn't bet)
Seat 2: 711a3682 folded before Flop (didn't bet)
Seat 3: 53c36c1 (button) folded before Flop (didn't bet)
Seat 4: 2c4553d9 (small blind) showed [5d 9d] and lost with Ace High Flush
Seat 5: 7ffbbea8 (big blind) showed [Qh 4h] and won ($2.53) with Fours Full over Kings


Poker Hand #HD1860454863: Hold'em No Limit ($0.05/$0.1) - 2024/07/17 10:44:49
Table 'NLHRed6' 6-max Seat #2 is the button
Seat 1: Hero ($10 in chips)
Seat 2: 711a3682 ($12.77 in chips)
Seat 3: 53c36c1 ($7.09 in chips)
Seat 4: 2c4553d9 ($16.29 in chips)
Seat 5: 7ffbbea8 ($11.77 in chips)
53c36c1: posts small blind $0.05
2c4553d9: posts big blind $0.1
*** HOLE CARDS ***
Dealt to Hero [9h Ks]
Dealt to 711a3682 
Dealt to 53c36c1 
Dealt to 2c4553d9 
Dealt to 7ffbbea8 
7ffbbea8: folds
Hero: folds
711a3682: raises $0.2 to $0.3
53c36c1: folds
2c4553d9: folds
Uncalled bet ($0.2) returned to 711a3682
*** SHOWDOWN ***
711a3682 collected $0.25 from pot
*** SUMMARY ***
Total pot $0.25 | Rake $0 | Jackpot $0 | Bingo $0 | Fortune $0 | Tax $0
Seat 1: Hero folded before Flop (didn't bet)
Seat 2: 711a3682 (button) collected ($0.25)
Seat 3: 53c36c1 (small blind) folded before Flop
Seat 4: 2c4553d9 (big blind) folded before Flop
Seat 5: 7ffbbea8 folded before Flop (didn't bet)


Poker Hand #HD1860454820: Hold'em No Limit ($0.05/$0.1) - 2024/07/17 10:44:22
Table 'NLHRed6' 6-max Seat #1 is the button
Seat 1: Hero ($10 in chips)
Seat 2: 711a3682 ($13.52 in chips)
Seat 3: 53c36c1 ($6.41 in chips)
Seat 4: 2c4553d9 ($16.29 in chips)
Seat 5: 7ffbbea8 ($11.77 in chips)
711a3682: posts small blind $0.05
53c36c1: posts big blind $0.1
*** HOLE CARDS ***
Dealt to Hero [6s 4h]
Dealt to 711a3682 
Dealt to 53c36c1 
Dealt to 2c4553d9 
Dealt to 7ffbbea8 
2c4553d9: folds
7ffbbea8: folds
Hero: folds
711a3682: raises $0.15 to $0.25
53c36c1: raises $0.5 to $0.75
711a3682: calls $0.5
*** FLOP *** [Tc 2h Qd]
711a3682: checks
53c36c1: bets $0.75
711a3682: folds
Uncalled bet ($0.75) returned to 53c36c1
*** SHOWDOWN ***
53c36c1 collected $1.43 from pot
*** SUMMARY ***
Total pot $1.5 | Rake $0.07 | Jackpot $0 | Bingo $0 | Fortune $0 | Tax $0
Board [Tc 2h Qd]
Seat 1: Hero (button) folded before Flop (didn't bet)
Seat 2: 711a3682 (small blind) folded on the Flop
Seat 3: 53c36c1 (big blind) won ($1.43)
Seat 4: 2c4553d9 folded before Flop (didn't bet)
Seat 5: 7ffbbea8 folded before Flop (didn't bet)


Poker Hand #HD1860454702: Hold'em No Limit ($0.05/$0.1) - 2024/07/17 10:43:11
Table 'NLHRed6' 6-max Seat #5 is the button
Seat 1: Hero ($10 in chips)
Seat 2: 711a3682 ($14.86 in chips)
Seat 3: 53c36c1 ($5.15 in chips)
Seat 4: 2c4553d9 ($16.29 in chips)
Seat 5: 7ffbbea8 ($11.77 in chips)
Hero: posts small blind $0.05
711a3682: posts big blind $0.1
*** HOLE CARDS ***
Dealt to Hero [5d Qh]
Dealt to 711a3682 
Dealt to 53c36c1 
Dealt to 2c4553d9 
Dealt to 7ffbbea8 
53c36c1: raises $0.1 to $0.2
2c4553d9: folds
7ffbbea8: folds
Hero: folds
711a3682: calls $0.1
*** FLOP *** [7s Td Kd]
711a3682: checks
53c36c1: checks
*** TURN *** [7s Td Kd] [5h]
711a3682: bets $0.23
53c36c1: calls $0.23
*** RIVER *** [7s Td Kd 5h] [8d]
711a3682: checks
53c36c1: bets $0.91
711a3682: calls $0.91
53c36c1: shows [8s 8c] (Three Eights)
711a3682: shows [2c Kc] (Pair of Kings)
*** SHOWDOWN ***
53c36c1 collected $2.6 from pot
*** SUMMARY ***
Total pot $2.73 | Rake $0.13 | Jackpot $0 | Bingo $0 | Fortune $0 | Tax $0
Board [7s Td Kd 5h 8d]
Seat 1: Hero (small blind) folded before Flop
Seat 2: 711a3682 (big blind) showed [2c Kc] and lost with Pair of Kings
Seat 3: 53c36c1 showed [8s 8c] and won ($2.6) with Three Eights
Seat 4: 2c4553d9 folded before Flop (didn't bet)
Seat 5: 7ffbbea8 (button) folded before Flop (didn't bet)


Poker Hand #HD1860454685: Hold'em No Limit ($0.05/$0.1) - 2024/07/17 10:42:59
Table 'NLHRed6' 6-max Seat #4 is the button
Seat 1: Hero ($10 in chips)
Seat 2: 711a3682 ($14.86 in chips)
Seat 3: 53c36c1 ($5 in chips)
Seat 4: 2c4553d9 ($16.29 in chips)
Seat 5: 7ffbbea8 ($11.82 in chips)
7ffbbea8: posts small blind $0.05
Hero: posts big blind $0.1
*** HOLE CARDS ***
Dealt to Hero [Kh 6d]
Dealt to 711a3682 
Dealt to 53c36c1 
Dealt to 2c4553d9 
Dealt to 7ffbbea8 
711a3682: folds
53c36c1: raises $0.1 to $0.2
2c4553d9: folds
7ffbbea8: folds
Hero: folds
Uncalled bet ($0.1) returned to 53c36c1
*** SHOWDOWN ***
53c36c1 collected $0.25 from pot
*** SUMMARY ***
Total pot $0.25 | Rake $0 | Jackpot $0 | Bingo $0 | Fortune $0 | Tax $0
Seat 1: Hero (big blind) folded before Flop
Seat 2: 711a3682 folded before Flop (didn't bet)
Seat 3: 53c36c1 collected ($0.25)
Seat 4: 2c4553d9 (button) folded before Flop (didn't bet)
Seat 5: 7ffbbea8 (small blind) folded before Flop


Poker Hand #HD1860454648: Hold'em No Limit ($0.05/$0.1) - 2024/07/17 10:42:35
Table 'NLHRed6' 6-max Seat #3 is the button
Seat 1: Hero ($10 in chips)
Seat 2: 711a3682 ($14.71 in chips)
Seat 3: 53c36c1 ($5 in chips)
Seat 4: 2c4553d9 ($16.34 in chips)
Seat 5: 7ffbbea8 ($11.92 in chips)
2c4553d9: posts small blind $0.05
7ffbbea8: posts big blind $0.1
*** HOLE CARDS ***
Dealt to Hero [Jd 3s]
Dealt to 711a3682 
Dealt to 53c36c1 
Dealt to 2c4553d9 
Dealt to 7ffbbea8 
Hero: folds
711a3682: raises $0.15 to $0.25
53c36c1: folds
2c4553d9: folds
7ffbbea8: folds
Uncalled bet ($0.15) returned to 711a3682
*** SHOWDOWN ***
711a3682 collected $0.25 from pot
*** SUMMARY ***
Total pot $0.25 | Rake $0 | Jackpot $0 | Bingo $0 | Fortune $0 | Tax $0
Seat 1: Hero folded before Flop (didn't bet)
Seat 2: 711a3682 collected ($0.25)
Seat 3: 53c36c1 (button) folded before Flop (didn't bet)
Seat 4: 2c4553d9 (small blind) folded before Flop
Seat 5: 7ffbbea8 (big blind) folded before Flop


Poker Hand #HD1860454593: Hold'em No Limit ($0.05/$0.1) - 2024/07/17 10:42:00
Table 'NLHRed6' 6-max Seat #2 is the button
Seat 1: Hero ($10 in chips)
Seat 2: 711a3682 ($15.24 in chips)
Seat 3: 53c36c1 ($5.05 in chips)
Seat 4: 2c4553d9 ($15.81 in chips)
Seat 5: 7ffbbea8 ($11.92 in chips)
53c36c1: posts small blind $0.05
2c4553d9: posts big blind $0.1
*** HOLE CARDS ***
Dealt to Hero [3h 3d]
Dealt to 711a3682 
Dealt to 53c36c1 
Dealt to 2c4553d9 
Dealt to 7ffbbea8 
7ffbbea8: folds
Hero: folds
711a3682: raises $0.15 to $0.25
53c36c1: folds
2c4553d9: calls $0.15
*** FLOP *** [5d 9c As]
2c4553d9: checks
711a3682: bets $0.28
2c4553d9: calls $0.28
*** TURN *** [5d 9c As] [Th]
2c4553d9: checks
711a3682: checks
*** RIVER *** [5d 9c As Th] [Qc]
2c4553d9: checks
711a3682: checks
2c4553d9: shows [2s Ad] (Pair of Aces)
711a3682: shows [7h Kh] (Ace-High)
*** SHOWDOWN ***
2c4553d9 collected $1.06 from pot
*** SUMMARY ***
Total pot $1.11 | Rake $0.05 | Jackpot $0 | Bingo $0 | Fortune $0 | Tax $0
Board [5d 9c As Th Qc]
Seat 1: Hero folded before Flop (didn't bet)
Seat 2: 711a3682 (button) showed [7h Kh] and lost with Ace-High
Seat 3: 53c36c1 (small blind) folded before Flop
Seat 4: 2c4553d9 (big blind) showed [2s Ad] and won ($1.06) with Pair of Aces
Seat 5: 7ffbbea8 folded before Flop (didn't bet)


Poker Hand #HD1860454567: Hold'em No Limit ($0.05/$0.1) - 2024/07/17 10:41:41
Table 'NLHRed6' 6-max Seat #1 is the button
Seat 1: Hero ($10 in chips)
Seat 2: 711a3682 ($15.29 in chips)
Seat 3: 53c36c1 ($5 in chips)
Seat 4: 2c4553d9 ($15.81 in chips)
Seat 5: 7ffbbea8 ($11.92 in chips)
711a3682: posts small blind $0.05
53c36c1: posts big blind $0.1
*** HOLE CARDS ***
Dealt to Hero [9c 3d]
Dealt to 711a3682 
Dealt to 53c36c1 
Dealt to 2c4553d9 
Dealt to 7ffbbea8 
2c4553d9: folds
7ffbbea8: folds
Hero: folds
711a3682: folds
Uncalled bet ($0.05) returned to 53c36c1
*** SHOWDOWN ***
53c36c1 collected $0.1 from pot
*** SUMMARY ***
Total pot $0.1 | Rake $0 | Jackpot $0 | Bingo $0 | Fortune $0 | Tax $0
Seat 1: Hero (button) folded before Flop (didn't bet)
Seat 2: 711a3682 (small blind) folded before Flop
Seat 3: 53c36c1 (big blind) collected ($0.1)
Seat 4: 2c4553d9 folded before Flop (didn't bet)
Seat 5: 7ffbbea8 folded before Flop (didn't bet)


Poker Hand #HD1860454465: Hold'em No Limit ($0.05/$0.1) - 2024/07/17 10:40:37
Table 'NLHRed6' 6-max Seat #5 is the button
Seat 1: Hero ($10 in chips)
Seat 2: 711a3682 ($10.42 in chips)
Seat 3: 53c36c1 ($5.42 in chips)
Seat 4: 2c4553d9 ($16.01 in chips)
Seat 5: 7ffbbea8 ($11.92 in chips)
Hero: posts small blind $0.05
711a3682: posts big blind $0.1
*** HOLE CARDS ***
Dealt to Hero [Qd Jh]
Dealt to 711a3682 
Dealt to 53c36c1 
Dealt to 2c4553d9 
Dealt to 7ffbbea8 
53c36c1: raises $0.1 to $0.2
2c4553d9: calls $0.2
7ffbbea8: folds
Hero: folds
711a3682: raises $0.96 to $1.16
53c36c1: calls $0.96
2c4553d9: folds
*** FLOP *** [9h 4d 9d]
711a3682: bets $1.29
53c36c1: raises $2.97 to $4.26 and is all-in
711a3682: calls $2.97
53c36c1: shows [8s 8h] (Pair of Nines and Pair of Eights)
711a3682: shows [Qh Qc] (Pair of Queens and Pair of Nines)
*** TURN *** [9h 4d 9d] [As]
711a3682: Chooses to EV Cashout 
*** RIVER *** [9h 4d 9d As] [7h]
711a3682: Pays Cashout Risk ($0.15)
*** SHOWDOWN ***
711a3682 collected $10.44 from pot
*** SUMMARY ***
Total pot $11.09 | Rake $0.55 | Jackpot $0.1 | Bingo $0 | Fortune $0 | Tax $0
Board [9h 4d 9d As 7h]
Seat 1: Hero (small blind) folded before Flop
Seat 2: 711a3682 (big blind) showed [Qh Qc] and won ($10.44) with Pair of Queens and Pair of Nines, Cashout Risk ($0.15)
Seat 3: 53c36c1 showed [8s 8h] and lost with Pair of Nines and Pair of Eights
Seat 4: 2c4553d9 folded before Flop
Seat 5: 7ffbbea8 (button) folded before Flop (didn't bet)


Poker Hand #HD1860454447: Hold'em No Limit ($0.05/$0.1) - 2024/07/17 10:40:23
Table 'NLHRed6' 6-max Seat #4 is the button
Seat 1: Hero ($10 in chips)
Seat 2: 711a3682 ($10.42 in chips)
Seat 3: 53c36c1 ($5.42 in chips)
Seat 4: 2c4553d9 ($15.86 in chips)
Seat 5: 7ffbbea8 ($11.97 in chips)
7ffbbea8: posts small blind $0.05
Hero: posts big blind $0.1
*** HOLE CARDS ***
Dealt to Hero [As 2c]
Dealt to 711a3682 
Dealt to 53c36c1 
Dealt to 2c4553d9 
Dealt to 7ffbbea8 
711a3682: folds
53c36c1: folds
2c4553d9: raises $0.1 to $0.2
7ffbbea8: folds
Hero: folds
Uncalled bet ($0.1) returned to 2c4553d9
*** SHOWDOWN ***
2c4553d9 collected $0.25 from pot
*** SUMMARY ***
Total pot $0.25 | Rake $0 | Jackpot $0 | Bingo $0 | Fortune $0 | Tax $0
Seat 1: Hero (big blind) folded before Flop
Seat 2: 711a3682 folded before Flop (didn't bet)
Seat 3: 53c36c1 folded before Flop (didn't bet)
Seat 4: 2c4553d9 (button) collected ($0.25)
Seat 5: 7ffbbea8 (small blind) folded before Flop


