Poker Hand #HD1746220879: Hold'em No Limit ($0.02/$0.05) - 2024/04/25 17:31:58
Table 'NLHBlue6' 6-max Seat #3 is the button
Seat 1: Hero ($5.82 in chips)
Seat 2: ab8378d ($5.35 in chips)
Seat 3: cf3ee1d9 ($5.48 in chips)
Seat 4: 9d20a3a ($5.23 in chips)
Seat 5: de724118 ($6.36 in chips)
Seat 6: 93756986 ($4.95 in chips)
9d20a3a: posts small blind $0.02
de724118: posts big blind $0.05
*** HOLE CARDS ***
Dealt to Hero [2s Qs]
Dealt to ab8378d 
Dealt to cf3ee1d9 
Dealt to 9d20a3a 
Dealt to de724118 
Dealt to 93756986 
93756986: folds
Hero: folds
ab8378d: folds
cf3ee1d9: raises $0.05 to $0.1
9d20a3a: folds
de724118: calls $0.05
*** FLOP *** [8h 9h Jc]
de724118: checks
cf3ee1d9: bets $0.12
de724118: calls $0.12
*** TURN *** [8h 9h Jc] [9d]
de724118: checks
cf3ee1d9: bets $0.29
de724118: calls $0.29
*** RIVER *** [8h 9h Jc 9d] [3s]
de724118: checks
cf3ee1d9: bets $0.78
de724118: folds
Uncalled bet ($0.78) returned to cf3ee1d9
de724118: shows [8s] (Pair of Nines and Pair of Eights)
*** SHOWDOWN ***
cf3ee1d9 collected $0.99 from pot
*** SUMMARY ***
Total pot $1.04 | Rake $0.05 | Jackpot $0 | Bingo $0 | Fortune $0 | Tax $0
Board [8h 9h Jc 9d 3s]
Seat 1: Hero folded before Flop (didn't bet)
Seat 2: ab8378d folded before Flop (didn't bet)
Seat 3: cf3ee1d9 (button) won ($0.99)
Seat 4: 9d20a3a (small blind) folded before Flop
Seat 5: de724118 (big blind) folded on the River
Seat 6: 93756986 folded before Flop (didn't bet)


Poker Hand #HD1746220710: Hold'em No Limit ($0.02/$0.05) - 2024/04/25 17:30:53
Table 'NLHBlue6' 6-max Seat #2 is the button
Seat 1: Hero ($5.82 in chips)
Seat 2: ab8378d ($5.35 in chips)
Seat 3: cf3ee1d9 ($5.53 in chips)
Seat 4: 9d20a3a ($5.13 in chips)
Seat 5: de724118 ($6.36 in chips)
Seat 6: 93756986 ($5 in chips)
cf3ee1d9: posts small blind $0.02
9d20a3a: posts big blind $0.05
93756986: posts big blind $0.05
*** HOLE CARDS ***
Dealt to Hero [7d Ad]
Dealt to ab8378d 
Dealt to cf3ee1d9 
Dealt to 9d20a3a 
Dealt to de724118 
Dealt to 93756986 
de724118: folds
93756986: checks
Hero: folds
ab8378d: folds
cf3ee1d9: calls $0.03
9d20a3a: checks
*** FLOP *** [Kh 9s 9h]
cf3ee1d9: checks
9d20a3a: checks
93756986: checks
*** TURN *** [Kh 9s 9h] [5c]
cf3ee1d9: checks
9d20a3a: checks
93756986: checks
*** RIVER *** [Kh 9s 9h 5c] [Ac]
cf3ee1d9: checks
9d20a3a: checks
93756986: checks
cf3ee1d9: shows [Jh 7c] (Pair of Nines)
9d20a3a: shows [2d As] (Pair of Aces and Pair of Nines)
93756986: shows [2s 4s] (Pair of Nines)
*** SHOWDOWN ***
9d20a3a collected $0.15 from pot
*** SUMMARY ***
Total pot $0.15 | Rake $0 | Jackpot $0 | Bingo $0 | Fortune $0 | Tax $0
Board [Kh 9s 9h 5c Ac]
Seat 1: Hero folded before Flop (didn't bet)
Seat 2: ab8378d (button) folded before Flop (didn't bet)
Seat 3: cf3ee1d9 (small blind) showed [Jh 7c] and lost with Pair of Nines
Seat 4: 9d20a3a (big blind) showed [2d As] and won ($0.15) with Pair of Aces and Pair of Nines
Seat 5: de724118 folded before Flop (didn't bet)
Seat 6: 93756986 showed [2s 4s] and lost with Pair of Nines


Poker Hand #HD1746220554: Hold'em No Limit ($0.02/$0.05) - 2024/04/25 17:29:47
Table 'NLHBlue6' 6-max Seat #1 is the button
Seat 1: Hero ($7.3 in chips)
Seat 2: ab8378d ($5.37 in chips)
Seat 3: cf3ee1d9 ($5.58 in chips)
Seat 4: 9d20a3a ($5.13 in chips)
Seat 5: de724118 ($5 in chips)
ab8378d: posts small blind $0.02
cf3ee1d9: posts big blind $0.05
de724118: posts big blind $0.05
*** HOLE CARDS ***
Dealt to Hero [Kh Jh]
Dealt to ab8378d 
Dealt to cf3ee1d9 
Dealt to 9d20a3a 
Dealt to de724118 
9d20a3a: folds
de724118: checks
Hero: raises $0.15 to $0.2
ab8378d: folds
cf3ee1d9: folds
de724118: calls $0.15
*** FLOP *** [Th 5h Td]
de724118: checks
Hero: bets $0.26
de724118: raises $0.26 to $0.52
Hero: calls $0.26
*** TURN *** [Th 5h Td] [Qs]
de724118: bets $0.76
Hero: calls $0.76
*** RIVER *** [Th 5h Td Qs] [Qh]
de724118: bets $3.03
Hero: folds
Uncalled bet ($3.03) returned to de724118
Hero: shows [Kh Jh] (King High Flush)
*** SHOWDOWN ***
de724118 collected $2.84 from pot
*** SUMMARY ***
Total pot $3.03 | Rake $0.14 | Jackpot $0.05 | Bingo $0 | Fortune $0 | Tax $0
Board [Th 5h Td Qs Qh]
Seat 1: Hero (button) folded on the River
Seat 2: ab8378d (small blind) folded before Flop
Seat 3: cf3ee1d9 (big blind) folded before Flop
Seat 4: 9d20a3a folded before Flop (didn't bet)
Seat 5: de724118 won ($2.84)


Poker Hand #HD1746220431: Hold'em No Limit ($0.02/$0.05) - 2024/04/25 17:29:04
Table 'NLHBlue6' 6-max Seat #4 is the button
Seat 1: Hero ($7.45 in chips)
Seat 2: ab8378d ($5.37 in chips)
Seat 3: cf3ee1d9 ($5.58 in chips)
Seat 4: 9d20a3a ($5.13 in chips)
Seat 6: 4dc68a34 ($1.1 in chips)
4dc68a34: posts small blind $0.02
Hero: posts big blind $0.05
*** HOLE CARDS ***
Dealt to Hero [2d 3h]
Dealt to ab8378d 
Dealt to cf3ee1d9 
Dealt to 9d20a3a 
Dealt to 4dc68a34 
ab8378d: folds
cf3ee1d9: folds
9d20a3a: folds
4dc68a34: calls $0.03
Hero: checks
*** FLOP *** [Qc 3d Qs]
4dc68a34: checks
Hero: checks
*** TURN *** [Qc 3d Qs] [Kd]
4dc68a34: bets $0.1
Hero: calls $0.1
*** RIVER *** [Qc 3d Qs Kd] [5s]
4dc68a34: bets $0.15
Hero: folds
Uncalled bet ($0.15) returned to 4dc68a34
*** SHOWDOWN ***
4dc68a34 collected $0.29 from pot
*** SUMMARY ***
Total pot $0.3 | Rake $0.01 | Jackpot $0 | Bingo $0 | Fortune $0 | Tax $0
Board [Qc 3d Qs Kd 5s]
Seat 1: Hero (big blind) folded on the River
Seat 2: ab8378d folded before Flop (didn't bet)
Seat 3: cf3ee1d9 folded before Flop (didn't bet)
Seat 4: 9d20a3a (button) folded before Flop (didn't bet)
Seat 6: 4dc68a34 (small blind) won ($0.29)


Poker Hand #HD1746220235: Hold'em No Limit ($0.02/$0.05) - 2024/04/25 17:27:44
Table 'NLHBlue6' 6-max Seat #3 is the button
Seat 1: Hero ($7.45 in chips)
Seat 2: ab8378d ($5.07 in chips)
Seat 3: cf3ee1d9 ($5.58 in chips)
Seat 4: 9d20a3a ($5.15 in chips)
Seat 6: 4dc68a34 ($1.16 in chips)
9d20a3a: posts small blind $0.02
4dc68a34: posts big blind $0.05
*** HOLE CARDS ***
Dealt to Hero [5s 6d]
Dealt to ab8378d 
Dealt to cf3ee1d9 
Dealt to 9d20a3a 
Dealt to 4dc68a34 
Hero: folds
ab8378d: raises $0.05 to $0.1
cf3ee1d9: folds
9d20a3a: folds
4dc68a34: raises $0.08 to $0.18
ab8378d: raises $0.38 to $0.56
4dc68a34: calls $0.38
*** FLOP *** [7h 7d 5c]
4dc68a34: bets $0.6 and is all-in
ab8378d: calls $0.6
4dc68a34: shows [8c Ac] (Pair of Sevens)
ab8378d: shows [9c As] (Pair of Sevens)
*** TURN *** [7h 7d 5c] [Js]
*** RIVER *** [7h 7d 5c Js] [5d]
ab8378d: Receives Cashout ($0.37)
*** SHOWDOWN ***
4dc68a34 collected $1.1 from pot
ab8378d collected $1.09 from pot
*** SUMMARY ***
Total pot $2.34 | Rake $0.1 | Jackpot $0.05 | Bingo $0 | Fortune $0 | Tax $0
Board [7h 7d 5c Js 5d]
Seat 1: Hero folded before Flop (didn't bet)
Seat 2: ab8378d showed [9c As] and won ($0) with Pair of Sevens and Pair of Fives, EV Cashout ($1.46)
Seat 3: cf3ee1d9 (button) folded before Flop (didn't bet)
Seat 4: 9d20a3a (small blind) folded before Flop
Seat 6: 4dc68a34 (big blind) showed [8c Ac] and won ($1.1) with Pair of Sevens and Pair of Fives


Poker Hand #HD1746220033: Hold'em No Limit ($0.02/$0.05) - 2024/04/25 17:26:28
Table 'NLHBlue6' 6-max Seat #2 is the button
Seat 1: Hero ($7.45 in chips)
Seat 2: ab8378d ($5.37 in chips)
Seat 3: cf3ee1d9 ($5.6 in chips)
Seat 4: 9d20a3a ($4.86 in chips)
Seat 5: 205291 ($12.39 in chips)
Seat 6: 4dc68a34 ($1.16 in chips)
cf3ee1d9: posts small blind $0.02
9d20a3a: posts big blind $0.05
*** HOLE CARDS ***
Dealt to Hero [8d 3c]
Dealt to ab8378d 
Dealt to cf3ee1d9 
Dealt to 9d20a3a 
Dealt to 205291 
Dealt to 4dc68a34 
205291: folds
4dc68a34: folds
Hero: folds
ab8378d: raises $0.05 to $0.1
cf3ee1d9: folds
9d20a3a: calls $0.05
*** FLOP *** [5c 5h 2s]
9d20a3a: checks
ab8378d: bets $0.05
9d20a3a: raises $0.15 to $0.2
ab8378d: calls $0.15
*** TURN *** [5c 5h 2s] [Th]
9d20a3a: bets $0.57
ab8378d: folds
Uncalled bet ($0.57) returned to 9d20a3a
*** SHOWDOWN ***
9d20a3a collected $0.59 from pot
*** SUMMARY ***
Total pot $0.62 | Rake $0.03 | Jackpot $0 | Bingo $0 | Fortune $0 | Tax $0
Board [5c 5h 2s Th]
Seat 1: Hero folded before Flop (didn't bet)
Seat 2: ab8378d (button) folded on the Turn
Seat 3: cf3ee1d9 (small blind) folded before Flop
Seat 4: 9d20a3a (big blind) won ($0.59)
Seat 5: 205291 folded before Flop (didn't bet)
Seat 6: 4dc68a34 folded before Flop (didn't bet)


Poker Hand #HD1746219931: Hold'em No Limit ($0.02/$0.05) - 2024/04/25 17:25:55
Table 'NLHBlue6' 6-max Seat #1 is the button
Seat 1: Hero ($7.45 in chips)
Seat 2: ab8378d ($5.32 in chips)
Seat 3: cf3ee1d9 ($5.65 in chips)
Seat 4: 9d20a3a ($4.86 in chips)
Seat 5: 205291 ($12.39 in chips)
Seat 6: 4dc68a34 ($1.16 in chips)
ab8378d: posts small blind $0.02
cf3ee1d9: posts big blind $0.05
*** HOLE CARDS ***
Dealt to Hero [6d Kc]
Dealt to ab8378d 
Dealt to cf3ee1d9 
Dealt to 9d20a3a 
Dealt to 205291 
Dealt to 4dc68a34 
9d20a3a: folds
205291: folds
4dc68a34: folds
Hero: folds
ab8378d: calls $0.03
cf3ee1d9: checks
*** FLOP *** [6c 9h 9s]
ab8378d: bets $0.05
cf3ee1d9: folds
Uncalled bet ($0.05) returned to ab8378d
*** SHOWDOWN ***
ab8378d collected $0.1 from pot
*** SUMMARY ***
Total pot $0.1 | Rake $0 | Jackpot $0 | Bingo $0 | Fortune $0 | Tax $0
Board [6c 9h 9s]
Seat 1: Hero (button) folded before Flop (didn't bet)
Seat 2: ab8378d (small blind) won ($0.1)
Seat 3: cf3ee1d9 (big blind) folded on the Flop
Seat 4: 9d20a3a folded before Flop (didn't bet)
Seat 5: 205291 folded before Flop (didn't bet)
Seat 6: 4dc68a34 folded before Flop (didn't bet)


Poker Hand #HD1746219887: Hold'em No Limit ($0.02/$0.05) - 2024/04/25 17:25:38
Table 'NLHBlue6' 6-max Seat #6 is the button
Seat 1: Hero ($7.47 in chips)
Seat 2: ab8378d ($5.37 in chips)
Seat 3: cf3ee1d9 ($5.65 in chips)
Seat 4: 9d20a3a ($4.86 in chips)
Seat 5: 205291 ($12.32 in chips)
Seat 6: 4dc68a34 ($1.16 in chips)
Hero: posts small blind $0.02
ab8378d: posts big blind $0.05
*** HOLE CARDS ***
Dealt to Hero [Ah 2d]
Dealt to ab8378d 
Dealt to cf3ee1d9 
Dealt to 9d20a3a 
Dealt to 205291 
Dealt to 4dc68a34 
cf3ee1d9: folds
9d20a3a: folds
205291: raises $0.08 to $0.13
4dc68a34: folds
Hero: folds
ab8378d: folds
Uncalled bet ($0.08) returned to 205291
*** SHOWDOWN ***
205291 collected $0.12 from pot
*** SUMMARY ***
Total pot $0.12 | Rake $0 | Jackpot $0 | Bingo $0 | Fortune $0 | Tax $0
Seat 1: Hero (small blind) folded before Flop
Seat 2: ab8378d (big blind) folded before Flop
Seat 3: cf3ee1d9 folded before Flop (didn't bet)
Seat 4: 9d20a3a folded before Flop (didn't bet)
Seat 5: 205291 collected ($0.12)
Seat 6: 4dc68a34 (button) folded before Flop (didn't bet)


Poker Hand #HD1746219844: Hold'em No Limit ($0.02/$0.05) - 2024/04/25 17:25:20
Table 'NLHBlue6' 6-max Seat #5 is the button
Seat 1: Hero ($7.52 in chips)
Seat 2: ab8378d ($5.37 in chips)
Seat 3: cf3ee1d9 ($5.58 in chips)
Seat 4: 9d20a3a ($4.86 in chips)
Seat 5: 205291 ($12.32 in chips)
Seat 6: 4dc68a34 ($1.18 in chips)
4dc68a34: posts small blind $0.02
Hero: posts big blind $0.05
*** HOLE CARDS ***
Dealt to Hero [3h 9c]
Dealt to ab8378d 
Dealt to cf3ee1d9 
Dealt to 9d20a3a 
Dealt to 205291 
Dealt to 4dc68a34 
ab8378d: folds
cf3ee1d9: raises $0.05 to $0.1
9d20a3a: folds
205291: folds
4dc68a34: folds
Hero: folds
Uncalled bet ($0.05) returned to cf3ee1d9
*** SHOWDOWN ***
cf3ee1d9 collected $0.12 from pot
*** SUMMARY ***
Total pot $0.12 | Rake $0 | Jackpot $0 | Bingo $0 | Fortune $0 | Tax $0
Seat 1: Hero (big blind) folded before Flop
Seat 2: ab8378d folded before Flop (didn't bet)
Seat 3: cf3ee1d9 collected ($0.12)
Seat 4: 9d20a3a folded before Flop (didn't bet)
Seat 5: 205291 (button) folded before Flop (didn't bet)
Seat 6: 4dc68a34 (small blind) folded before Flop


Poker Hand #HD1746219764: Hold'em No Limit ($0.02/$0.05) - 2024/04/25 17:24:49
Table 'NLHBlue6' 6-max Seat #4 is the button
Seat 1: Hero ($7.52 in chips)
Seat 2: ab8378d ($5.37 in chips)
Seat 3: cf3ee1d9 ($5.58 in chips)
Seat 4: 9d20a3a ($4.86 in chips)
Seat 5: 205291 ($12.27 in chips)
Seat 6: 4dc68a34 ($1.23 in chips)
205291: posts small blind $0.02
4dc68a34: posts big blind $0.05
*** HOLE CARDS ***
Dealt to Hero [7d Tc]
Dealt to ab8378d 
Dealt to cf3ee1d9 
Dealt to 9d20a3a 
Dealt to 205291 
Dealt to 4dc68a34 
Hero: folds
ab8378d: folds
cf3ee1d9: folds
9d20a3a: folds
205291: raises $0.1 to $0.15
4dc68a34: folds
Uncalled bet ($0.1) returned to 205291
*** SHOWDOWN ***
205291 collected $0.1 from pot
*** SUMMARY ***
Total pot $0.1 | Rake $0 | Jackpot $0 | Bingo $0 | Fortune $0 | Tax $0
Seat 1: Hero folded before Flop (didn't bet)
Seat 2: ab8378d folded before Flop (didn't bet)
Seat 3: cf3ee1d9 folded before Flop (didn't bet)
Seat 4: 9d20a3a (button) folded before Flop (didn't bet)
Seat 5: 205291 (small blind) collected ($0.1)
Seat 6: 4dc68a34 (big blind) folded before Flop


Poker Hand #HD1746219589: Hold'em No Limit ($0.02/$0.05) - 2024/04/25 17:23:45
Table 'NLHBlue6' 6-max Seat #3 is the button
Seat 1: Hero ($7.52 in chips)
Seat 2: ab8378d ($5.37 in chips)
Seat 3: cf3ee1d9 ($5.58 in chips)
Seat 4: 9d20a3a ($4.88 in chips)
Seat 5: 205291 ($12.42 in chips)
Seat 6: 4dc68a34 ($1.07 in chips)
9d20a3a: posts small blind $0.02
205291: posts big blind $0.05
*** HOLE CARDS ***
Dealt to Hero [Ac 5s]
Dealt to ab8378d 
Dealt to cf3ee1d9 
Dealt to 9d20a3a 
Dealt to 205291 
Dealt to 4dc68a34 
4dc68a34: raises $0.1 to $0.15
Hero: folds
ab8378d: folds
cf3ee1d9: folds
9d20a3a: folds
205291: calls $0.1
*** FLOP *** [5h 6d Ks]
205291: checks
4dc68a34: bets $0.16
205291: folds
Uncalled bet ($0.16) returned to 4dc68a34
*** SHOWDOWN ***
4dc68a34 collected $0.31 from pot
*** SUMMARY ***
Total pot $0.32 | Rake $0.01 | Jackpot $0 | Bingo $0 | Fortune $0 | Tax $0
Board [5h 6d Ks]
Seat 1: Hero folded before Flop (didn't bet)
Seat 2: ab8378d folded before Flop (didn't bet)
Seat 3: cf3ee1d9 (button) folded before Flop (didn't bet)
Seat 4: 9d20a3a (small blind) folded before Flop
Seat 5: 205291 (big blind) folded on the Flop
Seat 6: 4dc68a34 won ($0.31)


Poker Hand #HD1746219537: Hold'em No Limit ($0.02/$0.05) - 2024/04/25 17:23:26
Table 'NLHBlue6' 6-max Seat #2 is the button
Seat 1: Hero ($7.52 in chips)
Seat 2: ab8378d ($5.37 in chips)
Seat 3: cf3ee1d9 ($5.53 in chips)
Seat 4: 9d20a3a ($4.93 in chips)
Seat 5: 205291 ($12.42 in chips)
Seat 6: 4dc68a34 ($1.07 in chips)
cf3ee1d9: posts small blind $0.02
9d20a3a: posts big blind $0.05
*** HOLE CARDS ***
Dealt to Hero [3s Ts]
Dealt to ab8378d 
Dealt to cf3ee1d9 
Dealt to 9d20a3a 
Dealt to 205291 
Dealt to 4dc68a34 
205291: folds
4dc68a34: folds
Hero: folds
ab8378d: folds
cf3ee1d9: raises $0.05 to $0.1
9d20a3a: folds
Uncalled bet ($0.05) returned to cf3ee1d9
*** SHOWDOWN ***
cf3ee1d9 collected $0.1 from pot
*** SUMMARY ***
Total pot $0.1 | Rake $0 | Jackpot $0 | Bingo $0 | Fortune $0 | Tax $0
Seat 1: Hero folded before Flop (didn't bet)
Seat 2: ab8378d (button) folded before Flop (didn't bet)
Seat 3: cf3ee1d9 (small blind) collected ($0.1)
Seat 4: 9d20a3a (big blind) folded before Flop
Seat 5: 205291 folded before Flop (didn't bet)
Seat 6: 4dc68a34 folded before Flop (didn't bet)


Poker Hand #HD1746219464: Hold'em No Limit ($0.02/$0.05) - 2024/04/25 17:22:58
Table 'NLHBlue6' 6-max Seat #1 is the button
Seat 1: Hero ($7.52 in chips)
Seat 2: ab8378d ($5.39 in chips)
Seat 3: cf3ee1d9 ($5.58 in chips)
Seat 4: 9d20a3a ($4.93 in chips)
Seat 5: 205291 ($12.42 in chips)
Seat 6: 4dc68a34 ($1 in chips)
ab8378d: posts small blind $0.02
cf3ee1d9: posts big blind $0.05
4dc68a34: posts big blind $0.05
*** HOLE CARDS ***
Dealt to Hero [Ad 2h]
Dealt to ab8378d 
Dealt to cf3ee1d9 
Dealt to 9d20a3a 
Dealt to 205291 
Dealt to 4dc68a34 
9d20a3a: folds
205291: folds
4dc68a34: checks
Hero: folds
ab8378d: folds
cf3ee1d9: checks
*** FLOP *** [Kc 9s 4s]
cf3ee1d9: checks
4dc68a34: bets $0.12
cf3ee1d9: folds
Uncalled bet ($0.12) returned to 4dc68a34
*** SHOWDOWN ***
4dc68a34 collected $0.12 from pot
*** SUMMARY ***
Total pot $0.12 | Rake $0 | Jackpot $0 | Bingo $0 | Fortune $0 | Tax $0
Board [Kc 9s 4s]
Seat 1: Hero (button) folded before Flop (didn't bet)
Seat 2: ab8378d (small blind) folded before Flop
Seat 3: cf3ee1d9 (big blind) folded on the Flop
Seat 4: 9d20a3a folded before Flop (didn't bet)
Seat 5: 205291 folded before Flop (didn't bet)
Seat 6: 4dc68a34 won ($0.12)


Poker Hand #HD1746219420: Hold'em No Limit ($0.02/$0.05) - 2024/04/25 17:22:39
Table 'NLHBlue6' 6-max Seat #5 is the button
Seat 1: Hero ($7.54 in chips)
Seat 2: ab8378d ($5.44 in chips)
Seat 3: cf3ee1d9 ($5.68 in chips)
Seat 4: 9d20a3a ($4.93 in chips)
Seat 5: 205291 ($12.26 in chips)
Hero: posts small blind $0.02
ab8378d: posts big blind $0.05
*** HOLE CARDS ***
Dealt to Hero [4s 4c]
Dealt to ab8378d 
Dealt to cf3ee1d9 
Dealt to 9d20a3a 
Dealt to 205291 
cf3ee1d9: raises $0.05 to $0.1
9d20a3a: folds
205291: raises $0.21 to $0.31
Hero: folds
ab8378d: folds
cf3ee1d9: folds
Uncalled bet ($0.21) returned to 205291
*** SHOWDOWN ***
205291 collected $0.26 from pot
*** SUMMARY ***
Total pot $0.27 | Rake $0.01 | Jackpot $0 | Bingo $0 | Fortune $0 | Tax $0
Seat 1: Hero (small blind) folded before Flop
Seat 2: ab8378d (big blind) folded before Flop
Seat 3: cf3ee1d9 folded before Flop
Seat 4: 9d20a3a folded before Flop (didn't bet)
Seat 5: 205291 (button) collected ($0.26)


Poker Hand #HD1746219199: Hold'em No Limit ($0.02/$0.05) - 2024/04/25 17:21:15
Table 'NLHBlue6' 6-max Seat #4 is the button
Seat 1: Hero ($7.54 in chips)
Seat 2: ab8378d ($5 in chips)
Seat 3: cf3ee1d9 ($5.68 in chips)
Seat 4: 9d20a3a ($4.93 in chips)
Seat 5: 205291 ($12.69 in chips)
Seat 6: 2e4217d7 ($7.31 in chips)
205291: posts small blind $0.02
2e4217d7: posts big blind $0.05
*** HOLE CARDS ***
Dealt to Hero [3h Ac]
Dealt to ab8378d 
Dealt to cf3ee1d9 
Dealt to 9d20a3a 
Dealt to 205291 
Dealt to 2e4217d7 
Hero: folds
ab8378d: raises $0.05 to $0.1
cf3ee1d9: folds
9d20a3a: folds
205291: calls $0.08
2e4217d7: folds
*** FLOP *** [4d 7h Th]
205291: checks
ab8378d: bets $0.11
205291: calls $0.11
*** TURN *** [4d 7h Th] [5h]
205291: checks
ab8378d: bets $0.15
205291: calls $0.15
*** RIVER *** [4d 7h Th 5h] [6h]
205291: checks
ab8378d: bets $0.07
205291: calls $0.07
ab8378d: shows [Kh Td] (King High Flush)
205291: shows [9c Tc] (Pair of Tens)
*** SHOWDOWN ***
ab8378d collected $0.87 from pot
*** SUMMARY ***
Total pot $0.91 | Rake $0.04 | Jackpot $0 | Bingo $0 | Fortune $0 | Tax $0
Board [4d 7h Th 5h 6h]
Seat 1: Hero folded before Flop (didn't bet)
Seat 2: ab8378d showed [Kh Td] and won ($0.87) with King High Flush
Seat 3: cf3ee1d9 folded before Flop (didn't bet)
Seat 4: 9d20a3a (button) folded before Flop (didn't bet)
Seat 5: 205291 (small blind) showed [9c Tc] and lost with Pair of Tens
Seat 6: 2e4217d7 (big blind) folded before Flop


Poker Hand #HD1746219145: Hold'em No Limit ($0.02/$0.05) - 2024/04/25 17:20:53
Table 'NLHBlue6' 6-max Seat #3 is the button
Seat 1: Hero ($7.54 in chips)
Seat 2: ab8378d ($5 in chips)
Seat 3: cf3ee1d9 ($5.68 in chips)
Seat 4: 9d20a3a ($4.95 in chips)
Seat 5: 205291 ($12.74 in chips)
Seat 6: 2e4217d7 ($7.24 in chips)
9d20a3a: posts small blind $0.02
205291: posts big blind $0.05
*** HOLE CARDS ***
Dealt to Hero [2d 7s]
Dealt to ab8378d 
Dealt to cf3ee1d9 
Dealt to 9d20a3a 
Dealt to 205291 
Dealt to 2e4217d7 
2e4217d7: raises $0.09 to $0.14
Hero: folds
ab8378d: folds
cf3ee1d9: folds
9d20a3a: folds
205291: folds
Uncalled bet ($0.09) returned to 2e4217d7
*** SHOWDOWN ***
2e4217d7 collected $0.12 from pot
*** SUMMARY ***
Total pot $0.12 | Rake $0 | Jackpot $0 | Bingo $0 | Fortune $0 | Tax $0
Seat 1: Hero folded before Flop (didn't bet)
Seat 2: ab8378d folded before Flop (didn't bet)
Seat 3: cf3ee1d9 (button) folded before Flop (didn't bet)
Seat 4: 9d20a3a (small blind) folded before Flop
Seat 5: 205291 (big blind) folded before Flop
Seat 6: 2e4217d7 collected ($0.12)


Poker Hand #HD1746218891: Hold'em No Limit ($0.02/$0.05) - 2024/04/25 17:19:06
Table 'NLHBlue6' 6-max Seat #2 is the button
Seat 1: Hero ($7.54 in chips)
Seat 2: ab8378d ($5.17 in chips)
Seat 3: cf3ee1d9 ($5.7 in chips)
Seat 4: 9d20a3a ($5 in chips)
Seat 5: 205291 ($6.47 in chips)
Seat 6: 2e4217d7 ($13.71 in chips)
cf3ee1d9: posts small blind $0.02
9d20a3a: posts big blind $0.05
*** HOLE CARDS ***
Dealt to Hero [Js 8h]
Dealt to ab8378d 
Dealt to cf3ee1d9 
Dealt to 9d20a3a 
Dealt to 205291 
Dealt to 2e4217d7 
205291: raises $0.05 to $0.1
2e4217d7: raises $0.18 to $0.28
Hero: folds
ab8378d: calls $0.28
cf3ee1d9: folds
9d20a3a: folds
205291: calls $0.18
*** FLOP *** [Qc 8c 3h]
205291: checks
2e4217d7: bets $0.61
ab8378d: folds
205291: calls $0.61
*** TURN *** [Qc 8c 3h] [Qh]
205291: checks
2e4217d7: bets $1.41
205291: calls $1.41
*** RIVER *** [Qc 8c 3h Qh] [Kh]
205291: checks
2e4217d7: bets $4.95
205291: calls $4.17 and is all-in
Uncalled bet ($0.78) returned to 2e4217d7
2e4217d7: shows [Qd Td] (Three Queens)
205291: shows [Ks Qs] (Queens Full over Kings)
*** SHOWDOWN ***
205291 collected $12.74 from pot
*** SUMMARY ***
Total pot $13.29 | Rake $0.5 | Jackpot $0.05 | Bingo $0 | Fortune $0 | Tax $0
Board [Qc 8c 3h Qh Kh]
Seat 1: Hero folded before Flop (didn't bet)
Seat 2: ab8378d (button) folded on the Flop
Seat 3: cf3ee1d9 (small blind) folded before Flop
Seat 4: 9d20a3a (big blind) folded before Flop
Seat 5: 205291 showed [Ks Qs] and won ($12.74) with Queens Full over Kings
Seat 6: 2e4217d7 showed [Qd Td] and lost with Three Queens


Poker Hand #HD1746218793: Hold'em No Limit ($0.02/$0.05) - 2024/04/25 17:18:26
Table 'NLHBlue6' 6-max Seat #1 is the button
Seat 1: Hero ($7.54 in chips)
Seat 2: ab8378d ($5.02 in chips)
Seat 3: cf3ee1d9 ($5.86 in chips)
Seat 5: 205291 ($6.47 in chips)
Seat 6: 2e4217d7 ($13.71 in chips)
ab8378d: posts small blind $0.02
cf3ee1d9: posts big blind $0.05
*** HOLE CARDS ***
Dealt to Hero [8s Ah]
Dealt to ab8378d 
Dealt to cf3ee1d9 
Dealt to 205291 
Dealt to 2e4217d7 
205291: folds
2e4217d7: folds
Hero: folds
ab8378d: raises $0.11 to $0.16
cf3ee1d9: calls $0.11
*** FLOP *** [2d Kc Ad]
ab8378d: bets $0.19
cf3ee1d9: folds
Uncalled bet ($0.19) returned to ab8378d
*** SHOWDOWN ***
ab8378d collected $0.31 from pot
*** SUMMARY ***
Total pot $0.32 | Rake $0.01 | Jackpot $0 | Bingo $0 | Fortune $0 | Tax $0
Board [2d Kc Ad]
Seat 1: Hero (button) folded before Flop (didn't bet)
Seat 2: ab8378d (small blind) won ($0.31)
Seat 3: cf3ee1d9 (big blind) folded on the Flop
Seat 5: 205291 folded before Flop (didn't bet)
Seat 6: 2e4217d7 folded before Flop (didn't bet)


Poker Hand #HD1746218762: Hold'em No Limit ($0.02/$0.05) - 2024/04/25 17:18:16
Table 'NLHBlue6' 6-max Seat #6 is the button
Seat 1: Hero ($7.56 in chips)
Seat 2: ab8378d ($5 in chips)
Seat 3: cf3ee1d9 ($5.86 in chips)
Seat 6: 2e4217d7 ($13.71 in chips)
Hero: posts small blind $0.02
ab8378d: posts big blind $0.05
*** HOLE CARDS ***
Dealt to Hero [Kc 2h]
Dealt to ab8378d 
Dealt to cf3ee1d9 
Dealt to 2e4217d7 
cf3ee1d9: folds
2e4217d7: folds
Hero: folds
Uncalled bet ($0.03) returned to ab8378d
*** SHOWDOWN ***
ab8378d collected $0.04 from pot
*** SUMMARY ***
Total pot $0.04 | Rake $0 | Jackpot $0 | Bingo $0 | Fortune $0 | Tax $0
Seat 1: Hero (small blind) folded before Flop
Seat 2: ab8378d (big blind) collected ($0.04)
Seat 3: cf3ee1d9 folded before Flop (didn't bet)
Seat 6: 2e4217d7 (button) folded before Flop (didn't bet)


Poker Hand #HD1746218679: Hold'em No Limit ($0.02/$0.05) - 2024/04/25 17:17:43
Table 'NLHBlue6' 6-max Seat #5 is the button
Seat 1: Hero ($7.45 in chips)
Seat 2: ab8378d ($5 in chips)
Seat 3: cf3ee1d9 ($5.86 in chips)
Seat 5: 205291 ($6.47 in chips)
Seat 6: 2e4217d7 ($13.73 in chips)
2e4217d7: posts small blind $0.02
Hero: posts big blind $0.05
*** HOLE CARDS ***
Dealt to Hero [As Kh]
Dealt to ab8378d 
Dealt to cf3ee1d9 
Dealt to 205291 
Dealt to 2e4217d7 
ab8378d: raises $0.05 to $0.1
cf3ee1d9: folds
205291: folds
2e4217d7: folds
Hero: raises $0.35 to $0.45
ab8378d: folds
Uncalled bet ($0.35) returned to Hero
*** SHOWDOWN ***
Hero collected $0.21 from pot
*** SUMMARY ***
Total pot $0.22 | Rake $0.01 | Jackpot $0 | Bingo $0 | Fortune $0 | Tax $0
Seat 1: Hero (big blind) collected ($0.21)
Seat 2: ab8378d folded before Flop
Seat 3: cf3ee1d9 folded before Flop (didn't bet)
Seat 5: 205291 (button) folded before Flop (didn't bet)
Seat 6: 2e4217d7 (small blind) folded before Flop


Poker Hand #HD1746218556: Hold'em No Limit ($0.02/$0.05) - 2024/04/25 17:16:55
Table 'NLHBlue6' 6-max Seat #3 is the button
Seat 1: Hero ($7.45 in chips)
Seat 2: ab8378d ($5.02 in chips)
Seat 3: cf3ee1d9 ($5.86 in chips)
Seat 5: 205291 ($6.49 in chips)
Seat 6: 2e4217d7 ($13.17 in chips)
205291: posts small blind $0.02
2e4217d7: posts big blind $0.05
ab8378d: posts big blind $0.05
ab8378d: posts missed blind $0.02
*** HOLE CARDS ***
Dealt to Hero [9s 2c]
Dealt to ab8378d 
Dealt to cf3ee1d9 
Dealt to 205291 
Dealt to 2e4217d7 
Hero: folds
ab8378d: raises $0.05 to $0.1
cf3ee1d9: folds
205291: folds
2e4217d7: raises $0.24 to $0.34
ab8378d: calls $0.24
*** FLOP *** [8s Js 9c]
2e4217d7: bets $0.24
ab8378d: calls $0.24
*** TURN *** [8s Js 9c] [Td]
2e4217d7: bets $0.8
ab8378d: folds
Uncalled bet ($0.8) returned to 2e4217d7
*** SHOWDOWN ***
2e4217d7 collected $1.14 from pot
*** SUMMARY ***
Total pot $1.2 | Rake $0.06 | Jackpot $0 | Bingo $0 | Fortune $0 | Tax $0
Board [8s Js 9c Td]
Seat 1: Hero folded before Flop (didn't bet)
Seat 2: ab8378d folded on the Turn
Seat 3: cf3ee1d9 (button) folded before Flop (didn't bet)
Seat 5: 205291 (small blind) folded before Flop
Seat 6: 2e4217d7 (big blind) won ($1.14)


Poker Hand #HD1746218430: Hold'em No Limit ($0.02/$0.05) - 2024/04/25 17:16:06
Table 'NLHBlue6' 6-max Seat #1 is the button
Seat 1: Hero ($7.45 in chips)
Seat 3: cf3ee1d9 ($5 in chips)
Seat 4: c7ad7fe8 ($1 in chips)
Seat 5: 205291 ($6.49 in chips)
Seat 6: 2e4217d7 ($13.17 in chips)
cf3ee1d9: posts small blind $0.02
c7ad7fe8: posts big blind $0.05
*** HOLE CARDS ***
Dealt to Hero [5d 2c]
Dealt to cf3ee1d9 
Dealt to c7ad7fe8 
Dealt to 205291 
Dealt to 2e4217d7 
205291: folds
2e4217d7: folds
Hero: folds
cf3ee1d9: raises $0.05 to $0.1
c7ad7fe8: calls $0.05
*** FLOP *** [Qd 6d 8h]
cf3ee1d9: bets $0.11
c7ad7fe8: raises $0.79 to $0.9 and is all-in
cf3ee1d9: calls $0.79
c7ad7fe8: shows [5c 7h] (Queen-High)
cf3ee1d9: shows [Ad 8d] (Pair of Eights)
*** TURN *** [Qd 6d 8h] [Kd]
*** RIVER *** [Qd 6d 8h Kd] [5h]
*** SHOWDOWN ***
cf3ee1d9 collected $1.86 from pot
*** SUMMARY ***
Total pot $2 | Rake $0.09 | Jackpot $0.05 | Bingo $0 | Fortune $0 | Tax $0
Board [Qd 6d 8h Kd 5h]
Seat 1: Hero (button) folded before Flop (didn't bet)
Seat 3: cf3ee1d9 (small blind) showed [Ad 8d] and won ($1.86) with Ace High Flush
Seat 4: c7ad7fe8 (big blind) showed [5c 7h] and lost with Pair of Fives
Seat 5: 205291 folded before Flop (didn't bet)
Seat 6: 2e4217d7 folded before Flop (didn't bet)


Poker Hand #HD1746218387: Hold'em No Limit ($0.02/$0.05) - 2024/04/25 17:15:52
Table 'NLHBlue6' 6-max Seat #6 is the button
Seat 1: Hero ($7.47 in chips)
Seat 3: cf3ee1d9 ($5 in chips)
Seat 5: 205291 ($6.49 in chips)
Seat 6: 2e4217d7 ($13.1 in chips)
Hero: posts small blind $0.02
cf3ee1d9: posts big blind $0.05
*** HOLE CARDS ***
Dealt to Hero [Tc 5s]
Dealt to cf3ee1d9 
Dealt to 205291 
Dealt to 2e4217d7 
205291: folds
2e4217d7: raises $0.09 to $0.14
Hero: folds
cf3ee1d9: folds
Uncalled bet ($0.09) returned to 2e4217d7
*** SHOWDOWN ***
2e4217d7 collected $0.12 from pot
*** SUMMARY ***
Total pot $0.12 | Rake $0 | Jackpot $0 | Bingo $0 | Fortune $0 | Tax $0
Seat 1: Hero (small blind) folded before Flop
Seat 3: cf3ee1d9 (big blind) folded before Flop
Seat 5: 205291 folded before Flop (didn't bet)
Seat 6: 2e4217d7 (button) collected ($0.12)


Poker Hand #HD1746218307: Hold'em No Limit ($0.02/$0.05) - 2024/04/25 17:15:19
Table 'NLHBlue6' 6-max Seat #5 is the button
Seat 1: Hero ($7.6 in chips)
Seat 5: 205291 ($6.62 in chips)
Seat 6: 2e4217d7 ($12.86 in chips)
2e4217d7: posts small blind $0.02
Hero: posts big blind $0.05
*** HOLE CARDS ***
Dealt to Hero [Tc Jc]
Dealt to 205291 
Dealt to 2e4217d7 
205291: raises $0.08 to $0.13
2e4217d7: calls $0.11
Hero: calls $0.08
*** FLOP *** [5h 4c 4s]
2e4217d7: checks
Hero: checks
205291: checks
*** TURN *** [5h 4c 4s] [7h]
2e4217d7: bets $0.26
Hero: folds
205291: folds
Uncalled bet ($0.26) returned to 2e4217d7
*** SHOWDOWN ***
2e4217d7 collected $0.37 from pot
*** SUMMARY ***
Total pot $0.39 | Rake $0.02 | Jackpot $0 | Bingo $0 | Fortune $0 | Tax $0
Board [5h 4c 4s 7h]
Seat 1: Hero (big blind) folded on the Turn
Seat 5: 205291 (button) folded on the Turn
Seat 6: 2e4217d7 (small blind) won ($0.37)


Poker Hand #HD1746218064: Hold'em No Limit ($0.02/$0.05) - 2024/04/25 17:13:47
Table 'NLHBlue6' 6-max Seat #4 is the button
Seat 1: Hero ($5.43 in chips)
Seat 4: ab7b0d6c ($2.39 in chips)
Seat 5: 205291 ($6.64 in chips)
Seat 6: 2e4217d7 ($12.91 in chips)
205291: posts small blind $0.02
2e4217d7: posts big blind $0.05
*** HOLE CARDS ***
Dealt to Hero [Qd Jd]
Dealt to ab7b0d6c 
Dealt to 205291 
Dealt to 2e4217d7 
Hero: raises $0.05 to $0.1
ab7b0d6c: calls $0.1
205291: folds
2e4217d7: folds
*** FLOP *** [6d Jh 7c]
Hero: checks
ab7b0d6c: bets $0.09
Hero: calls $0.09
*** TURN *** [6d Jh 7c] [3h]
Hero: checks
ab7b0d6c: bets $0.34
Hero: calls $0.34
*** RIVER *** [6d Jh 7c 3h] [2h]
Hero: checks
ab7b0d6c: bets $1.86 and is all-in
Hero: calls $1.86
ab7b0d6c: shows [4d 4s] (Pair of Fours)
Hero: shows [Qd Jd] (Pair of Jacks)
*** SHOWDOWN ***
Hero collected $4.56 from pot
*** SUMMARY ***
Total pot $4.85 | Rake $0.24 | Jackpot $0.05 | Bingo $0 | Fortune $0 | Tax $0
Board [6d Jh 7c 3h 2h]
Seat 1: Hero showed [Qd Jd] and won ($4.56) with Pair of Jacks
Seat 4: ab7b0d6c (button) showed [4d 4s] and lost with Pair of Fours
Seat 5: 205291 (small blind) folded before Flop
Seat 6: 2e4217d7 (big blind) folded before Flop


Poker Hand #HD1746218041: Hold'em No Limit ($0.02/$0.05) - 2024/04/25 17:13:39
Table 'NLHBlue6' 6-max Seat #1 is the button
Seat 1: Hero ($5.43 in chips)
Seat 4: ab7b0d6c ($2.41 in chips)
Seat 5: 205291 ($6.62 in chips)
Seat 6: 2e4217d7 ($12.91 in chips)
ab7b0d6c: posts small blind $0.02
205291: posts big blind $0.05
*** HOLE CARDS ***
Dealt to Hero [2c Jh]
Dealt to ab7b0d6c 
Dealt to 205291 
Dealt to 2e4217d7 
2e4217d7: folds
Hero: folds
ab7b0d6c: folds
Uncalled bet ($0.03) returned to 205291
*** SHOWDOWN ***
205291 collected $0.04 from pot
*** SUMMARY ***
Total pot $0.04 | Rake $0 | Jackpot $0 | Bingo $0 | Fortune $0 | Tax $0
Seat 1: Hero (button) folded before Flop (didn't bet)
Seat 4: ab7b0d6c (small blind) folded before Flop
Seat 5: 205291 (big blind) collected ($0.04)
Seat 6: 2e4217d7 folded before Flop (didn't bet)


Poker Hand #HD1746217978: Hold'em No Limit ($0.02/$0.05) - 2024/04/25 17:13:13
Table 'NLHBlue6' 6-max Seat #6 is the button
Seat 1: Hero ($5.45 in chips)
Seat 2: ab8378d ($5.07 in chips)
Seat 4: ab7b0d6c ($2.41 in chips)
Seat 5: 205291 ($6.43 in chips)
Seat 6: 2e4217d7 ($13.04 in chips)
Hero: posts small blind $0.02
ab8378d: posts big blind $0.05
*** HOLE CARDS ***
Dealt to Hero [2s Ts]
Dealt to ab8378d 
Dealt to ab7b0d6c 
Dealt to 205291 
Dealt to 2e4217d7 
ab7b0d6c: folds
205291: raises $0.08 to $0.13
2e4217d7: calls $0.13
Hero: folds
ab8378d: folds
*** FLOP *** [Qs 9d Kd]
205291: bets $0.11
2e4217d7: folds
Uncalled bet ($0.11) returned to 205291
*** SHOWDOWN ***
205291 collected $0.32 from pot
*** SUMMARY ***
Total pot $0.33 | Rake $0.01 | Jackpot $0 | Bingo $0 | Fortune $0 | Tax $0
Board [Qs 9d Kd]
Seat 1: Hero (small blind) folded before Flop
Seat 2: ab8378d (big blind) folded before Flop
Seat 4: ab7b0d6c folded before Flop (didn't bet)
Seat 5: 205291 won ($0.32)
Seat 6: 2e4217d7 (button) folded on the Flop


Poker Hand #HD1746217932: Hold'em No Limit ($0.02/$0.05) - 2024/04/25 17:12:53
Table 'NLHBlue6' 6-max Seat #5 is the button
Seat 1: Hero ($5.5 in chips)
Seat 2: ab8378d ($5 in chips)
Seat 4: ab7b0d6c ($2.41 in chips)
Seat 5: 205291 ($6.43 in chips)
Seat 6: 2e4217d7 ($13.06 in chips)
2e4217d7: posts small blind $0.02
Hero: posts big blind $0.05
*** HOLE CARDS ***
Dealt to Hero [9c 4h]
Dealt to ab8378d 
Dealt to ab7b0d6c 
Dealt to 205291 
Dealt to 2e4217d7 
ab8378d: raises $0.05 to $0.1
ab7b0d6c: folds
205291: folds
2e4217d7: folds
Hero: folds
Uncalled bet ($0.05) returned to ab8378d
*** SHOWDOWN ***
ab8378d collected $0.12 from pot
*** SUMMARY ***
Total pot $0.12 | Rake $0 | Jackpot $0 | Bingo $0 | Fortune $0 | Tax $0
Seat 1: Hero (big blind) folded before Flop
Seat 2: ab8378d collected ($0.12)
Seat 4: ab7b0d6c folded before Flop (didn't bet)
Seat 5: 205291 (button) folded before Flop (didn't bet)
Seat 6: 2e4217d7 (small blind) folded before Flop


Poker Hand #HD1746217665: Hold'em No Limit ($0.02/$0.05) - 2024/04/25 17:11:11
Table 'NLHBlue6' 6-max Seat #4 is the button
Seat 1: Hero ($5.5 in chips)
Seat 2: ab8378d ($5 in chips)
Seat 3: dd329ac7 ($3.29 in chips)
Seat 4: ab7b0d6c ($5 in chips)
Seat 5: 205291 ($6.45 in chips)
Seat 6: 2e4217d7 ($5.19 in chips)
205291: posts small blind $0.02
2e4217d7: posts big blind $0.05
*** HOLE CARDS ***
Dealt to Hero [5s Ks]
Dealt to ab8378d 
Dealt to dd329ac7 
Dealt to ab7b0d6c 
Dealt to 205291 
Dealt to 2e4217d7 
Hero: folds
ab8378d: raises $0.05 to $0.1
dd329ac7: calls $0.1
ab7b0d6c: raises $0.65 to $0.75
205291: folds
2e4217d7: calls $0.7
ab8378d: folds
dd329ac7: calls $0.65
*** FLOP *** [2c Qc 8h]
2e4217d7: checks
dd329ac7: checks
ab7b0d6c: bets $0.79
2e4217d7: calls $0.79
dd329ac7: calls $0.79
*** TURN *** [2c Qc 8h] [Th]
2e4217d7: checks
dd329ac7: checks
ab7b0d6c: bets $3.46 and is all-in
2e4217d7: calls $3.46
dd329ac7: calls $1.75 and is all-in
ab7b0d6c: shows [As 9s] (Ace-High)
2e4217d7: shows [Tc Ts] (Three Tens)
dd329ac7: shows [Qd Td] (Pair of Queens and Pair of Tens)
*** RIVER *** [2c Qc 8h Th] [Kh]
*** SHOWDOWN ***
2e4217d7 collected $9.57 from pot
2e4217d7 collected $3.3 from pot
*** SUMMARY ***
Total pot $13.41 | Rake $0.49 | Jackpot $0.05 | Bingo $0 | Fortune $0 | Tax $0
Board [2c Qc 8h Th Kh]
Seat 1: Hero folded before Flop (didn't bet)
Seat 2: ab8378d folded before Flop
Seat 3: dd329ac7 showed [Qd Td] and lost with Pair of Queens and Pair of Tens
Seat 4: ab7b0d6c (button) showed [As 9s] and lost with Ace-High
Seat 5: 205291 (small blind) folded before Flop
Seat 6: 2e4217d7 (big blind) showed [Tc Ts] and won ($12.87) with Three Tens


Poker Hand #HD1746217471: Hold'em No Limit ($0.02/$0.05) - 2024/04/25 17:09:49
Table 'NLHBlue6' 6-max Seat #3 is the button
Seat 1: Hero ($5.5 in chips)
Seat 2: ab8378d ($5 in chips)
Seat 3: dd329ac7 ($2.21 in chips)
Seat 4: ab7b0d6c ($5.13 in chips)
Seat 5: 205291 ($6.8 in chips)
Seat 6: 2e4217d7 ($5.19 in chips)
ab7b0d6c: posts small blind $0.02
205291: posts big blind $0.05
ab8378d: posts big blind $0.05
ab8378d: posts missed blind $0.02
*** HOLE CARDS ***
Dealt to Hero [Kh 7h]
Dealt to ab8378d 
Dealt to dd329ac7 
Dealt to ab7b0d6c 
Dealt to 205291 
Dealt to 2e4217d7 
2e4217d7: folds
Hero: folds
ab8378d: raises $0.05 to $0.1
dd329ac7: calls $0.1
ab7b0d6c: calls $0.08
205291: calls $0.05
*** FLOP *** [Qh Jh 7c]
ab7b0d6c: checks
205291: checks
ab8378d: checks
dd329ac7: bets $0.1
ab7b0d6c: calls $0.1
205291: calls $0.1
ab8378d: folds
*** TURN *** [Qh Jh 7c] [5c]
ab7b0d6c: checks
205291: checks
dd329ac7: bets $0.15
ab7b0d6c: calls $0.15
205291: calls $0.15
*** RIVER *** [Qh Jh 7c 5c] [Qc]
ab7b0d6c: checks
205291: checks
dd329ac7: bets $0.4
ab7b0d6c: calls $0.4
205291: folds
dd329ac7: shows [Td Qs] (Three Queens)
ab7b0d6c: shows [Kc Js] (Pair of Queens and Pair of Jacks)
*** SHOWDOWN ***
dd329ac7 collected $1.83 from pot
*** SUMMARY ***
Total pot $1.97 | Rake $0.09 | Jackpot $0.05 | Bingo $0 | Fortune $0 | Tax $0
Board [Qh Jh 7c 5c Qc]
Seat 1: Hero folded before Flop (didn't bet)
Seat 2: ab8378d folded on the Flop
Seat 3: dd329ac7 (button) showed [Td Qs] and won ($1.83) with Three Queens
Seat 4: ab7b0d6c (small blind) showed [Kc Js] and lost with Pair of Queens and Pair of Jacks
Seat 5: 205291 (big blind) folded on the River
Seat 6: 2e4217d7 folded before Flop (didn't bet)


Poker Hand #HD1746217419: Hold'em No Limit ($0.02/$0.05) - 2024/04/25 17:09:25
Table 'NLHBlue6' 6-max Seat #1 is the button
Seat 1: Hero ($5.5 in chips)
Seat 3: dd329ac7 ($2.16 in chips)
Seat 4: ab7b0d6c ($5.18 in chips)
Seat 5: 205291 ($6.8 in chips)
Seat 6: 2e4217d7 ($5.19 in chips)
dd329ac7: posts small blind $0.02
ab7b0d6c: posts big blind $0.05
*** HOLE CARDS ***
Dealt to Hero [7s Ah]
Dealt to dd329ac7 
Dealt to ab7b0d6c 
Dealt to 205291 
Dealt to 2e4217d7 
205291: folds
2e4217d7: folds
Hero: folds
dd329ac7: raises $0.2 to $0.25
ab7b0d6c: folds
Uncalled bet ($0.2) returned to dd329ac7
*** SHOWDOWN ***
dd329ac7 collected $0.1 from pot
*** SUMMARY ***
Total pot $0.1 | Rake $0 | Jackpot $0 | Bingo $0 | Fortune $0 | Tax $0
Seat 1: Hero (button) folded before Flop (didn't bet)
Seat 3: dd329ac7 (small blind) collected ($0.1)
Seat 4: ab7b0d6c (big blind) folded before Flop
Seat 5: 205291 folded before Flop (didn't bet)
Seat 6: 2e4217d7 folded before Flop (didn't bet)


Poker Hand #HD1746217375: Hold'em No Limit ($0.02/$0.05) - 2024/04/25 17:09:12
Table 'NLHBlue6' 6-max Seat #6 is the button
Seat 1: Hero ($5.52 in chips)
Seat 3: dd329ac7 ($2.14 in chips)
Seat 4: ab7b0d6c ($5.18 in chips)
Seat 5: 205291 ($6.8 in chips)
Seat 6: 2e4217d7 ($5.19 in chips)
Hero: posts small blind $0.02
dd329ac7: posts big blind $0.05
*** HOLE CARDS ***
Dealt to Hero [Kd 2h]
Dealt to dd329ac7 
Dealt to ab7b0d6c 
Dealt to 205291 
Dealt to 2e4217d7 
ab7b0d6c: folds
205291: folds
2e4217d7: folds
Hero: folds
Uncalled bet ($0.03) returned to dd329ac7
*** SHOWDOWN ***
dd329ac7 collected $0.04 from pot
*** SUMMARY ***
Total pot $0.04 | Rake $0 | Jackpot $0 | Bingo $0 | Fortune $0 | Tax $0
Seat 1: Hero (small blind) folded before Flop
Seat 3: dd329ac7 (big blind) collected ($0.04)
Seat 4: ab7b0d6c folded before Flop (didn't bet)
Seat 5: 205291 folded before Flop (didn't bet)
Seat 6: 2e4217d7 (button) folded before Flop (didn't bet)


Poker Hand #HD1746217302: Hold'em No Limit ($0.02/$0.05) - 2024/04/25 17:08:40
Table 'NLHBlue6' 6-max Seat #5 is the button
Seat 1: Hero ($5.57 in chips)
Seat 4: ab7b0d6c ($5.18 in chips)
Seat 5: 205291 ($6.93 in chips)
Seat 6: 2e4217d7 ($5.02 in chips)
2e4217d7: posts small blind $0.02
Hero: posts big blind $0.05
*** HOLE CARDS ***
Dealt to Hero [Tc 7h]
Dealt to ab7b0d6c 
Dealt to 205291 
Dealt to 2e4217d7 
ab7b0d6c: folds
205291: raises $0.08 to $0.13
2e4217d7: calls $0.11
Hero: folds
*** FLOP *** [5h 5d 8s]
2e4217d7: checks
205291: checks
*** TURN *** [5h 5d 8s] [Th]
2e4217d7: bets $0.21
205291: folds
Uncalled bet ($0.21) returned to 2e4217d7
*** SHOWDOWN ***
2e4217d7 collected $0.3 from pot
*** SUMMARY ***
Total pot $0.31 | Rake $0.01 | Jackpot $0 | Bingo $0 | Fortune $0 | Tax $0
Board [5h 5d 8s Th]
Seat 1: Hero (big blind) folded before Flop
Seat 4: ab7b0d6c folded before Flop (didn't bet)
Seat 5: 205291 (button) folded on the Turn
Seat 6: 2e4217d7 (small blind) won ($0.3)


Poker Hand #HD1746217268: Hold'em No Limit ($0.02/$0.05) - 2024/04/25 17:08:27
Table 'NLHBlue6' 6-max Seat #4 is the button
Seat 1: Hero ($5.5 in chips)
Seat 4: ab7b0d6c ($5.18 in chips)
Seat 5: 205291 ($6.95 in chips)
Seat 6: 2e4217d7 ($5.07 in chips)
205291: posts small blind $0.02
2e4217d7: posts big blind $0.05
*** HOLE CARDS ***
Dealt to Hero [Jh Kh]
Dealt to ab7b0d6c 
Dealt to 205291 
Dealt to 2e4217d7 
Hero: raises $0.05 to $0.1
ab7b0d6c: folds
205291: folds
2e4217d7: folds
Uncalled bet ($0.05) returned to Hero
*** SHOWDOWN ***
Hero collected $0.12 from pot
*** SUMMARY ***
Total pot $0.12 | Rake $0 | Jackpot $0 | Bingo $0 | Fortune $0 | Tax $0
Seat 1: Hero collected ($0.12)
Seat 4: ab7b0d6c (button) folded before Flop (didn't bet)
Seat 5: 205291 (small blind) folded before Flop
Seat 6: 2e4217d7 (big blind) folded before Flop


Poker Hand #HD1746217218: Hold'em No Limit ($0.02/$0.05) - 2024/04/25 17:08:00
Table 'NLHBlue6' 6-max Seat #3 is the button
Seat 1: Hero ($5.5 in chips)
Seat 3: fb66a50b ($7.09 in chips)
Seat 4: ab7b0d6c ($5 in chips)
Seat 5: 205291 ($7 in chips)
Seat 6: 2e4217d7 ($5.21 in chips)
ab7b0d6c: posts small blind $0.02
205291: posts big blind $0.05
*** HOLE CARDS ***
Dealt to Hero [4h As]
Dealt to fb66a50b 
Dealt to ab7b0d6c 
Dealt to 205291 
Dealt to 2e4217d7 
2e4217d7: raises $0.09 to $0.14
Hero: folds
fb66a50b: folds
ab7b0d6c: raises $0.36 to $0.5
205291: folds
2e4217d7: folds
Uncalled bet ($0.36) returned to ab7b0d6c
*** SHOWDOWN ***
ab7b0d6c collected $0.32 from pot
*** SUMMARY ***
Total pot $0.33 | Rake $0.01 | Jackpot $0 | Bingo $0 | Fortune $0 | Tax $0
Seat 1: Hero folded before Flop (didn't bet)
Seat 3: fb66a50b (button) folded before Flop (didn't bet)
Seat 4: ab7b0d6c (small blind) collected ($0.32)
Seat 5: 205291 (big blind) folded before Flop
Seat 6: 2e4217d7 folded before Flop


Poker Hand #HD1746217156: Hold'em No Limit ($0.02/$0.05) - 2024/04/25 17:07:33
Table 'NLHBlue6' 6-max Seat #1 is the button
Seat 1: Hero ($5.5 in chips)
Seat 2: ab8378d ($5 in chips)
Seat 3: fb66a50b ($7.14 in chips)
Seat 4: ab7b0d6c ($5 in chips)
Seat 5: 205291 ($7 in chips)
Seat 6: 2e4217d7 ($5.14 in chips)
ab8378d: posts small blind $0.02
fb66a50b: posts big blind $0.05
*** HOLE CARDS ***
Dealt to Hero [8s Kd]
Dealt to ab8378d 
Dealt to fb66a50b 
Dealt to ab7b0d6c 
Dealt to 205291 
Dealt to 2e4217d7 
ab7b0d6c: folds
205291: folds
2e4217d7: raises $0.09 to $0.14
Hero: folds
ab8378d: folds
fb66a50b: folds
Uncalled bet ($0.09) returned to 2e4217d7
*** SHOWDOWN ***
2e4217d7 collected $0.12 from pot
*** SUMMARY ***
Total pot $0.12 | Rake $0 | Jackpot $0 | Bingo $0 | Fortune $0 | Tax $0
Seat 1: Hero (button) folded before Flop (didn't bet)
Seat 2: ab8378d (small blind) folded before Flop
Seat 3: fb66a50b (big blind) folded before Flop
Seat 4: ab7b0d6c folded before Flop (didn't bet)
Seat 5: 205291 folded before Flop (didn't bet)
Seat 6: 2e4217d7 collected ($0.12)


Poker Hand #HD1746216969: Hold'em No Limit ($0.02/$0.05) - 2024/04/25 17:06:20
Table 'NLHBlue6' 6-max Seat #6 is the button
Seat 1: Hero ($5.52 in chips)
Seat 2: ab8378d ($5 in chips)
Seat 3: fb66a50b ($7.14 in chips)
Seat 4: ab7b0d6c ($5.56 in chips)
Seat 5: 205291 ($7 in chips)
Seat 6: 2e4217d7 ($4.23 in chips)
Hero: posts small blind $0.02
ab8378d: posts big blind $0.05
*** HOLE CARDS ***
Dealt to Hero [8c 4d]
Dealt to ab8378d 
Dealt to fb66a50b 
Dealt to ab7b0d6c 
Dealt to 205291 
Dealt to 2e4217d7 
fb66a50b: folds
ab7b0d6c: raises $0.1 to $0.15
205291: folds
2e4217d7: calls $0.15
Hero: folds
ab8378d: folds
*** FLOP *** [9c 9d 8d]
ab7b0d6c: checks
2e4217d7: bets $0.25
ab7b0d6c: calls $0.25
*** TURN *** [9c 9d 8d] [Ks]
ab7b0d6c: checks
2e4217d7: checks
*** RIVER *** [9c 9d 8d Ks] [3s]
ab7b0d6c: checks
2e4217d7: bets $0.58
ab7b0d6c: calls $0.58
2e4217d7: shows [Jd Kc] (Pair of Kings and Pair of Nines)
ab7b0d6c: shows [Qc Qd] (Pair of Queens and Pair of Nines)
*** SHOWDOWN ***
2e4217d7 collected $1.89 from pot
*** SUMMARY ***
Total pot $2.03 | Rake $0.09 | Jackpot $0.05 | Bingo $0 | Fortune $0 | Tax $0
Board [9c 9d 8d Ks 3s]
Seat 1: Hero (small blind) folded before Flop
Seat 2: ab8378d (big blind) folded before Flop
Seat 3: fb66a50b folded before Flop (didn't bet)
Seat 4: ab7b0d6c showed [Qc Qd] and lost with Pair of Queens and Pair of Nines
Seat 5: 205291 folded before Flop (didn't bet)
Seat 6: 2e4217d7 (button) showed [Jd Kc] and won ($1.89) with Pair of Kings and Pair of Nines


Poker Hand #HD1746216881: Hold'em No Limit ($0.02/$0.05) - 2024/04/25 17:05:45
Table 'NLHBlue6' 6-max Seat #5 is the button
Seat 1: Hero ($5.57 in chips)
Seat 2: ab8378d ($5 in chips)
Seat 3: fb66a50b ($7.14 in chips)
Seat 4: ab7b0d6c ($5.56 in chips)
Seat 5: 205291 ($7 in chips)
Seat 6: 2e4217d7 ($4.13 in chips)
2e4217d7: posts small blind $0.02
Hero: posts big blind $0.05
ab8378d: posts big blind $0.05
*** HOLE CARDS ***
Dealt to Hero [3h 6d]
Dealt to ab8378d 
Dealt to fb66a50b 
Dealt to ab7b0d6c 
Dealt to 205291 
Dealt to 2e4217d7 
ab8378d: checks
fb66a50b: folds
ab7b0d6c: folds
205291: folds
2e4217d7: raises $0.15 to $0.2
Hero: folds
ab8378d: folds
Uncalled bet ($0.15) returned to 2e4217d7
*** SHOWDOWN ***
2e4217d7 collected $0.15 from pot
*** SUMMARY ***
Total pot $0.15 | Rake $0 | Jackpot $0 | Bingo $0 | Fortune $0 | Tax $0
Seat 1: Hero (big blind) folded before Flop
Seat 2: ab8378d folded before Flop
Seat 3: fb66a50b folded before Flop (didn't bet)
Seat 4: ab7b0d6c folded before Flop (didn't bet)
Seat 5: 205291 (button) folded before Flop (didn't bet)
Seat 6: 2e4217d7 (small blind) collected ($0.15)


Poker Hand #HD1746216775: Hold'em No Limit ($0.02/$0.05) - 2024/04/25 17:05:03
Table 'NLHBlue6' 6-max Seat #4 is the button
Seat 1: Hero ($5.57 in chips)
Seat 3: fb66a50b ($7.14 in chips)
Seat 4: ab7b0d6c ($5.56 in chips)
Seat 5: 205291 ($6.73 in chips)
Seat 6: 2e4217d7 ($4.43 in chips)
205291: posts small blind $0.02
2e4217d7: posts big blind $0.05
*** HOLE CARDS ***
Dealt to Hero [Qs 4c]
Dealt to fb66a50b 
Dealt to ab7b0d6c 
Dealt to 205291 
Dealt to 2e4217d7 
Hero: folds
fb66a50b: folds
ab7b0d6c: folds
205291: raises $0.1 to $0.15
2e4217d7: calls $0.1
*** FLOP *** [Ad Jd 9h]
205291: bets $0.15
2e4217d7: calls $0.15
*** TURN *** [Ad Jd 9h] [Kd]
205291: checks
2e4217d7: checks
*** RIVER *** [Ad Jd 9h Kd] [3d]
205291: checks
2e4217d7: checks
205291: shows [7c As] (Pair of Aces)
2e4217d7: shows [Th Ks] (Pair of Kings)
*** SHOWDOWN ***
205291 collected $0.57 from pot
*** SUMMARY ***
Total pot $0.6 | Rake $0.03 | Jackpot $0 | Bingo $0 | Fortune $0 | Tax $0
Board [Ad Jd 9h Kd 3d]
Seat 1: Hero folded before Flop (didn't bet)
Seat 3: fb66a50b folded before Flop (didn't bet)
Seat 4: ab7b0d6c (button) folded before Flop (didn't bet)
Seat 5: 205291 (small blind) showed [7c As] and won ($0.57) with Pair of Aces
Seat 6: 2e4217d7 (big blind) showed [Th Ks] and lost with Pair of Kings


Poker Hand #HD1746216705: Hold'em No Limit ($0.02/$0.05) - 2024/04/25 17:04:35
Table 'NLHBlue6' 6-max Seat #3 is the button
Seat 1: Hero ($5.57 in chips)
Seat 3: fb66a50b ($7 in chips)
Seat 4: ab7b0d6c ($5.58 in chips)
Seat 5: 205291 ($6.86 in chips)
Seat 6: 2e4217d7 ($4.43 in chips)
ab7b0d6c: posts small blind $0.02
205291: posts big blind $0.05
*** HOLE CARDS ***
Dealt to Hero [6d 4d]
Dealt to fb66a50b 
Dealt to ab7b0d6c 
Dealt to 205291 
Dealt to 2e4217d7 
2e4217d7: folds
Hero: folds
fb66a50b: raises $0.08 to $0.13
ab7b0d6c: folds
205291: calls $0.08
*** FLOP *** [7d 4h 6h]
205291: checks
fb66a50b: bets $0.2
205291: folds
Uncalled bet ($0.2) returned to fb66a50b
*** SHOWDOWN ***
fb66a50b collected $0.27 from pot
*** SUMMARY ***
Total pot $0.28 | Rake $0.01 | Jackpot $0 | Bingo $0 | Fortune $0 | Tax $0
Board [7d 4h 6h]
Seat 1: Hero folded before Flop (didn't bet)
Seat 3: fb66a50b (button) won ($0.27)
Seat 4: ab7b0d6c (small blind) folded before Flop
Seat 5: 205291 (big blind) folded on the Flop
Seat 6: 2e4217d7 folded before Flop (didn't bet)


Poker Hand #HD1746216693: Hold'em No Limit ($0.02/$0.05) - 2024/04/25 17:04:26
Table 'NLHBlue6' 6-max Seat #1 is the button
Seat 1: Hero ($5.57 in chips)
Seat 3: fb66a50b ($7.02 in chips)
Seat 4: ab7b0d6c ($5.56 in chips)
Seat 5: 205291 ($6.86 in chips)
Seat 6: 2e4217d7 ($4.43 in chips)
fb66a50b: posts small blind $0.02
ab7b0d6c: posts big blind $0.05
*** HOLE CARDS ***
Dealt to Hero [9h 3s]
Dealt to fb66a50b 
Dealt to ab7b0d6c 
Dealt to 205291 
Dealt to 2e4217d7 
205291: folds
2e4217d7: folds
Hero: folds
fb66a50b: folds
Uncalled bet ($0.03) returned to ab7b0d6c
*** SHOWDOWN ***
ab7b0d6c collected $0.04 from pot
*** SUMMARY ***
Total pot $0.04 | Rake $0 | Jackpot $0 | Bingo $0 | Fortune $0 | Tax $0
Seat 1: Hero (button) folded before Flop (didn't bet)
Seat 3: fb66a50b (small blind) folded before Flop
Seat 4: ab7b0d6c (big blind) collected ($0.04)
Seat 5: 205291 folded before Flop (didn't bet)
Seat 6: 2e4217d7 folded before Flop (didn't bet)


Poker Hand #HD1746216656: Hold'em No Limit ($0.02/$0.05) - 2024/04/25 17:04:16
Table 'NLHBlue6' 6-max Seat #6 is the button
Seat 1: Hero ($5.59 in chips)
Seat 3: fb66a50b ($7 in chips)
Seat 4: ab7b0d6c ($5.56 in chips)
Seat 5: 205291 ($6.86 in chips)
Seat 6: 2e4217d7 ($4.43 in chips)
Hero: posts small blind $0.02
fb66a50b: posts big blind $0.05
*** HOLE CARDS ***
Dealt to Hero [4s 3h]
Dealt to fb66a50b 
Dealt to ab7b0d6c 
Dealt to 205291 
Dealt to 2e4217d7 
ab7b0d6c: folds
205291: folds
2e4217d7: folds
Hero: folds
Uncalled bet ($0.03) returned to fb66a50b
*** SHOWDOWN ***
fb66a50b collected $0.04 from pot
*** SUMMARY ***
Total pot $0.04 | Rake $0 | Jackpot $0 | Bingo $0 | Fortune $0 | Tax $0
Seat 1: Hero (small blind) folded before Flop
Seat 3: fb66a50b (big blind) collected ($0.04)
Seat 4: ab7b0d6c folded before Flop (didn't bet)
Seat 5: 205291 folded before Flop (didn't bet)
Seat 6: 2e4217d7 (button) folded before Flop (didn't bet)


Poker Hand #HD1746216588: Hold'em No Limit ($0.02/$0.05) - 2024/04/25 17:03:50
Table 'NLHBlue6' 6-max Seat #5 is the button
Seat 1: Hero ($5.64 in chips)
Seat 2: b61f990d ($2.4 in chips)
Seat 3: fb66a50b ($7.13 in chips)
Seat 4: ab7b0d6c ($5.37 in chips)
Seat 5: 205291 ($6.86 in chips)
Seat 6: 2e4217d7 ($4.45 in chips)
2e4217d7: posts small blind $0.02
Hero: posts big blind $0.05
*** HOLE CARDS ***
Dealt to Hero [9c 3d]
Dealt to b61f990d 
Dealt to fb66a50b 
Dealt to ab7b0d6c 
Dealt to 205291 
Dealt to 2e4217d7 
b61f990d: folds
fb66a50b: raises $0.08 to $0.13
ab7b0d6c: raises $0.37 to $0.5
205291: folds
2e4217d7: folds
Hero: folds
fb66a50b: folds
Uncalled bet ($0.37) returned to ab7b0d6c
*** SHOWDOWN ***
ab7b0d6c collected $0.32 from pot
*** SUMMARY ***
Total pot $0.33 | Rake $0.01 | Jackpot $0 | Bingo $0 | Fortune $0 | Tax $0
Seat 1: Hero (big blind) folded before Flop
Seat 2: b61f990d folded before Flop (didn't bet)
Seat 3: fb66a50b folded before Flop
Seat 4: ab7b0d6c collected ($0.32)
Seat 5: 205291 (button) folded before Flop (didn't bet)
Seat 6: 2e4217d7 (small blind) folded before Flop


Poker Hand #HD1746216465: Hold'em No Limit ($0.02/$0.05) - 2024/04/25 17:02:55
Table 'NLHBlue6' 6-max Seat #4 is the button
Seat 1: Hero ($5.39 in chips)
Seat 2: b61f990d ($2.4 in chips)
Seat 3: fb66a50b ($7.13 in chips)
Seat 4: ab7b0d6c ($5.37 in chips)
Seat 5: 205291 ($6.88 in chips)
Seat 6: 2e4217d7 ($4.7 in chips)
205291: posts small blind $0.02
2e4217d7: posts big blind $0.05
*** HOLE CARDS ***
Dealt to Hero [8h 8s]
Dealt to b61f990d 
Dealt to fb66a50b 
Dealt to ab7b0d6c 
Dealt to 205291 
Dealt to 2e4217d7 
Hero: raises $0.05 to $0.1
b61f990d: folds
fb66a50b: folds
ab7b0d6c: folds
205291: folds
2e4217d7: calls $0.05
*** FLOP *** [3c Td 2s]
2e4217d7: bets $0.15
Hero: calls $0.15
*** TURN *** [3c Td 2s] [9d]
2e4217d7: checks
Hero: checks
*** RIVER *** [3c Td 2s 9d] [7d]
2e4217d7: checks
Hero: checks
2e4217d7: shows [Ac 5s] (Ace-High)
Hero: shows [8h 8s] (Pair of Eights)
*** SHOWDOWN ***
Hero collected $0.5 from pot
*** SUMMARY ***
Total pot $0.52 | Rake $0.02 | Jackpot $0 | Bingo $0 | Fortune $0 | Tax $0
Board [3c Td 2s 9d 7d]
Seat 1: Hero showed [8h 8s] and won ($0.5) with Pair of Eights
Seat 2: b61f990d folded before Flop (didn't bet)
Seat 3: fb66a50b folded before Flop (didn't bet)
Seat 4: ab7b0d6c (button) folded before Flop (didn't bet)
Seat 5: 205291 (small blind) folded before Flop
Seat 6: 2e4217d7 (big blind) showed [Ac 5s] and lost with Ace-High


Poker Hand #HD1746216384: Hold'em No Limit ($0.02/$0.05) - 2024/04/25 17:02:25
Table 'NLHBlue6' 6-max Seat #3 is the button
Seat 1: Hero ($5.39 in chips)
Seat 2: b61f990d ($2.5 in chips)
Seat 3: fb66a50b ($7.13 in chips)
Seat 4: ab7b0d6c ($5.23 in chips)
Seat 5: 205291 ($6.93 in chips)
Seat 6: 2e4217d7 ($4.7 in chips)
ab7b0d6c: posts small blind $0.02
205291: posts big blind $0.05
*** HOLE CARDS ***
Dealt to Hero [7h 9h]
Dealt to b61f990d 
Dealt to fb66a50b 
Dealt to ab7b0d6c 
Dealt to 205291 
Dealt to 2e4217d7 
2e4217d7: folds
Hero: folds
b61f990d: raises $0.05 to $0.1
fb66a50b: folds
ab7b0d6c: raises $0.4 to $0.5
205291: folds
b61f990d: folds
Uncalled bet ($0.4) returned to ab7b0d6c
*** SHOWDOWN ***
ab7b0d6c collected $0.24 from pot
*** SUMMARY ***
Total pot $0.25 | Rake $0.01 | Jackpot $0 | Bingo $0 | Fortune $0 | Tax $0
Seat 1: Hero folded before Flop (didn't bet)
Seat 2: b61f990d folded before Flop
Seat 3: fb66a50b (button) folded before Flop (didn't bet)
Seat 4: ab7b0d6c (small blind) collected ($0.24)
Seat 5: 205291 (big blind) folded before Flop
Seat 6: 2e4217d7 folded before Flop (didn't bet)


Poker Hand #HD1746216245: Hold'em No Limit ($0.02/$0.05) - 2024/04/25 17:01:27
Table 'NLHBlue6' 6-max Seat #2 is the button
Seat 1: Hero ($5.39 in chips)
Seat 2: b61f990d ($2.01 in chips)
Seat 3: fb66a50b ($7.15 in chips)
Seat 4: ab7b0d6c ($5.28 in chips)
Seat 5: 205291 ($5.1 in chips)
Seat 6: 2e4217d7 ($4.7 in chips)
fb66a50b: posts small blind $0.02
ab7b0d6c: posts big blind $0.05
*** HOLE CARDS ***
Dealt to Hero [9d 3h]
Dealt to b61f990d 
Dealt to fb66a50b 
Dealt to ab7b0d6c 
Dealt to 205291 
Dealt to 2e4217d7 
205291: raises $0.08 to $0.13
2e4217d7: folds
Hero: folds
b61f990d: raises $0.33 to $0.46
fb66a50b: folds
ab7b0d6c: folds
205291: calls $0.33
*** FLOP *** [Tc As 3c]
205291: checks
b61f990d: checks
*** TURN *** [Tc As 3c] [2h]
205291: checks
b61f990d: checks
*** RIVER *** [Tc As 3c 2h] [6h]
205291: bets $1.85
b61f990d: calls $1.55 and is all-in
Uncalled bet ($0.3) returned to 205291
205291: shows [Ts Td] (Three Tens)
b61f990d: shows [Jc Jd] (Pair of Jacks)
*** SHOWDOWN ***
205291 collected $3.84 from pot
*** SUMMARY ***
Total pot $4.09 | Rake $0.2 | Jackpot $0.05 | Bingo $0 | Fortune $0 | Tax $0
Board [Tc As 3c 2h 6h]
Seat 1: Hero folded before Flop (didn't bet)
Seat 2: b61f990d (button) showed [Jc Jd] and lost with Pair of Jacks
Seat 3: fb66a50b (small blind) folded before Flop
Seat 4: ab7b0d6c (big blind) folded before Flop
Seat 5: 205291 showed [Ts Td] and won ($3.84) with Three Tens
Seat 6: 2e4217d7 folded before Flop (didn't bet)


Poker Hand #HD1746216158: Hold'em No Limit ($0.02/$0.05) - 2024/04/25 17:00:50
Table 'NLHBlue6' 6-max Seat #1 is the button
Seat 1: Hero ($5.39 in chips)
Seat 2: b61f990d ($2.03 in chips)
Seat 3: fb66a50b ($7.13 in chips)
Seat 4: ab7b0d6c ($5.28 in chips)
Seat 5: 205291 ($5.1 in chips)
Seat 6: 2e4217d7 ($4.7 in chips)
b61f990d: posts small blind $0.02
fb66a50b: posts big blind $0.05
*** HOLE CARDS ***
Dealt to Hero [3h As]
Dealt to b61f990d 
Dealt to fb66a50b 
Dealt to ab7b0d6c 
Dealt to 205291 
Dealt to 2e4217d7 
ab7b0d6c: folds
205291: folds
2e4217d7: folds
Hero: folds
b61f990d: folds
Uncalled bet ($0.03) returned to fb66a50b
*** SHOWDOWN ***
fb66a50b collected $0.04 from pot
*** SUMMARY ***
Total pot $0.04 | Rake $0 | Jackpot $0 | Bingo $0 | Fortune $0 | Tax $0
Seat 1: Hero (button) folded before Flop (didn't bet)
Seat 2: b61f990d (small blind) folded before Flop
Seat 3: fb66a50b (big blind) collected ($0.04)
Seat 4: ab7b0d6c folded before Flop (didn't bet)
Seat 5: 205291 folded before Flop (didn't bet)
Seat 6: 2e4217d7 folded before Flop (didn't bet)


Poker Hand #HD1746216099: Hold'em No Limit ($0.02/$0.05) - 2024/04/25 17:00:26
Table 'NLHBlue6' 6-max Seat #6 is the button
Seat 1: Hero ($5.41 in chips)
Seat 2: b61f990d ($2.01 in chips)
Seat 3: fb66a50b ($7.13 in chips)
Seat 4: ab7b0d6c ($5.28 in chips)
Seat 5: 205291 ($5.1 in chips)
Seat 6: 2e4217d7 ($4.7 in chips)
Hero: posts small blind $0.02
b61f990d: posts big blind $0.05
*** HOLE CARDS ***
Dealt to Hero [Js 9c]
Dealt to b61f990d 
Dealt to fb66a50b 
Dealt to ab7b0d6c 
Dealt to 205291 
Dealt to 2e4217d7 
fb66a50b: folds
ab7b0d6c: folds
205291: folds
2e4217d7: folds
Hero: folds
Uncalled bet ($0.03) returned to b61f990d
*** SHOWDOWN ***
b61f990d collected $0.04 from pot
*** SUMMARY ***
Total pot $0.04 | Rake $0 | Jackpot $0 | Bingo $0 | Fortune $0 | Tax $0
Seat 1: Hero (small blind) folded before Flop
Seat 2: b61f990d (big blind) collected ($0.04)
Seat 3: fb66a50b folded before Flop (didn't bet)
Seat 4: ab7b0d6c folded before Flop (didn't bet)
Seat 5: 205291 folded before Flop (didn't bet)
Seat 6: 2e4217d7 (button) folded before Flop (didn't bet)


Poker Hand #HD1746215924: Hold'em No Limit ($0.02/$0.05) - 2024/04/25 16:59:13
Table 'NLHBlue6' 6-max Seat #5 is the button
Seat 1: Hero ($5.56 in chips)
Seat 2: b61f990d ($2.01 in chips)
Seat 3: fb66a50b ($7.13 in chips)
Seat 4: ab7b0d6c ($5.43 in chips)
Seat 5: 205291 ($5.1 in chips)
Seat 6: 2e4217d7 ($4.42 in chips)
2e4217d7: posts small blind $0.02
Hero: posts big blind $0.05
*** HOLE CARDS ***
Dealt to Hero [Jh Qd]
Dealt to b61f990d 
Dealt to fb66a50b 
Dealt to ab7b0d6c 
Dealt to 205291 
Dealt to 2e4217d7 
b61f990d: folds
fb66a50b: folds
ab7b0d6c: raises $0.1 to $0.15
205291: folds
2e4217d7: calls $0.13
Hero: calls $0.1
*** FLOP *** [4c Td 2c]
2e4217d7: checks
Hero: checks
ab7b0d6c: checks
*** TURN *** [4c Td 2c] [4h]
2e4217d7: bets $0.3
Hero: folds
ab7b0d6c: folds
Uncalled bet ($0.3) returned to 2e4217d7
*** SHOWDOWN ***
2e4217d7 collected $0.43 from pot
*** SUMMARY ***
Total pot $0.45 | Rake $0.02 | Jackpot $0 | Bingo $0 | Fortune $0 | Tax $0
Board [4c Td 2c 4h]
Seat 1: Hero (big blind) folded on the Turn
Seat 2: b61f990d folded before Flop (didn't bet)
Seat 3: fb66a50b folded before Flop (didn't bet)
Seat 4: ab7b0d6c folded on the Turn
Seat 5: 205291 (button) folded before Flop (didn't bet)
Seat 6: 2e4217d7 (small blind) won ($0.43)


Poker Hand #HD1746215858: Hold'em No Limit ($0.02/$0.05) - 2024/04/25 16:58:45
Table 'NLHBlue6' 6-max Seat #4 is the button
Seat 1: Hero ($5.56 in chips)
Seat 2: b61f990d ($2.01 in chips)
Seat 3: fb66a50b ($7.13 in chips)
Seat 4: ab7b0d6c ($5.36 in chips)
Seat 5: 205291 ($5.12 in chips)
Seat 6: 2e4217d7 ($4.47 in chips)
205291: posts small blind $0.02
2e4217d7: posts big blind $0.05
*** HOLE CARDS ***
Dealt to Hero [4h Qd]
Dealt to b61f990d 
Dealt to fb66a50b 
Dealt to ab7b0d6c 
Dealt to 205291 
Dealt to 2e4217d7 
Hero: folds
b61f990d: folds
fb66a50b: folds
ab7b0d6c: raises $0.08 to $0.13
205291: folds
2e4217d7: folds
Uncalled bet ($0.08) returned to ab7b0d6c
*** SHOWDOWN ***
ab7b0d6c collected $0.12 from pot
*** SUMMARY ***
Total pot $0.12 | Rake $0 | Jackpot $0 | Bingo $0 | Fortune $0 | Tax $0
Seat 1: Hero folded before Flop (didn't bet)
Seat 2: b61f990d folded before Flop (didn't bet)
Seat 3: fb66a50b folded before Flop (didn't bet)
Seat 4: ab7b0d6c (button) collected ($0.12)
Seat 5: 205291 (small blind) folded before Flop
Seat 6: 2e4217d7 (big blind) folded before Flop


Poker Hand #HD1746215761: Hold'em No Limit ($0.02/$0.05) - 2024/04/25 16:58:01
Table 'NLHBlue6' 6-max Seat #3 is the button
Seat 1: Hero ($5.56 in chips)
Seat 2: b61f990d ($2.5 in chips)
Seat 3: fb66a50b ($7.13 in chips)
Seat 4: ab7b0d6c ($5.38 in chips)
Seat 5: 205291 ($5.17 in chips)
Seat 6: 2e4217d7 ($3.96 in chips)
ab7b0d6c: posts small blind $0.02
205291: posts big blind $0.05
*** HOLE CARDS ***
Dealt to Hero [3d Qd]
Dealt to b61f990d 
Dealt to fb66a50b 
Dealt to ab7b0d6c 
Dealt to 205291 
Dealt to 2e4217d7 
2e4217d7: raises $0.09 to $0.14
Hero: folds
b61f990d: raises $0.35 to $0.49
fb66a50b: folds
ab7b0d6c: folds
205291: folds
2e4217d7: calls $0.35
*** FLOP *** [8s Th 9h]
2e4217d7: checks
b61f990d: checks
*** TURN *** [8s Th 9h] [Jd]
2e4217d7: bets $0.7
b61f990d: folds
Uncalled bet ($0.7) returned to 2e4217d7
*** SHOWDOWN ***
2e4217d7 collected $1 from pot
*** SUMMARY ***
Total pot $1.05 | Rake $0.05 | Jackpot $0 | Bingo $0 | Fortune $0 | Tax $0
Board [8s Th 9h Jd]
Seat 1: Hero folded before Flop (didn't bet)
Seat 2: b61f990d folded on the Turn
Seat 3: fb66a50b (button) folded before Flop (didn't bet)
Seat 4: ab7b0d6c (small blind) folded before Flop
Seat 5: 205291 (big blind) folded before Flop
Seat 6: 2e4217d7 won ($1)


Poker Hand #HD1746135493: Hold'em No Limit ($0.02/$0.05) - 2024/04/25 16:56:12
Table 'NLHBlue6' 6-max Seat #2 is the button
Seat 1: Hero ($5.56 in chips)
Seat 2: b61f990d ($2.5 in chips)
Seat 3: fb66a50b ($4.95 in chips)
Seat 4: ab7b0d6c ($6.58 in chips)
Seat 5: 205291 ($5.17 in chips)
Seat 6: 2e4217d7 ($5.16 in chips)
fb66a50b: posts small blind $0.02
ab7b0d6c: posts big blind $0.05
*** HOLE CARDS ***
Dealt to Hero [7c 3c]
Dealt to b61f990d 
Dealt to fb66a50b 
Dealt to ab7b0d6c 
Dealt to 205291 
Dealt to 2e4217d7 
205291: folds
2e4217d7: raises $0.09 to $0.14
Hero: folds
b61f990d: folds
fb66a50b: calls $0.12
ab7b0d6c: raises $0.46 to $0.6
2e4217d7: calls $0.46
fb66a50b: calls $0.46
*** FLOP *** [Ah 9d 8h]
fb66a50b: checks
ab7b0d6c: bets $0.6
2e4217d7: calls $0.6
fb66a50b: calls $0.6
*** TURN *** [Ah 9d 8h] [4c]
fb66a50b: checks
ab7b0d6c: checks
2e4217d7: checks
*** RIVER *** [Ah 9d 8h 4c] [6s]
fb66a50b: bets $1.19
ab7b0d6c: folds
2e4217d7: folds
Uncalled bet ($1.19) returned to fb66a50b
*** SHOWDOWN ***
fb66a50b collected $3.38 from pot
*** SUMMARY ***
Total pot $3.6 | Rake $0.17 | Jackpot $0.05 | Bingo $0 | Fortune $0 | Tax $0
Board [Ah 9d 8h 4c 6s]
Seat 1: Hero folded before Flop (didn't bet)
Seat 2: b61f990d (button) folded before Flop (didn't bet)
Seat 3: fb66a50b (small blind) won ($3.38)
Seat 4: ab7b0d6c (big blind) folded on the River
Seat 5: 205291 folded before Flop (didn't bet)
Seat 6: 2e4217d7 folded on the River


Poker Hand #HD1746135303: Hold'em No Limit ($0.02/$0.05) - 2024/04/25 16:54:53
Table 'NLHBlue6' 6-max Seat #1 is the button
Seat 1: Hero ($5 in chips)
Seat 2: b61f990d ($1.69 in chips)
Seat 3: fb66a50b ($5 in chips)
Seat 4: ab7b0d6c ($6.58 in chips)
Seat 5: 205291 ($5.17 in chips)
Seat 6: 2e4217d7 ($5.16 in chips)
b61f990d: posts small blind $0.02
fb66a50b: posts big blind $0.05
*** HOLE CARDS ***
Dealt to Hero [Jd Ac]
Dealt to b61f990d 
Dealt to fb66a50b 
Dealt to ab7b0d6c 
Dealt to 205291 
Dealt to 2e4217d7 
ab7b0d6c: folds
205291: folds
2e4217d7: folds
Hero: raises $0.07 to $0.12
b61f990d: calls $0.1
fb66a50b: folds
*** FLOP *** [5d Qd Ah]
b61f990d: checks
Hero: bets $0.15
b61f990d: calls $0.15
*** TURN *** [5d Qd Ah] [Ad]
b61f990d: bets $0.3
Hero: calls $0.3
*** RIVER *** [5d Qd Ah Ad] [9s]
b61f990d: checks
Hero: bets $0.6
b61f990d: folds
Uncalled bet ($0.6) returned to Hero
*** SHOWDOWN ***
Hero collected $1.13 from pot
*** SUMMARY ***
Total pot $1.19 | Rake $0.06 | Jackpot $0 | Bingo $0 | Fortune $0 | Tax $0
Board [5d Qd Ah Ad 9s]
Seat 1: Hero (button) won ($1.13)
Seat 2: b61f990d (small blind) folded on the River
Seat 3: fb66a50b (big blind) folded before Flop
Seat 4: ab7b0d6c folded before Flop (didn't bet)
Seat 5: 205291 folded before Flop (didn't bet)
Seat 6: 2e4217d7 folded before Flop (didn't bet)


Poker Hand #HD1746135268: Hold'em No Limit ($0.02/$0.05) - 2024/04/25 16:54:37
Table 'NLHBlue6' 6-max Seat #6 is the button
Seat 1: Hero ($5.02 in chips)
Seat 2: b61f990d ($1.74 in chips)
Seat 4: ab7b0d6c ($6.51 in chips)
Seat 5: 205291 ($5.17 in chips)
Seat 6: 2e4217d7 ($5.16 in chips)
Hero: posts small blind $0.02
b61f990d: posts big blind $0.05
*** HOLE CARDS ***
Dealt to Hero [Kd 7c]
Dealt to b61f990d 
Dealt to ab7b0d6c 
Dealt to 205291 
Dealt to 2e4217d7 
ab7b0d6c: raises $0.1 to $0.15
205291: folds
2e4217d7: folds
Hero: folds
b61f990d: folds
Uncalled bet ($0.1) returned to ab7b0d6c
*** SHOWDOWN ***
ab7b0d6c collected $0.12 from pot
*** SUMMARY ***
Total pot $0.12 | Rake $0 | Jackpot $0 | Bingo $0 | Fortune $0 | Tax $0
Seat 1: Hero (small blind) folded before Flop
Seat 2: b61f990d (big blind) folded before Flop
Seat 4: ab7b0d6c collected ($0.12)
Seat 5: 205291 folded before Flop (didn't bet)
Seat 6: 2e4217d7 (button) folded before Flop (didn't bet)


Poker Hand #HD1746135172: Hold'em No Limit ($0.02/$0.05) - 2024/04/25 16:53:59
Table 'NLHBlue6' 6-max Seat #5 is the button
Seat 1: Hero ($5.07 in chips)
Seat 2: b61f990d ($1.74 in chips)
Seat 3: 5c16018f ($11.87 in chips)
Seat 4: ab7b0d6c ($6.51 in chips)
Seat 5: 205291 ($5 in chips)
Seat 6: 2e4217d7 ($5.29 in chips)
2e4217d7: posts small blind $0.02
Hero: posts big blind $0.05
*** HOLE CARDS ***
Dealt to Hero [2s Ah]
Dealt to b61f990d 
Dealt to 5c16018f 
Dealt to ab7b0d6c 
Dealt to 205291 
Dealt to 2e4217d7 
b61f990d: folds
5c16018f: folds
ab7b0d6c: folds
205291: raises $0.08 to $0.13
2e4217d7: calls $0.11
Hero: folds
*** FLOP *** [8s 6h Td]
2e4217d7: checks
205291: bets $0.11
2e4217d7: folds
Uncalled bet ($0.11) returned to 205291
*** SHOWDOWN ***
205291 collected $0.3 from pot
*** SUMMARY ***
Total pot $0.31 | Rake $0.01 | Jackpot $0 | Bingo $0 | Fortune $0 | Tax $0
Board [8s 6h Td]
Seat 1: Hero (big blind) folded before Flop
Seat 2: b61f990d folded before Flop (didn't bet)
Seat 3: 5c16018f folded before Flop (didn't bet)
Seat 4: ab7b0d6c folded before Flop (didn't bet)
Seat 5: 205291 (button) won ($0.3)
Seat 6: 2e4217d7 (small blind) folded on the Flop


Poker Hand #HD1746135126: Hold'em No Limit ($0.02/$0.05) - 2024/04/25 16:53:38
Table 'NLHBlue6' 6-max Seat #4 is the button
Seat 1: Hero ($5.07 in chips)
Seat 2: b61f990d ($1.74 in chips)
Seat 3: 5c16018f ($11.8 in chips)
Seat 4: ab7b0d6c ($6.51 in chips)
Seat 5: 205291 ($5 in chips)
Seat 6: 2e4217d7 ($5.34 in chips)
205291: posts small blind $0.02
2e4217d7: posts big blind $0.05
*** HOLE CARDS ***
Dealt to Hero [5h 7c]
Dealt to b61f990d 
Dealt to 5c16018f 
Dealt to ab7b0d6c 
Dealt to 205291 
Dealt to 2e4217d7 
Hero: folds
b61f990d: folds
5c16018f: raises $0.07 to $0.12
ab7b0d6c: folds
205291: folds
2e4217d7: folds
Uncalled bet ($0.07) returned to 5c16018f
*** SHOWDOWN ***
5c16018f collected $0.12 from pot
*** SUMMARY ***
Total pot $0.12 | Rake $0 | Jackpot $0 | Bingo $0 | Fortune $0 | Tax $0
Seat 1: Hero folded before Flop (didn't bet)
Seat 2: b61f990d folded before Flop (didn't bet)
Seat 3: 5c16018f collected ($0.12)
Seat 4: ab7b0d6c (button) folded before Flop (didn't bet)
Seat 5: 205291 (small blind) folded before Flop
Seat 6: 2e4217d7 (big blind) folded before Flop


Poker Hand #HD1746135076: Hold'em No Limit ($0.02/$0.05) - 2024/04/25 16:53:21
Table 'NLHBlue6' 6-max Seat #3 is the button
Seat 1: Hero ($5 in chips)
Seat 2: b61f990d ($1.74 in chips)
Seat 3: 5c16018f ($11.8 in chips)
Seat 4: ab7b0d6c ($6.53 in chips)
Seat 5: 205291 ($5 in chips)
ab7b0d6c: posts small blind $0.02
205291: posts big blind $0.05
*** HOLE CARDS ***
Dealt to Hero [Jc Js]
Dealt to b61f990d 
Dealt to 5c16018f 
Dealt to ab7b0d6c 
Dealt to 205291 
Hero: raises $0.05 to $0.1
b61f990d: folds
5c16018f: folds
ab7b0d6c: folds
205291: folds
Uncalled bet ($0.05) returned to Hero
*** SHOWDOWN ***
Hero collected $0.12 from pot
*** SUMMARY ***
Total pot $0.12 | Rake $0 | Jackpot $0 | Bingo $0 | Fortune $0 | Tax $0
Seat 1: Hero collected ($0.12)
Seat 2: b61f990d folded before Flop (didn't bet)
Seat 3: 5c16018f (button) folded before Flop (didn't bet)
Seat 4: ab7b0d6c (small blind) folded before Flop
Seat 5: 205291 (big blind) folded before Flop


Poker Hand #HD1746134862: Hold'em No Limit ($0.02/$0.05) - 2024/04/25 16:51:48
Table 'NLHBlue6' 6-max Seat #2 is the button
Seat 1: Hero ($8.69 in chips)
Seat 2: b61f990d ($1.74 in chips)
Seat 3: 5c16018f ($6.15 in chips)
Seat 4: ab7b0d6c ($6.58 in chips)
Seat 5: 205291 ($5 in chips)
5c16018f: posts small blind $0.02
ab7b0d6c: posts big blind $0.05
*** HOLE CARDS ***
Dealt to Hero [Qh Qc]
Dealt to b61f990d 
Dealt to 5c16018f 
Dealt to ab7b0d6c 
Dealt to 205291 
205291: folds
Hero: raises $0.07 to $0.12
b61f990d: folds
5c16018f: raises $0.43 to $0.55
ab7b0d6c: folds
Hero: raises $0.76 to $1.31
5c16018f: raises $4.84 to $6.15 and is all-in
Hero: calls $4.84
5c16018f: shows [Kd Kh]
Hero: shows [Qh Qc]
*** FLOP *** [6s Jd 5c]
*** TURN *** [6s Jd 5c] [5d]
*** RIVER *** [6s Jd 5c 5d] [9d]
*** SHOWDOWN ***
5c16018f collected $11.8 from pot
*** SUMMARY ***
Total pot $12.35 | Rake $0.5 | Jackpot $0.05 | Bingo $0 | Fortune $0 | Tax $0
Board [6s Jd 5c 5d 9d]
Seat 1: Hero showed [Qh Qc] and lost with Pair of Queens and Pair of Fives
Seat 2: b61f990d (button) folded before Flop (didn't bet)
Seat 3: 5c16018f (small blind) showed [Kd Kh] and won ($11.8) with Pair of Kings and Pair of Fives
Seat 4: ab7b0d6c (big blind) folded before Flop
Seat 5: 205291 folded before Flop (didn't bet)


Poker Hand #HD1746134751: Hold'em No Limit ($0.02/$0.05) - 2024/04/25 16:51:05
Table 'NLHBlue6' 6-max Seat #1 is the button
Seat 1: Hero ($8.69 in chips)
Seat 2: b61f990d ($1.76 in chips)
Seat 3: 5c16018f ($6.3 in chips)
Seat 4: ab7b0d6c ($6.42 in chips)
Seat 5: 205291 ($5 in chips)
b61f990d: posts small blind $0.02
5c16018f: posts big blind $0.05
*** HOLE CARDS ***
Dealt to Hero [5d Tc]
Dealt to b61f990d 
Dealt to 5c16018f 
Dealt to ab7b0d6c 
Dealt to 205291 
ab7b0d6c: raises $0.1 to $0.15
205291: folds
Hero: folds
b61f990d: folds
5c16018f: calls $0.1
*** FLOP *** [4s Jc Qs]
5c16018f: checks
ab7b0d6c: bets $0.11
5c16018f: folds
Uncalled bet ($0.11) returned to ab7b0d6c
*** SHOWDOWN ***
ab7b0d6c collected $0.31 from pot
*** SUMMARY ***
Total pot $0.32 | Rake $0.01 | Jackpot $0 | Bingo $0 | Fortune $0 | Tax $0
Board [4s Jc Qs]
Seat 1: Hero (button) folded before Flop (didn't bet)
Seat 2: b61f990d (small blind) folded before Flop
Seat 3: 5c16018f (big blind) folded on the Flop
Seat 4: ab7b0d6c won ($0.31)
Seat 5: 205291 folded before Flop (didn't bet)


Poker Hand #HD1746134679: Hold'em No Limit ($0.02/$0.05) - 2024/04/25 16:50:36
Table 'NLHBlue6' 6-max Seat #5 is the button
Seat 1: Hero ($8.84 in chips)
Seat 2: b61f990d ($1.62 in chips)
Seat 3: 5c16018f ($6.3 in chips)
Seat 4: ab7b0d6c ($6.42 in chips)
Seat 5: 205291 ($5 in chips)
Hero: posts small blind $0.02
b61f990d: posts big blind $0.05
*** HOLE CARDS ***
Dealt to Hero [8d 7d]
Dealt to b61f990d 
Dealt to 5c16018f 
Dealt to ab7b0d6c 
Dealt to 205291 
5c16018f: folds
ab7b0d6c: folds
205291: folds
Hero: raises $0.1 to $0.15
b61f990d: raises $0.3 to $0.45
Hero: folds
Uncalled bet ($0.3) returned to b61f990d
*** SHOWDOWN ***
b61f990d collected $0.29 from pot
*** SUMMARY ***
Total pot $0.3 | Rake $0.01 | Jackpot $0 | Bingo $0 | Fortune $0 | Tax $0
Seat 1: Hero (small blind) folded before Flop
Seat 2: b61f990d (big blind) collected ($0.29)
Seat 3: 5c16018f folded before Flop (didn't bet)
Seat 4: ab7b0d6c folded before Flop (didn't bet)
Seat 5: 205291 (button) folded before Flop (didn't bet)


Poker Hand #HD1746134660: Hold'em No Limit ($0.02/$0.05) - 2024/04/25 16:50:25
Table 'NLHBlue6' 6-max Seat #4 is the button
Seat 1: Hero ($8.82 in chips)
Seat 2: b61f990d ($1.62 in chips)
Seat 3: 5c16018f ($6.3 in chips)
Seat 4: ab7b0d6c ($6.42 in chips)
Seat 5: 205291 ($5 in chips)
205291: posts small blind $0.02
Hero: posts big blind $0.05
*** HOLE CARDS ***
Dealt to Hero [2d 5d]
Dealt to b61f990d 
Dealt to 5c16018f 
Dealt to ab7b0d6c 
Dealt to 205291 
b61f990d: folds
5c16018f: folds
ab7b0d6c: folds
205291: folds
Uncalled bet ($0.03) returned to Hero
*** SHOWDOWN ***
Hero collected $0.04 from pot
*** SUMMARY ***
Total pot $0.04 | Rake $0 | Jackpot $0 | Bingo $0 | Fortune $0 | Tax $0
Seat 1: Hero (big blind) collected ($0.04)
Seat 2: b61f990d folded before Flop (didn't bet)
Seat 3: 5c16018f folded before Flop (didn't bet)
Seat 4: ab7b0d6c (button) folded before Flop (didn't bet)
Seat 5: 205291 (small blind) folded before Flop


Poker Hand #HD1746134585: Hold'em No Limit ($0.02/$0.05) - 2024/04/25 16:49:56
Table 'NLHBlue6' 6-max Seat #3 is the button
Seat 1: Hero ($8.82 in chips)
Seat 2: b61f990d ($1.62 in chips)
Seat 3: 5c16018f ($6.3 in chips)
Seat 4: ab7b0d6c ($6.37 in chips)
Seat 5: 205291 ($5 in chips)
ab7b0d6c: posts small blind $0.02
205291: posts big blind $0.05
*** HOLE CARDS ***
Dealt to Hero [4h 3h]
Dealt to b61f990d 
Dealt to 5c16018f 
Dealt to ab7b0d6c 
Dealt to 205291 
Hero: folds
b61f990d: folds
5c16018f: folds
ab7b0d6c: calls $0.03
205291: checks
*** FLOP *** [7d 9s Ac]
ab7b0d6c: bets $0.05
205291: folds
Uncalled bet ($0.05) returned to ab7b0d6c
*** SHOWDOWN ***
ab7b0d6c collected $0.1 from pot
*** SUMMARY ***
Total pot $0.1 | Rake $0 | Jackpot $0 | Bingo $0 | Fortune $0 | Tax $0
Board [7d 9s Ac]
Seat 1: Hero folded before Flop (didn't bet)
Seat 2: b61f990d folded before Flop (didn't bet)
Seat 3: 5c16018f (button) folded before Flop (didn't bet)
Seat 4: ab7b0d6c (small blind) won ($0.1)
Seat 5: 205291 (big blind) folded on the Flop


Poker Hand #HD1746134499: Hold'em No Limit ($0.02/$0.05) - 2024/04/25 16:49:28
Table 'NLHBlue6' 6-max Seat #2 is the button
Seat 1: Hero ($8.64 in chips)
Seat 2: b61f990d ($1.74 in chips)
Seat 3: 5c16018f ($6.32 in chips)
Seat 4: ab7b0d6c ($6.42 in chips)
Seat 5: 205291 ($5 in chips)
5c16018f: posts small blind $0.02
ab7b0d6c: posts big blind $0.05
*** HOLE CARDS ***
Dealt to Hero [Ad Ks]
Dealt to b61f990d 
Dealt to 5c16018f 
Dealt to ab7b0d6c 
Dealt to 205291 
205291: folds
Hero: raises $0.07 to $0.12
b61f990d: calls $0.12
5c16018f: folds
ab7b0d6c: folds
*** FLOP *** [5h Js Jc]
Hero: bets $0.15
b61f990d: folds
Uncalled bet ($0.15) returned to Hero
*** SHOWDOWN ***
Hero collected $0.3 from pot
*** SUMMARY ***
Total pot $0.31 | Rake $0.01 | Jackpot $0 | Bingo $0 | Fortune $0 | Tax $0
Board [5h Js Jc]
Seat 1: Hero won ($0.3)
Seat 2: b61f990d (button) folded on the Flop
Seat 3: 5c16018f (small blind) folded before Flop
Seat 4: ab7b0d6c (big blind) folded before Flop
Seat 5: 205291 folded before Flop (didn't bet)


Poker Hand #HD1746134344: Hold'em No Limit ($0.02/$0.05) - 2024/04/25 16:48:22
Table 'NLHBlue6' 6-max Seat #1 is the button
Seat 1: Hero ($8.64 in chips)
Seat 2: b61f990d ($1.76 in chips)
Seat 3: 5c16018f ($6.37 in chips)
Seat 4: ab7b0d6c ($5.73 in chips)
Seat 5: 205291 ($5 in chips)
b61f990d: posts small blind $0.02
5c16018f: posts big blind $0.05
*** HOLE CARDS ***
Dealt to Hero [9c 8c]
Dealt to b61f990d 
Dealt to 5c16018f 
Dealt to ab7b0d6c 
Dealt to 205291 
ab7b0d6c: raises $0.1 to $0.15
205291: raises $0.28 to $0.43
Hero: folds
b61f990d: folds
5c16018f: folds
ab7b0d6c: calls $0.28
*** FLOP *** [Td 3h 4s]
ab7b0d6c: checks
205291: bets $0.31
ab7b0d6c: calls $0.31
*** TURN *** [Td 3h 4s] [Qs]
ab7b0d6c: checks
205291: checks
*** RIVER *** [Td 3h 4s Qs] [Kd]
ab7b0d6c: bets $0.52
205291: folds
Uncalled bet ($0.52) returned to ab7b0d6c
*** SHOWDOWN ***
ab7b0d6c collected $1.43 from pot
*** SUMMARY ***
Total pot $1.55 | Rake $0.07 | Jackpot $0.05 | Bingo $0 | Fortune $0 | Tax $0
Board [Td 3h 4s Qs Kd]
Seat 1: Hero (button) folded before Flop (didn't bet)
Seat 2: b61f990d (small blind) folded before Flop
Seat 3: 5c16018f (big blind) folded before Flop
Seat 4: ab7b0d6c won ($1.43)
Seat 5: 205291 folded on the River


Poker Hand #HD1746134210: Hold'em No Limit ($0.02/$0.05) - 2024/04/25 16:47:25
Table 'NLHBlue6' 6-max Seat #6 is the button
Seat 1: Hero ($8.66 in chips)
Seat 2: b61f990d ($1.81 in chips)
Seat 3: 5c16018f ($6.37 in chips)
Seat 4: ab7b0d6c ($5.73 in chips)
Seat 5: 205291 ($5.11 in chips)
Seat 6: 2e4217d7 ($5.15 in chips)
Hero: posts small blind $0.02
b61f990d: posts big blind $0.05
*** HOLE CARDS ***
Dealt to Hero [Tc 4h]
Dealt to b61f990d 
Dealt to 5c16018f 
Dealt to ab7b0d6c 
Dealt to 205291 
Dealt to 2e4217d7 
5c16018f: folds
ab7b0d6c: folds
205291: raises $0.08 to $0.13
2e4217d7: calls $0.13
Hero: folds
b61f990d: folds
*** FLOP *** [9h Ad 7h]
205291: checks
2e4217d7: checks
*** TURN *** [9h Ad 7h] [Ah]
205291: checks
2e4217d7: checks
*** RIVER *** [9h Ad 7h Ah] [2s]
205291: checks
2e4217d7: checks
205291: shows [Ts Js] (Pair of Aces)
2e4217d7: shows [Ks 6s] (Pair of Aces)
*** SHOWDOWN ***
2e4217d7 collected $0.32 from pot
*** SUMMARY ***
Total pot $0.33 | Rake $0.01 | Jackpot $0 | Bingo $0 | Fortune $0 | Tax $0
Board [9h Ad 7h Ah 2s]
Seat 1: Hero (small blind) folded before Flop
Seat 2: b61f990d (big blind) folded before Flop
Seat 3: 5c16018f folded before Flop (didn't bet)
Seat 4: ab7b0d6c folded before Flop (didn't bet)
Seat 5: 205291 showed [Ts Js] and lost with Pair of Aces
Seat 6: 2e4217d7 (button) showed [Ks 6s] and won ($0.32) with Pair of Aces


Poker Hand #HD1746134161: Hold'em No Limit ($0.02/$0.05) - 2024/04/25 16:47:06
Table 'NLHBlue6' 6-max Seat #5 is the button
Seat 1: Hero ($8.64 in chips)
Seat 2: b61f990d ($1.81 in chips)
Seat 3: 5c16018f ($6.37 in chips)
Seat 4: ab7b0d6c ($5.73 in chips)
Seat 5: 205291 ($5.11 in chips)
Seat 6: 2e4217d7 ($5.17 in chips)
2e4217d7: posts small blind $0.02
Hero: posts big blind $0.05
*** HOLE CARDS ***
Dealt to Hero [8d 8s]
Dealt to b61f990d 
Dealt to 5c16018f 
Dealt to ab7b0d6c 
Dealt to 205291 
Dealt to 2e4217d7 
b61f990d: folds
5c16018f: folds
ab7b0d6c: folds
205291: folds
2e4217d7: folds
Uncalled bet ($0.03) returned to Hero
*** SHOWDOWN ***
Hero collected $0.04 from pot
*** SUMMARY ***
Total pot $0.04 | Rake $0 | Jackpot $0 | Bingo $0 | Fortune $0 | Tax $0
Seat 1: Hero (big blind) collected ($0.04)
Seat 2: b61f990d folded before Flop (didn't bet)
Seat 3: 5c16018f folded before Flop (didn't bet)
Seat 4: ab7b0d6c folded before Flop (didn't bet)
Seat 5: 205291 (button) folded before Flop (didn't bet)
Seat 6: 2e4217d7 (small blind) folded before Flop


Poker Hand #HD1746134077: Hold'em No Limit ($0.02/$0.05) - 2024/04/25 16:46:29
Table 'NLHBlue6' 6-max Seat #4 is the button
Seat 1: Hero ($8.64 in chips)
Seat 2: b61f990d ($1.74 in chips)
Seat 3: 5c16018f ($6.37 in chips)
Seat 4: ab7b0d6c ($5.73 in chips)
Seat 5: 205291 ($5.13 in chips)
Seat 6: 2e4217d7 ($5.22 in chips)
205291: posts small blind $0.02
2e4217d7: posts big blind $0.05
*** HOLE CARDS ***
Dealt to Hero [7h 6s]
Dealt to b61f990d 
Dealt to 5c16018f 
Dealt to ab7b0d6c 
Dealt to 205291 
Dealt to 2e4217d7 
Hero: folds
b61f990d: raises $0.05 to $0.1
5c16018f: folds
ab7b0d6c: folds
205291: folds
2e4217d7: folds
Uncalled bet ($0.05) returned to b61f990d
*** SHOWDOWN ***
b61f990d collected $0.12 from pot
*** SUMMARY ***
Total pot $0.12 | Rake $0 | Jackpot $0 | Bingo $0 | Fortune $0 | Tax $0
Seat 1: Hero folded before Flop (didn't bet)
Seat 2: b61f990d collected ($0.12)
Seat 3: 5c16018f folded before Flop (didn't bet)
Seat 4: ab7b0d6c (button) folded before Flop (didn't bet)
Seat 5: 205291 (small blind) folded before Flop
Seat 6: 2e4217d7 (big blind) folded before Flop


Poker Hand #HD1746133938: Hold'em No Limit ($0.02/$0.05) - 2024/04/25 16:45:24
Table 'NLHBlue6' 6-max Seat #3 is the button
Seat 1: Hero ($8.64 in chips)
Seat 2: b61f990d ($1.74 in chips)
Seat 3: 5c16018f ($6.49 in chips)
Seat 4: ab7b0d6c ($5.75 in chips)
Seat 5: 205291 ($5 in chips)
Seat 6: 2e4217d7 ($5.22 in chips)
ab7b0d6c: posts small blind $0.02
205291: posts big blind $0.05
*** HOLE CARDS ***
Dealt to Hero [8d 9h]
Dealt to b61f990d 
Dealt to 5c16018f 
Dealt to ab7b0d6c 
Dealt to 205291 
Dealt to 2e4217d7 
2e4217d7: folds
Hero: folds
b61f990d: folds
5c16018f: raises $0.07 to $0.12
ab7b0d6c: folds
205291: calls $0.07
*** FLOP *** [2h 6d 2s]
205291: checks
5c16018f: checks
*** TURN *** [2h 6d 2s] [Td]
205291: bets $0.2
5c16018f: folds
Uncalled bet ($0.2) returned to 205291
*** SHOWDOWN ***
205291 collected $0.25 from pot
*** SUMMARY ***
Total pot $0.26 | Rake $0.01 | Jackpot $0 | Bingo $0 | Fortune $0 | Tax $0
Board [2h 6d 2s Td]
Seat 1: Hero folded before Flop (didn't bet)
Seat 2: b61f990d folded before Flop (didn't bet)
Seat 3: 5c16018f (button) folded on the Turn
Seat 4: ab7b0d6c (small blind) folded before Flop
Seat 5: 205291 (big blind) won ($0.25)
Seat 6: 2e4217d7 folded before Flop (didn't bet)


Poker Hand #HD1746133888: Hold'em No Limit ($0.02/$0.05) - 2024/04/25 16:45:06
Table 'NLHBlue6' 6-max Seat #2 is the button
Seat 1: Hero ($8.57 in chips)
Seat 2: b61f990d ($1.74 in chips)
Seat 3: 5c16018f ($6.51 in chips)
Seat 4: ab7b0d6c ($5.8 in chips)
Seat 5: 205291 ($5 in chips)
Seat 6: 2e4217d7 ($5.22 in chips)
5c16018f: posts small blind $0.02
ab7b0d6c: posts big blind $0.05
*** HOLE CARDS ***
Dealt to Hero [Ad Ac]
Dealt to b61f990d 
Dealt to 5c16018f 
Dealt to ab7b0d6c 
Dealt to 205291 
Dealt to 2e4217d7 
205291: folds
2e4217d7: folds
Hero: raises $0.07 to $0.12
b61f990d: folds
5c16018f: folds
ab7b0d6c: folds
Uncalled bet ($0.07) returned to Hero
*** SHOWDOWN ***
Hero collected $0.12 from pot
*** SUMMARY ***
Total pot $0.12 | Rake $0 | Jackpot $0 | Bingo $0 | Fortune $0 | Tax $0
Seat 1: Hero collected ($0.12)
Seat 2: b61f990d (button) folded before Flop (didn't bet)
Seat 3: 5c16018f (small blind) folded before Flop
Seat 4: ab7b0d6c (big blind) folded before Flop
Seat 5: 205291 folded before Flop (didn't bet)
Seat 6: 2e4217d7 folded before Flop (didn't bet)


Poker Hand #HD1746133780: Hold'em No Limit ($0.02/$0.05) - 2024/04/25 16:44:22
Table 'NLHBlue6' 6-max Seat #1 is the button
Seat 1: Hero ($8.57 in chips)
Seat 2: b61f990d ($1.89 in chips)
Seat 3: 5c16018f ($6.56 in chips)
Seat 4: ab7b0d6c ($5.47 in chips)
Seat 5: 205291 ($5 in chips)
Seat 6: 2e4217d7 ($5.37 in chips)
b61f990d: posts small blind $0.02
5c16018f: posts big blind $0.05
*** HOLE CARDS ***
Dealt to Hero [Js 8d]
Dealt to b61f990d 
Dealt to 5c16018f 
Dealt to ab7b0d6c 
Dealt to 205291 
Dealt to 2e4217d7 
ab7b0d6c: raises $0.1 to $0.15
205291: folds
2e4217d7: calls $0.15
Hero: folds
b61f990d: calls $0.13
5c16018f: folds
*** FLOP *** [7d 9c As]
b61f990d: checks
ab7b0d6c: bets $0.17
2e4217d7: folds
b61f990d: folds
Uncalled bet ($0.17) returned to ab7b0d6c
*** SHOWDOWN ***
ab7b0d6c collected $0.48 from pot
*** SUMMARY ***
Total pot $0.5 | Rake $0.02 | Jackpot $0 | Bingo $0 | Fortune $0 | Tax $0
Board [7d 9c As]
Seat 1: Hero (button) folded before Flop (didn't bet)
Seat 2: b61f990d (small blind) folded on the Flop
Seat 3: 5c16018f (big blind) folded before Flop
Seat 4: ab7b0d6c won ($0.48)
Seat 5: 205291 folded before Flop (didn't bet)
Seat 6: 2e4217d7 folded on the Flop


Poker Hand #HD1746133582: Hold'em No Limit ($0.02/$0.05) - 2024/04/25 16:43:00
Table 'NLHBlue6' 6-max Seat #6 is the button
Seat 1: Hero ($8.59 in chips)
Seat 2: b61f990d ($1.94 in chips)
Seat 3: 5c16018f ($5.7 in chips)
Seat 4: ab7b0d6c ($5.47 in chips)
Seat 5: 205291 ($5 in chips)
Seat 6: 2e4217d7 ($6.3 in chips)
Hero: posts small blind $0.02
b61f990d: posts big blind $0.05
*** HOLE CARDS ***
Dealt to Hero [5d Ad]
Dealt to b61f990d 
Dealt to 5c16018f 
Dealt to ab7b0d6c 
Dealt to 205291 
Dealt to 2e4217d7 
5c16018f: raises $0.09 to $0.14
ab7b0d6c: folds
205291: folds
2e4217d7: raises $0.24 to $0.38
Hero: folds
b61f990d: folds
5c16018f: calls $0.24
*** FLOP *** [Js Qh Th]
5c16018f: checks
2e4217d7: checks
*** TURN *** [Js Qh Th] [Kh]
5c16018f: checks
2e4217d7: bets $0.55
5c16018f: calls $0.55
*** RIVER *** [Js Qh Th Kh] [5h]
5c16018f: checks
2e4217d7: checks
5c16018f: shows [Qs Qd] (Three Queens)
2e4217d7: shows [Jd Ts] (Pair of Jacks and Pair of Tens)
*** SHOWDOWN ***
5c16018f collected $1.79 from pot
*** SUMMARY ***
Total pot $1.93 | Rake $0.09 | Jackpot $0.05 | Bingo $0 | Fortune $0 | Tax $0
Board [Js Qh Th Kh 5h]
Seat 1: Hero (small blind) folded before Flop
Seat 2: b61f990d (big blind) folded before Flop
Seat 3: 5c16018f showed [Qs Qd] and won ($1.79) with Three Queens
Seat 4: ab7b0d6c folded before Flop (didn't bet)
Seat 5: 205291 folded before Flop (didn't bet)
Seat 6: 2e4217d7 (button) showed [Jd Ts] and lost with Pair of Jacks and Pair of Tens


Poker Hand #HD1746133509: Hold'em No Limit ($0.02/$0.05) - 2024/04/25 16:42:32
Table 'NLHBlue6' 6-max Seat #5 is the button
Seat 1: Hero ($8.64 in chips)
Seat 2: b61f990d ($1.94 in chips)
Seat 3: 5c16018f ($5.7 in chips)
Seat 4: ab7b0d6c ($5.47 in chips)
Seat 5: 205291 ($5 in chips)
Seat 6: 2e4217d7 ($6.25 in chips)
2e4217d7: posts small blind $0.02
Hero: posts big blind $0.05
*** HOLE CARDS ***
Dealt to Hero [4d 3h]
Dealt to b61f990d 
Dealt to 5c16018f 
Dealt to ab7b0d6c 
Dealt to 205291 
Dealt to 2e4217d7 
b61f990d: folds
5c16018f: folds
ab7b0d6c: folds
205291: folds
2e4217d7: raises $0.05 to $0.1
Hero: folds
Uncalled bet ($0.05) returned to 2e4217d7
*** SHOWDOWN ***
2e4217d7 collected $0.1 from pot
*** SUMMARY ***
Total pot $0.1 | Rake $0 | Jackpot $0 | Bingo $0 | Fortune $0 | Tax $0
Seat 1: Hero (big blind) folded before Flop
Seat 2: b61f990d folded before Flop (didn't bet)
Seat 3: 5c16018f folded before Flop (didn't bet)
Seat 4: ab7b0d6c folded before Flop (didn't bet)
Seat 5: 205291 (button) folded before Flop (didn't bet)
Seat 6: 2e4217d7 (small blind) collected ($0.1)


Poker Hand #HD1746133447: Hold'em No Limit ($0.02/$0.05) - 2024/04/25 16:42:06
Table 'NLHBlue6' 6-max Seat #4 is the button
Seat 1: Hero ($8.74 in chips)
Seat 2: b61f990d ($1.94 in chips)
Seat 3: 5c16018f ($5.7 in chips)
Seat 4: ab7b0d6c ($5.31 in chips)
Seat 5: 205291 ($5 in chips)
Seat 6: 2e4217d7 ($6.3 in chips)
205291: posts small blind $0.02
2e4217d7: posts big blind $0.05
*** HOLE CARDS ***
Dealt to Hero [Jd Qh]
Dealt to b61f990d 
Dealt to 5c16018f 
Dealt to ab7b0d6c 
Dealt to 205291 
Dealt to 2e4217d7 
Hero: raises $0.05 to $0.1
b61f990d: folds
5c16018f: folds
ab7b0d6c: raises $0.4 to $0.5
205291: folds
2e4217d7: folds
Hero: folds
Uncalled bet ($0.4) returned to ab7b0d6c
*** SHOWDOWN ***
ab7b0d6c collected $0.26 from pot
*** SUMMARY ***
Total pot $0.27 | Rake $0.01 | Jackpot $0 | Bingo $0 | Fortune $0 | Tax $0
Seat 1: Hero folded before Flop
Seat 2: b61f990d folded before Flop (didn't bet)
Seat 3: 5c16018f folded before Flop (didn't bet)
Seat 4: ab7b0d6c (button) collected ($0.26)
Seat 5: 205291 (small blind) folded before Flop
Seat 6: 2e4217d7 (big blind) folded before Flop


Poker Hand #HD1746133385: Hold'em No Limit ($0.02/$0.05) - 2024/04/25 16:41:41
Table 'NLHBlue6' 6-max Seat #3 is the button
Seat 1: Hero ($8.74 in chips)
Seat 2: b61f990d ($1.87 in chips)
Seat 3: 5c16018f ($5.7 in chips)
Seat 4: ab7b0d6c ($5.33 in chips)
Seat 5: 205291 ($5 in chips)
Seat 6: 2e4217d7 ($6.3 in chips)
ab7b0d6c: posts small blind $0.02
205291: posts big blind $0.05
*** HOLE CARDS ***
Dealt to Hero [8d Js]
Dealt to b61f990d 
Dealt to 5c16018f 
Dealt to ab7b0d6c 
Dealt to 205291 
Dealt to 2e4217d7 
2e4217d7: folds
Hero: folds
b61f990d: raises $0.05 to $0.1
5c16018f: folds
ab7b0d6c: folds
205291: folds
Uncalled bet ($0.05) returned to b61f990d
*** SHOWDOWN ***
b61f990d collected $0.12 from pot
*** SUMMARY ***
Total pot $0.12 | Rake $0 | Jackpot $0 | Bingo $0 | Fortune $0 | Tax $0
Seat 1: Hero folded before Flop (didn't bet)
Seat 2: b61f990d collected ($0.12)
Seat 3: 5c16018f (button) folded before Flop (didn't bet)
Seat 4: ab7b0d6c (small blind) folded before Flop
Seat 5: 205291 (big blind) folded before Flop
Seat 6: 2e4217d7 folded before Flop (didn't bet)


Poker Hand #HD1746133189: Hold'em No Limit ($0.02/$0.05) - 2024/04/25 16:40:18
Table 'NLHBlue6' 6-max Seat #2 is the button
Seat 1: Hero ($8.74 in chips)
Seat 2: b61f990d ($1.87 in chips)
Seat 3: 5c16018f ($5.72 in chips)
Seat 4: ab7b0d6c ($5 in chips)
Seat 5: 205291 ($5 in chips)
Seat 6: 2e4217d7 ($6.64 in chips)
5c16018f: posts small blind $0.02
ab7b0d6c: posts big blind $0.05
*** HOLE CARDS ***
Dealt to Hero [Jc Qd]
Dealt to b61f990d 
Dealt to 5c16018f 
Dealt to ab7b0d6c 
Dealt to 205291 
Dealt to 2e4217d7 
205291: folds
2e4217d7: raises $0.09 to $0.14
Hero: folds
b61f990d: folds
5c16018f: folds
ab7b0d6c: calls $0.09
*** FLOP *** [4h 4c Js]
ab7b0d6c: checks
2e4217d7: checks
*** TURN *** [4h 4c Js] [Jh]
ab7b0d6c: checks
2e4217d7: bets $0.2
ab7b0d6c: calls $0.2
*** RIVER *** [4h 4c Js Jh] [6c]
ab7b0d6c: checks
2e4217d7: checks
ab7b0d6c: shows [Ac 6s] (Pair of Jacks and Pair of Sixes)
2e4217d7: shows [8s Ks] (Pair of Jacks and Pair of Fours)
*** SHOWDOWN ***
ab7b0d6c collected $0.67 from pot
*** SUMMARY ***
Total pot $0.7 | Rake $0.03 | Jackpot $0 | Bingo $0 | Fortune $0 | Tax $0
Board [4h 4c Js Jh 6c]
Seat 1: Hero folded before Flop (didn't bet)
Seat 2: b61f990d (button) folded before Flop (didn't bet)
Seat 3: 5c16018f (small blind) folded before Flop
Seat 4: ab7b0d6c (big blind) showed [Ac 6s] and won ($0.67) with Pair of Jacks and Pair of Sixes
Seat 5: 205291 folded before Flop (didn't bet)
Seat 6: 2e4217d7 showed [8s Ks] and lost with Pair of Jacks and Pair of Fours


Poker Hand #HD1746133080: Hold'em No Limit ($0.02/$0.05) - 2024/04/25 16:39:35
Table 'NLHBlue6' 6-max Seat #1 is the button
Seat 1: Hero ($8.74 in chips)
Seat 2: b61f990d ($2.01 in chips)
Seat 3: 5c16018f ($5.77 in chips)
Seat 4: ab7b0d6c ($5 in chips)
Seat 5: 205291 ($5 in chips)
Seat 6: 2e4217d7 ($6.46 in chips)
b61f990d: posts small blind $0.02
5c16018f: posts big blind $0.05
*** HOLE CARDS ***
Dealt to Hero [Jc 3h]
Dealt to b61f990d 
Dealt to 5c16018f 
Dealt to ab7b0d6c 
Dealt to 205291 
Dealt to 2e4217d7 
ab7b0d6c: folds
205291: folds
2e4217d7: raises $0.09 to $0.14
Hero: folds
b61f990d: calls $0.12
5c16018f: folds
*** FLOP *** [As 3d 3c]
b61f990d: checks
2e4217d7: bets $0.22
b61f990d: folds
Uncalled bet ($0.22) returned to 2e4217d7
*** SHOWDOWN ***
2e4217d7 collected $0.32 from pot
*** SUMMARY ***
Total pot $0.33 | Rake $0.01 | Jackpot $0 | Bingo $0 | Fortune $0 | Tax $0
Board [As 3d 3c]
Seat 1: Hero (button) folded before Flop (didn't bet)
Seat 2: b61f990d (small blind) folded on the Flop
Seat 3: 5c16018f (big blind) folded before Flop
Seat 4: ab7b0d6c folded before Flop (didn't bet)
Seat 5: 205291 folded before Flop (didn't bet)
Seat 6: 2e4217d7 won ($0.32)


Poker Hand #HD1746132975: Hold'em No Limit ($0.02/$0.05) - 2024/04/25 16:38:49
Table 'NLHBlue6' 6-max Seat #6 is the button
Seat 1: Hero ($8.57 in chips)
Seat 2: b61f990d ($2.06 in chips)
Seat 3: 5c16018f ($5.77 in chips)
Seat 4: ab7b0d6c ($5 in chips)
Seat 5: 205291 ($5.05 in chips)
Seat 6: 2e4217d7 ($6.46 in chips)
Hero: posts small blind $0.02
b61f990d: posts big blind $0.05
*** HOLE CARDS ***
Dealt to Hero [Th Kh]
Dealt to b61f990d 
Dealt to 5c16018f 
Dealt to ab7b0d6c 
Dealt to 205291 
Dealt to 2e4217d7 
5c16018f: folds
ab7b0d6c: folds
205291: raises $0.08 to $0.13
2e4217d7: folds
Hero: raises $0.42 to $0.55
b61f990d: folds
205291: folds
Uncalled bet ($0.42) returned to Hero
*** SHOWDOWN ***
Hero collected $0.3 from pot
*** SUMMARY ***
Total pot $0.31 | Rake $0.01 | Jackpot $0 | Bingo $0 | Fortune $0 | Tax $0
Seat 1: Hero (small blind) collected ($0.3)
Seat 2: b61f990d (big blind) folded before Flop
Seat 3: 5c16018f folded before Flop (didn't bet)
Seat 4: ab7b0d6c folded before Flop (didn't bet)
Seat 5: 205291 folded before Flop
Seat 6: 2e4217d7 (button) folded before Flop (didn't bet)


Poker Hand #HD1746132866: Hold'em No Limit ($0.02/$0.05) - 2024/04/25 16:38:03
Table 'NLHBlue6' 6-max Seat #5 is the button
Seat 1: Hero ($8.67 in chips)
Seat 2: b61f990d ($1.95 in chips)
Seat 3: 5c16018f ($5.77 in chips)
Seat 4: ab7b0d6c ($5 in chips)
Seat 5: 205291 ($5.05 in chips)
Seat 6: 2e4217d7 ($6.48 in chips)
2e4217d7: posts small blind $0.02
Hero: posts big blind $0.05
*** HOLE CARDS ***
Dealt to Hero [Ks Jh]
Dealt to b61f990d 
Dealt to 5c16018f 
Dealt to ab7b0d6c 
Dealt to 205291 
Dealt to 2e4217d7 
b61f990d: raises $0.05 to $0.1
5c16018f: folds
ab7b0d6c: folds
205291: folds
2e4217d7: folds
Hero: calls $0.05
*** FLOP *** [7h 9s Ad]
Hero: checks
b61f990d: bets $0.11
Hero: folds
Uncalled bet ($0.11) returned to b61f990d
*** SHOWDOWN ***
b61f990d collected $0.21 from pot
*** SUMMARY ***
Total pot $0.22 | Rake $0.01 | Jackpot $0 | Bingo $0 | Fortune $0 | Tax $0
Board [7h 9s Ad]
Seat 1: Hero (big blind) folded on the Flop
Seat 2: b61f990d won ($0.21)
Seat 3: 5c16018f folded before Flop (didn't bet)
Seat 4: ab7b0d6c folded before Flop (didn't bet)
Seat 5: 205291 (button) folded before Flop (didn't bet)
Seat 6: 2e4217d7 (small blind) folded before Flop


Poker Hand #HD1746132801: Hold'em No Limit ($0.02/$0.05) - 2024/04/25 16:37:43
Table 'NLHBlue6' 6-max Seat #4 is the button
Seat 1: Hero ($8.67 in chips)
Seat 2: b61f990d ($1.95 in chips)
Seat 3: 5c16018f ($5.77 in chips)
Seat 4: ab7b0d6c ($5 in chips)
Seat 5: 205291 ($5 in chips)
Seat 6: 2e4217d7 ($6.53 in chips)
205291: posts small blind $0.02
2e4217d7: posts big blind $0.05
*** HOLE CARDS ***
Dealt to Hero [6h Ts]
Dealt to b61f990d 
Dealt to 5c16018f 
Dealt to ab7b0d6c 
Dealt to 205291 
Dealt to 2e4217d7 
Hero: folds
b61f990d: folds
5c16018f: folds
ab7b0d6c: folds
205291: raises $0.1 to $0.15
2e4217d7: folds
Uncalled bet ($0.1) returned to 205291
*** SHOWDOWN ***
205291 collected $0.1 from pot
*** SUMMARY ***
Total pot $0.1 | Rake $0 | Jackpot $0 | Bingo $0 | Fortune $0 | Tax $0
Seat 1: Hero folded before Flop (didn't bet)
Seat 2: b61f990d folded before Flop (didn't bet)
Seat 3: 5c16018f folded before Flop (didn't bet)
Seat 4: ab7b0d6c (button) folded before Flop (didn't bet)
Seat 5: 205291 (small blind) collected ($0.1)
Seat 6: 2e4217d7 (big blind) folded before Flop


Poker Hand #HD1746132649: Hold'em No Limit ($0.02/$0.05) - 2024/04/25 16:36:40
Table 'NLHBlue6' 6-max Seat #3 is the button
Seat 1: Hero ($8.67 in chips)
Seat 2: b61f990d ($2.33 in chips)
Seat 3: 5c16018f ($5.77 in chips)
Seat 4: ab7b0d6c ($5 in chips)
Seat 5: 205291 ($5.05 in chips)
Seat 6: 2e4217d7 ($6.12 in chips)
ab7b0d6c: posts small blind $0.02
205291: posts big blind $0.05
*** HOLE CARDS ***
Dealt to Hero [Ad 9s]
Dealt to b61f990d 
Dealt to 5c16018f 
Dealt to ab7b0d6c 
Dealt to 205291 
Dealt to 2e4217d7 
2e4217d7: raises $0.09 to $0.14
Hero: folds
b61f990d: calls $0.14
5c16018f: folds
ab7b0d6c: folds
205291: folds
*** FLOP *** [Jd 9d 4c]
2e4217d7: bets $0.24
b61f990d: calls $0.24
*** TURN *** [Jd 9d 4c] [3d]
2e4217d7: bets $0.55
b61f990d: folds
Uncalled bet ($0.55) returned to 2e4217d7
*** SHOWDOWN ***
2e4217d7 collected $0.79 from pot
*** SUMMARY ***
Total pot $0.83 | Rake $0.04 | Jackpot $0 | Bingo $0 | Fortune $0 | Tax $0
Board [Jd 9d 4c 3d]
Seat 1: Hero folded before Flop (didn't bet)
Seat 2: b61f990d folded on the Turn
Seat 3: 5c16018f (button) folded before Flop (didn't bet)
Seat 4: ab7b0d6c (small blind) folded before Flop
Seat 5: 205291 (big blind) folded before Flop
Seat 6: 2e4217d7 won ($0.79)


Poker Hand #HD1746132530: Hold'em No Limit ($0.02/$0.05) - 2024/04/25 16:35:47
Table 'NLHBlue6' 6-max Seat #2 is the button
Seat 1: Hero ($8.67 in chips)
Seat 2: b61f990d ($2.86 in chips)
Seat 3: 5c16018f ($5.24 in chips)
Seat 4: ab7b0d6c ($5 in chips)
Seat 5: 205291 ($5.05 in chips)
Seat 6: 2e4217d7 ($6.12 in chips)
5c16018f: posts small blind $0.02
ab7b0d6c: posts big blind $0.05
*** HOLE CARDS ***
Dealt to Hero [Jd 2h]
Dealt to b61f990d 
Dealt to 5c16018f 
Dealt to ab7b0d6c 
Dealt to 205291 
Dealt to 2e4217d7 
205291: folds
2e4217d7: folds
Hero: folds
b61f990d: raises $0.05 to $0.1
5c16018f: raises $0.43 to $0.53
ab7b0d6c: folds
b61f990d: calls $0.43
*** FLOP *** [7c Kd 7d]
5c16018f: bets $0.59
b61f990d: folds
Uncalled bet ($0.59) returned to 5c16018f
*** SHOWDOWN ***
5c16018f collected $1.06 from pot
*** SUMMARY ***
Total pot $1.11 | Rake $0.05 | Jackpot $0 | Bingo $0 | Fortune $0 | Tax $0
Board [7c Kd 7d]
Seat 1: Hero folded before Flop (didn't bet)
Seat 2: b61f990d (button) folded on the Flop
Seat 3: 5c16018f (small blind) won ($1.06)
Seat 4: ab7b0d6c (big blind) folded before Flop
Seat 5: 205291 folded before Flop (didn't bet)
Seat 6: 2e4217d7 folded before Flop (didn't bet)


Poker Hand #HD1746132476: Hold'em No Limit ($0.02/$0.05) - 2024/04/25 16:35:28
Table 'NLHBlue6' 6-max Seat #1 is the button
Seat 1: Hero ($8.67 in chips)
Seat 2: b61f990d ($2.81 in chips)
Seat 3: 5c16018f ($5.29 in chips)
Seat 4: ab7b0d6c ($5 in chips)
Seat 5: 205291 ($5.05 in chips)
Seat 6: 2e4217d7 ($6.12 in chips)
b61f990d: posts small blind $0.02
5c16018f: posts big blind $0.05
*** HOLE CARDS ***
Dealt to Hero [Qs 2c]
Dealt to b61f990d 
Dealt to 5c16018f 
Dealt to ab7b0d6c 
Dealt to 205291 
Dealt to 2e4217d7 
ab7b0d6c: folds
205291: folds
2e4217d7: folds
Hero: folds
b61f990d: raises $0.05 to $0.1
5c16018f: folds
Uncalled bet ($0.05) returned to b61f990d
*** SHOWDOWN ***
b61f990d collected $0.1 from pot
*** SUMMARY ***
Total pot $0.1 | Rake $0 | Jackpot $0 | Bingo $0 | Fortune $0 | Tax $0
Seat 1: Hero (button) folded before Flop (didn't bet)
Seat 2: b61f990d (small blind) collected ($0.1)
Seat 3: 5c16018f (big blind) folded before Flop
Seat 4: ab7b0d6c folded before Flop (didn't bet)
Seat 5: 205291 folded before Flop (didn't bet)
Seat 6: 2e4217d7 folded before Flop (didn't bet)


Poker Hand #HD1746132355: Hold'em No Limit ($0.02/$0.05) - 2024/04/25 16:34:34
Table 'NLHBlue6' 6-max Seat #6 is the button
Seat 1: Hero ($8.69 in chips)
Seat 2: b61f990d ($2.95 in chips)
Seat 3: 5c16018f ($5.14 in chips)
Seat 4: ab7b0d6c ($5 in chips)
Seat 5: 205291 ($5.05 in chips)
Seat 6: 2e4217d7 ($6.12 in chips)
Hero: posts small blind $0.02
b61f990d: posts big blind $0.05
*** HOLE CARDS ***
Dealt to Hero [Td Qs]
Dealt to b61f990d 
Dealt to 5c16018f 
Dealt to ab7b0d6c 
Dealt to 205291 
Dealt to 2e4217d7 
5c16018f: raises $0.09 to $0.14
ab7b0d6c: folds
205291: folds
2e4217d7: folds
Hero: folds
b61f990d: calls $0.09
*** FLOP *** [9c 2c 6h]
b61f990d: checks
5c16018f: checks
*** TURN *** [9c 2c 6h] [Tc]
b61f990d: checks
5c16018f: checks
*** RIVER *** [9c 2c 6h Tc] [Jh]
b61f990d: checks
5c16018f: checks
b61f990d: shows [5s 3s] (Jack-High)
5c16018f: shows [Kd Ac] (Ace-High)
*** SHOWDOWN ***
5c16018f collected $0.29 from pot
*** SUMMARY ***
Total pot $0.3 | Rake $0.01 | Jackpot $0 | Bingo $0 | Fortune $0 | Tax $0
Board [9c 2c 6h Tc Jh]
Seat 1: Hero (small blind) folded before Flop
Seat 2: b61f990d (big blind) showed [5s 3s] and lost with Jack-High
Seat 3: 5c16018f showed [Kd Ac] and won ($0.29) with Ace-High
Seat 4: ab7b0d6c folded before Flop (didn't bet)
Seat 5: 205291 folded before Flop (didn't bet)
Seat 6: 2e4217d7 (button) folded before Flop (didn't bet)


Poker Hand #HD1746132326: Hold'em No Limit ($0.02/$0.05) - 2024/04/25 16:34:22
Table 'NLHBlue6' 6-max Seat #5 is the button
Seat 1: Hero ($8.67 in chips)
Seat 3: 5c16018f ($5.14 in chips)
Seat 4: ab7b0d6c ($5 in chips)
Seat 5: 205291 ($5.05 in chips)
Seat 6: 2e4217d7 ($6.14 in chips)
2e4217d7: posts small blind $0.02
Hero: posts big blind $0.05
*** HOLE CARDS ***
Dealt to Hero [7d 5h]
Dealt to 5c16018f 
Dealt to ab7b0d6c 
Dealt to 205291 
Dealt to 2e4217d7 
5c16018f: folds
ab7b0d6c: folds
205291: folds
2e4217d7: folds
Uncalled bet ($0.03) returned to Hero
*** SHOWDOWN ***
Hero collected $0.04 from pot
*** SUMMARY ***
Total pot $0.04 | Rake $0 | Jackpot $0 | Bingo $0 | Fortune $0 | Tax $0
Seat 1: Hero (big blind) collected ($0.04)
Seat 3: 5c16018f folded before Flop (didn't bet)
Seat 4: ab7b0d6c folded before Flop (didn't bet)
Seat 5: 205291 (button) folded before Flop (didn't bet)
Seat 6: 2e4217d7 (small blind) folded before Flop


Poker Hand #HD1746132137: Hold'em No Limit ($0.02/$0.05) - 2024/04/25 16:33:03
Table 'NLHBlue6' 6-max Seat #4 is the button
Seat 1: Hero ($8.67 in chips)
Seat 3: 5c16018f ($5.14 in chips)
Seat 4: ab7b0d6c ($5.19 in chips)
Seat 5: 205291 ($5.07 in chips)
Seat 6: 2e4217d7 ($4 in chips)
205291: posts small blind $0.02
2e4217d7: posts big blind $0.05
*** HOLE CARDS ***
Dealt to Hero [Td 9c]
Dealt to 5c16018f 
Dealt to ab7b0d6c 
Dealt to 205291 
Dealt to 2e4217d7 
Hero: folds
5c16018f: folds
ab7b0d6c: raises $0.07 to $0.12
205291: folds
2e4217d7: calls $0.07
*** FLOP *** [Kh 9h 2d]
2e4217d7: checks
ab7b0d6c: bets $0.09
2e4217d7: raises $0.3 to $0.39
ab7b0d6c: calls $0.3
*** TURN *** [Kh 9h 2d] [4d]
2e4217d7: bets $0.69
ab7b0d6c: calls $0.69
*** RIVER *** [Kh 9h 2d 4d] [Qs]
2e4217d7: checks
ab7b0d6c: bets $1.21
2e4217d7: calls $1.21
ab7b0d6c: shows [5d Ah] (Ace-High)
2e4217d7: shows [Kd Js] (Pair of Kings)
*** SHOWDOWN ***
2e4217d7 collected $4.55 from pot
*** SUMMARY ***
Total pot $4.84 | Rake $0.24 | Jackpot $0.05 | Bingo $0 | Fortune $0 | Tax $0
Board [Kh 9h 2d 4d Qs]
Seat 1: Hero folded before Flop (didn't bet)
Seat 3: 5c16018f folded before Flop (didn't bet)
Seat 4: ab7b0d6c (button) showed [5d Ah] and lost with Ace-High
Seat 5: 205291 (small blind) folded before Flop
Seat 6: 2e4217d7 (big blind) showed [Kd Js] and won ($4.55) with Pair of Kings


Poker Hand #HD1746132092: Hold'em No Limit ($0.02/$0.05) - 2024/04/25 16:32:50
Table 'NLHBlue6' 6-max Seat #3 is the button
Seat 1: Hero ($8.67 in chips)
Seat 3: 5c16018f ($5.14 in chips)
Seat 4: ab7b0d6c ($5.21 in chips)
Seat 5: 205291 ($5.05 in chips)
ab7b0d6c: posts small blind $0.02
205291: posts big blind $0.05
*** HOLE CARDS ***
Dealt to Hero [3h Jd]
Dealt to 5c16018f 
Dealt to ab7b0d6c 
Dealt to 205291 
Hero: folds
5c16018f: folds
ab7b0d6c: folds
Uncalled bet ($0.03) returned to 205291
*** SHOWDOWN ***
205291 collected $0.04 from pot
*** SUMMARY ***
Total pot $0.04 | Rake $0 | Jackpot $0 | Bingo $0 | Fortune $0 | Tax $0
Seat 1: Hero folded before Flop (didn't bet)
Seat 3: 5c16018f (button) folded before Flop (didn't bet)
Seat 4: ab7b0d6c (small blind) folded before Flop
Seat 5: 205291 (big blind) collected ($0.04)


Poker Hand #HD1746131998: Hold'em No Limit ($0.02/$0.05) - 2024/04/25 16:32:09
Table 'NLHBlue6' 6-max Seat #1 is the button
Seat 1: Hero ($8.88 in chips)
Seat 3: 5c16018f ($5.16 in chips)
Seat 4: ab7b0d6c ($5 in chips)
Seat 5: 205291 ($5.05 in chips)
5c16018f: posts small blind $0.02
ab7b0d6c: posts big blind $0.05
*** HOLE CARDS ***
Dealt to Hero [Kc Qc]
Dealt to 5c16018f 
Dealt to ab7b0d6c 
Dealt to 205291 
205291: folds
Hero: raises $0.07 to $0.12
5c16018f: folds
ab7b0d6c: calls $0.07
*** FLOP *** [7s 5d 7c]
ab7b0d6c: checks
Hero: bets $0.09
ab7b0d6c: calls $0.09
*** TURN *** [7s 5d 7c] [6s]
ab7b0d6c: checks
Hero: checks
*** RIVER *** [7s 5d 7c 6s] [8h]
ab7b0d6c: checks
Hero: checks
ab7b0d6c: shows [8c Ah] (Pair of Eights and Pair of Sevens)
Hero: shows [Kc Qc] (Pair of Sevens)
*** SHOWDOWN ***
ab7b0d6c collected $0.42 from pot
*** SUMMARY ***
Total pot $0.44 | Rake $0.02 | Jackpot $0 | Bingo $0 | Fortune $0 | Tax $0
Board [7s 5d 7c 6s 8h]
Seat 1: Hero (button) showed [Kc Qc] and lost with Pair of Sevens
Seat 3: 5c16018f (small blind) folded before Flop
Seat 4: ab7b0d6c (big blind) showed [8c Ah] and won ($0.42) with Pair of Eights and Pair of Sevens
Seat 5: 205291 folded before Flop (didn't bet)


Poker Hand #HD1746131923: Hold'em No Limit ($0.02/$0.05) - 2024/04/25 16:31:39
Table 'NLHBlue6' 6-max Seat #5 is the button
Seat 1: Hero ($8.9 in chips)
Seat 3: 5c16018f ($5 in chips)
Seat 4: ab7b0d6c ($5.06 in chips)
Seat 5: 205291 ($5.05 in chips)
Hero: posts small blind $0.02
5c16018f: posts big blind $0.05
*** HOLE CARDS ***
Dealt to Hero [9h 7s]
Dealt to 5c16018f 
Dealt to ab7b0d6c 
Dealt to 205291 
ab7b0d6c: raises $0.1 to $0.15
205291: folds
Hero: folds
5c16018f: raises $0.35 to $0.5
ab7b0d6c: folds
Uncalled bet ($0.35) returned to 5c16018f
*** SHOWDOWN ***
5c16018f collected $0.31 from pot
*** SUMMARY ***
Total pot $0.32 | Rake $0.01 | Jackpot $0 | Bingo $0 | Fortune $0 | Tax $0
Seat 1: Hero (small blind) folded before Flop
Seat 3: 5c16018f (big blind) collected ($0.31)
Seat 4: ab7b0d6c folded before Flop
Seat 5: 205291 (button) folded before Flop (didn't bet)


Poker Hand #HD1746131893: Hold'em No Limit ($0.02/$0.05) - 2024/04/25 16:31:26
Table 'NLHBlue6' 6-max Seat #4 is the button
Seat 1: Hero ($8.95 in chips)
Seat 3: 5c16018f ($5 in chips)
Seat 4: ab7b0d6c ($5.06 in chips)
Seat 5: 205291 ($5 in chips)
205291: posts small blind $0.02
Hero: posts big blind $0.05
*** HOLE CARDS ***
Dealt to Hero [Ah 2d]
Dealt to 5c16018f 
Dealt to ab7b0d6c 
Dealt to 205291 
5c16018f: folds
ab7b0d6c: folds
205291: raises $0.1 to $0.15
Hero: folds
Uncalled bet ($0.1) returned to 205291
*** SHOWDOWN ***
205291 collected $0.1 from pot
*** SUMMARY ***
Total pot $0.1 | Rake $0 | Jackpot $0 | Bingo $0 | Fortune $0 | Tax $0
Seat 1: Hero (big blind) folded before Flop
Seat 3: 5c16018f folded before Flop (didn't bet)
Seat 4: ab7b0d6c (button) folded before Flop (didn't bet)
Seat 5: 205291 (small blind) collected ($0.1)


Poker Hand #HD1746131743: Hold'em No Limit ($0.02/$0.05) - 2024/04/25 16:30:20
Table 'NLHBlue6' 6-max Seat #3 is the button
Seat 1: Hero ($5.14 in chips)
Seat 3: 5c16018f ($5 in chips)
Seat 4: ab7b0d6c ($5.08 in chips)
Seat 5: 205291 ($5 in chips)
Seat 6: 2e4217d7 ($4.21 in chips)
ab7b0d6c: posts small blind $0.02
205291: posts big blind $0.05
*** HOLE CARDS ***
Dealt to Hero [Qs Qh]
Dealt to 5c16018f 
Dealt to ab7b0d6c 
Dealt to 205291 
Dealt to 2e4217d7 
2e4217d7: raises $0.09 to $0.14
Hero: raises $0.41 to $0.55
5c16018f: folds
ab7b0d6c: folds
205291: folds
2e4217d7: calls $0.41
*** FLOP *** [3c 6h 3s]
2e4217d7: checks
Hero: bets $0.74
2e4217d7: calls $0.74
*** TURN *** [3c 6h 3s] [7d]
2e4217d7: checks
Hero: bets $0.88
2e4217d7: calls $0.88
*** RIVER *** [3c 6h 3s 7d] [7s]
2e4217d7: checks
Hero: bets $2.97 and is all-in
2e4217d7: calls $2.04 and is all-in
Uncalled bet ($0.93) returned to Hero
Hero: shows [Qs Qh] (Pair of Queens and Pair of Sevens)
2e4217d7: shows [5s 5h] (Pair of Sevens and Pair of Fives)
*** SHOWDOWN ***
Hero collected $8.02 from pot
*** SUMMARY ***
Total pot $8.49 | Rake $0.42 | Jackpot $0.05 | Bingo $0 | Fortune $0 | Tax $0
Board [3c 6h 3s 7d 7s]
Seat 1: Hero showed [Qs Qh] and won ($8.02) with Pair of Queens and Pair of Sevens
Seat 3: 5c16018f (button) folded before Flop (didn't bet)
Seat 4: ab7b0d6c (small blind) folded before Flop
Seat 5: 205291 (big blind) folded before Flop
Seat 6: 2e4217d7 showed [5s 5h] and lost with Pair of Sevens and Pair of Fives


Poker Hand #HD1746131691: Hold'em No Limit ($0.02/$0.05) - 2024/04/25 16:30:02
Table 'NLHBlue6' 6-max Seat #1 is the button
Seat 1: Hero ($5.07 in chips)
Seat 3: 5c16018f ($5 in chips)
Seat 4: ab7b0d6c ($5.13 in chips)
Seat 6: 2e4217d7 ($4.21 in chips)
5c16018f: posts small blind $0.02
ab7b0d6c: posts big blind $0.05
*** HOLE CARDS ***
Dealt to Hero [5s As]
Dealt to 5c16018f 
Dealt to ab7b0d6c 
Dealt to 2e4217d7 
2e4217d7: folds
Hero: raises $0.07 to $0.12
5c16018f: folds
ab7b0d6c: folds
Uncalled bet ($0.07) returned to Hero
*** SHOWDOWN ***
Hero collected $0.12 from pot
*** SUMMARY ***
Total pot $0.12 | Rake $0 | Jackpot $0 | Bingo $0 | Fortune $0 | Tax $0
Seat 1: Hero (button) collected ($0.12)
Seat 3: 5c16018f (small blind) folded before Flop
Seat 4: ab7b0d6c (big blind) folded before Flop
Seat 6: 2e4217d7 folded before Flop (didn't bet)


Poker Hand #HD1746131591: Hold'em No Limit ($0.02/$0.05) - 2024/04/25 16:29:15
Table 'NLHBlue6' 6-max Seat #6 is the button
Seat 1: Hero ($5.09 in chips)
Seat 3: 5c16018f ($5 in chips)
Seat 4: ab7b0d6c ($5.13 in chips)
Seat 6: 2e4217d7 ($4.14 in chips)
Hero: posts small blind $0.02
5c16018f: posts big blind $0.05
*** HOLE CARDS ***
Dealt to Hero [7d 6s]
Dealt to 5c16018f 
Dealt to ab7b0d6c 
Dealt to 2e4217d7 
ab7b0d6c: folds
2e4217d7: calls $0.05
Hero: folds
5c16018f: checks
*** FLOP *** [3d 4c Kh]
5c16018f: checks
2e4217d7: checks
*** TURN *** [3d 4c Kh] [4d]
5c16018f: checks
2e4217d7: checks
*** RIVER *** [3d 4c Kh 4d] [3s]
5c16018f: checks
2e4217d7: checks
5c16018f: shows [5c 2h] (Pair of Fours and Pair of Treys)
2e4217d7: shows [6h Ah] (Pair of Fours and Pair of Treys)
*** SHOWDOWN ***
2e4217d7 collected $0.12 from pot
*** SUMMARY ***
Total pot $0.12 | Rake $0 | Jackpot $0 | Bingo $0 | Fortune $0 | Tax $0
Board [3d 4c Kh 4d 3s]
Seat 1: Hero (small blind) folded before Flop
Seat 3: 5c16018f (big blind) showed [5c 2h] and lost with Pair of Fours and Pair of Treys
Seat 4: ab7b0d6c folded before Flop (didn't bet)
Seat 6: 2e4217d7 (button) showed [6h Ah] and won ($0.12) with Pair of Fours and Pair of Treys


Poker Hand #HD1746131548: Hold'em No Limit ($0.02/$0.05) - 2024/04/25 16:28:57
Table 'NLHBlue6' 6-max Seat #4 is the button
Seat 1: Hero ($5.14 in chips)
Seat 3: 5c16018f ($5 in chips)
Seat 4: ab7b0d6c ($5.13 in chips)
Seat 6: 2e4217d7 ($4.09 in chips)
2e4217d7: posts small blind $0.02
Hero: posts big blind $0.05
*** HOLE CARDS ***
Dealt to Hero [5d 9c]
Dealt to 5c16018f 
Dealt to ab7b0d6c 
Dealt to 2e4217d7 
5c16018f: folds
ab7b0d6c: folds
2e4217d7: raises $0.09 to $0.14
Hero: folds
Uncalled bet ($0.09) returned to 2e4217d7
*** SHOWDOWN ***
2e4217d7 collected $0.1 from pot
*** SUMMARY ***
Total pot $0.1 | Rake $0 | Jackpot $0 | Bingo $0 | Fortune $0 | Tax $0
Seat 1: Hero (big blind) folded before Flop
Seat 3: 5c16018f folded before Flop (didn't bet)
Seat 4: ab7b0d6c (button) folded before Flop (didn't bet)
Seat 6: 2e4217d7 (small blind) collected ($0.1)


Poker Hand #HD1746131460: Hold'em No Limit ($0.02/$0.05) - 2024/04/25 16:28:22
Table 'NLHBlue6' 6-max Seat #3 is the button
Seat 1: Hero ($5.14 in chips)
Seat 3: 5c16018f ($5 in chips)
Seat 4: ab7b0d6c ($5.08 in chips)
Seat 6: 2e4217d7 ($4.14 in chips)
ab7b0d6c: posts small blind $0.02
2e4217d7: posts big blind $0.05
*** HOLE CARDS ***
Dealt to Hero [6d 3c]
Dealt to 5c16018f 
Dealt to ab7b0d6c 
Dealt to 2e4217d7 
Hero: folds
5c16018f: folds
ab7b0d6c: raises $0.1 to $0.15
2e4217d7: folds
Uncalled bet ($0.1) returned to ab7b0d6c
*** SHOWDOWN ***
ab7b0d6c collected $0.1 from pot
*** SUMMARY ***
Total pot $0.1 | Rake $0 | Jackpot $0 | Bingo $0 | Fortune $0 | Tax $0
Seat 1: Hero folded before Flop (didn't bet)
Seat 3: 5c16018f (button) folded before Flop (didn't bet)
Seat 4: ab7b0d6c (small blind) collected ($0.1)
Seat 6: 2e4217d7 (big blind) folded before Flop


Poker Hand #HD1746131419: Hold'em No Limit ($0.02/$0.05) - 2024/04/25 16:28:03
Table 'NLHBlue6' 6-max Seat #1 is the button
Seat 1: Hero ($5.07 in chips)
Seat 3: 5c16018f ($5.02 in chips)
Seat 4: ab7b0d6c ($5.13 in chips)
Seat 6: 2e4217d7 ($4.14 in chips)
5c16018f: posts small blind $0.02
ab7b0d6c: posts big blind $0.05
*** HOLE CARDS ***
Dealt to Hero [Jd Jc]
Dealt to 5c16018f 
Dealt to ab7b0d6c 
Dealt to 2e4217d7 
2e4217d7: folds
Hero: raises $0.07 to $0.12
5c16018f: folds
ab7b0d6c: folds
Uncalled bet ($0.07) returned to Hero
*** SHOWDOWN ***
Hero collected $0.12 from pot
*** SUMMARY ***
Total pot $0.12 | Rake $0 | Jackpot $0 | Bingo $0 | Fortune $0 | Tax $0
Seat 1: Hero (button) collected ($0.12)
Seat 3: 5c16018f (small blind) folded before Flop
Seat 4: ab7b0d6c (big blind) folded before Flop
Seat 6: 2e4217d7 folded before Flop (didn't bet)


Poker Hand #HD1746131394: Hold'em No Limit ($0.02/$0.05) - 2024/04/25 16:27:51
Table 'NLHBlue6' 6-max Seat #6 is the button
Seat 1: Hero ($5.09 in chips)
Seat 3: 5c16018f ($5 in chips)
Seat 4: ab7b0d6c ($5.13 in chips)
Seat 6: 2e4217d7 ($4.14 in chips)
Hero: posts small blind $0.02
5c16018f: posts big blind $0.05
*** HOLE CARDS ***
Dealt to Hero [5h Jc]
Dealt to 5c16018f 
Dealt to ab7b0d6c 
Dealt to 2e4217d7 
ab7b0d6c: folds
2e4217d7: folds
Hero: folds
Uncalled bet ($0.03) returned to 5c16018f
*** SHOWDOWN ***
5c16018f collected $0.04 from pot
*** SUMMARY ***
Total pot $0.04 | Rake $0 | Jackpot $0 | Bingo $0 | Fortune $0 | Tax $0
Seat 1: Hero (small blind) folded before Flop
Seat 3: 5c16018f (big blind) collected ($0.04)
Seat 4: ab7b0d6c folded before Flop (didn't bet)
Seat 6: 2e4217d7 (button) folded before Flop (didn't bet)


Poker Hand #HD1746131301: Hold'em No Limit ($0.02/$0.05) - 2024/04/25 16:27:07
Table 'NLHBlue6' 6-max Seat #5 is the button
Seat 1: Hero ($5.14 in chips)
Seat 2: b61f990d ($2.95 in chips)
Seat 3: 5c16018f ($5 in chips)
Seat 4: ab7b0d6c ($5.28 in chips)
Seat 5: 80140239 ($1.33 in chips)
Seat 6: 2e4217d7 ($3.95 in chips)
2e4217d7: posts small blind $0.02
Hero: posts big blind $0.05
*** HOLE CARDS ***
Dealt to Hero [6s 5h]
Dealt to b61f990d 
Dealt to 5c16018f 
Dealt to ab7b0d6c 
Dealt to 80140239 
Dealt to 2e4217d7 
b61f990d: folds
5c16018f: folds
ab7b0d6c: raises $0.1 to $0.15
80140239: folds
2e4217d7: calls $0.13
Hero: folds
*** FLOP *** [Ks Kc 5d]
2e4217d7: bets $0.12
ab7b0d6c: folds
Uncalled bet ($0.12) returned to 2e4217d7
*** SHOWDOWN ***
2e4217d7 collected $0.34 from pot
*** SUMMARY ***
Total pot $0.35 | Rake $0.01 | Jackpot $0 | Bingo $0 | Fortune $0 | Tax $0
Board [Ks Kc 5d]
Seat 1: Hero (big blind) folded before Flop
Seat 2: b61f990d folded before Flop (didn't bet)
Seat 3: 5c16018f folded before Flop (didn't bet)
Seat 4: ab7b0d6c folded on the Flop
Seat 5: 80140239 (button) folded before Flop (didn't bet)
Seat 6: 2e4217d7 (small blind) won ($0.34)


Poker Hand #HD1746131211: Hold'em No Limit ($0.02/$0.05) - 2024/04/25 16:26:29
Table 'NLHBlue6' 6-max Seat #4 is the button
Seat 1: Hero ($5.07 in chips)
Seat 2: b61f990d ($2.95 in chips)
Seat 3: 5c16018f ($5 in chips)
Seat 4: ab7b0d6c ($5.28 in chips)
Seat 5: 80140239 ($1.35 in chips)
Seat 6: 2e4217d7 ($4 in chips)
80140239: posts small blind $0.02
2e4217d7: posts big blind $0.05
*** HOLE CARDS ***
Dealt to Hero [7d Ad]
Dealt to b61f990d 
Dealt to 5c16018f 
Dealt to ab7b0d6c 
Dealt to 80140239 
Dealt to 2e4217d7 
Hero: raises $0.05 to $0.1
b61f990d: folds
5c16018f: folds
ab7b0d6c: folds
80140239: folds
2e4217d7: folds
Uncalled bet ($0.05) returned to Hero
*** SHOWDOWN ***
Hero collected $0.12 from pot
*** SUMMARY ***
Total pot $0.12 | Rake $0 | Jackpot $0 | Bingo $0 | Fortune $0 | Tax $0
Seat 1: Hero collected ($0.12)
Seat 2: b61f990d folded before Flop (didn't bet)
Seat 3: 5c16018f folded before Flop (didn't bet)
Seat 4: ab7b0d6c (button) folded before Flop (didn't bet)
Seat 5: 80140239 (small blind) folded before Flop
Seat 6: 2e4217d7 (big blind) folded before Flop


Poker Hand #HD1746131018: Hold'em No Limit ($0.02/$0.05) - 2024/04/25 16:25:00
Table 'NLHBlue6' 6-max Seat #3 is the button
Seat 1: Hero ($5.07 in chips)
Seat 2: b61f990d ($2.95 in chips)
Seat 3: 5c16018f ($5 in chips)
Seat 4: ab7b0d6c ($5.47 in chips)
Seat 5: 80140239 ($1 in chips)
ab7b0d6c: posts small blind $0.02
80140239: posts big blind $0.05
*** HOLE CARDS ***
Dealt to Hero [4s 9d]
Dealt to b61f990d 
Dealt to 5c16018f 
Dealt to ab7b0d6c 
Dealt to 80140239 
Hero: folds
b61f990d: folds
5c16018f: raises $0.05 to $0.1
ab7b0d6c: calls $0.08
80140239: calls $0.05
*** FLOP *** [Th 2c Ad]
ab7b0d6c: checks
80140239: checks
5c16018f: bets $0.09
ab7b0d6c: calls $0.09
80140239: calls $0.09
*** TURN *** [Th 2c Ad] [Ah]
ab7b0d6c: checks
80140239: checks
5c16018f: checks
*** RIVER *** [Th 2c Ad Ah] [2s]
ab7b0d6c: checks
80140239: bets $0.2
5c16018f: folds
ab7b0d6c: folds
Uncalled bet ($0.2) returned to 80140239
*** SHOWDOWN ***
80140239 collected $0.54 from pot
*** SUMMARY ***
Total pot $0.57 | Rake $0.03 | Jackpot $0 | Bingo $0 | Fortune $0 | Tax $0
Board [Th 2c Ad Ah 2s]
Seat 1: Hero folded before Flop (didn't bet)
Seat 2: b61f990d folded before Flop (didn't bet)
Seat 3: 5c16018f (button) folded on the River
Seat 4: ab7b0d6c (small blind) folded on the River
Seat 5: 80140239 (big blind) won ($0.54)


Poker Hand #HD1746130997: Hold'em No Limit ($0.02/$0.05) - 2024/04/25 16:24:50
Table 'NLHBlue6' 6-max Seat #2 is the button
Seat 1: Hero ($5.07 in chips)
Seat 2: b61f990d ($2.95 in chips)
Seat 3: 5c16018f ($5 in chips)
Seat 4: ab7b0d6c ($5.45 in chips)
5c16018f: posts small blind $0.02
ab7b0d6c: posts big blind $0.05
*** HOLE CARDS ***
Dealt to Hero [3h 9d]
Dealt to b61f990d 
Dealt to 5c16018f 
Dealt to ab7b0d6c 
Hero: folds
b61f990d: folds
5c16018f: folds
Uncalled bet ($0.03) returned to ab7b0d6c
*** SHOWDOWN ***
ab7b0d6c collected $0.04 from pot
*** SUMMARY ***
Total pot $0.04 | Rake $0 | Jackpot $0 | Bingo $0 | Fortune $0 | Tax $0
Seat 1: Hero folded before Flop (didn't bet)
Seat 2: b61f990d (button) folded before Flop (didn't bet)
Seat 3: 5c16018f (small blind) folded before Flop
Seat 4: ab7b0d6c (big blind) collected ($0.04)


Poker Hand #HD1746130969: Hold'em No Limit ($0.02/$0.05) - 2024/04/25 16:24:35
Table 'NLHBlue6' 6-max Seat #1 is the button
Seat 1: Hero ($5 in chips)
Seat 2: b61f990d ($2.97 in chips)
Seat 3: 5c16018f ($5.05 in chips)
Seat 4: ab7b0d6c ($5.45 in chips)
b61f990d: posts small blind $0.02
5c16018f: posts big blind $0.05
*** HOLE CARDS ***
Dealt to Hero [Qd Kh]
Dealt to b61f990d 
Dealt to 5c16018f 
Dealt to ab7b0d6c 
ab7b0d6c: folds
Hero: raises $0.07 to $0.12
b61f990d: folds
5c16018f: folds
Uncalled bet ($0.07) returned to Hero
*** SHOWDOWN ***
Hero collected $0.12 from pot
*** SUMMARY ***
Total pot $0.12 | Rake $0 | Jackpot $0 | Bingo $0 | Fortune $0 | Tax $0
Seat 1: Hero (button) collected ($0.12)
Seat 2: b61f990d (small blind) folded before Flop
Seat 3: 5c16018f (big blind) folded before Flop
Seat 4: ab7b0d6c folded before Flop (didn't bet)


Poker Hand #HD1746130939: Hold'em No Limit ($0.02/$0.05) - 2024/04/25 16:24:25
Table 'NLHBlue6' 6-max Seat #6 is the button
Seat 1: Hero ($5 in chips)
Seat 2: b61f990d ($2.95 in chips)
Seat 3: 5c16018f ($5.05 in chips)
Seat 4: ab7b0d6c ($5.45 in chips)
Seat 6: 1567ddc5 ($1.61 in chips)
Hero: posts small blind $0.02
b61f990d: posts big blind $0.05
*** HOLE CARDS ***
Dealt to Hero [4d Td]
Dealt to b61f990d 
Dealt to 5c16018f 
Dealt to ab7b0d6c 
Dealt to 1567ddc5 
5c16018f: folds
ab7b0d6c: folds
1567ddc5: folds
Hero: folds
Uncalled bet ($0.03) returned to b61f990d
*** SHOWDOWN ***
b61f990d collected $0.04 from pot
*** SUMMARY ***
Total pot $0.04 | Rake $0 | Jackpot $0 | Bingo $0 | Fortune $0 | Tax $0
Seat 1: Hero (small blind) folded before Flop
Seat 2: b61f990d (big blind) collected ($0.04)
Seat 3: 5c16018f folded before Flop (didn't bet)
Seat 4: ab7b0d6c folded before Flop (didn't bet)
Seat 6: 1567ddc5 (button) folded before Flop (didn't bet)


Poker Hand #HD1746130825: Hold'em No Limit ($0.02/$0.05) - 2024/04/25 16:23:30
Table 'NLHBlue6' 6-max Seat #4 is the button
Seat 1: Hero ($5.49 in chips)
Seat 2: b61f990d ($2.95 in chips)
Seat 3: 5c16018f ($5.05 in chips)
Seat 4: ab7b0d6c ($5.45 in chips)
Seat 6: 1567ddc5 ($1.22 in chips)
1567ddc5: posts small blind $0.02
Hero: posts big blind $0.05
*** HOLE CARDS ***
Dealt to Hero [Qd 3h]
Dealt to b61f990d 
Dealt to 5c16018f 
Dealt to ab7b0d6c 
Dealt to 1567ddc5 
b61f990d: folds
5c16018f: folds
ab7b0d6c: folds
1567ddc5: calls $0.03
Hero: checks
*** FLOP *** [Qh 6d Qc]
1567ddc5: checks
Hero: bets $0.07
1567ddc5: raises $1.1 to $1.17 and is all-in
Hero: calls $1.1
1567ddc5: shows [8c Qs] (Three Queens)
Hero: shows [Qd 3h] (Three Queens)
1567ddc5: Chooses to EV Cashout 
*** TURN *** [Qh 6d Qc] [2h]
*** RIVER *** [Qh 6d Qc 2h] [9d]
1567ddc5: Pays Cashout Risk ($0.66)
*** SHOWDOWN ***
1567ddc5 collected $2.27 from pot
*** SUMMARY ***
Total pot $2.44 | Rake $0.12 | Jackpot $0.05 | Bingo $0 | Fortune $0 | Tax $0
Board [Qh 6d Qc 2h 9d]
Seat 1: Hero (big blind) showed [Qd 3h] and lost with Three Queens
Seat 2: b61f990d folded before Flop (didn't bet)
Seat 3: 5c16018f folded before Flop (didn't bet)
Seat 4: ab7b0d6c (button) folded before Flop (didn't bet)
Seat 6: 1567ddc5 (small blind) showed [8c Qs] and won ($2.27) with Three Queens, Cashout Risk ($0.66)


Poker Hand #HD1746130801: Hold'em No Limit ($0.02/$0.05) - 2024/04/25 16:23:18
Table 'NLHBlue6' 6-max Seat #3 is the button
Seat 1: Hero ($5.49 in chips)
Seat 2: b61f990d ($2.88 in chips)
Seat 3: 5c16018f ($5.05 in chips)
Seat 4: ab7b0d6c ($5.47 in chips)
Seat 6: 1567ddc5 ($1.27 in chips)
ab7b0d6c: posts small blind $0.02
1567ddc5: posts big blind $0.05
*** HOLE CARDS ***
Dealt to Hero [7s Ks]
Dealt to b61f990d 
Dealt to 5c16018f 
Dealt to ab7b0d6c 
Dealt to 1567ddc5 
Hero: folds
b61f990d: raises $0.05 to $0.1
5c16018f: folds
ab7b0d6c: folds
1567ddc5: folds
Uncalled bet ($0.05) returned to b61f990d
*** SHOWDOWN ***
b61f990d collected $0.12 from pot
*** SUMMARY ***
Total pot $0.12 | Rake $0 | Jackpot $0 | Bingo $0 | Fortune $0 | Tax $0
Seat 1: Hero folded before Flop (didn't bet)
Seat 2: b61f990d collected ($0.12)
Seat 3: 5c16018f (button) folded before Flop (didn't bet)
Seat 4: ab7b0d6c (small blind) folded before Flop
Seat 6: 1567ddc5 (big blind) folded before Flop


Poker Hand #HD1746130725: Hold'em No Limit ($0.02/$0.05) - 2024/04/25 16:22:47
Table 'NLHBlue6' 6-max Seat #2 is the button
Seat 1: Hero ($5.71 in chips)
Seat 2: b61f990d ($2.88 in chips)
Seat 3: 5c16018f ($5.07 in chips)
Seat 4: ab7b0d6c ($5.52 in chips)
Seat 5: 4d3453a6 ($6.58 in chips)
Seat 6: 1567ddc5 ($1 in chips)
5c16018f: posts small blind $0.02
ab7b0d6c: posts big blind $0.05
*** HOLE CARDS ***
Dealt to Hero [7c 7s]
Dealt to b61f990d 
Dealt to 5c16018f 
Dealt to ab7b0d6c 
Dealt to 4d3453a6 
Dealt to 1567ddc5 
4d3453a6: folds
1567ddc5: calls $0.05
Hero: raises $0.17 to $0.22
b61f990d: folds
5c16018f: folds
ab7b0d6c: folds
1567ddc5: calls $0.17
*** FLOP *** [Tc Ad As]
1567ddc5: checks
Hero: checks
*** TURN *** [Tc Ad As] [4s]
1567ddc5: checks
Hero: checks
*** RIVER *** [Tc Ad As 4s] [9s]
1567ddc5: bets $0.51
Hero: folds
Uncalled bet ($0.51) returned to 1567ddc5
*** SHOWDOWN ***
1567ddc5 collected $0.49 from pot
*** SUMMARY ***
Total pot $0.51 | Rake $0.02 | Jackpot $0 | Bingo $0 | Fortune $0 | Tax $0
Board [Tc Ad As 4s 9s]
Seat 1: Hero folded on the River
Seat 2: b61f990d (button) folded before Flop (didn't bet)
Seat 3: 5c16018f (small blind) folded before Flop
Seat 4: ab7b0d6c (big blind) folded before Flop
Seat 5: 4d3453a6 folded before Flop (didn't bet)
Seat 6: 1567ddc5 won ($0.49)


Poker Hand #HD1746130695: Hold'em No Limit ($0.02/$0.05) - 2024/04/25 16:22:35
Table 'NLHBlue6' 6-max Seat #1 is the button
Seat 1: Hero ($5.71 in chips)
Seat 2: b61f990d ($2.9 in chips)
Seat 3: 5c16018f ($5.05 in chips)
Seat 4: ab7b0d6c ($5.52 in chips)
Seat 5: 4d3453a6 ($6.58 in chips)
Seat 6: 1567ddc5 ($1 in chips)
b61f990d: posts small blind $0.02
5c16018f: posts big blind $0.05
*** HOLE CARDS ***
Dealt to Hero [8h Qc]
Dealt to b61f990d 
Dealt to 5c16018f 
Dealt to ab7b0d6c 
Dealt to 4d3453a6 
Dealt to 1567ddc5 
ab7b0d6c: folds
4d3453a6: folds
1567ddc5: folds
Hero: folds
b61f990d: folds
Uncalled bet ($0.03) returned to 5c16018f
*** SHOWDOWN ***
5c16018f collected $0.04 from pot
*** SUMMARY ***
Total pot $0.04 | Rake $0 | Jackpot $0 | Bingo $0 | Fortune $0 | Tax $0
Seat 1: Hero (button) folded before Flop (didn't bet)
Seat 2: b61f990d (small blind) folded before Flop
Seat 3: 5c16018f (big blind) collected ($0.04)
Seat 4: ab7b0d6c folded before Flop (didn't bet)
Seat 5: 4d3453a6 folded before Flop (didn't bet)
Seat 6: 1567ddc5 folded before Flop (didn't bet)


Poker Hand #HD1746130677: Hold'em No Limit ($0.02/$0.05) - 2024/04/25 16:22:25
Table 'NLHBlue6' 6-max Seat #6 is the button
Seat 1: Hero ($5.73 in chips)
Seat 2: b61f990d ($2.88 in chips)
Seat 3: 5c16018f ($5.05 in chips)
Seat 4: ab7b0d6c ($5.52 in chips)
Seat 5: 4d3453a6 ($6.58 in chips)
Seat 6: 1567ddc5 ($1 in chips)
Hero: posts small blind $0.02
b61f990d: posts big blind $0.05
*** HOLE CARDS ***
Dealt to Hero [Qd Th]
Dealt to b61f990d 
Dealt to 5c16018f 
Dealt to ab7b0d6c 
Dealt to 4d3453a6 
Dealt to 1567ddc5 
5c16018f: folds
ab7b0d6c: folds
4d3453a6: folds
1567ddc5: folds
Hero: folds
Uncalled bet ($0.03) returned to b61f990d
*** SHOWDOWN ***
b61f990d collected $0.04 from pot
*** SUMMARY ***
Total pot $0.04 | Rake $0 | Jackpot $0 | Bingo $0 | Fortune $0 | Tax $0
Seat 1: Hero (small blind) folded before Flop
Seat 2: b61f990d (big blind) collected ($0.04)
Seat 3: 5c16018f folded before Flop (didn't bet)
Seat 4: ab7b0d6c folded before Flop (didn't bet)
Seat 5: 4d3453a6 folded before Flop (didn't bet)
Seat 6: 1567ddc5 (button) folded before Flop (didn't bet)


Poker Hand #HD1746130621: Hold'em No Limit ($0.02/$0.05) - 2024/04/25 16:22:02
Table 'NLHBlue6' 6-max Seat #5 is the button
Seat 1: Hero ($5.71 in chips)
Seat 2: b61f990d ($2.88 in chips)
Seat 3: 5c16018f ($5.05 in chips)
Seat 4: ab7b0d6c ($5.52 in chips)
Seat 5: 4d3453a6 ($6.58 in chips)
Seat 6: 1567ddc5 ($1.02 in chips)
1567ddc5: posts small blind $0.02
Hero: posts big blind $0.05
*** HOLE CARDS ***
Dealt to Hero [As 8d]
Dealt to b61f990d 
Dealt to 5c16018f 
Dealt to ab7b0d6c 
Dealt to 4d3453a6 
Dealt to 1567ddc5 
b61f990d: folds
5c16018f: folds
ab7b0d6c: folds
4d3453a6: folds
1567ddc5: folds
Uncalled bet ($0.03) returned to Hero
*** SHOWDOWN ***
Hero collected $0.04 from pot
*** SUMMARY ***
Total pot $0.04 | Rake $0 | Jackpot $0 | Bingo $0 | Fortune $0 | Tax $0
Seat 1: Hero (big blind) collected ($0.04)
Seat 2: b61f990d folded before Flop (didn't bet)
Seat 3: 5c16018f folded before Flop (didn't bet)
Seat 4: ab7b0d6c folded before Flop (didn't bet)
Seat 5: 4d3453a6 (button) folded before Flop (didn't bet)
Seat 6: 1567ddc5 (small blind) folded before Flop


Poker Hand #HD1746130593: Hold'em No Limit ($0.02/$0.05) - 2024/04/25 16:21:50
Table 'NLHBlue6' 6-max Seat #4 is the button
Seat 1: Hero ($5.71 in chips)
Seat 2: b61f990d ($2.88 in chips)
Seat 3: 5c16018f ($5.05 in chips)
Seat 4: ab7b0d6c ($5.52 in chips)
Seat 5: 4d3453a6 ($6.6 in chips)
Seat 6: 1567ddc5 ($1 in chips)
4d3453a6: posts small blind $0.02
1567ddc5: posts big blind $0.05
*** HOLE CARDS ***
Dealt to Hero [7d Ks]
Dealt to b61f990d 
Dealt to 5c16018f 
Dealt to ab7b0d6c 
Dealt to 4d3453a6 
Dealt to 1567ddc5 
Hero: folds
b61f990d: folds
5c16018f: folds
ab7b0d6c: folds
4d3453a6: folds
Uncalled bet ($0.03) returned to 1567ddc5
*** SHOWDOWN ***
1567ddc5 collected $0.04 from pot
*** SUMMARY ***
Total pot $0.04 | Rake $0 | Jackpot $0 | Bingo $0 | Fortune $0 | Tax $0
Seat 1: Hero folded before Flop (didn't bet)
Seat 2: b61f990d folded before Flop (didn't bet)
Seat 3: 5c16018f folded before Flop (didn't bet)
Seat 4: ab7b0d6c (button) folded before Flop (didn't bet)
Seat 5: 4d3453a6 (small blind) folded before Flop
Seat 6: 1567ddc5 (big blind) collected ($0.04)


Poker Hand #HD1746130530: Hold'em No Limit ($0.02/$0.05) - 2024/04/25 16:21:23
Table 'NLHBlue6' 6-max Seat #3 is the button
Seat 1: Hero ($5.71 in chips)
Seat 2: b61f990d ($2.88 in chips)
Seat 3: 5c16018f ($5.05 in chips)
Seat 4: ab7b0d6c ($5.47 in chips)
Seat 5: 4d3453a6 ($6.65 in chips)
ab7b0d6c: posts small blind $0.02
4d3453a6: posts big blind $0.05
*** HOLE CARDS ***
Dealt to Hero [9s 3s]
Dealt to b61f990d 
Dealt to 5c16018f 
Dealt to ab7b0d6c 
Dealt to 4d3453a6 
Hero: folds
b61f990d: folds
5c16018f: folds
ab7b0d6c: calls $0.03
4d3453a6: checks
*** FLOP *** [9h 4c 8h]
ab7b0d6c: bets $0.05
4d3453a6: folds
Uncalled bet ($0.05) returned to ab7b0d6c
*** SHOWDOWN ***
ab7b0d6c collected $0.1 from pot
*** SUMMARY ***
Total pot $0.1 | Rake $0 | Jackpot $0 | Bingo $0 | Fortune $0 | Tax $0
Board [9h 4c 8h]
Seat 1: Hero folded before Flop (didn't bet)
Seat 2: b61f990d folded before Flop (didn't bet)
Seat 3: 5c16018f (button) folded before Flop (didn't bet)
Seat 4: ab7b0d6c (small blind) won ($0.1)
Seat 5: 4d3453a6 (big blind) folded on the Flop


Poker Hand #HD1746130474: Hold'em No Limit ($0.02/$0.05) - 2024/04/25 16:20:58
Table 'NLHBlue6' 6-max Seat #2 is the button
Seat 1: Hero ($5.71 in chips)
Seat 2: b61f990d ($2.88 in chips)
Seat 3: 5c16018f ($5 in chips)
Seat 4: ab7b0d6c ($5.52 in chips)
Seat 5: 4d3453a6 ($6.65 in chips)
5c16018f: posts small blind $0.02
ab7b0d6c: posts big blind $0.05
*** HOLE CARDS ***
Dealt to Hero [Js 4s]
Dealt to b61f990d 
Dealt to 5c16018f 
Dealt to ab7b0d6c 
Dealt to 4d3453a6 
4d3453a6: folds
Hero: folds
b61f990d: folds
5c16018f: raises $0.05 to $0.1
ab7b0d6c: folds
Uncalled bet ($0.05) returned to 5c16018f
*** SHOWDOWN ***
5c16018f collected $0.1 from pot
*** SUMMARY ***
Total pot $0.1 | Rake $0 | Jackpot $0 | Bingo $0 | Fortune $0 | Tax $0
Seat 1: Hero folded before Flop (didn't bet)
Seat 2: b61f990d (button) folded before Flop (didn't bet)
Seat 3: 5c16018f (small blind) collected ($0.1)
Seat 4: ab7b0d6c (big blind) folded before Flop
Seat 5: 4d3453a6 folded before Flop (didn't bet)


Poker Hand #HD1746130383: Hold'em No Limit ($0.02/$0.05) - 2024/04/25 16:20:13
Table 'NLHBlue6' 6-max Seat #1 is the button
Seat 1: Hero ($6.21 in chips)
Seat 2: b61f990d ($2.9 in chips)
Seat 3: 5c16018f ($5 in chips)
Seat 4: ab7b0d6c ($5 in chips)
Seat 5: 4d3453a6 ($6.65 in chips)
b61f990d: posts small blind $0.02
5c16018f: posts big blind $0.05
*** HOLE CARDS ***
Dealt to Hero [Qh Qs]
Dealt to b61f990d 
Dealt to 5c16018f 
Dealt to ab7b0d6c 
Dealt to 4d3453a6 
ab7b0d6c: raises $0.1 to $0.15
4d3453a6: folds
Hero: raises $0.35 to $0.5
b61f990d: folds
5c16018f: folds
ab7b0d6c: calls $0.35
*** FLOP *** [Ks 3d Ad]
ab7b0d6c: checks
Hero: checks
*** TURN *** [Ks 3d Ad] [9h]
ab7b0d6c: bets $0.36
Hero: folds
Uncalled bet ($0.36) returned to ab7b0d6c
*** SHOWDOWN ***
ab7b0d6c collected $1.02 from pot
*** SUMMARY ***
Total pot $1.07 | Rake $0.05 | Jackpot $0 | Bingo $0 | Fortune $0 | Tax $0
Board [Ks 3d Ad 9h]
Seat 1: Hero (button) folded on the Turn
Seat 2: b61f990d (small blind) folded before Flop
Seat 3: 5c16018f (big blind) folded before Flop
Seat 4: ab7b0d6c won ($1.02)
Seat 5: 4d3453a6 folded before Flop (didn't bet)


Poker Hand #HD1746130332: Hold'em No Limit ($0.02/$0.05) - 2024/04/25 16:19:53
Table 'NLHBlue6' 6-max Seat #5 is the button
Seat 1: Hero ($6.23 in chips)
Seat 2: b61f990d ($2.88 in chips)
Seat 3: 5c16018f ($5 in chips)
Seat 4: ab7b0d6c ($5 in chips)
Seat 5: 4d3453a6 ($6.65 in chips)
Hero: posts small blind $0.02
b61f990d: posts big blind $0.05
*** HOLE CARDS ***
Dealt to Hero [6d 9d]
Dealt to b61f990d 
Dealt to 5c16018f 
Dealt to ab7b0d6c 
Dealt to 4d3453a6 
5c16018f: folds
ab7b0d6c: folds
4d3453a6: folds
Hero: folds
Uncalled bet ($0.03) returned to b61f990d
*** SHOWDOWN ***
b61f990d collected $0.04 from pot
*** SUMMARY ***
Total pot $0.04 | Rake $0 | Jackpot $0 | Bingo $0 | Fortune $0 | Tax $0
Seat 1: Hero (small blind) folded before Flop
Seat 2: b61f990d (big blind) collected ($0.04)
Seat 3: 5c16018f folded before Flop (didn't bet)
Seat 4: ab7b0d6c folded before Flop (didn't bet)
Seat 5: 4d3453a6 (button) folded before Flop (didn't bet)


Poker Hand #HD1746130267: Hold'em No Limit ($0.02/$0.05) - 2024/04/25 16:19:22
Table 'NLHBlue6' 6-max Seat #4 is the button
Seat 1: Hero ($6.21 in chips)
Seat 2: b61f990d ($2.88 in chips)
Seat 3: 5c16018f ($5 in chips)
Seat 4: ab7b0d6c ($5 in chips)
Seat 5: 4d3453a6 ($6.67 in chips)
4d3453a6: posts small blind $0.02
Hero: posts big blind $0.05
*** HOLE CARDS ***
Dealt to Hero [2d Kh]
Dealt to b61f990d 
Dealt to 5c16018f 
Dealt to ab7b0d6c 
Dealt to 4d3453a6 
b61f990d: folds
5c16018f: folds
ab7b0d6c: folds
4d3453a6: folds
Uncalled bet ($0.03) returned to Hero
*** SHOWDOWN ***
Hero collected $0.04 from pot
*** SUMMARY ***
Total pot $0.04 | Rake $0 | Jackpot $0 | Bingo $0 | Fortune $0 | Tax $0
Seat 1: Hero (big blind) collected ($0.04)
Seat 2: b61f990d folded before Flop (didn't bet)
Seat 3: 5c16018f folded before Flop (didn't bet)
Seat 4: ab7b0d6c (button) folded before Flop (didn't bet)
Seat 5: 4d3453a6 (small blind) folded before Flop


Poker Hand #HD1746130145: Hold'em No Limit ($0.02/$0.05) - 2024/04/25 16:18:29
Table 'NLHBlue6' 6-max Seat #3 is the button
Seat 1: Hero ($6.21 in chips)
Seat 2: b61f990d ($2.88 in chips)
Seat 3: 5c16018f ($5 in chips)
Seat 4: ab7b0d6c ($5 in chips)
Seat 5: 4d3453a6 ($6.34 in chips)
Seat 6: f9f2ba85 ($5.21 in chips)
ab7b0d6c: posts small blind $0.02
4d3453a6: posts big blind $0.05
*** HOLE CARDS ***
Dealt to Hero [Qc 4h]
Dealt to b61f990d 
Dealt to 5c16018f 
Dealt to ab7b0d6c 
Dealt to 4d3453a6 
Dealt to f9f2ba85 
f9f2ba85: raises $0.08 to $0.13
Hero: folds
b61f990d: folds
5c16018f: folds
ab7b0d6c: folds
4d3453a6: calls $0.08
*** FLOP *** [4s Ah 8c]
4d3453a6: checks
f9f2ba85: bets $0.08
4d3453a6: calls $0.08
*** TURN *** [4s Ah 8c] [7c]
4d3453a6: checks
f9f2ba85: bets $0.13
4d3453a6: calls $0.13
*** RIVER *** [4s Ah 8c 7c] [6s]
4d3453a6: checks
f9f2ba85: checks
4d3453a6: shows [4d 4c] (Three Fours)
f9f2ba85: shows [Qh Qs] (Pair of Queens)
*** SHOWDOWN ***
4d3453a6 collected $0.67 from pot
*** SUMMARY ***
Total pot $0.7 | Rake $0.03 | Jackpot $0 | Bingo $0 | Fortune $0 | Tax $0
Board [4s Ah 8c 7c 6s]
Seat 1: Hero folded before Flop (didn't bet)
Seat 2: b61f990d folded before Flop (didn't bet)
Seat 3: 5c16018f (button) folded before Flop (didn't bet)
Seat 4: ab7b0d6c (small blind) folded before Flop
Seat 5: 4d3453a6 (big blind) showed [4d 4c] and won ($0.67) with Three Fours
Seat 6: f9f2ba85 showed [Qh Qs] and lost with Pair of Queens


Poker Hand #HD1746130009: Hold'em No Limit ($0.02/$0.05) - 2024/04/25 16:17:30
Table 'NLHBlue6' 6-max Seat #2 is the button
Seat 1: Hero ($6.21 in chips)
Seat 2: b61f990d ($3.03 in chips)
Seat 3: 5c16018f ($5.02 in chips)
Seat 4: ab7b0d6c ($5 in chips)
Seat 5: 4d3453a6 ($6.04 in chips)
Seat 6: f9f2ba85 ($5.21 in chips)
5c16018f: posts small blind $0.02
ab7b0d6c: posts big blind $0.05
*** HOLE CARDS ***
Dealt to Hero [8s 9s]
Dealt to b61f990d 
Dealt to 5c16018f 
Dealt to ab7b0d6c 
Dealt to 4d3453a6 
Dealt to f9f2ba85 
4d3453a6: raises $0.1 to $0.15
f9f2ba85: folds
Hero: folds
b61f990d: calls $0.15
5c16018f: folds
ab7b0d6c: calls $0.1
*** FLOP *** [9d 4s 5c]
ab7b0d6c: checks
4d3453a6: bets $0.36
b61f990d: folds
ab7b0d6c: folds
Uncalled bet ($0.36) returned to 4d3453a6
*** SHOWDOWN ***
4d3453a6 collected $0.45 from pot
*** SUMMARY ***
Total pot $0.47 | Rake $0.02 | Jackpot $0 | Bingo $0 | Fortune $0 | Tax $0
Board [9d 4s 5c]
Seat 1: Hero folded before Flop (didn't bet)
Seat 2: b61f990d (button) folded on the Flop
Seat 3: 5c16018f (small blind) folded before Flop
Seat 4: ab7b0d6c (big blind) folded on the Flop
Seat 5: 4d3453a6 won ($0.45)
Seat 6: f9f2ba85 folded before Flop (didn't bet)


Poker Hand #HD1746129962: Hold'em No Limit ($0.02/$0.05) - 2024/04/25 16:17:09
Table 'NLHBlue6' 6-max Seat #1 is the button
Seat 1: Hero ($6.14 in chips)
Seat 2: b61f990d ($3.05 in chips)
Seat 3: 5c16018f ($5.07 in chips)
Seat 4: ab7b0d6c ($5 in chips)
Seat 5: 4d3453a6 ($6.04 in chips)
Seat 6: f9f2ba85 ($5.21 in chips)
b61f990d: posts small blind $0.02
5c16018f: posts big blind $0.05
*** HOLE CARDS ***
Dealt to Hero [Ah 7s]
Dealt to b61f990d 
Dealt to 5c16018f 
Dealt to ab7b0d6c 
Dealt to 4d3453a6 
Dealt to f9f2ba85 
ab7b0d6c: folds
4d3453a6: folds
f9f2ba85: folds
Hero: raises $0.07 to $0.12
b61f990d: folds
5c16018f: folds
Uncalled bet ($0.07) returned to Hero
*** SHOWDOWN ***
Hero collected $0.12 from pot
*** SUMMARY ***
Total pot $0.12 | Rake $0 | Jackpot $0 | Bingo $0 | Fortune $0 | Tax $0
Seat 1: Hero (button) collected ($0.12)
Seat 2: b61f990d (small blind) folded before Flop
Seat 3: 5c16018f (big blind) folded before Flop
Seat 4: ab7b0d6c folded before Flop (didn't bet)
Seat 5: 4d3453a6 folded before Flop (didn't bet)
Seat 6: f9f2ba85 folded before Flop (didn't bet)


Poker Hand #HD1746129928: Hold'em No Limit ($0.02/$0.05) - 2024/04/25 16:16:53
Table 'NLHBlue6' 6-max Seat #6 is the button
Seat 1: Hero ($6.16 in chips)
Seat 2: b61f990d ($3.1 in chips)
Seat 3: 5c16018f ($5.07 in chips)
Seat 4: ab7b0d6c ($5 in chips)
Seat 5: 4d3453a6 ($6.04 in chips)
Seat 6: f9f2ba85 ($5.14 in chips)
Hero: posts small blind $0.02
b61f990d: posts big blind $0.05
*** HOLE CARDS ***
Dealt to Hero [Ah 8d]
Dealt to b61f990d 
Dealt to 5c16018f 
Dealt to ab7b0d6c 
Dealt to 4d3453a6 
Dealt to f9f2ba85 
5c16018f: folds
ab7b0d6c: folds
4d3453a6: folds
f9f2ba85: raises $0.08 to $0.13
Hero: folds
b61f990d: folds
Uncalled bet ($0.08) returned to f9f2ba85
*** SHOWDOWN ***
f9f2ba85 collected $0.12 from pot
*** SUMMARY ***
Total pot $0.12 | Rake $0 | Jackpot $0 | Bingo $0 | Fortune $0 | Tax $0
Seat 1: Hero (small blind) folded before Flop
Seat 2: b61f990d (big blind) folded before Flop
Seat 3: 5c16018f folded before Flop (didn't bet)
Seat 4: ab7b0d6c folded before Flop (didn't bet)
Seat 5: 4d3453a6 folded before Flop (didn't bet)
Seat 6: f9f2ba85 (button) collected ($0.12)


Poker Hand #HD1746129894: Hold'em No Limit ($0.02/$0.05) - 2024/04/25 16:16:37
Table 'NLHBlue6' 6-max Seat #5 is the button
Seat 1: Hero ($6.14 in chips)
Seat 2: b61f990d ($3.1 in chips)
Seat 3: 5c16018f ($5.07 in chips)
Seat 4: ab7b0d6c ($5 in chips)
Seat 5: 4d3453a6 ($6.04 in chips)
Seat 6: f9f2ba85 ($5.16 in chips)
f9f2ba85: posts small blind $0.02
Hero: posts big blind $0.05
*** HOLE CARDS ***
Dealt to Hero [6h 2s]
Dealt to b61f990d 
Dealt to 5c16018f 
Dealt to ab7b0d6c 
Dealt to 4d3453a6 
Dealt to f9f2ba85 
b61f990d: folds
5c16018f: folds
ab7b0d6c: folds
4d3453a6: folds
f9f2ba85: folds
Uncalled bet ($0.03) returned to Hero
*** SHOWDOWN ***
Hero collected $0.04 from pot
*** SUMMARY ***
Total pot $0.04 | Rake $0 | Jackpot $0 | Bingo $0 | Fortune $0 | Tax $0
Seat 1: Hero (big blind) collected ($0.04)
Seat 2: b61f990d folded before Flop (didn't bet)
Seat 3: 5c16018f folded before Flop (didn't bet)
Seat 4: ab7b0d6c folded before Flop (didn't bet)
Seat 5: 4d3453a6 (button) folded before Flop (didn't bet)
Seat 6: f9f2ba85 (small blind) folded before Flop


Poker Hand #HD1746129848: Hold'em No Limit ($0.02/$0.05) - 2024/04/25 16:16:22
Table 'NLHBlue6' 6-max Seat #4 is the button
Seat 1: Hero ($6.14 in chips)
Seat 2: b61f990d ($3.1 in chips)
Seat 3: 5c16018f ($5 in chips)
Seat 4: ab7b0d6c ($5 in chips)
Seat 5: 4d3453a6 ($6.06 in chips)
Seat 6: f9f2ba85 ($5.21 in chips)
4d3453a6: posts small blind $0.02
f9f2ba85: posts big blind $0.05
*** HOLE CARDS ***
Dealt to Hero [5s 6d]
Dealt to b61f990d 
Dealt to 5c16018f 
Dealt to ab7b0d6c 
Dealt to 4d3453a6 
Dealt to f9f2ba85 
Hero: folds
b61f990d: folds
5c16018f: raises $0.07 to $0.12
ab7b0d6c: folds
4d3453a6: folds
f9f2ba85: folds
Uncalled bet ($0.07) returned to 5c16018f
*** SHOWDOWN ***
5c16018f collected $0.12 from pot
*** SUMMARY ***
Total pot $0.12 | Rake $0 | Jackpot $0 | Bingo $0 | Fortune $0 | Tax $0
Seat 1: Hero folded before Flop (didn't bet)
Seat 2: b61f990d folded before Flop (didn't bet)
Seat 3: 5c16018f collected ($0.12)
Seat 4: ab7b0d6c (button) folded before Flop (didn't bet)
Seat 5: 4d3453a6 (small blind) folded before Flop
Seat 6: f9f2ba85 (big blind) folded before Flop


Poker Hand #HD1746129790: Hold'em No Limit ($0.02/$0.05) - 2024/04/25 16:15:54
Table 'NLHBlue6' 6-max Seat #3 is the button
Seat 1: Hero ($6.07 in chips)
Seat 2: b61f990d ($3.1 in chips)
Seat 3: 5c16018f ($5 in chips)
Seat 4: ab7b0d6c ($5 in chips)
Seat 5: 4d3453a6 ($6.11 in chips)
Seat 6: f9f2ba85 ($5.21 in chips)
ab7b0d6c: posts small blind $0.02
4d3453a6: posts big blind $0.05
*** HOLE CARDS ***
Dealt to Hero [Tc Ac]
Dealt to b61f990d 
Dealt to 5c16018f 
Dealt to ab7b0d6c 
Dealt to 4d3453a6 
Dealt to f9f2ba85 
f9f2ba85: folds
Hero: raises $0.05 to $0.1
b61f990d: folds
5c16018f: folds
ab7b0d6c: folds
4d3453a6: folds
Uncalled bet ($0.05) returned to Hero
*** SHOWDOWN ***
Hero collected $0.12 from pot
*** SUMMARY ***
Total pot $0.12 | Rake $0 | Jackpot $0 | Bingo $0 | Fortune $0 | Tax $0
Seat 1: Hero collected ($0.12)
Seat 2: b61f990d folded before Flop (didn't bet)
Seat 3: 5c16018f (button) folded before Flop (didn't bet)
Seat 4: ab7b0d6c (small blind) folded before Flop
Seat 5: 4d3453a6 (big blind) folded before Flop
Seat 6: f9f2ba85 folded before Flop (didn't bet)


Poker Hand #HD1746129698: Hold'em No Limit ($0.02/$0.05) - 2024/04/25 16:15:12
Table 'NLHBlue6' 6-max Seat #2 is the button
Seat 1: Hero ($6.07 in chips)
Seat 2: b61f990d ($3.1 in chips)
Seat 3: 5c16018f ($5 in chips)
Seat 4: ab7b0d6c ($5 in chips)
Seat 5: 4d3453a6 ($6.26 in chips)
Seat 6: f9f2ba85 ($5 in chips)
5c16018f: posts small blind $0.02
ab7b0d6c: posts big blind $0.05
*** HOLE CARDS ***
Dealt to Hero [5h 2c]
Dealt to b61f990d 
Dealt to 5c16018f 
Dealt to ab7b0d6c 
Dealt to 4d3453a6 
Dealt to f9f2ba85 
4d3453a6: raises $0.1 to $0.15
f9f2ba85: raises $0.1 to $0.25
Hero: folds
b61f990d: folds
5c16018f: folds
ab7b0d6c: folds
4d3453a6: folds
Uncalled bet ($0.1) returned to f9f2ba85
*** SHOWDOWN ***
f9f2ba85 collected $0.36 from pot
*** SUMMARY ***
Total pot $0.37 | Rake $0.01 | Jackpot $0 | Bingo $0 | Fortune $0 | Tax $0
Seat 1: Hero folded before Flop (didn't bet)
Seat 2: b61f990d (button) folded before Flop (didn't bet)
Seat 3: 5c16018f (small blind) folded before Flop
Seat 4: ab7b0d6c (big blind) folded before Flop
Seat 5: 4d3453a6 folded before Flop
Seat 6: f9f2ba85 collected ($0.36)


Poker Hand #HD1746129644: Hold'em No Limit ($0.02/$0.05) - 2024/04/25 16:14:49
Table 'NLHBlue6' 6-max Seat #1 is the button
Seat 1: Hero ($6.07 in chips)
Seat 2: b61f990d ($3.01 in chips)
Seat 3: 5c16018f ($5.07 in chips)
Seat 5: 4d3453a6 ($6.26 in chips)
Seat 6: f9f2ba85 ($5 in chips)
b61f990d: posts small blind $0.02
5c16018f: posts big blind $0.05
*** HOLE CARDS ***
Dealt to Hero [9h 8d]
Dealt to b61f990d 
Dealt to 5c16018f 
Dealt to 4d3453a6 
Dealt to f9f2ba85 
4d3453a6: folds
f9f2ba85: folds
Hero: folds
b61f990d: raises $0.05 to $0.1
5c16018f: calls $0.05
*** FLOP *** [Js 5d Qs]
b61f990d: bets $0.15
5c16018f: folds
Uncalled bet ($0.15) returned to b61f990d
*** SHOWDOWN ***
b61f990d collected $0.19 from pot
*** SUMMARY ***
Total pot $0.2 | Rake $0.01 | Jackpot $0 | Bingo $0 | Fortune $0 | Tax $0
Board [Js 5d Qs]
Seat 1: Hero (button) folded before Flop (didn't bet)
Seat 2: b61f990d (small blind) won ($0.19)
Seat 3: 5c16018f (big blind) folded on the Flop
Seat 5: 4d3453a6 folded before Flop (didn't bet)
Seat 6: f9f2ba85 folded before Flop (didn't bet)


Poker Hand #HD1746129552: Hold'em No Limit ($0.02/$0.05) - 2024/04/25 16:14:03
Table 'NLHBlue6' 6-max Seat #6 is the button
Seat 1: Hero ($6.09 in chips)
Seat 2: b61f990d ($2.62 in chips)
Seat 3: 5c16018f ($5.07 in chips)
Seat 5: 4d3453a6 ($6.26 in chips)
Seat 6: f9f2ba85 ($5.27 in chips)
Hero: posts small blind $0.02
b61f990d: posts big blind $0.05
*** HOLE CARDS ***
Dealt to Hero [7h Jd]
Dealt to b61f990d 
Dealt to 5c16018f 
Dealt to 4d3453a6 
Dealt to f9f2ba85 
5c16018f: folds
4d3453a6: folds
f9f2ba85: raises $0.08 to $0.13
Hero: folds
b61f990d: raises $0.28 to $0.41
f9f2ba85: calls $0.28
*** FLOP *** [2s 7s 7d]
b61f990d: bets $0.63
f9f2ba85: folds
Uncalled bet ($0.63) returned to b61f990d
*** SHOWDOWN ***
b61f990d collected $0.8 from pot
*** SUMMARY ***
Total pot $0.84 | Rake $0.04 | Jackpot $0 | Bingo $0 | Fortune $0 | Tax $0
Board [2s 7s 7d]
Seat 1: Hero (small blind) folded before Flop
Seat 2: b61f990d (big blind) won ($0.8)
Seat 3: 5c16018f folded before Flop (didn't bet)
Seat 5: 4d3453a6 folded before Flop (didn't bet)
Seat 6: f9f2ba85 (button) folded on the Flop


Poker Hand #HD1746129512: Hold'em No Limit ($0.02/$0.05) - 2024/04/25 16:13:50
Table 'NLHBlue6' 6-max Seat #5 is the button
Seat 1: Hero ($6.14 in chips)
Seat 2: b61f990d ($2.62 in chips)
Seat 3: 5c16018f ($5 in chips)
Seat 5: 4d3453a6 ($6.26 in chips)
Seat 6: f9f2ba85 ($5.29 in chips)
f9f2ba85: posts small blind $0.02
Hero: posts big blind $0.05
*** HOLE CARDS ***
Dealt to Hero [4s 7c]
Dealt to b61f990d 
Dealt to 5c16018f 
Dealt to 4d3453a6 
Dealt to f9f2ba85 
b61f990d: folds
5c16018f: raises $0.09 to $0.14
4d3453a6: folds
f9f2ba85: folds
Hero: folds
Uncalled bet ($0.09) returned to 5c16018f
*** SHOWDOWN ***
5c16018f collected $0.12 from pot
*** SUMMARY ***
Total pot $0.12 | Rake $0 | Jackpot $0 | Bingo $0 | Fortune $0 | Tax $0
Seat 1: Hero (big blind) folded before Flop
Seat 2: b61f990d folded before Flop (didn't bet)
Seat 3: 5c16018f collected ($0.12)
Seat 5: 4d3453a6 (button) folded before Flop (didn't bet)
Seat 6: f9f2ba85 (small blind) folded before Flop


Poker Hand #HD1746129475: Hold'em No Limit ($0.02/$0.05) - 2024/04/25 16:13:34
Table 'NLHBlue6' 6-max Seat #3 is the button
Seat 1: Hero ($6.14 in chips)
Seat 2: b61f990d ($2.62 in chips)
Seat 3: 5c16018f ($5 in chips)
Seat 5: 4d3453a6 ($6.28 in chips)
Seat 6: f9f2ba85 ($5.27 in chips)
4d3453a6: posts small blind $0.02
f9f2ba85: posts big blind $0.05
*** HOLE CARDS ***
Dealt to Hero [9d 5h]
Dealt to b61f990d 
Dealt to 5c16018f 
Dealt to 4d3453a6 
Dealt to f9f2ba85 
Hero: folds
b61f990d: folds
5c16018f: folds
4d3453a6: folds
Uncalled bet ($0.03) returned to f9f2ba85
*** SHOWDOWN ***
f9f2ba85 collected $0.04 from pot
*** SUMMARY ***
Total pot $0.04 | Rake $0 | Jackpot $0 | Bingo $0 | Fortune $0 | Tax $0
Seat 1: Hero folded before Flop (didn't bet)
Seat 2: b61f990d folded before Flop (didn't bet)
Seat 3: 5c16018f (button) folded before Flop (didn't bet)
Seat 5: 4d3453a6 (small blind) folded before Flop
Seat 6: f9f2ba85 (big blind) collected ($0.04)


Poker Hand #HD1746129425: Hold'em No Limit ($0.02/$0.05) - 2024/04/25 16:13:13
Table 'NLHBlue6' 6-max Seat #2 is the button
Seat 1: Hero ($6.07 in chips)
Seat 2: b61f990d ($2.62 in chips)
Seat 3: 5c16018f ($5 in chips)
Seat 5: 4d3453a6 ($6.33 in chips)
5c16018f: posts small blind $0.02
4d3453a6: posts big blind $0.05
*** HOLE CARDS ***
Dealt to Hero [Ad Qh]
Dealt to b61f990d 
Dealt to 5c16018f 
Dealt to 4d3453a6 
Hero: raises $0.07 to $0.12
b61f990d: folds
5c16018f: folds
4d3453a6: folds
Uncalled bet ($0.07) returned to Hero
*** SHOWDOWN ***
Hero collected $0.12 from pot
*** SUMMARY ***
Total pot $0.12 | Rake $0 | Jackpot $0 | Bingo $0 | Fortune $0 | Tax $0
Seat 1: Hero collected ($0.12)
Seat 2: b61f990d (button) folded before Flop (didn't bet)
Seat 3: 5c16018f (small blind) folded before Flop
Seat 5: 4d3453a6 (big blind) folded before Flop


Poker Hand #HD1746129353: Hold'em No Limit ($0.02/$0.05) - 2024/04/25 16:12:39
Table 'NLHBlue6' 6-max Seat #1 is the button
Seat 1: Hero ($6 in chips)
Seat 2: b61f990d ($2.64 in chips)
Seat 3: 5c16018f ($5 in chips)
Seat 4: 9c92842a ($9.58 in chips)
Seat 5: 4d3453a6 ($6.33 in chips)
b61f990d: posts small blind $0.02
5c16018f: posts big blind $0.05
*** HOLE CARDS ***
Dealt to Hero [2c As]
Dealt to b61f990d 
Dealt to 5c16018f 
Dealt to 9c92842a 
Dealt to 4d3453a6 
9c92842a: folds
4d3453a6: folds
Hero: raises $0.07 to $0.12
b61f990d: folds
5c16018f: folds
Uncalled bet ($0.07) returned to Hero
*** SHOWDOWN ***
Hero collected $0.12 from pot
*** SUMMARY ***
Total pot $0.12 | Rake $0 | Jackpot $0 | Bingo $0 | Fortune $0 | Tax $0
Seat 1: Hero (button) collected ($0.12)
Seat 2: b61f990d (small blind) folded before Flop
Seat 3: 5c16018f (big blind) folded before Flop
Seat 4: 9c92842a folded before Flop (didn't bet)
Seat 5: 4d3453a6 folded before Flop (didn't bet)


Poker Hand #HD1746129220: Hold'em No Limit ($0.02/$0.05) - 2024/04/25 16:11:40
Table 'NLHBlue6' 6-max Seat #5 is the button
Seat 1: Hero ($6.02 in chips)
Seat 2: b61f990d ($2.5 in chips)
Seat 3: 5c16018f ($5 in chips)
Seat 4: 9c92842a ($9.71 in chips)
Seat 5: 4d3453a6 ($6.33 in chips)
Hero: posts small blind $0.02
b61f990d: posts big blind $0.05
*** HOLE CARDS ***
Dealt to Hero [Js 7c]
Dealt to b61f990d 
Dealt to 5c16018f 
Dealt to 9c92842a 
Dealt to 4d3453a6 
5c16018f: folds
9c92842a: raises $0.08 to $0.13
4d3453a6: folds
Hero: folds
b61f990d: calls $0.08
*** FLOP *** [4h 4c 7d]
b61f990d: checks
9c92842a: checks
*** TURN *** [4h 4c 7d] [3h]
b61f990d: checks
9c92842a: checks
*** RIVER *** [4h 4c 7d 3h] [6d]
b61f990d: checks
9c92842a: checks
b61f990d: shows [6c Ac] (Pair of Sixes and Pair of Fours)
9c92842a: shows [2d Ad] (Pair of Fours)
*** SHOWDOWN ***
b61f990d collected $0.27 from pot
*** SUMMARY ***
Total pot $0.28 | Rake $0.01 | Jackpot $0 | Bingo $0 | Fortune $0 | Tax $0
Board [4h 4c 7d 3h 6d]
Seat 1: Hero (small blind) folded before Flop
Seat 2: b61f990d (big blind) showed [6c Ac] and won ($0.27) with Pair of Sixes and Pair of Fours
Seat 3: 5c16018f folded before Flop (didn't bet)
Seat 4: 9c92842a showed [2d Ad] and lost with Pair of Fours
Seat 5: 4d3453a6 (button) folded before Flop (didn't bet)


Poker Hand #HD1746129162: Hold'em No Limit ($0.02/$0.05) - 2024/04/25 16:11:13
Table 'NLHBlue6' 6-max Seat #4 is the button
Seat 1: Hero ($6.07 in chips)
Seat 3: 5c16018f ($5 in chips)
Seat 4: 9c92842a ($9.71 in chips)
Seat 5: 4d3453a6 ($6.28 in chips)
4d3453a6: posts small blind $0.02
Hero: posts big blind $0.05
*** HOLE CARDS ***
Dealt to Hero [2s Ad]
Dealt to 5c16018f 
Dealt to 9c92842a 
Dealt to 4d3453a6 
5c16018f: folds
9c92842a: folds
4d3453a6: raises $0.1 to $0.15
Hero: folds
Uncalled bet ($0.1) returned to 4d3453a6
*** SHOWDOWN ***
4d3453a6 collected $0.1 from pot
*** SUMMARY ***
Total pot $0.1 | Rake $0 | Jackpot $0 | Bingo $0 | Fortune $0 | Tax $0
Seat 1: Hero (big blind) folded before Flop
Seat 3: 5c16018f folded before Flop (didn't bet)
Seat 4: 9c92842a (button) folded before Flop (didn't bet)
Seat 5: 4d3453a6 (small blind) collected ($0.1)


Poker Hand #HD1746129101: Hold'em No Limit ($0.02/$0.05) - 2024/04/25 16:10:43
Table 'NLHBlue6' 6-max Seat #3 is the button
Seat 1: Hero ($6 in chips)
Seat 3: 5c16018f ($5 in chips)
Seat 4: 9c92842a ($9.73 in chips)
Seat 5: 4d3453a6 ($6.33 in chips)
Seat 6: f9f2ba85 ($5.27 in chips)
9c92842a: posts small blind $0.02
4d3453a6: posts big blind $0.05
*** HOLE CARDS ***
Dealt to Hero [8s 7s]
Dealt to 5c16018f 
Dealt to 9c92842a 
Dealt to 4d3453a6 
Dealt to f9f2ba85 
f9f2ba85: folds
Hero: raises $0.05 to $0.1
5c16018f: folds
9c92842a: folds
4d3453a6: folds
Uncalled bet ($0.05) returned to Hero
*** SHOWDOWN ***
Hero collected $0.12 from pot
*** SUMMARY ***
Total pot $0.12 | Rake $0 | Jackpot $0 | Bingo $0 | Fortune $0 | Tax $0
Seat 1: Hero collected ($0.12)
Seat 3: 5c16018f (button) folded before Flop (didn't bet)
Seat 4: 9c92842a (small blind) folded before Flop
Seat 5: 4d3453a6 (big blind) folded before Flop
Seat 6: f9f2ba85 folded before Flop (didn't bet)


Poker Hand #HD1746129065: Hold'em No Limit ($0.02/$0.05) - 2024/04/25 16:10:27
Table 'NLHBlue6' 6-max Seat #1 is the button
Seat 1: Hero ($6 in chips)
Seat 3: 5c16018f ($5 in chips)
Seat 4: 9c92842a ($9.71 in chips)
Seat 5: 4d3453a6 ($6.33 in chips)
Seat 6: f9f2ba85 ($5.27 in chips)
5c16018f: posts small blind $0.02
9c92842a: posts big blind $0.05
*** HOLE CARDS ***
Dealt to Hero [6c Ad]
Dealt to 5c16018f 
Dealt to 9c92842a 
Dealt to 4d3453a6 
Dealt to f9f2ba85 
4d3453a6: folds
f9f2ba85: folds
Hero: folds
5c16018f: folds
Uncalled bet ($0.03) returned to 9c92842a
*** SHOWDOWN ***
9c92842a collected $0.04 from pot
*** SUMMARY ***
Total pot $0.04 | Rake $0 | Jackpot $0 | Bingo $0 | Fortune $0 | Tax $0
Seat 1: Hero (button) folded before Flop (didn't bet)
Seat 3: 5c16018f (small blind) folded before Flop
Seat 4: 9c92842a (big blind) collected ($0.04)
Seat 5: 4d3453a6 folded before Flop (didn't bet)
Seat 6: f9f2ba85 folded before Flop (didn't bet)


Poker Hand #HD1746128904: Hold'em No Limit ($0.02/$0.05) - 2024/04/25 16:09:20
Table 'NLHBlue6' 6-max Seat #6 is the button
Seat 1: Hero ($6.07 in chips)
Seat 3: 5c16018f ($5.07 in chips)
Seat 4: 9c92842a ($9.71 in chips)
Seat 5: 4d3453a6 ($6.33 in chips)
Seat 6: f9f2ba85 ($5.27 in chips)
Hero: posts small blind $0.02
5c16018f: posts big blind $0.05
*** HOLE CARDS ***
Dealt to Hero [Ah 5d]
Dealt to 5c16018f 
Dealt to 9c92842a 
Dealt to 4d3453a6 
Dealt to f9f2ba85 
9c92842a: folds
4d3453a6: folds
f9f2ba85: folds
Hero: raises $0.1 to $0.15
5c16018f: calls $0.1
*** FLOP *** [Jd Ac 8c]
Hero: bets $0.1
5c16018f: calls $0.1
*** TURN *** [Jd Ac 8c] [7h]
Hero: bets $0.3
5c16018f: calls $0.3
*** RIVER *** [Jd Ac 8c 7h] [7d]
Hero: checks
5c16018f: bets $0.59
Hero: calls $0.59
5c16018f: shows [As Tc] (Pair of Aces and Pair of Sevens)
Hero: shows [Ah 5d] (Pair of Aces and Pair of Sevens)
*** SHOWDOWN ***
Hero collected $1.07 from pot
5c16018f collected $1.06 from pot
*** SUMMARY ***
Total pot $2.28 | Rake $0.1 | Jackpot $0.05 | Bingo $0 | Fortune $0 | Tax $0
Board [Jd Ac 8c 7h 7d]
Seat 1: Hero (small blind) showed [Ah 5d] and won ($1.07) with Pair of Aces and Pair of Sevens
Seat 3: 5c16018f (big blind) showed [As Tc] and won ($1.06) with Pair of Aces and Pair of Sevens
Seat 4: 9c92842a folded before Flop (didn't bet)
Seat 5: 4d3453a6 folded before Flop (didn't bet)
Seat 6: f9f2ba85 (button) folded before Flop (didn't bet)


Poker Hand #HD1746128816: Hold'em No Limit ($0.02/$0.05) - 2024/04/25 16:08:43
Table 'NLHBlue6' 6-max Seat #5 is the button
Seat 1: Hero ($5.93 in chips)
Seat 3: 5c16018f ($5.07 in chips)
Seat 4: 9c92842a ($9.84 in chips)
Seat 5: 4d3453a6 ($6.33 in chips)
Seat 6: f9f2ba85 ($5.29 in chips)
f9f2ba85: posts small blind $0.02
Hero: posts big blind $0.05
*** HOLE CARDS ***
Dealt to Hero [9c Kc]
Dealt to 5c16018f 
Dealt to 9c92842a 
Dealt to 4d3453a6 
Dealt to f9f2ba85 
5c16018f: folds
9c92842a: raises $0.08 to $0.13
4d3453a6: folds
f9f2ba85: folds
Hero: calls $0.08
*** FLOP *** [Tc Ks 5s]
Hero: checks
9c92842a: checks
*** TURN *** [Tc Ks 5s] [4s]
Hero: bets $0.1
9c92842a: folds
Uncalled bet ($0.1) returned to Hero
*** SHOWDOWN ***
Hero collected $0.27 from pot
*** SUMMARY ***
Total pot $0.28 | Rake $0.01 | Jackpot $0 | Bingo $0 | Fortune $0 | Tax $0
Board [Tc Ks 5s 4s]
Seat 1: Hero (big blind) won ($0.27)
Seat 3: 5c16018f folded before Flop (didn't bet)
Seat 4: 9c92842a folded on the Turn
Seat 5: 4d3453a6 (button) folded before Flop (didn't bet)
Seat 6: f9f2ba85 (small blind) folded before Flop


Poker Hand #HD1746128773: Hold'em No Limit ($0.02/$0.05) - 2024/04/25 16:08:21
Table 'NLHBlue6' 6-max Seat #4 is the button
Seat 1: Hero ($5.93 in chips)
Seat 3: 5c16018f ($5 in chips)
Seat 4: 9c92842a ($9.84 in chips)
Seat 5: 4d3453a6 ($6.35 in chips)
Seat 6: f9f2ba85 ($5.34 in chips)
4d3453a6: posts small blind $0.02
f9f2ba85: posts big blind $0.05
*** HOLE CARDS ***
Dealt to Hero [4d 8h]
Dealt to 5c16018f 
Dealt to 9c92842a 
Dealt to 4d3453a6 
Dealt to f9f2ba85 
Hero: folds
5c16018f: raises $0.07 to $0.12
9c92842a: folds
4d3453a6: folds
f9f2ba85: folds
Uncalled bet ($0.07) returned to 5c16018f
*** SHOWDOWN ***
5c16018f collected $0.12 from pot
*** SUMMARY ***
Total pot $0.12 | Rake $0 | Jackpot $0 | Bingo $0 | Fortune $0 | Tax $0
Seat 1: Hero folded before Flop (didn't bet)
Seat 3: 5c16018f collected ($0.12)
Seat 4: 9c92842a (button) folded before Flop (didn't bet)
Seat 5: 4d3453a6 (small blind) folded before Flop
Seat 6: f9f2ba85 (big blind) folded before Flop


Poker Hand #HD1746128739: Hold'em No Limit ($0.02/$0.05) - 2024/04/25 16:08:05
Table 'NLHBlue6' 6-max Seat #3 is the button
Seat 1: Hero ($5.93 in chips)
Seat 3: 5c16018f ($5 in chips)
Seat 4: 9c92842a ($9.86 in chips)
Seat 5: 4d3453a6 ($6.4 in chips)
Seat 6: f9f2ba85 ($5.27 in chips)
9c92842a: posts small blind $0.02
4d3453a6: posts big blind $0.05
*** HOLE CARDS ***
Dealt to Hero [Kc Jh]
Dealt to 5c16018f 
Dealt to 9c92842a 
Dealt to 4d3453a6 
Dealt to f9f2ba85 
f9f2ba85: raises $0.08 to $0.13
Hero: folds
5c16018f: folds
9c92842a: folds
4d3453a6: folds
Uncalled bet ($0.08) returned to f9f2ba85
*** SHOWDOWN ***
f9f2ba85 collected $0.12 from pot
*** SUMMARY ***
Total pot $0.12 | Rake $0 | Jackpot $0 | Bingo $0 | Fortune $0 | Tax $0
Seat 1: Hero folded before Flop (didn't bet)
Seat 3: 5c16018f (button) folded before Flop (didn't bet)
Seat 4: 9c92842a (small blind) folded before Flop
Seat 5: 4d3453a6 (big blind) folded before Flop
Seat 6: f9f2ba85 collected ($0.12)


Poker Hand #HD1746128696: Hold'em No Limit ($0.02/$0.05) - 2024/04/25 16:07:48
Table 'NLHBlue6' 6-max Seat #1 is the button
Seat 1: Hero ($5.93 in chips)
Seat 3: 5c16018f ($5 in chips)
Seat 4: 9c92842a ($9.91 in chips)
Seat 5: 4d3453a6 ($6.4 in chips)
Seat 6: f9f2ba85 ($5.2 in chips)
5c16018f: posts small blind $0.02
9c92842a: posts big blind $0.05
*** HOLE CARDS ***
Dealt to Hero [4c 2c]
Dealt to 5c16018f 
Dealt to 9c92842a 
Dealt to 4d3453a6 
Dealt to f9f2ba85 
4d3453a6: folds
f9f2ba85: raises $0.08 to $0.13
Hero: folds
5c16018f: folds
9c92842a: folds
Uncalled bet ($0.08) returned to f9f2ba85
*** SHOWDOWN ***
f9f2ba85 collected $0.12 from pot
*** SUMMARY ***
Total pot $0.12 | Rake $0 | Jackpot $0 | Bingo $0 | Fortune $0 | Tax $0
Seat 1: Hero (button) folded before Flop (didn't bet)
Seat 3: 5c16018f (small blind) folded before Flop
Seat 4: 9c92842a (big blind) folded before Flop
Seat 5: 4d3453a6 folded before Flop (didn't bet)
Seat 6: f9f2ba85 collected ($0.12)


Poker Hand #HD1746128574: Hold'em No Limit ($0.02/$0.05) - 2024/04/25 16:06:55
Table 'NLHBlue6' 6-max Seat #6 is the button
Seat 1: Hero ($5.95 in chips)
Seat 3: 5c16018f ($5.12 in chips)
Seat 4: 9c92842a ($9.74 in chips)
Seat 5: 4d3453a6 ($6.4 in chips)
Seat 6: f9f2ba85 ($5.2 in chips)
Hero: posts small blind $0.02
5c16018f: posts big blind $0.05
*** HOLE CARDS ***
Dealt to Hero [9s 7d]
Dealt to 5c16018f 
Dealt to 9c92842a 
Dealt to 4d3453a6 
Dealt to f9f2ba85 
9c92842a: raises $0.05 to $0.1
4d3453a6: folds
f9f2ba85: folds
Hero: folds
5c16018f: calls $0.05
*** FLOP *** [8h 7s 6h]
5c16018f: checks
9c92842a: checks
*** TURN *** [8h 7s 6h] [6s]
5c16018f: bets $0.06
9c92842a: raises $0.19 to $0.25
5c16018f: folds
Uncalled bet ($0.19) returned to 9c92842a
*** SHOWDOWN ***
9c92842a collected $0.33 from pot
*** SUMMARY ***
Total pot $0.34 | Rake $0.01 | Jackpot $0 | Bingo $0 | Fortune $0 | Tax $0
Board [8h 7s 6h 6s]
Seat 1: Hero (small blind) folded before Flop
Seat 3: 5c16018f (big blind) folded on the Turn
Seat 4: 9c92842a won ($0.33)
Seat 5: 4d3453a6 folded before Flop (didn't bet)
Seat 6: f9f2ba85 (button) folded before Flop (didn't bet)


Poker Hand #HD1746128538: Hold'em No Limit ($0.02/$0.05) - 2024/04/25 16:06:39
Table 'NLHBlue6' 6-max Seat #5 is the button
Seat 1: Hero ($6 in chips)
Seat 3: 5c16018f ($5.12 in chips)
Seat 4: 9c92842a ($9.74 in chips)
Seat 5: 4d3453a6 ($6.4 in chips)
Seat 6: f9f2ba85 ($5.15 in chips)
f9f2ba85: posts small blind $0.02
Hero: posts big blind $0.05
*** HOLE CARDS ***
Dealt to Hero [3s 8s]
Dealt to 5c16018f 
Dealt to 9c92842a 
Dealt to 4d3453a6 
Dealt to f9f2ba85 
5c16018f: folds
9c92842a: folds
4d3453a6: folds
f9f2ba85: raises $0.1 to $0.15
Hero: folds
Uncalled bet ($0.1) returned to f9f2ba85
*** SHOWDOWN ***
f9f2ba85 collected $0.1 from pot
*** SUMMARY ***
Total pot $0.1 | Rake $0 | Jackpot $0 | Bingo $0 | Fortune $0 | Tax $0
Seat 1: Hero (big blind) folded before Flop
Seat 3: 5c16018f folded before Flop (didn't bet)
Seat 4: 9c92842a folded before Flop (didn't bet)
Seat 5: 4d3453a6 (button) folded before Flop (didn't bet)
Seat 6: f9f2ba85 (small blind) collected ($0.1)


Poker Hand #HD1746128496: Hold'em No Limit ($0.02/$0.05) - 2024/04/25 16:06:20
Table 'NLHBlue6' 6-max Seat #4 is the button
Seat 1: Hero ($6 in chips)
Seat 3: 5c16018f ($5.05 in chips)
Seat 4: 9c92842a ($9.74 in chips)
Seat 5: 4d3453a6 ($6.42 in chips)
Seat 6: f9f2ba85 ($5.2 in chips)
4d3453a6: posts small blind $0.02
f9f2ba85: posts big blind $0.05
*** HOLE CARDS ***
Dealt to Hero [6s Jd]
Dealt to 5c16018f 
Dealt to 9c92842a 
Dealt to 4d3453a6 
Dealt to f9f2ba85 
Hero: folds
5c16018f: raises $0.07 to $0.12
9c92842a: folds
4d3453a6: folds
f9f2ba85: folds
Uncalled bet ($0.07) returned to 5c16018f
*** SHOWDOWN ***
5c16018f collected $0.12 from pot
*** SUMMARY ***
Total pot $0.12 | Rake $0 | Jackpot $0 | Bingo $0 | Fortune $0 | Tax $0
Seat 1: Hero folded before Flop (didn't bet)
Seat 3: 5c16018f collected ($0.12)
Seat 4: 9c92842a (button) folded before Flop (didn't bet)
Seat 5: 4d3453a6 (small blind) folded before Flop
Seat 6: f9f2ba85 (big blind) folded before Flop


Poker Hand #HD1746128457: Hold'em No Limit ($0.02/$0.05) - 2024/04/25 16:06:02
Table 'NLHBlue6' 6-max Seat #3 is the button
Seat 1: Hero ($6 in chips)
Seat 3: 5c16018f ($5.05 in chips)
Seat 4: 9c92842a ($9.76 in chips)
Seat 5: 4d3453a6 ($6.4 in chips)
Seat 6: f9f2ba85 ($5.2 in chips)
9c92842a: posts small blind $0.02
4d3453a6: posts big blind $0.05
*** HOLE CARDS ***
Dealt to Hero [2h 8s]
Dealt to 5c16018f 
Dealt to 9c92842a 
Dealt to 4d3453a6 
Dealt to f9f2ba85 
f9f2ba85: folds
Hero: folds
5c16018f: folds
9c92842a: folds
Uncalled bet ($0.03) returned to 4d3453a6
*** SHOWDOWN ***
4d3453a6 collected $0.04 from pot
*** SUMMARY ***
Total pot $0.04 | Rake $0 | Jackpot $0 | Bingo $0 | Fortune $0 | Tax $0
Seat 1: Hero folded before Flop (didn't bet)
Seat 3: 5c16018f (button) folded before Flop (didn't bet)
Seat 4: 9c92842a (small blind) folded before Flop
Seat 5: 4d3453a6 (big blind) collected ($0.04)
Seat 6: f9f2ba85 folded before Flop (didn't bet)


Poker Hand #HD1746128416: Hold'em No Limit ($0.02/$0.05) - 2024/04/25 16:05:44
Table 'NLHBlue6' 6-max Seat #1 is the button
Seat 1: Hero ($6 in chips)
Seat 3: 5c16018f ($5 in chips)
Seat 4: 9c92842a ($9.81 in chips)
Seat 5: 4d3453a6 ($6.4 in chips)
Seat 6: f9f2ba85 ($5.2 in chips)
5c16018f: posts small blind $0.02
9c92842a: posts big blind $0.05
*** HOLE CARDS ***
Dealt to Hero [5h Kd]
Dealt to 5c16018f 
Dealt to 9c92842a 
Dealt to 4d3453a6 
Dealt to f9f2ba85 
4d3453a6: folds
f9f2ba85: folds
Hero: folds
5c16018f: raises $0.05 to $0.1
9c92842a: folds
Uncalled bet ($0.05) returned to 5c16018f
*** SHOWDOWN ***
5c16018f collected $0.1 from pot
*** SUMMARY ***
Total pot $0.1 | Rake $0 | Jackpot $0 | Bingo $0 | Fortune $0 | Tax $0
Seat 1: Hero (button) folded before Flop (didn't bet)
Seat 3: 5c16018f (small blind) collected ($0.1)
Seat 4: 9c92842a (big blind) folded before Flop
Seat 5: 4d3453a6 folded before Flop (didn't bet)
Seat 6: f9f2ba85 folded before Flop (didn't bet)


Poker Hand #HD1746128367: Hold'em No Limit ($0.02/$0.05) - 2024/04/25 16:05:20
Table 'NLHBlue6' 6-max Seat #6 is the button
Seat 1: Hero ($6.02 in chips)
Seat 3: 5c16018f ($5 in chips)
Seat 4: 9c92842a ($9.81 in chips)
Seat 5: 4d3453a6 ($6.33 in chips)
Seat 6: f9f2ba85 ($5.2 in chips)
Hero: posts small blind $0.02
5c16018f: posts big blind $0.05
*** HOLE CARDS ***
Dealt to Hero [Qh 6d]
Dealt to 5c16018f 
Dealt to 9c92842a 
Dealt to 4d3453a6 
Dealt to f9f2ba85 
9c92842a: folds
4d3453a6: raises $0.08 to $0.13
f9f2ba85: folds
Hero: folds
5c16018f: folds
Uncalled bet ($0.08) returned to 4d3453a6
*** SHOWDOWN ***
4d3453a6 collected $0.12 from pot
*** SUMMARY ***
Total pot $0.12 | Rake $0 | Jackpot $0 | Bingo $0 | Fortune $0 | Tax $0
Seat 1: Hero (small blind) folded before Flop
Seat 3: 5c16018f (big blind) folded before Flop
Seat 4: 9c92842a folded before Flop (didn't bet)
Seat 5: 4d3453a6 collected ($0.12)
Seat 6: f9f2ba85 (button) folded before Flop (didn't bet)


Poker Hand #HD1746128321: Hold'em No Limit ($0.02/$0.05) - 2024/04/25 16:04:55
Table 'NLHBlue6' 6-max Seat #5 is the button
Seat 1: Hero ($6.07 in chips)
Seat 3: 5c16018f ($5 in chips)
Seat 4: 9c92842a ($9.81 in chips)
Seat 5: 4d3453a6 ($6.33 in chips)
Seat 6: f9f2ba85 ($5.02 in chips)
f9f2ba85: posts small blind $0.02
Hero: posts big blind $0.05
*** HOLE CARDS ***
Dealt to Hero [2d 8c]
Dealt to 5c16018f 
Dealt to 9c92842a 
Dealt to 4d3453a6 
Dealt to f9f2ba85 
5c16018f: raises $0.09 to $0.14
9c92842a: folds
4d3453a6: folds
f9f2ba85: raises $0.43 to $0.57
Hero: folds
5c16018f: folds
Uncalled bet ($0.43) returned to f9f2ba85
*** SHOWDOWN ***
f9f2ba85 collected $0.32 from pot
*** SUMMARY ***
Total pot $0.33 | Rake $0.01 | Jackpot $0 | Bingo $0 | Fortune $0 | Tax $0
Seat 1: Hero (big blind) folded before Flop
Seat 3: 5c16018f folded before Flop
Seat 4: 9c92842a folded before Flop (didn't bet)
Seat 5: 4d3453a6 (button) folded before Flop (didn't bet)
Seat 6: f9f2ba85 (small blind) collected ($0.32)


Poker Hand #HD1746128288: Hold'em No Limit ($0.02/$0.05) - 2024/04/25 16:04:43
Table 'NLHBlue6' 6-max Seat #4 is the button
Seat 1: Hero ($6.07 in chips)
Seat 3: 5c16018f ($5 in chips)
Seat 4: 9c92842a ($9.81 in chips)
Seat 5: 4d3453a6 ($6.35 in chips)
Seat 6: f9f2ba85 ($5 in chips)
4d3453a6: posts small blind $0.02
f9f2ba85: posts big blind $0.05
*** HOLE CARDS ***
Dealt to Hero [8s 5c]
Dealt to 5c16018f 
Dealt to 9c92842a 
Dealt to 4d3453a6 
Dealt to f9f2ba85 
Hero: folds
5c16018f: folds
9c92842a: folds
4d3453a6: folds
Uncalled bet ($0.03) returned to f9f2ba85
*** SHOWDOWN ***
f9f2ba85 collected $0.04 from pot
*** SUMMARY ***
Total pot $0.04 | Rake $0 | Jackpot $0 | Bingo $0 | Fortune $0 | Tax $0
Seat 1: Hero folded before Flop (didn't bet)
Seat 3: 5c16018f folded before Flop (didn't bet)
Seat 4: 9c92842a (button) folded before Flop (didn't bet)
Seat 5: 4d3453a6 (small blind) folded before Flop
Seat 6: f9f2ba85 (big blind) collected ($0.04)


Poker Hand #HD1746128214: Hold'em No Limit ($0.02/$0.05) - 2024/04/25 16:04:11
Table 'NLHBlue6' 6-max Seat #3 is the button
Seat 1: Hero ($6 in chips)
Seat 3: 5c16018f ($5 in chips)
Seat 4: 9c92842a ($9.83 in chips)
Seat 5: 4d3453a6 ($6.4 in chips)
Seat 6: f9f2ba85 ($5 in chips)
9c92842a: posts small blind $0.02
4d3453a6: posts big blind $0.05
*** HOLE CARDS ***
Dealt to Hero [Ac Kc]
Dealt to 5c16018f 
Dealt to 9c92842a 
Dealt to 4d3453a6 
Dealt to f9f2ba85 
f9f2ba85: folds
Hero: raises $0.07 to $0.12
5c16018f: folds
9c92842a: folds
4d3453a6: folds
Uncalled bet ($0.07) returned to Hero
*** SHOWDOWN ***
Hero collected $0.12 from pot
*** SUMMARY ***
Total pot $0.12 | Rake $0 | Jackpot $0 | Bingo $0 | Fortune $0 | Tax $0
Seat 1: Hero collected ($0.12)
Seat 3: 5c16018f (button) folded before Flop (didn't bet)
Seat 4: 9c92842a (small blind) folded before Flop
Seat 5: 4d3453a6 (big blind) folded before Flop
Seat 6: f9f2ba85 folded before Flop (didn't bet)


Poker Hand #HD1746128113: Hold'em No Limit ($0.02/$0.05) - 2024/04/25 16:03:30
Table 'NLHBlue6' 6-max Seat #1 is the button
Seat 1: Hero ($6 in chips)
Seat 3: 5c16018f ($5.02 in chips)
Seat 4: 9c92842a ($9.7 in chips)
Seat 5: 4d3453a6 ($6.4 in chips)
Seat 6: f9f2ba85 ($5 in chips)
5c16018f: posts small blind $0.02
9c92842a: posts big blind $0.05
*** HOLE CARDS ***
Dealt to Hero [2c 7h]
Dealt to 5c16018f 
Dealt to 9c92842a 
Dealt to 4d3453a6 
Dealt to f9f2ba85 
4d3453a6: folds
f9f2ba85: folds
Hero: folds
5c16018f: raises $0.09 to $0.14
9c92842a: calls $0.09
*** FLOP *** [5h Kh 5d]
5c16018f: checks
9c92842a: bets $0.14
5c16018f: folds
Uncalled bet ($0.14) returned to 9c92842a
*** SHOWDOWN ***
9c92842a collected $0.27 from pot
*** SUMMARY ***
Total pot $0.28 | Rake $0.01 | Jackpot $0 | Bingo $0 | Fortune $0 | Tax $0
Board [5h Kh 5d]
Seat 1: Hero (button) folded before Flop (didn't bet)
Seat 3: 5c16018f (small blind) folded on the Flop
Seat 4: 9c92842a (big blind) won ($0.27)
Seat 5: 4d3453a6 folded before Flop (didn't bet)
Seat 6: f9f2ba85 folded before Flop (didn't bet)


Poker Hand #HD1746128092: Hold'em No Limit ($0.02/$0.05) - 2024/04/25 16:03:19
Table 'NLHBlue6' 6-max Seat #6 is the button
Seat 1: Hero ($6.02 in chips)
Seat 3: 5c16018f ($5 in chips)
Seat 4: 9c92842a ($9.7 in chips)
Seat 5: 4d3453a6 ($6.4 in chips)
Seat 6: f9f2ba85 ($5 in chips)
Hero: posts small blind $0.02
5c16018f: posts big blind $0.05
*** HOLE CARDS ***
Dealt to Hero [2h Qs]
Dealt to 5c16018f 
Dealt to 9c92842a 
Dealt to 4d3453a6 
Dealt to f9f2ba85 
9c92842a: folds
4d3453a6: folds
f9f2ba85: folds
Hero: folds
Uncalled bet ($0.03) returned to 5c16018f
*** SHOWDOWN ***
5c16018f collected $0.04 from pot
*** SUMMARY ***
Total pot $0.04 | Rake $0 | Jackpot $0 | Bingo $0 | Fortune $0 | Tax $0
Seat 1: Hero (small blind) folded before Flop
Seat 3: 5c16018f (big blind) collected ($0.04)
Seat 4: 9c92842a folded before Flop (didn't bet)
Seat 5: 4d3453a6 folded before Flop (didn't bet)
Seat 6: f9f2ba85 (button) folded before Flop (didn't bet)


Poker Hand #HD1746127934: Hold'em No Limit ($0.02/$0.05) - 2024/04/25 16:02:11
Table 'NLHBlue6' 6-max Seat #5 is the button
Seat 1: Hero ($6.07 in chips)
Seat 2: 2b9dfc13 ($5.99 in chips)
Seat 3: 5c16018f ($5 in chips)
Seat 4: 9c92842a ($9.41 in chips)
Seat 5: 4d3453a6 ($6.4 in chips)
Seat 6: f9f2ba85 ($5 in chips)
f9f2ba85: posts small blind $0.02
Hero: posts big blind $0.05
*** HOLE CARDS ***
Dealt to Hero [4c Tc]
Dealt to 2b9dfc13 
Dealt to 5c16018f 
Dealt to 9c92842a 
Dealt to 4d3453a6 
Dealt to f9f2ba85 
2b9dfc13: raises $0.05 to $0.1
5c16018f: folds
9c92842a: calls $0.1
4d3453a6: folds
f9f2ba85: folds
Hero: folds
*** FLOP *** [4s Jc 4h]
2b9dfc13: checks
9c92842a: checks
*** TURN *** [4s Jc 4h] [3d]
2b9dfc13: checks
9c92842a: checks
*** RIVER *** [4s Jc 4h 3d] [Qc]
2b9dfc13: bets $0.14
9c92842a: raises $0.28 to $0.42
2b9dfc13: folds
Uncalled bet ($0.28) returned to 9c92842a
*** SHOWDOWN ***
9c92842a collected $0.53 from pot
*** SUMMARY ***
Total pot $0.55 | Rake $0.02 | Jackpot $0 | Bingo $0 | Fortune $0 | Tax $0
Board [4s Jc 4h 3d Qc]
Seat 1: Hero (big blind) folded before Flop
Seat 2: 2b9dfc13 folded on the River
Seat 3: 5c16018f folded before Flop (didn't bet)
Seat 4: 9c92842a won ($0.53)
Seat 5: 4d3453a6 (button) folded before Flop (didn't bet)
Seat 6: f9f2ba85 (small blind) folded before Flop


Poker Hand #HD1746127857: Hold'em No Limit ($0.02/$0.05) - 2024/04/25 16:01:42
Table 'NLHBlue6' 6-max Seat #4 is the button
Seat 1: Hero ($6 in chips)
Seat 2: 2b9dfc13 ($5.99 in chips)
Seat 3: 5c16018f ($5 in chips)
Seat 4: 9c92842a ($9.41 in chips)
Seat 5: 4d3453a6 ($6.42 in chips)
Seat 6: f9f2ba85 ($5 in chips)
4d3453a6: posts small blind $0.02
f9f2ba85: posts big blind $0.05
*** HOLE CARDS ***
Dealt to Hero [Th Kh]
Dealt to 2b9dfc13 
Dealt to 5c16018f 
Dealt to 9c92842a 
Dealt to 4d3453a6 
Dealt to f9f2ba85 
Hero: raises $0.05 to $0.1
2b9dfc13: folds
5c16018f: folds
9c92842a: folds
4d3453a6: folds
f9f2ba85: folds
Uncalled bet ($0.05) returned to Hero
*** SHOWDOWN ***
Hero collected $0.12 from pot
*** SUMMARY ***
Total pot $0.12 | Rake $0 | Jackpot $0 | Bingo $0 | Fortune $0 | Tax $0
Seat 1: Hero collected ($0.12)
Seat 2: 2b9dfc13 folded before Flop (didn't bet)
Seat 3: 5c16018f folded before Flop (didn't bet)
Seat 4: 9c92842a (button) folded before Flop (didn't bet)
Seat 5: 4d3453a6 (small blind) folded before Flop
Seat 6: f9f2ba85 (big blind) folded before Flop


Poker Hand #HD1746127824: Hold'em No Limit ($0.02/$0.05) - 2024/04/25 16:01:28
Table 'NLHBlue6' 6-max Seat #3 is the button
Seat 1: Hero ($6 in chips)
Seat 2: 2b9dfc13 ($5.99 in chips)
Seat 3: 5c16018f ($5 in chips)
Seat 4: 9c92842a ($9.43 in chips)
Seat 5: 4d3453a6 ($6.4 in chips)
Seat 6: f9f2ba85 ($5 in chips)
9c92842a: posts small blind $0.02
4d3453a6: posts big blind $0.05
*** HOLE CARDS ***
Dealt to Hero [8d Js]
Dealt to 2b9dfc13 
Dealt to 5c16018f 
Dealt to 9c92842a 
Dealt to 4d3453a6 
Dealt to f9f2ba85 
f9f2ba85: folds
Hero: folds
2b9dfc13: folds
5c16018f: folds
9c92842a: folds
Uncalled bet ($0.03) returned to 4d3453a6
*** SHOWDOWN ***
4d3453a6 collected $0.04 from pot
*** SUMMARY ***
Total pot $0.04 | Rake $0 | Jackpot $0 | Bingo $0 | Fortune $0 | Tax $0
Seat 1: Hero folded before Flop (didn't bet)
Seat 2: 2b9dfc13 folded before Flop (didn't bet)
Seat 3: 5c16018f (button) folded before Flop (didn't bet)
Seat 4: 9c92842a (small blind) folded before Flop
Seat 5: 4d3453a6 (big blind) collected ($0.04)
Seat 6: f9f2ba85 folded before Flop (didn't bet)


Poker Hand #HD1746127748: Hold'em No Limit ($0.02/$0.05) - 2024/04/25 16:00:57
Table 'NLHBlue6' 6-max Seat #2 is the button
Seat 1: Hero ($6.12 in chips)
Seat 2: 2b9dfc13 ($5.81 in chips)
Seat 3: 5c16018f ($5 in chips)
Seat 4: 9c92842a ($9.48 in chips)
Seat 5: 4d3453a6 ($6.4 in chips)
Seat 6: f9f2ba85 ($5 in chips)
5c16018f: posts small blind $0.02
9c92842a: posts big blind $0.05
*** HOLE CARDS ***
Dealt to Hero [Qh Th]
Dealt to 2b9dfc13 
Dealt to 5c16018f 
Dealt to 9c92842a 
Dealt to 4d3453a6 
Dealt to f9f2ba85 
4d3453a6: folds
f9f2ba85: folds
Hero: raises $0.07 to $0.12
2b9dfc13: raises $0.31 to $0.43
5c16018f: folds
9c92842a: folds
Hero: folds
Uncalled bet ($0.31) returned to 2b9dfc13
*** SHOWDOWN ***
2b9dfc13 collected $0.3 from pot
*** SUMMARY ***
Total pot $0.31 | Rake $0.01 | Jackpot $0 | Bingo $0 | Fortune $0 | Tax $0
Seat 1: Hero folded before Flop
Seat 2: 2b9dfc13 (button) collected ($0.3)
Seat 3: 5c16018f (small blind) folded before Flop
Seat 4: 9c92842a (big blind) folded before Flop
Seat 5: 4d3453a6 folded before Flop (didn't bet)
Seat 6: f9f2ba85 folded before Flop (didn't bet)


Poker Hand #HD1746127692: Hold'em No Limit ($0.02/$0.05) - 2024/04/25 16:00:29
Table 'NLHBlue6' 6-max Seat #1 is the button
Seat 1: Hero ($6.12 in chips)
Seat 2: 2b9dfc13 ($5.62 in chips)
Seat 3: 5c16018f ($5 in chips)
Seat 4: 9c92842a ($9.48 in chips)
Seat 5: 4d3453a6 ($6.55 in chips)
Seat 6: f9f2ba85 ($5 in chips)
2b9dfc13: posts small blind $0.02
5c16018f: posts big blind $0.05
*** HOLE CARDS ***
Dealt to Hero [Qc 9s]
Dealt to 2b9dfc13 
Dealt to 5c16018f 
Dealt to 9c92842a 
Dealt to 4d3453a6 
Dealt to f9f2ba85 
9c92842a: folds
4d3453a6: raises $0.1 to $0.15
f9f2ba85: folds
Hero: folds
2b9dfc13: raises $0.35 to $0.5
5c16018f: folds
4d3453a6: folds
Uncalled bet ($0.35) returned to 2b9dfc13
*** SHOWDOWN ***
2b9dfc13 collected $0.34 from pot
*** SUMMARY ***
Total pot $0.35 | Rake $0.01 | Jackpot $0 | Bingo $0 | Fortune $0 | Tax $0
Seat 1: Hero (button) folded before Flop (didn't bet)
Seat 2: 2b9dfc13 (small blind) collected ($0.34)
Seat 3: 5c16018f (big blind) folded before Flop
Seat 4: 9c92842a folded before Flop (didn't bet)
Seat 5: 4d3453a6 folded before Flop
Seat 6: f9f2ba85 folded before Flop (didn't bet)


Poker Hand #HD1746127616: Hold'em No Limit ($0.02/$0.05) - 2024/04/25 15:59:59
Table 'NLHBlue6' 6-max Seat #6 is the button
Seat 1: Hero ($6.14 in chips)
Seat 2: 2b9dfc13 ($5.36 in chips)
Seat 3: 5c16018f ($5 in chips)
Seat 4: 9c92842a ($9.61 in chips)
Seat 5: 4d3453a6 ($6.55 in chips)
Seat 6: f9f2ba85 ($5 in chips)
Hero: posts small blind $0.02
2b9dfc13: posts big blind $0.05
*** HOLE CARDS ***
Dealt to Hero [8s Ks]
Dealt to 2b9dfc13 
Dealt to 5c16018f 
Dealt to 9c92842a 
Dealt to 4d3453a6 
Dealt to f9f2ba85 
5c16018f: folds
9c92842a: raises $0.08 to $0.13
4d3453a6: folds
f9f2ba85: calls $0.13
Hero: folds
2b9dfc13: calls $0.08
*** FLOP *** [Td 3h Qc]
2b9dfc13: bets $0.21
9c92842a: folds
f9f2ba85: folds
Uncalled bet ($0.21) returned to 2b9dfc13
*** SHOWDOWN ***
2b9dfc13 collected $0.39 from pot
*** SUMMARY ***
Total pot $0.41 | Rake $0.02 | Jackpot $0 | Bingo $0 | Fortune $0 | Tax $0
Board [Td 3h Qc]
Seat 1: Hero (small blind) folded before Flop
Seat 2: 2b9dfc13 (big blind) won ($0.39)
Seat 3: 5c16018f folded before Flop (didn't bet)
Seat 4: 9c92842a folded on the Flop
Seat 5: 4d3453a6 folded before Flop (didn't bet)
Seat 6: f9f2ba85 (button) folded on the Flop


Poker Hand #HD1746127554: Hold'em No Limit ($0.02/$0.05) - 2024/04/25 15:59:32
Table 'NLHBlue6' 6-max Seat #5 is the button
Seat 1: Hero ($6.19 in chips)
Seat 2: 2b9dfc13 ($5.29 in chips)
Seat 3: 5c16018f ($5 in chips)
Seat 4: 9c92842a ($9.61 in chips)
Seat 5: 4d3453a6 ($6.55 in chips)
Seat 6: f9f2ba85 ($5.02 in chips)
f9f2ba85: posts small blind $0.02
Hero: posts big blind $0.05
*** HOLE CARDS ***
Dealt to Hero [4c 8d]
Dealt to 2b9dfc13 
Dealt to 5c16018f 
Dealt to 9c92842a 
Dealt to 4d3453a6 
Dealt to f9f2ba85 
2b9dfc13: raises $0.05 to $0.1
5c16018f: folds
9c92842a: folds
4d3453a6: folds
f9f2ba85: folds
Hero: folds
Uncalled bet ($0.05) returned to 2b9dfc13
*** SHOWDOWN ***
2b9dfc13 collected $0.12 from pot
*** SUMMARY ***
Total pot $0.12 | Rake $0 | Jackpot $0 | Bingo $0 | Fortune $0 | Tax $0
Seat 1: Hero (big blind) folded before Flop
Seat 2: 2b9dfc13 collected ($0.12)
Seat 3: 5c16018f folded before Flop (didn't bet)
Seat 4: 9c92842a folded before Flop (didn't bet)
Seat 5: 4d3453a6 (button) folded before Flop (didn't bet)
Seat 6: f9f2ba85 (small blind) folded before Flop


Poker Hand #HD1746127520: Hold'em No Limit ($0.02/$0.05) - 2024/04/25 15:59:19
Table 'NLHBlue6' 6-max Seat #4 is the button
Seat 1: Hero ($6.19 in chips)
Seat 2: 2b9dfc13 ($5.29 in chips)
Seat 3: 5c16018f ($5 in chips)
Seat 4: 9c92842a ($9.61 in chips)
Seat 5: 4d3453a6 ($6.57 in chips)
Seat 6: f9f2ba85 ($5 in chips)
4d3453a6: posts small blind $0.02
f9f2ba85: posts big blind $0.05
*** HOLE CARDS ***
Dealt to Hero [Qs 6h]
Dealt to 2b9dfc13 
Dealt to 5c16018f 
Dealt to 9c92842a 
Dealt to 4d3453a6 
Dealt to f9f2ba85 
Hero: folds
2b9dfc13: folds
5c16018f: folds
9c92842a: folds
4d3453a6: folds
Uncalled bet ($0.03) returned to f9f2ba85
*** SHOWDOWN ***
f9f2ba85 collected $0.04 from pot
*** SUMMARY ***
Total pot $0.04 | Rake $0 | Jackpot $0 | Bingo $0 | Fortune $0 | Tax $0
Seat 1: Hero folded before Flop (didn't bet)
Seat 2: 2b9dfc13 folded before Flop (didn't bet)
Seat 3: 5c16018f folded before Flop (didn't bet)
Seat 4: 9c92842a (button) folded before Flop (didn't bet)
Seat 5: 4d3453a6 (small blind) folded before Flop
Seat 6: f9f2ba85 (big blind) collected ($0.04)


Poker Hand #HD1746127467: Hold'em No Limit ($0.02/$0.05) - 2024/04/25 15:58:52
Table 'NLHBlue6' 6-max Seat #3 is the button
Seat 1: Hero ($6.19 in chips)
Seat 2: 2b9dfc13 ($5.05 in chips)
Seat 3: 5c16018f ($5 in chips)
Seat 4: 9c92842a ($9.71 in chips)
Seat 5: 4d3453a6 ($6.62 in chips)
9c92842a: posts small blind $0.02
4d3453a6: posts big blind $0.05
*** HOLE CARDS ***
Dealt to Hero [Ac 3d]
Dealt to 2b9dfc13 
Dealt to 5c16018f 
Dealt to 9c92842a 
Dealt to 4d3453a6 
Hero: folds
2b9dfc13: raises $0.05 to $0.1
5c16018f: calls $0.1
9c92842a: calls $0.08
4d3453a6: folds
*** FLOP *** [Td 8d Ts]
9c92842a: checks
2b9dfc13: bets $0.18
5c16018f: folds
9c92842a: folds
Uncalled bet ($0.18) returned to 2b9dfc13
*** SHOWDOWN ***
2b9dfc13 collected $0.34 from pot
*** SUMMARY ***
Total pot $0.35 | Rake $0.01 | Jackpot $0 | Bingo $0 | Fortune $0 | Tax $0
Board [Td 8d Ts]
Seat 1: Hero folded before Flop (didn't bet)
Seat 2: 2b9dfc13 won ($0.34)
Seat 3: 5c16018f (button) folded on the Flop
Seat 4: 9c92842a (small blind) folded on the Flop
Seat 5: 4d3453a6 (big blind) folded before Flop


Poker Hand #HD1746127445: Hold'em No Limit ($0.02/$0.05) - 2024/04/25 15:58:43
Table 'NLHBlue6' 6-max Seat #2 is the button
Seat 1: Hero ($6.19 in chips)
Seat 2: 2b9dfc13 ($5.05 in chips)
Seat 3: 5c16018f ($5 in chips)
Seat 4: 9c92842a ($9.69 in chips)
Seat 5: 4d3453a6 ($6.62 in chips)
5c16018f: posts small blind $0.02
9c92842a: posts big blind $0.05
*** HOLE CARDS ***
Dealt to Hero [3s Kh]
Dealt to 2b9dfc13 
Dealt to 5c16018f 
Dealt to 9c92842a 
Dealt to 4d3453a6 
4d3453a6: folds
Hero: folds
2b9dfc13: folds
5c16018f: folds
Uncalled bet ($0.03) returned to 9c92842a
*** SHOWDOWN ***
9c92842a collected $0.04 from pot
*** SUMMARY ***
Total pot $0.04 | Rake $0 | Jackpot $0 | Bingo $0 | Fortune $0 | Tax $0
Seat 1: Hero folded before Flop (didn't bet)
Seat 2: 2b9dfc13 (button) folded before Flop (didn't bet)
Seat 3: 5c16018f (small blind) folded before Flop
Seat 4: 9c92842a (big blind) collected ($0.04)
Seat 5: 4d3453a6 folded before Flop (didn't bet)


Poker Hand #HD1746127408: Hold'em No Limit ($0.02/$0.05) - 2024/04/25 15:58:29
Table 'NLHBlue6' 6-max Seat #1 is the button
Seat 1: Hero ($6.19 in chips)
Seat 2: 2b9dfc13 ($5 in chips)
Seat 3: 5c16018f ($5 in chips)
Seat 4: 9c92842a ($9.69 in chips)
Seat 5: 4d3453a6 ($6.62 in chips)
2b9dfc13: posts small blind $0.02
5c16018f: posts big blind $0.05
*** HOLE CARDS ***
Dealt to Hero [4s 5c]
Dealt to 2b9dfc13 
Dealt to 5c16018f 
Dealt to 9c92842a 
Dealt to 4d3453a6 
9c92842a: folds
4d3453a6: folds
Hero: folds
2b9dfc13: raises $0.1 to $0.15
5c16018f: folds
Uncalled bet ($0.1) returned to 2b9dfc13
*** SHOWDOWN ***
2b9dfc13 collected $0.1 from pot
*** SUMMARY ***
Total pot $0.1 | Rake $0 | Jackpot $0 | Bingo $0 | Fortune $0 | Tax $0
Seat 1: Hero (button) folded before Flop (didn't bet)
Seat 2: 2b9dfc13 (small blind) collected ($0.1)
Seat 3: 5c16018f (big blind) folded before Flop
Seat 4: 9c92842a folded before Flop (didn't bet)
Seat 5: 4d3453a6 folded before Flop (didn't bet)


Poker Hand #HD1746127299: Hold'em No Limit ($0.02/$0.05) - 2024/04/25 15:57:39
Table 'NLHBlue6' 6-max Seat #5 is the button
Seat 1: Hero ($6.21 in chips)
Seat 2: 2b9dfc13 ($5.12 in chips)
Seat 4: 9c92842a ($9.69 in chips)
Seat 5: 4d3453a6 ($5.9 in chips)
Hero: posts small blind $0.02
2b9dfc13: posts big blind $0.05
*** HOLE CARDS ***
Dealt to Hero [2h 6c]
Dealt to 2b9dfc13 
Dealt to 9c92842a 
Dealt to 4d3453a6 
9c92842a: folds
4d3453a6: raises $0.08 to $0.13
Hero: folds
2b9dfc13: raises $0.28 to $0.41
4d3453a6: calls $0.28
*** FLOP *** [6s Ks 4h]
2b9dfc13: bets $0.42
4d3453a6: calls $0.42
*** TURN *** [6s Ks 4h] [Ad]
2b9dfc13: checks
4d3453a6: checks
*** RIVER *** [6s Ks 4h Ad] [9c]
2b9dfc13: checks
4d3453a6: checks
2b9dfc13: shows [Qh Jd] (Ace-High)
4d3453a6: shows [Ts As] (Pair of Aces)
*** SHOWDOWN ***
4d3453a6 collected $1.55 from pot
*** SUMMARY ***
Total pot $1.68 | Rake $0.08 | Jackpot $0.05 | Bingo $0 | Fortune $0 | Tax $0
Board [6s Ks 4h Ad 9c]
Seat 1: Hero (small blind) folded before Flop
Seat 2: 2b9dfc13 (big blind) showed [Qh Jd] and lost with Ace-High
Seat 4: 9c92842a folded before Flop (didn't bet)
Seat 5: 4d3453a6 (button) showed [Ts As] and won ($1.55) with Pair of Aces


Poker Hand #HD1746127278: Hold'em No Limit ($0.02/$0.05) - 2024/04/25 15:57:28
Table 'NLHBlue6' 6-max Seat #4 is the button
Seat 1: Hero ($6.26 in chips)
Seat 2: 2b9dfc13 ($5.05 in chips)
Seat 4: 9c92842a ($9.69 in chips)
Seat 5: 4d3453a6 ($5.92 in chips)
4d3453a6: posts small blind $0.02
Hero: posts big blind $0.05
*** HOLE CARDS ***
Dealt to Hero [4c 9c]
Dealt to 2b9dfc13 
Dealt to 9c92842a 
Dealt to 4d3453a6 
2b9dfc13: raises $0.1 to $0.15
9c92842a: folds
4d3453a6: folds
Hero: folds
Uncalled bet ($0.1) returned to 2b9dfc13
*** SHOWDOWN ***
2b9dfc13 collected $0.12 from pot
*** SUMMARY ***
Total pot $0.12 | Rake $0 | Jackpot $0 | Bingo $0 | Fortune $0 | Tax $0
Seat 1: Hero (big blind) folded before Flop
Seat 2: 2b9dfc13 collected ($0.12)
Seat 4: 9c92842a (button) folded before Flop (didn't bet)
Seat 5: 4d3453a6 (small blind) folded before Flop


Poker Hand #HD1746127161: Hold'em No Limit ($0.02/$0.05) - 2024/04/25 15:56:40
Table 'NLHBlue6' 6-max Seat #3 is the button
Seat 1: Hero ($6.26 in chips)
Seat 2: 2b9dfc13 ($5 in chips)
Seat 3: 75954dda ($3.46 in chips)
Seat 4: 9c92842a ($9.71 in chips)
Seat 5: 4d3453a6 ($5.87 in chips)
9c92842a: posts small blind $0.02
4d3453a6: posts big blind $0.05
*** HOLE CARDS ***
Dealt to Hero [Td 5s]
Dealt to 2b9dfc13 
Dealt to 75954dda 
Dealt to 9c92842a 
Dealt to 4d3453a6 
Hero: folds
2b9dfc13: raises $0.05 to $0.1
75954dda: calls $0.1
9c92842a: folds
4d3453a6: calls $0.05
*** FLOP *** [8h Ad Qd]
4d3453a6: checks
2b9dfc13: checks
75954dda: checks
*** TURN *** [8h Ad Qd] [2c]
4d3453a6: checks
2b9dfc13: bets $0.16
75954dda: folds
4d3453a6: calls $0.16
*** RIVER *** [8h Ad Qd 2c] [2h]
4d3453a6: checks
2b9dfc13: checks
4d3453a6: shows [Ah 9d] (Pair of Aces and Pair of Twos)
2b9dfc13: shows [Ac 4h] (Pair of Aces and Pair of Twos)
*** SHOWDOWN ***
4d3453a6 collected $0.31 from pot
2b9dfc13 collected $0.31 from pot
*** SUMMARY ***
Total pot $0.64 | Rake $0.02 | Jackpot $0 | Bingo $0 | Fortune $0 | Tax $0
Board [8h Ad Qd 2c 2h]
Seat 1: Hero folded before Flop (didn't bet)
Seat 2: 2b9dfc13 showed [Ac 4h] and won ($0.31) with Pair of Aces and Pair of Twos
Seat 3: 75954dda (button) folded on the Turn
Seat 4: 9c92842a (small blind) folded before Flop
Seat 5: 4d3453a6 (big blind) showed [Ah 9d] and won ($0.31) with Pair of Aces and Pair of Twos


Poker Hand #HD1746126986: Hold'em No Limit ($0.02/$0.05) - 2024/04/25 15:55:19
Table 'NLHBlue6' 6-max Seat #2 is the button
Seat 1: Hero ($5.86 in chips)
Seat 2: 2b9dfc13 ($5.12 in chips)
Seat 3: 75954dda ($3.72 in chips)
Seat 4: 9c92842a ($9.76 in chips)
Seat 5: 4d3453a6 ($5.87 in chips)
75954dda: posts small blind $0.02
9c92842a: posts big blind $0.05
*** HOLE CARDS ***
Dealt to Hero [9c 9s]
Dealt to 2b9dfc13 
Dealt to 75954dda 
Dealt to 9c92842a 
Dealt to 4d3453a6 
4d3453a6: folds
Hero: raises $0.07 to $0.12
2b9dfc13: calls $0.12
75954dda: calls $0.1
9c92842a: folds
*** FLOP *** [4c 3s 8h]
75954dda: checks
Hero: bets $0.14
2b9dfc13: folds
75954dda: calls $0.14
*** TURN *** [4c 3s 8h] [Qs]
75954dda: checks
Hero: checks
*** RIVER *** [4c 3s 8h Qs] [8c]
75954dda: checks
Hero: checks
75954dda: shows [7s 5c] (Pair of Eights)
Hero: shows [9c 9s] (Pair of Nines and Pair of Eights)
*** SHOWDOWN ***
Hero collected $0.66 from pot
*** SUMMARY ***
Total pot $0.69 | Rake $0.03 | Jackpot $0 | Bingo $0 | Fortune $0 | Tax $0
Board [4c 3s 8h Qs 8c]
Seat 1: Hero showed [9c 9s] and won ($0.66) with Pair of Nines and Pair of Eights
Seat 2: 2b9dfc13 (button) folded on the Flop
Seat 3: 75954dda (small blind) showed [7s 5c] and lost with Pair of Eights
Seat 4: 9c92842a (big blind) folded before Flop
Seat 5: 4d3453a6 folded before Flop (didn't bet)


Poker Hand #HD1746126919: Hold'em No Limit ($0.02/$0.05) - 2024/04/25 15:54:53
Table 'NLHBlue6' 6-max Seat #1 is the button
Seat 1: Hero ($5.86 in chips)
Seat 2: 2b9dfc13 ($5.14 in chips)
Seat 3: 75954dda ($3.85 in chips)
Seat 4: 9c92842a ($9.76 in chips)
Seat 5: 4d3453a6 ($5.73 in chips)
2b9dfc13: posts small blind $0.02
75954dda: posts big blind $0.05
*** HOLE CARDS ***
Dealt to Hero [6s Jd]
Dealt to 2b9dfc13 
Dealt to 75954dda 
Dealt to 9c92842a 
Dealt to 4d3453a6 
9c92842a: folds
4d3453a6: raises $0.08 to $0.13
Hero: folds
2b9dfc13: folds
75954dda: calls $0.08
*** FLOP *** [7d Th 8s]
75954dda: checks
4d3453a6: bets $0.21
75954dda: folds
Uncalled bet ($0.21) returned to 4d3453a6
*** SHOWDOWN ***
4d3453a6 collected $0.27 from pot
*** SUMMARY ***
Total pot $0.28 | Rake $0.01 | Jackpot $0 | Bingo $0 | Fortune $0 | Tax $0
Board [7d Th 8s]
Seat 1: Hero (button) folded before Flop (didn't bet)
Seat 2: 2b9dfc13 (small blind) folded before Flop
Seat 3: 75954dda (big blind) folded on the Flop
Seat 4: 9c92842a folded before Flop (didn't bet)
Seat 5: 4d3453a6 won ($0.27)


Poker Hand #HD1746126815: Hold'em No Limit ($0.02/$0.05) - 2024/04/25 15:54:11
Table 'NLHBlue6' 6-max Seat #5 is the button
Seat 1: Hero ($5.88 in chips)
Seat 2: 2b9dfc13 ($5 in chips)
Seat 3: 75954dda ($3.85 in chips)
Seat 4: 9c92842a ($9.89 in chips)
Seat 5: 4d3453a6 ($5.73 in chips)
Hero: posts small blind $0.02
2b9dfc13: posts big blind $0.05
*** HOLE CARDS ***
Dealt to Hero [Ah 4s]
Dealt to 2b9dfc13 
Dealt to 75954dda 
Dealt to 9c92842a 
Dealt to 4d3453a6 
75954dda: folds
9c92842a: raises $0.08 to $0.13
4d3453a6: folds
Hero: folds
2b9dfc13: calls $0.08
*** FLOP *** [Ac 2h 9h]
2b9dfc13: checks
9c92842a: checks
*** TURN *** [Ac 2h 9h] [As]
2b9dfc13: checks
9c92842a: checks
*** RIVER *** [Ac 2h 9h As] [Qd]
2b9dfc13: bets $0.14
9c92842a: folds
Uncalled bet ($0.14) returned to 2b9dfc13
*** SHOWDOWN ***
2b9dfc13 collected $0.27 from pot
*** SUMMARY ***
Total pot $0.28 | Rake $0.01 | Jackpot $0 | Bingo $0 | Fortune $0 | Tax $0
Board [Ac 2h 9h As Qd]
Seat 1: Hero (small blind) folded before Flop
Seat 2: 2b9dfc13 (big blind) won ($0.27)
Seat 3: 75954dda folded before Flop (didn't bet)
Seat 4: 9c92842a folded on the River
Seat 5: 4d3453a6 (button) folded before Flop (didn't bet)


Poker Hand #HD1746126721: Hold'em No Limit ($0.02/$0.05) - 2024/04/25 15:53:27
Table 'NLHBlue6' 6-max Seat #4 is the button
Seat 1: Hero ($5.59 in chips)
Seat 2: 2b9dfc13 ($4.65 in chips)
Seat 3: 75954dda ($3.85 in chips)
Seat 4: 9c92842a ($9.89 in chips)
Seat 5: 4d3453a6 ($5.75 in chips)
4d3453a6: posts small blind $0.02
Hero: posts big blind $0.05
*** HOLE CARDS ***
Dealt to Hero [4h Ah]
Dealt to 2b9dfc13 
Dealt to 75954dda 
Dealt to 9c92842a 
Dealt to 4d3453a6 
2b9dfc13: raises $0.1 to $0.15
75954dda: folds
9c92842a: folds
4d3453a6: folds
Hero: calls $0.1
*** FLOP *** [7s 9s 5d]
Hero: checks
2b9dfc13: checks
*** TURN *** [7s 9s 5d] [2c]
Hero: bets $0.15
2b9dfc13: calls $0.15
*** RIVER *** [7s 9s 5d 2c] [6s]
Hero: bets $0.36
2b9dfc13: folds
Uncalled bet ($0.36) returned to Hero
*** SHOWDOWN ***
Hero collected $0.59 from pot
*** SUMMARY ***
Total pot $0.62 | Rake $0.03 | Jackpot $0 | Bingo $0 | Fortune $0 | Tax $0
Board [7s 9s 5d 2c 6s]
Seat 1: Hero (big blind) won ($0.59)
Seat 2: 2b9dfc13 folded on the River
Seat 3: 75954dda folded before Flop (didn't bet)
Seat 4: 9c92842a (button) folded before Flop (didn't bet)
Seat 5: 4d3453a6 (small blind) folded before Flop


Poker Hand #HD1746126649: Hold'em No Limit ($0.02/$0.05) - 2024/04/25 15:52:57
Table 'NLHBlue6' 6-max Seat #3 is the button
Seat 1: Hero ($5.59 in chips)
Seat 2: 2b9dfc13 ($4.75 in chips)
Seat 3: 75954dda ($3.61 in chips)
Seat 4: 9c92842a ($9.99 in chips)
Seat 5: 4d3453a6 ($5.8 in chips)
9c92842a: posts small blind $0.02
4d3453a6: posts big blind $0.05
*** HOLE CARDS ***
Dealt to Hero [6h 2d]
Dealt to 2b9dfc13 
Dealt to 75954dda 
Dealt to 9c92842a 
Dealt to 4d3453a6 
Hero: folds
2b9dfc13: raises $0.05 to $0.1
75954dda: calls $0.1
9c92842a: calls $0.08
4d3453a6: folds
*** FLOP *** [4c 6s 6d]
9c92842a: checks
2b9dfc13: checks
75954dda: bets $0.23
9c92842a: folds
2b9dfc13: folds
Uncalled bet ($0.23) returned to 75954dda
*** SHOWDOWN ***
75954dda collected $0.34 from pot
*** SUMMARY ***
Total pot $0.35 | Rake $0.01 | Jackpot $0 | Bingo $0 | Fortune $0 | Tax $0
Board [4c 6s 6d]
Seat 1: Hero folded before Flop (didn't bet)
Seat 2: 2b9dfc13 folded on the Flop
Seat 3: 75954dda (button) won ($0.34)
Seat 4: 9c92842a (small blind) folded on the Flop
Seat 5: 4d3453a6 (big blind) folded before Flop


Poker Hand #HD1746126553: Hold'em No Limit ($0.02/$0.05) - 2024/04/25 15:52:18
Table 'NLHBlue6' 6-max Seat #2 is the button
Seat 1: Hero ($5.3 in chips)
Seat 2: 2b9dfc13 ($4.75 in chips)
Seat 3: 75954dda ($3.88 in chips)
Seat 4: 9c92842a ($10.04 in chips)
Seat 5: 4d3453a6 ($5.8 in chips)
75954dda: posts small blind $0.02
9c92842a: posts big blind $0.05
*** HOLE CARDS ***
Dealt to Hero [Qh Kc]
Dealt to 2b9dfc13 
Dealt to 75954dda 
Dealt to 9c92842a 
Dealt to 4d3453a6 
4d3453a6: folds
Hero: raises $0.07 to $0.12
2b9dfc13: folds
75954dda: calls $0.1
9c92842a: folds
*** FLOP *** [Th Jc 6s]
75954dda: checks
Hero: bets $0.15
75954dda: calls $0.15
*** TURN *** [Th Jc 6s] [4d]
75954dda: checks
Hero: bets $0.39
75954dda: folds
Uncalled bet ($0.39) returned to Hero
*** SHOWDOWN ***
Hero collected $0.56 from pot
*** SUMMARY ***
Total pot $0.59 | Rake $0.03 | Jackpot $0 | Bingo $0 | Fortune $0 | Tax $0
Board [Th Jc 6s 4d]
Seat 1: Hero won ($0.56)
Seat 2: 2b9dfc13 (button) folded before Flop (didn't bet)
Seat 3: 75954dda (small blind) folded on the Turn
Seat 4: 9c92842a (big blind) folded before Flop
Seat 5: 4d3453a6 folded before Flop (didn't bet)


Poker Hand #HD1746126513: Hold'em No Limit ($0.02/$0.05) - 2024/04/25 15:51:58
Table 'NLHBlue6' 6-max Seat #1 is the button
Seat 1: Hero ($5.3 in chips)
Seat 2: 2b9dfc13 ($4.7 in chips)
Seat 3: 75954dda ($3.93 in chips)
Seat 4: 9c92842a ($10.04 in chips)
Seat 5: 4d3453a6 ($5.8 in chips)
Seat 6: c5939d3f ($8.99 in chips)
2b9dfc13: posts small blind $0.02
75954dda: posts big blind $0.05
*** HOLE CARDS ***
Dealt to Hero [Tc 3s]
Dealt to 2b9dfc13 
Dealt to 75954dda 
Dealt to 9c92842a 
Dealt to 4d3453a6 
Dealt to c5939d3f 
9c92842a: folds
4d3453a6: folds
c5939d3f: folds
Hero: folds
2b9dfc13: raises $0.1 to $0.15
75954dda: folds
Uncalled bet ($0.1) returned to 2b9dfc13
*** SHOWDOWN ***
2b9dfc13 collected $0.1 from pot
*** SUMMARY ***
Total pot $0.1 | Rake $0 | Jackpot $0 | Bingo $0 | Fortune $0 | Tax $0
Seat 1: Hero (button) folded before Flop (didn't bet)
Seat 2: 2b9dfc13 (small blind) collected ($0.1)
Seat 3: 75954dda (big blind) folded before Flop
Seat 4: 9c92842a folded before Flop (didn't bet)
Seat 5: 4d3453a6 folded before Flop (didn't bet)
Seat 6: c5939d3f folded before Flop (didn't bet)


Poker Hand #HD1746126366: Hold'em No Limit ($0.02/$0.05) - 2024/04/25 15:50:53
Table 'NLHBlue6' 6-max Seat #6 is the button
Seat 1: Hero ($5.32 in chips)
Seat 2: 2b9dfc13 ($4.75 in chips)
Seat 3: 75954dda ($3.93 in chips)
Seat 4: 9c92842a ($10.86 in chips)
Seat 5: 4d3453a6 ($5.8 in chips)
Seat 6: c5939d3f ($8.23 in chips)
Hero: posts small blind $0.02
2b9dfc13: posts big blind $0.05
*** HOLE CARDS ***
Dealt to Hero [Jc 9d]
Dealt to 2b9dfc13 
Dealt to 75954dda 
Dealt to 9c92842a 
Dealt to 4d3453a6 
Dealt to c5939d3f 
75954dda: folds
9c92842a: raises $0.08 to $0.13
4d3453a6: folds
c5939d3f: calls $0.13
Hero: folds
2b9dfc13: folds
*** FLOP *** [Jh 3h 4s]
9c92842a: bets $0.26
c5939d3f: calls $0.26
*** TURN *** [Jh 3h 4s] [2h]
9c92842a: checks
c5939d3f: bets $0.43
9c92842a: calls $0.43
*** RIVER *** [Jh 3h 4s 2h] [6h]
9c92842a: checks
c5939d3f: checks
9c92842a: shows [Jd Js] (Three Jacks)
c5939d3f: shows [7h 7d] (Jack High Flush)
*** SHOWDOWN ***
c5939d3f collected $1.58 from pot
*** SUMMARY ***
Total pot $1.71 | Rake $0.08 | Jackpot $0.05 | Bingo $0 | Fortune $0 | Tax $0
Board [Jh 3h 4s 2h 6h]
Seat 1: Hero (small blind) folded before Flop
Seat 2: 2b9dfc13 (big blind) folded before Flop
Seat 3: 75954dda folded before Flop (didn't bet)
Seat 4: 9c92842a showed [Jd Js] and lost with Three Jacks
Seat 5: 4d3453a6 folded before Flop (didn't bet)
Seat 6: c5939d3f (button) showed [7h 7d] and won ($1.58) with Jack High Flush


Poker Hand #HD1746126300: Hold'em No Limit ($0.02/$0.05) - 2024/04/25 15:50:20
Table 'NLHBlue6' 6-max Seat #5 is the button
Seat 1: Hero ($5.37 in chips)
Seat 2: 2b9dfc13 ($4.75 in chips)
Seat 3: 75954dda ($4.33 in chips)
Seat 4: 9c92842a ($10.86 in chips)
Seat 5: 4d3453a6 ($5.8 in chips)
Seat 6: c5939d3f ($7.82 in chips)
c5939d3f: posts small blind $0.02
Hero: posts big blind $0.05
*** HOLE CARDS ***
Dealt to Hero [Qh 6h]
Dealt to 2b9dfc13 
Dealt to 75954dda 
Dealt to 9c92842a 
Dealt to 4d3453a6 
Dealt to c5939d3f 
2b9dfc13: folds
75954dda: raises $0.05 to $0.1
9c92842a: folds
4d3453a6: folds
c5939d3f: raises $0.3 to $0.4
Hero: folds
75954dda: calls $0.3
*** FLOP *** [6s Th 5d]
c5939d3f: bets $0.43
75954dda: folds
Uncalled bet ($0.43) returned to c5939d3f
*** SHOWDOWN ***
c5939d3f collected $0.81 from pot
*** SUMMARY ***
Total pot $0.85 | Rake $0.04 | Jackpot $0 | Bingo $0 | Fortune $0 | Tax $0
Board [6s Th 5d]
Seat 1: Hero (big blind) folded before Flop
Seat 2: 2b9dfc13 folded before Flop (didn't bet)
Seat 3: 75954dda folded on the Flop
Seat 4: 9c92842a folded before Flop (didn't bet)
Seat 5: 4d3453a6 (button) folded before Flop (didn't bet)
Seat 6: c5939d3f (small blind) won ($0.81)


Poker Hand #HD1746126242: Hold'em No Limit ($0.02/$0.05) - 2024/04/25 15:49:53
Table 'NLHBlue6' 6-max Seat #4 is the button
Seat 1: Hero ($5.37 in chips)
Seat 2: 2b9dfc13 ($4.9 in chips)
Seat 3: 75954dda ($4.48 in chips)
Seat 4: 9c92842a ($10.51 in chips)
Seat 5: 4d3453a6 ($5.82 in chips)
Seat 6: c5939d3f ($7.87 in chips)
4d3453a6: posts small blind $0.02
c5939d3f: posts big blind $0.05
*** HOLE CARDS ***
Dealt to Hero [6s 2s]
Dealt to 2b9dfc13 
Dealt to 75954dda 
Dealt to 9c92842a 
Dealt to 4d3453a6 
Dealt to c5939d3f 
Hero: folds
2b9dfc13: raises $0.1 to $0.15
75954dda: calls $0.15
9c92842a: raises $0.4 to $0.55
4d3453a6: folds
c5939d3f: folds
2b9dfc13: folds
75954dda: folds
Uncalled bet ($0.4) returned to 9c92842a
*** SHOWDOWN ***
9c92842a collected $0.5 from pot
*** SUMMARY ***
Total pot $0.52 | Rake $0.02 | Jackpot $0 | Bingo $0 | Fortune $0 | Tax $0
Seat 1: Hero folded before Flop (didn't bet)
Seat 2: 2b9dfc13 folded before Flop
Seat 3: 75954dda folded before Flop
Seat 4: 9c92842a (button) collected ($0.5)
Seat 5: 4d3453a6 (small blind) folded before Flop
Seat 6: c5939d3f (big blind) folded before Flop


Poker Hand #HD1746126149: Hold'em No Limit ($0.02/$0.05) - 2024/04/25 15:49:13
Table 'NLHBlue6' 6-max Seat #3 is the button
Seat 1: Hero ($5.21 in chips)
Seat 2: 2b9dfc13 ($5 in chips)
Seat 3: 75954dda ($4.48 in chips)
Seat 4: 9c92842a ($10.53 in chips)
Seat 5: 4d3453a6 ($5.87 in chips)
Seat 6: c5939d3f ($7.87 in chips)
9c92842a: posts small blind $0.02
4d3453a6: posts big blind $0.05
*** HOLE CARDS ***
Dealt to Hero [Qs Kc]
Dealt to 2b9dfc13 
Dealt to 75954dda 
Dealt to 9c92842a 
Dealt to 4d3453a6 
Dealt to c5939d3f 
c5939d3f: folds
Hero: raises $0.05 to $0.1
2b9dfc13: calls $0.1
75954dda: folds
9c92842a: folds
4d3453a6: folds
*** FLOP *** [4c Kh 2s]
Hero: checks
2b9dfc13: checks
*** TURN *** [4c Kh 2s] [4d]
Hero: bets $0.14
2b9dfc13: folds
Uncalled bet ($0.14) returned to Hero
*** SHOWDOWN ***
Hero collected $0.26 from pot
*** SUMMARY ***
Total pot $0.27 | Rake $0.01 | Jackpot $0 | Bingo $0 | Fortune $0 | Tax $0
Board [4c Kh 2s 4d]
Seat 1: Hero won ($0.26)
Seat 2: 2b9dfc13 folded on the Turn
Seat 3: 75954dda (button) folded before Flop (didn't bet)
Seat 4: 9c92842a (small blind) folded before Flop
Seat 5: 4d3453a6 (big blind) folded before Flop
Seat 6: c5939d3f folded before Flop (didn't bet)


Poker Hand #HD1746125986: Hold'em No Limit ($0.02/$0.05) - 2024/04/25 15:47:52
Table 'NLHBlue6' 6-max Seat #2 is the button
Seat 1: Hero ($5.21 in chips)
Seat 2: 2b9dfc13 ($4.63 in chips)
Seat 3: 75954dda ($4.63 in chips)
Seat 4: 9c92842a ($10.58 in chips)
Seat 5: 4d3453a6 ($5.87 in chips)
Seat 6: c5939d3f ($8.02 in chips)
75954dda: posts small blind $0.02
9c92842a: posts big blind $0.05
*** HOLE CARDS ***
Dealt to Hero [4c 3s]
Dealt to 2b9dfc13 
Dealt to 75954dda 
Dealt to 9c92842a 
Dealt to 4d3453a6 
Dealt to c5939d3f 
4d3453a6: folds
c5939d3f: raises $0.1 to $0.15
Hero: folds
2b9dfc13: calls $0.15
75954dda: calls $0.13
9c92842a: folds
*** FLOP *** [3h 9d 7d]
75954dda: checks
c5939d3f: bets $0.38
2b9dfc13: raises $0.38 to $0.76
75954dda: folds
c5939d3f: raises $1.52 to $2.28
2b9dfc13: raises $2.2 to $4.48 and is all-in
c5939d3f: calls $2.2
2b9dfc13: shows [9s 7s] (Pair of Nines and Pair of Sevens)
c5939d3f: shows [9h 7h] (Pair of Nines and Pair of Sevens)
*** TURN *** [3h 9d 7d] [Ks]
*** RIVER *** [3h 9d 7d Ks] [Th]
*** SHOWDOWN ***
c5939d3f collected $4.48 from pot
2b9dfc13 collected $4.47 from pot
*** SUMMARY ***
Total pot $9.46 | Rake $0.46 | Jackpot $0.05 | Bingo $0 | Fortune $0 | Tax $0
Board [3h 9d 7d Ks Th]
Seat 1: Hero folded before Flop (didn't bet)
Seat 2: 2b9dfc13 (button) showed [9s 7s] and won ($4.47) with Pair of Nines and Pair of Sevens
Seat 3: 75954dda (small blind) folded on the Flop
Seat 4: 9c92842a (big blind) folded before Flop
Seat 5: 4d3453a6 folded before Flop (didn't bet)
Seat 6: c5939d3f showed [9h 7h] and won ($4.48) with Pair of Nines and Pair of Sevens


Poker Hand #HD1746125919: Hold'em No Limit ($0.02/$0.05) - 2024/04/25 15:47:24
Table 'NLHBlue6' 6-max Seat #1 is the button
Seat 1: Hero ($5 in chips)
Seat 2: 2b9dfc13 ($4.65 in chips)
Seat 3: 75954dda ($4.68 in chips)
Seat 4: 9c92842a ($10.58 in chips)
Seat 5: 4d3453a6 ($6.02 in chips)
Seat 6: c5939d3f ($8.02 in chips)
2b9dfc13: posts small blind $0.02
75954dda: posts big blind $0.05
*** HOLE CARDS ***
Dealt to Hero [As Qh]
Dealt to 2b9dfc13 
Dealt to 75954dda 
Dealt to 9c92842a 
Dealt to 4d3453a6 
Dealt to c5939d3f 
9c92842a: folds
4d3453a6: raises $0.1 to $0.15
c5939d3f: folds
Hero: raises $0.3 to $0.45
2b9dfc13: folds
75954dda: folds
4d3453a6: folds
Uncalled bet ($0.3) returned to Hero
*** SHOWDOWN ***
Hero collected $0.36 from pot
*** SUMMARY ***
Total pot $0.37 | Rake $0.01 | Jackpot $0 | Bingo $0 | Fortune $0 | Tax $0
Seat 1: Hero (button) collected ($0.36)
Seat 2: 2b9dfc13 (small blind) folded before Flop
Seat 3: 75954dda (big blind) folded before Flop
Seat 4: 9c92842a folded before Flop (didn't bet)
Seat 5: 4d3453a6 folded before Flop
Seat 6: c5939d3f folded before Flop (didn't bet)


Poker Hand #HD1746125865: Hold'em No Limit ($0.02/$0.05) - 2024/04/25 15:47:02
Table 'NLHBlue6' 6-max Seat #6 is the button
Seat 1: Hero ($5 in chips)
Seat 2: 2b9dfc13 ($4.7 in chips)
Seat 3: 75954dda ($4.61 in chips)
Seat 4: 9c92842a ($10.58 in chips)
Seat 5: 4d3453a6 ($6.02 in chips)
Seat 6: c5939d3f ($8.02 in chips)
Hero: posts small blind $0.02
2b9dfc13: posts big blind $0.05
*** HOLE CARDS ***
Dealt to Hero [Kc 9h]
Dealt to 2b9dfc13 
Dealt to 75954dda 
Dealt to 9c92842a 
Dealt to 4d3453a6 
Dealt to c5939d3f 
75954dda: raises $0.1 to $0.15
9c92842a: folds
4d3453a6: folds
c5939d3f: folds
Hero: folds
2b9dfc13: folds
Uncalled bet ($0.1) returned to 75954dda
*** SHOWDOWN ***
75954dda collected $0.12 from pot
*** SUMMARY ***
Total pot $0.12 | Rake $0 | Jackpot $0 | Bingo $0 | Fortune $0 | Tax $0
Seat 1: Hero (small blind) folded before Flop
Seat 2: 2b9dfc13 (big blind) folded before Flop
Seat 3: 75954dda collected ($0.12)
Seat 4: 9c92842a folded before Flop (didn't bet)
Seat 5: 4d3453a6 folded before Flop (didn't bet)
Seat 6: c5939d3f (button) folded before Flop (didn't bet)


Poker Hand #HD1746125772: Hold'em No Limit ($0.02/$0.05) - 2024/04/25 15:46:20
Table 'NLHBlue6' 6-max Seat #5 is the button
Seat 1: Hero ($5 in chips)
Seat 2: 2b9dfc13 ($5 in chips)
Seat 3: 75954dda ($4.61 in chips)
Seat 4: 9c92842a ($10.58 in chips)
Seat 5: 4d3453a6 ($5.68 in chips)
Seat 6: c5939d3f ($8.04 in chips)
c5939d3f: posts small blind $0.02
Hero: posts big blind $0.05
*** HOLE CARDS ***
Dealt to Hero [8h 4c]
Dealt to 2b9dfc13 
Dealt to 75954dda 
Dealt to 9c92842a 
Dealt to 4d3453a6 
Dealt to c5939d3f 
2b9dfc13: raises $0.05 to $0.1
75954dda: folds
9c92842a: folds
4d3453a6: raises $0.2 to $0.3
c5939d3f: folds
Hero: folds
2b9dfc13: calls $0.2
*** FLOP *** [3c 9h 5s]
2b9dfc13: checks
4d3453a6: bets $0.23
2b9dfc13: folds
Uncalled bet ($0.23) returned to 4d3453a6
*** SHOWDOWN ***
4d3453a6 collected $0.64 from pot
*** SUMMARY ***
Total pot $0.67 | Rake $0.03 | Jackpot $0 | Bingo $0 | Fortune $0 | Tax $0
Board [3c 9h 5s]
Seat 1: Hero (big blind) folded before Flop
Seat 2: 2b9dfc13 folded on the Flop
Seat 3: 75954dda folded before Flop (didn't bet)
Seat 4: 9c92842a folded before Flop (didn't bet)
Seat 5: 4d3453a6 (button) won ($0.64)
Seat 6: c5939d3f (small blind) folded before Flop


Poker Hand #HD1746045621: Hold'em No Limit ($0.02/$0.05) - 2024/04/25 15:45:11
Table 'NLHBlue6' 6-max Seat #4 is the button
Seat 1: Hero ($5 in chips)
Seat 2: 2b9dfc13 ($4.66 in chips)
Seat 3: 75954dda ($4.61 in chips)
Seat 4: 9c92842a ($10.58 in chips)
Seat 5: 4d3453a6 ($5.7 in chips)
Seat 6: c5939d3f ($7.45 in chips)
4d3453a6: posts small blind $0.02
c5939d3f: posts big blind $0.05
*** HOLE CARDS ***
Dealt to Hero [Qc 8s]
Dealt to 2b9dfc13 
Dealt to 75954dda 
Dealt to 9c92842a 
Dealt to 4d3453a6 
Dealt to c5939d3f 
Hero: folds
2b9dfc13: raises $0.1 to $0.15
75954dda: folds
9c92842a: folds
4d3453a6: folds
c5939d3f: calls $0.1
*** FLOP *** [9h 4c 2h]
c5939d3f: checks
2b9dfc13: bets $0.16
c5939d3f: calls $0.16
*** TURN *** [9h 4c 2h] [3h]
c5939d3f: checks
2b9dfc13: bets $0.32
c5939d3f: raises $0.64 to $0.96
2b9dfc13: folds
Uncalled bet ($0.64) returned to c5939d3f
*** SHOWDOWN ***
c5939d3f collected $1.22 from pot
*** SUMMARY ***
Total pot $1.28 | Rake $0.06 | Jackpot $0 | Bingo $0 | Fortune $0 | Tax $0
Board [9h 4c 2h 3h]
Seat 1: Hero folded before Flop (didn't bet)
Seat 2: 2b9dfc13 folded on the Turn
Seat 3: 75954dda folded before Flop (didn't bet)
Seat 4: 9c92842a (button) folded before Flop (didn't bet)
Seat 5: 4d3453a6 (small blind) folded before Flop
Seat 6: c5939d3f (big blind) won ($1.22)


Poker Hand #HD1746045525: Hold'em No Limit ($0.02/$0.05) - 2024/04/25 15:44:31
Table 'NLHBlue6' 6-max Seat #3 is the button
Seat 1: Hero ($5 in chips)
Seat 2: 2b9dfc13 ($4.81 in chips)
Seat 3: 75954dda ($4.61 in chips)
Seat 4: 9c92842a ($10.73 in chips)
Seat 5: 4d3453a6 ($5.75 in chips)
Seat 6: c5939d3f ($7.12 in chips)
9c92842a: posts small blind $0.02
4d3453a6: posts big blind $0.05
*** HOLE CARDS ***
Dealt to Hero [4h 7d]
Dealt to 2b9dfc13 
Dealt to 75954dda 
Dealt to 9c92842a 
Dealt to 4d3453a6 
Dealt to c5939d3f 
c5939d3f: raises $0.1 to $0.15
Hero: folds
2b9dfc13: calls $0.15
75954dda: folds
9c92842a: calls $0.13
4d3453a6: folds
*** FLOP *** [6s 3s 4d]
9c92842a: checks
c5939d3f: checks
2b9dfc13: checks
*** TURN *** [6s 3s 4d] [Qh]
9c92842a: checks
c5939d3f: bets $0.25
2b9dfc13: folds
9c92842a: folds
Uncalled bet ($0.25) returned to c5939d3f
*** SHOWDOWN ***
c5939d3f collected $0.48 from pot
*** SUMMARY ***
Total pot $0.5 | Rake $0.02 | Jackpot $0 | Bingo $0 | Fortune $0 | Tax $0
Board [6s 3s 4d Qh]
Seat 1: Hero folded before Flop (didn't bet)
Seat 2: 2b9dfc13 folded on the Turn
Seat 3: 75954dda (button) folded before Flop (didn't bet)
Seat 4: 9c92842a (small blind) folded on the Turn
Seat 5: 4d3453a6 (big blind) folded before Flop
Seat 6: c5939d3f won ($0.48)


Poker Hand #HD1746045495: Hold'em No Limit ($0.02/$0.05) - 2024/04/25 15:44:19
Table 'NLHBlue6' 6-max Seat #2 is the button
Seat 1: Hero ($5 in chips)
Seat 2: 2b9dfc13 ($4.81 in chips)
Seat 3: 75954dda ($4.63 in chips)
Seat 4: 9c92842a ($10.71 in chips)
Seat 5: 4d3453a6 ($5.75 in chips)
Seat 6: c5939d3f ($7.12 in chips)
75954dda: posts small blind $0.02
9c92842a: posts big blind $0.05
*** HOLE CARDS ***
Dealt to Hero [5h Tc]
Dealt to 2b9dfc13 
Dealt to 75954dda 
Dealt to 9c92842a 
Dealt to 4d3453a6 
Dealt to c5939d3f 
4d3453a6: folds
c5939d3f: folds
Hero: folds
2b9dfc13: folds
75954dda: folds
Uncalled bet ($0.03) returned to 9c92842a
*** SHOWDOWN ***
9c92842a collected $0.04 from pot
*** SUMMARY ***
Total pot $0.04 | Rake $0 | Jackpot $0 | Bingo $0 | Fortune $0 | Tax $0
Seat 1: Hero folded before Flop (didn't bet)
Seat 2: 2b9dfc13 (button) folded before Flop (didn't bet)
Seat 3: 75954dda (small blind) folded before Flop
Seat 4: 9c92842a (big blind) collected ($0.04)
Seat 5: 4d3453a6 folded before Flop (didn't bet)
Seat 6: c5939d3f folded before Flop (didn't bet)


Poker Hand #HD1746045468: Hold'em No Limit ($0.02/$0.05) - 2024/04/25 15:44:10
Table 'NLHBlue6' 6-max Seat #1 is the button
Seat 1: Hero ($5 in chips)
Seat 2: 2b9dfc13 ($4.83 in chips)
Seat 3: 75954dda ($4.61 in chips)
Seat 4: 9c92842a ($10.71 in chips)
Seat 5: 4d3453a6 ($5.75 in chips)
Seat 6: c5939d3f ($7.12 in chips)
2b9dfc13: posts small blind $0.02
75954dda: posts big blind $0.05
*** HOLE CARDS ***
Dealt to Hero [9c 2h]
Dealt to 2b9dfc13 
Dealt to 75954dda 
Dealt to 9c92842a 
Dealt to 4d3453a6 
Dealt to c5939d3f 
9c92842a: folds
4d3453a6: folds
c5939d3f: folds
Hero: folds
2b9dfc13: folds
Uncalled bet ($0.03) returned to 75954dda
*** SHOWDOWN ***
75954dda collected $0.04 from pot
*** SUMMARY ***
Total pot $0.04 | Rake $0 | Jackpot $0 | Bingo $0 | Fortune $0 | Tax $0
Seat 1: Hero (button) folded before Flop (didn't bet)
Seat 2: 2b9dfc13 (small blind) folded before Flop
Seat 3: 75954dda (big blind) collected ($0.04)
Seat 4: 9c92842a folded before Flop (didn't bet)
Seat 5: 4d3453a6 folded before Flop (didn't bet)
Seat 6: c5939d3f folded before Flop (didn't bet)


Poker Hand #HD1746045423: Hold'em No Limit ($0.02/$0.05) - 2024/04/25 15:43:46
Table 'NLHBlue6' 6-max Seat #6 is the button
Seat 1: Hero ($5 in chips)
Seat 2: 2b9dfc13 ($4.93 in chips)
Seat 3: 75954dda ($4.5 in chips)
Seat 4: 9c92842a ($10.71 in chips)
Seat 5: 4d3453a6 ($5.75 in chips)
Seat 6: c5939d3f ($7.12 in chips)
Hero: posts small blind $0.02
2b9dfc13: posts big blind $0.05
*** HOLE CARDS ***
Dealt to Hero [4s Qs]
Dealt to 2b9dfc13 
Dealt to 75954dda 
Dealt to 9c92842a 
Dealt to 4d3453a6 
Dealt to c5939d3f 
75954dda: raises $0.05 to $0.1
9c92842a: folds
4d3453a6: folds
c5939d3f: folds
Hero: folds
2b9dfc13: calls $0.05
*** FLOP *** [7s 4h Th]
2b9dfc13: checks
75954dda: bets $0.22
2b9dfc13: folds
Uncalled bet ($0.22) returned to 75954dda
*** SHOWDOWN ***
75954dda collected $0.21 from pot
*** SUMMARY ***
Total pot $0.22 | Rake $0.01 | Jackpot $0 | Bingo $0 | Fortune $0 | Tax $0
Board [7s 4h Th]
Seat 1: Hero (small blind) folded before Flop
Seat 2: 2b9dfc13 (big blind) folded on the Flop
Seat 3: 75954dda won ($0.21)
Seat 4: 9c92842a folded before Flop (didn't bet)
Seat 5: 4d3453a6 folded before Flop (didn't bet)
Seat 6: c5939d3f (button) folded before Flop (didn't bet)


Poker Hand #HD1746045397: Hold'em No Limit ($0.02/$0.05) - 2024/04/25 15:43:33
Table 'NLHBlue6' 6-max Seat #5 is the button
Seat 1: Hero ($5 in chips)
Seat 2: 2b9dfc13 ($4.93 in chips)
Seat 3: 75954dda ($4.5 in chips)
Seat 4: 9c92842a ($10.64 in chips)
Seat 5: 4d3453a6 ($5.75 in chips)
Seat 6: c5939d3f ($7.14 in chips)
c5939d3f: posts small blind $0.02
Hero: posts big blind $0.05
*** HOLE CARDS ***
Dealt to Hero [3c 9s]
Dealt to 2b9dfc13 
Dealt to 75954dda 
Dealt to 9c92842a 
Dealt to 4d3453a6 
Dealt to c5939d3f 
2b9dfc13: folds
75954dda: folds
9c92842a: raises $0.08 to $0.13
4d3453a6: folds
c5939d3f: folds
Hero: folds
Uncalled bet ($0.08) returned to 9c92842a
*** SHOWDOWN ***
9c92842a collected $0.12 from pot
*** SUMMARY ***
Total pot $0.12 | Rake $0 | Jackpot $0 | Bingo $0 | Fortune $0 | Tax $0
Seat 1: Hero (big blind) folded before Flop
Seat 2: 2b9dfc13 folded before Flop (didn't bet)
Seat 3: 75954dda folded before Flop (didn't bet)
Seat 4: 9c92842a collected ($0.12)
Seat 5: 4d3453a6 (button) folded before Flop (didn't bet)
Seat 6: c5939d3f (small blind) folded before Flop


